,Date,Country,City,Killed,Injured,Total,Description
1,1/1/2002,Indonesia,Palu,1,0,1,Four bombs explode at Christian churches and one man dies in a hand grenade attack in Jakarta.
2,1/1/2002,India,Baramulla,1,0,1,Terrorists enter the home of a civilian and kill his wife.
3,1/1/2002,India,Poshkar,2,0,2,Two civilians are abducted from their homes then executed by the Mujahideen.
4,2/1/2002,India,Rajouri,6,9,15,Three separate terror attacks in the district leave a civilian and five security forces dead.
5,2/1/2002,India,Jehangir Chowk,2,25,27,A Muslim militant kills two and injures twenty-five in a grenade attack on a city street.
6,3/1/2002,Pakistan,Karachi,1,0,1,A cleric is gunned down in a sectarian attack.
7,4/1/2002,India,Kashmir,2,0,2,Two civilians are abducted and killed by the Mujahideen in separate incidents (Badran and Kulgam).
8,5/1/2002,India,Mahore,2,3,5,An ambush on a security patrol leaves two members dead.
9,6/1/2002,India,Ramsu,3,12,15,Three brothers are killed in their home by Lashkar-e-Toiba terrorists.  A dozen others are injured in the attack.
10,6/1/2002,India,Luddu,4,4,8,"Four civilians, three of whom were in the same family are gunned down when fleeing their home after Jaish-e-Mohammed cadres flush them out with grenades."
11,6/1/2002,USA,"Tampa, FL",0,0,0,Fifteen year-old flies plane into an office building in Tampa. Suicide note reveals his admiration for Osama Bin Laden and desire to commit a terrorist attack.
12,8/1/2002,India,Srinagar,1,2,3,Soldier killed by two Mujahideen suicide attackers.
13,9/1/2002,Israel,Kerem Shalom,4,2,6,Palestinian terrorists infiltrate border and kill four soldiers. Two others were wounded.
14,9/1/2002,Pakistan,Gulshan-i-Iqbal,1,0,1,Government official is killed by Islamists.
15,10/1/2002,India,Bafliaz,1,0,1,Terrorists kill a village official.
16,13/1/2002,India,Beerwah,1,0,1,A civilian is murdered by the Mujahideen.
17,14/1/2002,India,Kashmir,6,3,9,"In separate attacks, three civilians are killed by Islamic militants.  A security checkpoint is attacked as well, with three security forces killed."
18,15/1/2002,Israel,Givat Ze-ev,1,1,2,Woman killed near gas station. Her aunt is injured in the shooting attack by Palestinians.
19,15/1/2002,Israel,Beit Jala,1,0,1,An American citizen is kidnapped then killed by Al-Aqsa Brigade.
20,15/1/2002,India,Keri,2,0,2,A man and his wife are abducted and killed by Lashkar-e-Toiba.
21,16/1/2002,Indonesia,Malei,1,0,1,A Christian man is gunned down by angry Muslims while collecting fruit.
22,16/1/2002,Pakistan,Lahore,0,5,5,Five guards are injured in an Islamist attack on the airport.
23,16/1/2002,Israel,Jenin,1,0,1,Arab killed in Jenin while sitting in a car bearing Israeli license plates.
24,17/1/2002,Israel,Hadera,6,35,41,Terrorist barges into a bat mitzvah reception and kills six guests with an assault rifle. Thirty-five others also shot.
25,17/1/2002,India,Kanak Mandi,2,8,10,Two civilians are killed in a terrorist bombing.  Eight others are injured.
26,18/1/2002,India,Budhan,0,2,2,Two children are injured when a Muslim throws a grenade into a house.
27,20/1/2002,India,Behra,11,3,14,"Muslim terrorists invade a home and slaughter eight children, two women and one man in a bloody rampage."
28,22/1/2002,Israel,Jerusalem,2,40,42,"Palestinian terrorist fires assault rifle into a bus-stop, killing two women and injuring forty others."
29,22/1/2002,Bangladesh,Kolkata,5,20,25,Five guards at the American Center are killed in a drive-by shooting attack by Islamists.
30,23/1/2002,India,Donipora-Kantpora,2,0,2,Two civilians are abducted and murdered by the Mujahideen.
31,24/1/2002,India,Sathra,1,3,4,A security officer is killed in an ambush by Muslim militants.
32,26/1/2002,India,Hala,2,0,2,The Mujahideen murder a man and his mother inside their home.
33,27/1/2002,Israel,Jerusalem,1,150,151,An 81-year-old is killed and over one-hundred and fifty injured by suicide bomber armed with more than 10k of explosives.
34,27/1/2002,India,Pingla Dai,2,0,2,Two civilians are killed by Islamic terrorists at their village.
35,30/1/2002,India,Lachipora,2,0,2,An off-duty police officer and a family member are killed in their home by the Mujahideen.
36,31/1/2002,India,Reasi,3,5,8,"Islamic militants lob a grenade at the families of migrant workers, killing three, including two infants."
37,31/1/2002,India,Sarhuti,1,1,2,Two family members are injured in a Mujahideen attack on their home.  One later dies of injuries.
38,31/1/2002,India,Soo Bathoi,2,0,2,Pakistani-backed militants abduct two civilians and kill them in captivity.
39,1/2/2002,India,Srinagar,1,0,1,Muslim separatists assassinate an independent newspaper editor in his office.
40,1/2/2002,India,Dodabug,2,0,2,A political activist and his bodyguard are gunned down.
41,1/2/2002,India,Sangrawas,2,0,2,Two civilians are abducted and murdered by Muslim terrorists.
42,3/2/2002,Algeria,al-Medya,12,8,20,Five Islamic fundamentalists set up a false roadblock and proceed to slaughter a dozen unlucky motorists.
43,4/2/2002,Bangladesh,Chittagong,1,3,4,"Jamaat-e-Islami militants set off a series of bombs at a press club, killing at least one person."
44,4/2/2002,Pakistan,Jhang,1,0,1,Two Muslim terrorists gun down a cop involved in anti-terror activities.
45,4/2/2002,India,Batfozen,3,0,3,"Islamic militants attack two women in their home, brutally killing them along with the young daughter of one."
46,4/2/2002,Algeria,Seidi Lakhder,22,3,25,Most of the 25 victims were from the same family and were killed for trying to defend themselves. Knives and bullets were used by the Muslim radicals.
47,6/2/2002,Israel,Moshav Hamra,3,0,3,Three people including a mother and her 11-year-old daughter are killed in a home invasion by an armed terrorist.
48,7/2/2002,India,Chillar,1,0,1,A civilian is abducted and tortured to death by the Mujahideen.
49,8/2/2002,Israel,Jerusalem,1,0,1,A 25-year-old Israeli is stabbed to death by four Palestinian teen-agers.
50,9/2/2002,Israel,Ariel,1,0,1,Elderly man shot to death in a Palestinian ambush while driving car.
51,10/2/2002,Israel,Be'er Sheva,2,4,6,Drive-by shooting leaves two young Israelis dead and four others wounded.
52,10/2/2002,Algeria,Bouqra,6,0,6,Islamic fundamentalists slaughter a family of six in a senseless and barbaric attack.
53,12/2/2002,Pakistan,Karachi,1,0,1,A doctor is gunned down outside his clinic in a sectarian attack.
54,12/2/2002,India,Parori Gujaran,3,1,4,Three security forces are killed by Muslim terrorists in a shootout.
55,13/2/2002,India,Bathian,1,0,1,Islamic militants kill a party activist and burn his house.
56,14/2/2002,India,Thanna Mandi,1,0,1,A woman is killed by a group of Muslims.
57,15/2/2002,Algeria,Jejil,3,1,4,Three members of the Algerian self-defense forces are killed in a bombing by Islamic fundamentalists.
58,15/2/2002,India,Kashmir,3,0,3,"Three civilians are murdered by terrorists in separate attacks (Gowran, Markpora Sumbal and woman at Darhal)."
59,16/2/2002,India,Narala,8,7,15,"In a horrible attack, Lashkar-e-Toiba terrorists massacre eight members of two families, including two women and four children."
60,16/2/2002,Israel,Karnei Shomron,3,30,33,Three teen-agers are blown apart by a Muslim suicide bomber at a pizzeria. Thirty others injured.
61,18/2/2002,Israel,Gush Katif,3,1,4,Three Israelis are killed in a Palestinian shooting attack.
62,19/2/2002,India,Gool,2,0,2,"Two people, including a civilian, are killed in an IED attack by the Mujahideen."
63,19/2/2002,India,Kishtwar,1,16,17,"A civilian is killed, and sixteen others injured in a grenade attack by Muslim terrorists."
64,19/2/2002,Israel,Ramallah,6,1,7,Six soldiers are killed when terrorists open fire at a roadblock.
65,22/2/2002,Israel,Jerusalem,1,0,1,A 59-year-old man is murdered by a Palestinian terrorist while driving home from work.
66,22/2/2002,Pakistan,Karachi,1,0,1,"Jewish journalist Daniel Pearl is kidnapped, held for several weeks, then killed by five Islamics. Videotape shows throat being cut."
67,22/2/2002,India,Aragam,2,2,4,"The Mujahideen attack four civilians, killing two of them."
68,23/2/2002,India,Wagbal,1,1,2,"A man is murdered by the Mujahideen, who also seriously injure his sister."
69,24/2/2002,Nigeria,Gombi,1,0,1,"A young Christian woman is kidnapped by four Muslim men, who slit her throat and leave her to die."
70,24/2/2002,Morocco,Casablanca,1,0,1,An 'impious' Muslim is stoned to death.
71,25/2/2002,Israel,Neve Ya'akov,1,2,3,One killed and two injured by a Palestinian terrorist while waiting for a bus.
72,25/2/2002,Israel,Tekoa,2,1,3,An Islamic terrorist kills two Jews and injures one other in a shooting attack.
73,26/2/2002,India,Gujarat,59,38,97,"In a horrific and senseless attack, a group of militant Muslims set fire to a train carrying Hindu pilgrims. Fifty-nine innocents are burned to death, including fifteen children."
74,26/2/2002,India,Kashmir,2,1,3,"Two civilians are killed in separate attacks by the Mujahideen (Moila, Newatta)."
75,26/2/2002,Pakistan,Rawalpindi,10,21,31,"Ten Shias are slaughtered, as Sunnis open up with automatic weapons at point-blank range at a mosque.  At least twenty others are injured."
76,27/2/2002,Nigeria,Ilorin,3,0,3,Eid-el-Kabir celebrants kill three Christians.
77,27/2/2002,India,Tangwari,1,1,2,The Mujahideen pull a man from a passenger bus and execute him by the roadside.
78,28/2/2002,Israel,Atarot,1,0,1,Jewish employer killed by a Muslim employee. Fatah takes credit for this attack.
79,28/2/2002,Pakistan,Karachi,2,11,13,"Islamists ambush a prisoner transport, killing a guard and a prisoner."
80,28/2/2002,India,Udhampur,2,0,2,Separate attacks by the Mujahideen leave a police officer and a civilian dead.
81,2/3/2002,India,Roshli,2,0,2,A man and wife are abducted from their home and killed by Muslim terrorists.
82,2/3/2002,Israel,Jerusalem,10,52,62,"Ten people, mostly women and small children were killed by a suicide bomber. Most were waiting with baby carriages for their husbands to return from the synagogue."
83,2/3/2002,Israel,Mar Saba,1,0,1,Jerusalem police detective assassinated by Tanzim while on holiday in the desert.
84,3/3/2002,Israel,Kissufim,1,4,5,Soldier killed at a roadblock by Palestinian gunman. Four others injured.
85,3/3/2002,Israel,Ofra,10,6,16,Hamas terrorist kills ten and wounds six by opening fire at a roadblock.
86,3/3/2002,India,Kashmir,2,0,2,"Two civilians are killed in separate terror attacks (Handwara, Yaripora)."
87,4/3/2002,India,Morha Pathana,4,0,4,The Mujahideen abduct and massacre four civilians in a brutal attack.
88,4/3/2002,Pakistan,Khyaban-e-Hafiz,1,0,1,A doctor is killed by two gunmen in a sectarian attack.
89,5/3/2002,Israel,Afula,1,17,18,85-year-old man is killed in a Fedayeen suicide bombing at a bus station.
90,5/3/2002,Israel,Bethlehem,1,1,2,A female motorist gunned down by a Palestinian sniper. Her husband is badly injured.
91,5/3/2002,Israel,Tel Aviv,3,30,33,Three Israelis are killed and more than thirty injured when two Muslim gunmen open fire at adjacent restaurants.
92,6/3/2002,Israel,Khan Yunis,2,0,2,Two Israeli soldiers are killed in a Palestinian ambush.
93,7/3/2002,Nigeria,Enugu,12,0,12,"Muslim gunmen storm a Christian prayer meeting attempting to kill the leader. Twelve are killed, an unknown number injured."
94,7/3/2002,Pakistan,Lyari,1,0,1,Another physician is killed in a sectarian attack on his car.
95,7/3/2002,India,Kashmir,3,0,3,"In separate attacks (Watnar, Mendhar, Androon) three civilians are killed after being taken captive."
96,7/3/2002,Israel,Gush Katif,5,23,28,Five Israeli teen-agers are killed and twenty-three are injured by a Palestinian sniper in a heinous shooting.
97,8/3/2002,Algeria,al-Bleida,6,0,6,"Islamic attackers open fire on a civilian vehicle then set the car on fire, killing a half-dozen people."
98,8/3/2002,Israel,Tulkarm,1,0,1,An Israelis soldier is killed by a Palestinian sniper.
99,8/3/2002,Pakistan,Multan,1,0,1,A retired Shia banker is killed by radical Sunnis in his shop.
100,9/3/2002,Pakistan,New Karachi,1,1,2,"A doctor is gunned down by Sunnis on motorcycles, who also injure a patient."
101,9/3/2002,Israel,Jerusalem,11,54,65,A Hamas (Islamic Resistance) suicide bomber kills eleven and injures 54 at a crowded cafe.
102,9/3/2002,Israel,Netanya,2,50,52,The Fatah Al-Aqsa Brigades takes credit for killing a 9-month-old infant and one other in grenade attack that also left 50 others injured.
103,10/3/2002,Pakistan,Akora Khattak,2,20,22,"Bomb rocks a local exhibition, killing at least two."
104,10/3/2002,India,Chak Seri,1,1,2,"The Mujahideen abduct two civilians, later executing one of them.  Fate of the other is unknown."
105,11/3/2002,Pakistan,Muzaffargarh,4,0,4,Four people are killed in sectarian violence between Shias and Sunnis.
106,12/3/2002,Israel,Metzuba,6,7,13,"Gunmen disguised in IDF uniforms ambush a bus and kill six, wound seven."
107,12/3/2002,Pakistan,Karimabad,1,0,1,A Shia doctor is gunned down outside his clinic.
108,12/3/2002,India,Kashmir,4,0,4,Four civilians are abducted and murdered by the Mujahideen in separate attacks.
109,13/3/2002,India,Morha Kuthyani,2,0,2,A civilian and his son are shot to death by radical Muslims.
110,13/3/2002,India,Nowshera,2,0,2,Islamic rebels rape a Hindu woman before killing her and her son.  The bodies are left in the forest.
111,14/3/2002,Israel,Gaza,3,2,5,Terrorists detonate a bomb by remote control that kills three Israelis and injures two.
112,16/3/2002,Pakistan,Jhang,5,0,5,Five policemen are gunned down by Islamists.
113,17/3/2002,Pakistan,Islamabad,5,45,50,Grenade attack on a Christian church kills five worshippers including American woman and her 17-year-old daughter. Forty-five others were injured.
114,17/3/2002,Israel,Kfar Saba,1,16,17,"A Palestinian terrorist opens fire on motorists, taking the life of a teenager and injuring sixteen others."
115,18/3/2002,Pakistan,Quetta,1,0,1,A party activist is killed in a sectarian attack.
116,19/3/2002,Algeria,Algiers,0,13,13,Thirteen injured by home-made bomb at the post office set by Islamic fundamentalists.
117,19/3/2002,Algeria,Souq al-Had,4,0,4,Four farmers are ambushed and killed by armed Islamic fundamentalists.
118,19/3/2002,Algeria,Souq al-Had,6,0,6,"Islamic fundamentalists kill six victims, all from the same family. The father and mother were beheaded - the four children mutilated."
119,19/3/2002,USA,"Tuscon, AZ",1,0,1,A 60-year-old man is gunned down by Muslim snipers on a golf course.
120,19/3/2002,Pakistan,Lahore,3,0,3,"Three people, including a professor, are killed in two sectarian attacks."
121,19/3/2002,India,Plangar,1,0,1,Militant Muslims hang a young girl.
122,20/3/2002,India,Dogripora,2,5,7,Two children are killed by a Mujahideen IED blast.
123,20/3/2002,Israel,Musmus,7,30,37,Seven passengers are killed when a Fedayeen suicide bomber blows up a passenger bus.  Thirty others are injured in the blast.
124,21/3/2002,Israel,Jerusalem,3,86,89,Suicide bomber kills three and injures eighty-six when detonating in a crowd of shoppers.
125,21/3/2002,Pakistan,Karachi,1,0,1,The Shia owner of a video shop is gunned down by militant Sunnis.
126,21/3/2002,India,Damhal Hanjipora,0,14,14,Fourteen people are injured when a Muslim radical throws a grenade at a bus stop.
127,22/3/2002,India,Shopian,0,35,35,Thirty-five people sustain injury when a Fedayeen hurls a grenade into a crowded market.
128,23/3/2002,India,Srinagar,2,20,22,A woman is among two people killed by Lashkar-e-Toiba in a grenade attack.
129,24/3/2002,Israel,Ramallah,1,0,1,A woman is killed by a Palestinian sniper while riding on a bus.
130,24/3/2002,India,Kashmir,6,2,8,Lashkar-e-Toiba terrorists are thought responsible for three attacks that leave six security force members dead.
131,25/3/2002,India,Malanu,1,0,1,A man is abducted and tortured to death by the Mujahideen.
132,27/3/2002,Israel,Netanya,29,133,162,Hamas (Islamic Resistance) bomber kills twenty-nine Jews celebrating Passover in a hotel. One-hundred and thirty-seven others are injured in the attack.
133,28/3/2002,Israel,Elon Moreh,4,0,4,"A 20-year-old man, his two middle-aged parents and his grandfather were killed during a home invasion by a Muslim gunman."
134,29/3/2002,Israel,Jerusalem,4,28,32,Two security guards are killed and twenty-eight people injured by a suicide bomber. Two soldiers were also killed by Palestinians in Ramallah.
135,29/3/2002,Israel,Neztarim,2,0,2,Two elderly Jews are killed by a Palestinian terrorist.  Two Palestinian groups claim credit.
136,29/3/2002,India,Rajouri,2,0,2,The Mujahideen burn houses and kill two civilians.
137,29/3/2002,India,Kalakote,2,1,3,A Fedayeen attack kills two border guards.
138,30/3/2002,India,Jammu,7,20,27,"A Fedayeen attack on a Hindu temple kills seven people, including a female pilgrim."
139,30/3/2002,Israel,Tel Aviv,1,30,31,"A 36-year-old woman is murdered, and thirty others wounded by a suicide bomber in a cafe."
140,31/3/2002,Israel,Haifa,15,40,55,Fifteen Israelis are killed in a restaurant by a Fedayeen suicide bomber. Over forty others are burned and maimed in the explosion.
141,31/3/2002,Pakistan,Bahawalpur,2,0,2,A mosque caretaker and his son are killed in a sectarian attack.
142,31/3/2002,India,Azmatabad,1,0,1,A man is killed inside his home merely for being the brother of a police officer.
143,1/4/2002,Pakistan,Spin Qaira,2,12,14,"Bomb explodes on a passenger bus, killing at least two people."
144,1/4/2002,India,Bowan-Watsar,1,1,2,Islamic terrorists kill a teacher inside his home in an attack that also injures his young son.
145,2/4/2002,India,Tabaloo-Sung,2,0,2,Two policemen are killed in a village ambush by the Mujahideen.
146,3/4/2002,India,Chanchora,2,1,3,"Terrorists attack the house of a civilian, killing his son.  Elsewhere (Handwara) a man is abducted and murdered."
147,4/4/2002,India,Lopra,1,0,1,A public works employee is murdered outside his residence.
148,4/4/2002,India,Baramulla,4,0,4,"In a brutal attack, Tehreek-e-Jehad-e-Islami members enter the house of a civilian and shoot him to death, along with his wife, daughter and another girl."
149,4/4/2002,Indonesia,Ambon,5,57,62,"An Islamist throws a bomb into a Christian center, killing five and injuring fifty-seven other innocents."
150,6/4/2002,Israel,Rafiah Yam,1,5,6,"Palestinian gunman opens fire at the entrance to a settlement. One is killed, five are wounded."
151,8/4/2002,Afghanistan,Jalalabad,9,92,101,"A terrorist bomb explodes near a government convoy. Nine are killed, ninety-two are injured."
152,8/4/2002,India,Dandli Dansal,8,6,14,"A horrific assault by Hizbul Mujahideen on a village leaves seven persons, including three children and two women dead.  Another child subsequently dies of injuries."
153,9/4/2002,India,Kulgam,2,0,2,Two brothers are abducted and murdered by Lashkar-e-Toiba.
154,9/4/2002,India,Kokernag,2,11,13,"A grenade attack by militant Muslims leaves two civilians dead and eleven others, including three girls, critically injured."
155,9/4/2002,Israel,Jenin,13,7,20,Thirteen IDF reservists are killed and seven injured by the combined efforts of a very young Palestinian suicide bomber and supporting gunfire.
156,10/4/2002,Israel,Yagur,8,22,30,Eight people are killed by a Muslim bomber while riding on a bus. Twenty-two others are injured in the attack.
157,11/4/2002,Tunisia,Erriadh,21,18,39,Islamic suicide bomber kills twenty-one in an attack on town's oldest synagogue. Youngest fatality is an 11-year-old German boy.
158,12/4/2002,Israel,Jerusalem,6,104,110,"Six people, including two Chinese nationals, are killed by a Palestinian suicide bomber at a bus stop in an attack that leaves one-hundred and four others injured."
159,12/4/2002,India,Kashmir,10,17,27,Four separate Fedayeen attacks across the region leave ten innocents dead and at least seventeen others injured.
160,13/4/2002,India,Bonkoot,1,2,3,A Mujahideen attack on a security patrol leaves one member dead.
161,14/4/2002,India,Pulwama,1,9,10,A grenade lobbed onto the road by a militant Muslim kills a civilian and injures nine others.
162,15/4/2002,India,Doda,1,0,1,A woman is cut down by Muslim terrorists.
163,16/4/2002,India,Srinagar,2,0,2,The Mujahideen kills two civilians with an IED.
164,16/4/2002,India,Awantipora,2,4,6,Two civilians are killed in a bomb blast at a market.
165,18/4/2002,India,Dooru,1,0,1,A civilian is abducted and killed by Islamic terrorists.
166,20/4/2002,India,Milan,3,4,7,"The Mujahideen attacks a security patrol, killing three members."
167,20/4/2002,India,Sagarian Azmatabad,2,0,2,Islamists kill a man and his grandmother at their residence.
168,21/4/2002,Pakistan,Karachi,1,0,1,A physician succumbs to injuries suffered in a sectarian attack.
169,22/4/2002,India,Kashmir,3,0,3,"In separate attacks, two people are abducted and killed, and a woman is killed inside her home by Islamic militants."
170,22/4/2002,India,Nagam,2,0,2,Two laborers are shot to death by Islamic terrorists.
171,23/4/2002,India,Shopian,1,3,4,Four students are kidnapped and 'severely' tortured.  A 15-year-old dies and the others are freed.
172,23/4/2002,Bangladesh,Chittagong,1,0,1,A Buddhist monk is stabbed to death by Islamic terrorists after returning home from prayers.
173,24/4/2002,Algeria,al-Jeije,16,0,16,"Fundamentalists kill a total of sixteen includes eight children and four women, all from the same family."
174,25/4/2002,India,Gharat Morh,1,2,3,A civilian is killed when Islamic militants lob a bomb under a passenger bus.  Twenty-one others are injured.
175,25/4/2002,Pakistan,Lahore,12,25,37,"Radical Sunnis bomb a Shia ceremony, slaughtering twelve, including seven women and five children.  Twenty-five others suffer injury."
176,25/4/2002,India,Dharmsal,2,0,2,Two civilians are abducted by militant Muslims.  Their bodies are recovered four days later.
177,25/4/2002,Algeria,Mashraat Sava,4,0,4,Armed Islamic attack kills four people.
178,27/4/2002,Israel,Adora,4,7,11,"Palestinian terrorists dressed in IDF uniforms infiltrate a settlement and killed four civilians, including a 5-year old boy. Seven others were injured."
179,28/4/2002,Sudan,Shoba Karika,24,23,47,"An Arab militia attacks two villages, killing about two dozen African civilians and burning many houses.  At least that many are injured as well."
180,28/4/2002,Indonesia,Soya,12,6,18,Muslims attack a Christian village with knives and guns. They are able to slaughter twelve people and hurt six more.
181,29/4/2002,India,Sangarwani Keller,1,0,1,A civilian is abducted and murdered by the Mujahideen.
182,1/5/2002,Pakistan,Muzaffarabad,1,4,5,A bombing kills a 5-year-old boy and injures four of his family members.
183,1/5/2002,Pakistan,Karachi,0,20,20,"Two blasts, occurring at a market and a nursery, injure twenty, including children."
184,1/5/2002,Bangladesh,Natore,1,25,26,"Islamic fundamentalists bomb a cinema, killing a young boy and injuring two dozen others."
185,2/5/2002,Algeria,Sedi Khaled,11,0,11,"Eleven civilians, including children, are massacred by Islamic fundamentalists."
186,2/5/2002,Algeria,Kasar Shalala,20,5,25,Islamist attack on civilians in the Teyart region leaves twenty dead.
187,2/5/2002,Pakistan,Karachi,1,4,5,A man is killed by a bomb in his own home.  Four family members are injured.
188,2/5/2002,India,Athwatoo,1,0,1,A civilian is abducted and murdered by the Mujahideen.
189,3/5/2002,India,Bandipore,3,0,3,Islamists behead two brothers and shoot another civilian dead in a separate attack.
190,4/5/2002,India,Madiyani,5,0,5,"Hizb-ul-Mujahideen murder five people, including two brothers and a father and son in an overnight raid."
191,5/5/2002,Pakistan,Karachi,1,0,1,A Sunni activist is slain in a sectarian attack.
192,5/5/2002,India,Kashmir,2,0,2,Two civilians are murdered by the Mujahideen in separate attacks (Hajipora & Budhal).
193,5/5/2002,Pakistan,Karachi,1,0,1,Policeman killed by Islamist gunmen.
194,6/5/2002,Pakistan,Karachi,3,0,3,"Three persons - principal of a government institute, his driver and assistant - are killed in an ambush by armed fundamentalists."
195,7/5/2002,Israel,Rishon Lezion,15,55,70,Fifteen people are killed and fifty-five more injured in a Fedayeen suicide attack on a crowded game club.
196,7/5/2002,Pakistan,Lahore,3,0,3,"Noted religious scholar Ghulam Murtaza Malik, his driver and a police personnel are shot to death by Islamists.."
197,7/5/2002,Pakistan,Karachi,1,0,1,Another sectarian killing by two gunmen.
198,8/5/2002,India,Morha Bagla,1,0,1,Two Jihad terrorists kill a man after getting directions from him.
199,8/5/2002,Pakistan,Karachi,16,34,50,Twelve French nationals and four Pakistanis are killed and 34 more injured in a suicide bombing against a bus opposite Sheraton Hotel.
200,9/5/2002,Dagestan,Kaspiisk,45,170,215,"Chechen terrorists detonate a bomb at a Russian military parade, slaughtering forty-five innocents and injuring more than one-hundred and seventy."
201,9/5/2002,Pakistan,Rawalpindi,2,1,3,Two policemen killed and one injured in Islamist attack.
202,9/5/2002,India,Dalwa,1,1,2,"Lashkar-e-Toiba abduct two brothers who refuse to join them.  Both are tortured, with one dying."
203,10/5/2002,India,Kither,1,1,2,The Mujahideen kill one civilian and severely injure another in their homes.
204,10/5/2002,India,Nandipora-Beerwah,2,0,2,A man and his elderly father are killed inside their home by militant Muslims.
205,12/5/2002,India,Butshungni-Winder,2,2,4,"The Mujahideen kill two civilians, critically injure another and abduct a fourth."
206,13/5/2002,India,Sarawa,1,0,1,Lashkar-e-Toiba terrorists force their way into a home and kill a man's son for his refusal to join them.
207,14/5/2002,Algeria,Baraqi,5,0,5,Five policeman are assassinated by fundamentalists in two separate attacks (first attack was in Dali Ibrahim).
208,14/5/2002,Algeria,Tazmalt,7,5,12,Religious fundamentalists set off a bomb at the entrance to a market.
209,14/5/2002,India,Kaluchak,36,48,84,"Islamic militants raid a military camp, killing thirty-six people, mostly the wives and children of Indian soldiers, including a 2-month-old child."
210,16/5/2002,Indonesia,Tamonjeka,2,0,2,Two Christian men are killed by suspected Muslim radicals.
211,17/5/2002,India,Bonkoot,1,1,2,Jaish-e-Mohammed murder an 18-year-old and injure his mother as she tries to protect him.
212,17/5/2002,India,Jammu,2,16,18,Two are killed in militant Muslim bomb blast.
213,19/5/2002,India,Chasana,4,7,11,Fedayeen attack on Indian military camp kills four and leaves seven injured.
214,19/5/2002,Israel,Netanya,3,59,62,A Palestinian suicide bomber kills three and injures fifty-nine other shoppers at a market.
215,21/5/2002,Pakistan,Karachi,1,12,13,One person is killed in a sectarian attack on a Shia religious procession.
216,22/5/2002,Israel,Rishon Lezion,2,40,42,A Palestinian suicide bomber kills two and injures forty people at a shopping mall.
217,22/5/2002,India,Kashmir,5,3,8,Five people are killed by the Mujahideen in four separate attacks.
218,22/5/2002,Pakistan,Gulistan-e-Mustafa,1,0,1,A Sunni activist is killed in a sectarian attack.
219,23/5/2002,India,Kashmir,2,10,12,"Two civilians are separately abducted and murdered by the Mujahideen (Kandi, Warpora).  Ten others are injured in a grenade attack at a bus station."
220,24/5/2002,India,Kupwara,2,0,2,Two civilians are killed in separate attacks by Islamic terrorists (one in captivity).
221,25/5/2002,India,Shopian,9,0,9,Nine persons are injured in a grenade attack on a city street.
222,25/5/2002,Indonesia,Saparua,5,11,16,A Muslim boat attack kills five Christians and wounds eleven others.
223,27/5/2002,USA,"Denton, TX",1,0,1,Muslim snipers kill a man as he works in his yard.
224,27/5/2002,Israel,Petah Tikva,2,37,39,Fatah takes credit for killing a 14-month-old baby and her grandmother near an ice-cream parlor in an attack that also injured thirty-seven.
225,28/5/2002,Israel,Itamar,3,2,5,Palestinian gunman kills three teenagers and injures another two. All youths were playing basketball in their community at the time.
226,28/5/2002,India,Sharat Shopian,2,0,2,The Mujahideen murder two sisters.
227,30/5/2002,Pakistan,Karachi,1,0,1,The female principle of a private school is shot to death by Islamists as she is walking to the building.
228,30/5/2002,India,Thanna Mandi,2,1,3,A female police officer and a civilian are killed in a Mujahideen attack.
229,30/5/2002,India,Thuru,2,0,2,Two security personnel are killed in a Jihad ambush.
230,30/5/2002,India,Doda,3,3,6,A Fedayeen attack on a police station leaves three officers dead and three injured.
231,31/5/2002,India,Gonikhan,1,16,17,A Jihadi kills a young child and injures sixteen others with a grenade.
232,31/5/2002,India,Srinagar,0,14,14,Fourteen people are critically injured in a grenade attack by a militant Muslim.
233,1/6/2002,India,Anantnag,0,18,18,Three women are among eighteen victims of a grenade attack on a city street.
234,2/6/2002,England,"Orpington, Kent",1,0,1,33-year-old British man beaten to death by a Muslim gang.
235,2/6/2002,Philippines,Jolo,1,2,3,Abu Sayyaf militants abduct three sailors and hold them for nearly a year.  Two escape and one is executed.
236,2/6/2002,India,Kashmir,2,0,2,Two civilians are murdered is separate Mujahideen attacks (Gudder & Botingo).
237,3/6/2002,India,Dureja,1,0,1,Muslims kill a woman for granting official approval to an inter-religious marriage.
238,5/6/2002,India,Bangalore,2,0,2,A Christian man and his Muslim wife are captured and hacked to death by her family for marrying outside Islam.  Their one-year-old baby is spared.
239,5/6/2002,India,Kashmir,3,0,3,Three civilians are killed by Jihadis in separate attacks.
240,5/6/2002,Indonesia,Tentena,4,17,21,"A bomb planted by Muslim radicals explodes on a church bus killing four, including the pastor, and wounding seventeen."
241,5/6/2002,Israel,Afula,17,38,55,Seventeen people killed by a Muslim suicide bomber while riding in a bus. Thirty-eight others were injured.
242,6/6/2002,Afghanistan,Kabul,2,0,2,The country's Deputy President and his driver are assassinated by the Taliban.
243,6/6/2002,Nigeria,Katsina,1,0,1,A Muslim mob clubs a Christian police officer to death after a cleric makes false charges that he trampled a Qur'an.
244,8/6/2002,India,Sultan Pathri,3,0,3,Three security forces are killed in a Mujahideen ambush.
245,8/6/2002,India,Mahore,4,0,4,Four village guards are captured and killed by Muslim terrorists posing as policemen.
246,9/6/2002,Indonesia,Kayamanya,1,0,1,An older Christian man is beheaded by a Muslim.
247,9/6/2002,India,Berneli,4,0,4,"In a brutal slaying, Islamic terrorists abduct four brothers from a wedding party, then execute them."
248,9/6/2002,India,Poonch,1,0,1,Jihadis kill a woman and set fire to three homes.
249,9/6/2002,Pakistan,Mashkey,2,0,2,A BNP party leader is assassinated along with an associate.
250,10/6/2002,Afghanistan,Kabul,1,0,1,A government official is stabbed to death by a crowd of Muslims.
251,10/6/2002,India,Gambhir Mugalan,1,0,1,"Militant Muslims abduct a girl on the day of her wedding, then cut off her head."
252,10/6/2002,India,Kashmir,3,0,3,"The Mujahideen kill three civilians in separate attacks, including a school teacher."
253,11/6/2002,Pakistan,Lahore,1,0,1,A man is murdered in prison by a member of the Anjaman-e-Sipahe Sahaba extremist group after being sentenced for blasphemy.
254,11/6/2002,India,Surankote,2,0,2,"Two civilians are abducted, tortured and killed by militant Muslims."
255,11/6/2002,Algeria,al-Medya,12,9,21,Armed Islamists open fire on a train.  One dozen passengers are murdered and several more are injured.
256,13/6/2002,India,Dharam Chowki,2,0,2,Muslim terrorists force entry into two houses and behead two civilians.
257,14/6/2002,Pakistan,Karachi,10,51,61,"Ten persons, including five women, killed and fifty-one others injured in a car-bomb blast outside the US Consulate."
258,15/6/2002,Pakistan,Faisalabad,0,1,1,A 16-year-old Christian girl is doused with acid for refusing to convert to Islam.
259,15/6/2002,India,Bindra,3,1,4,"Lashkar-e-Toiba terrorists lob a grenade at a group of Hindus returning from a pilgrimage, killing three children and injuring an adult."
260,16/6/2002,India,Balmakote,5,3,8,Five villagers are killed by Jihadis in an overnight attack.
261,17/6/2002,Pakistan,Multan,3,0,3,Radical Sunnis open fire on Shia worshippers as they are leaving a mosque.  Three people are killed.
262,18/6/2002,Israel,Jerusalem,19,50,69,"Several children on their way to school are among the nineteen dead and fifty injured by Fedayeen (""holy warrior"") suicide attack on a bus."
263,18/6/2002,India,Branwar,2,0,2,"The Mujahideen barge into the home of a civilian and kill him, along with his wife."
264,19/6/2002,India,Khanyar,1,0,1,A political activist is killed by al Umar Mujahideen.
265,19/6/2002,Israel,Jerusalem,7,35,42,"One day after killing nineteen Jews, a second Muslim blows up a bus-stop killing seven more. Thirty-five are injured."
266,20/6/2002,Israel,Itamar,4,4,8,Mother and three young sons killed in their home by Muslim invader.
267,21/6/2002,India,Kashmir,2,0,2,Two civilians are abducted and murdered by the Mujahideen (Zallah Charote & Bandipora).
268,26/6/2002,India,Chak Rishipora,2,0,2,A man and his wife are shot to death in their home by Muslim terrorists.
269,27/6/2002,Pakistan,Multan,1,0,1,A Shia activist is shot to death in a sectarian attack.
270,27/6/2002,India,Lal Chowk,1,37,38,"A woman is killed, and thirty-seven others injured when a militant Muslim hurls a grenade into the street."
271,27/6/2002,India,Gurwatan Bahak,5,0,5,Five members of a family of shepherds are massacred by the Mujahideen.
272,27/6/2002,Pakistan,Kachi Abadi,1,2,3,15-year old Christian tortured to death by police for blasphemy. In the same country a 17-year old Christian girl was blinded from having acid thrown in her face and another girl was raped (occurring on different days).
273,27/6/2002,Algeria,Bou Ismail,2,0,2,Two Islamic terrorists shot dead a bus driver and one passenger.
274,28/6/2002,Algeria,Algiers,13,0,13,"Islamic radicals riddle a bus with machine guns. Thirteen people are killed, an unknown number are wounded."
275,28/6/2002,India,Kakran-Kulgam,1,0,1,A policeman is abducted and murdered by the Mujahideen.
276,29/6/2002,India,Basuni,3,0,3,Three migrant workers are kidnapped and killed by Islamic terrorists.
277,30/6/2002,India,Gadyari,1,0,1,"The Mujahideen attack a wedding, killing a civilian."
278,1/7/2002,India,Kashmir,3,0,3,The Mujahideen murder three civilians in separate attacks.
279,2/7/2002,India,Singhpura Chatru,1,0,1,A man is abducted from his home and killed by Muslim terrorists.
280,3/7/2002,Indonesia,Landangan,1,0,1,Muslim gunmen murder a Christian man.
281,3/7/2002,Pakistan,Kohat,2,2,4,Two Pakistani security forces are killed when al-Qaeda militants stage an attack on a bridge.
282,4/7/2002,USA,Los Angeles,2,0,2,Muslim gunman kills two people waiting at the El Al counter in the LAX airport.
283,4/7/2002,India,Kashmir,2,0,2,Two civilians are killed in their homes by the Mujahideen (Bandipora & Shah Mohallah).
284,5/7/2002,India,Khansaheb,0,16,16,"Muslim militant lobs a hand grenade at a group of Hindus, injuring sixteen, including four women."
285,5/7/2002,India,Gandoh,3,1,4,A village herdsman is among three people killed by Islamic militants in separate attacks.
286,5/7/2002,Algeria,al-Arbaa,49,17,66,Bomb explosion results in the largest number of killings by Islamic fundamentalists since the beginning of the year.
287,7/7/2002,Indonesia,Wayura,1,0,1,A Christian fisherman is shot in the head by suspected Islamists.
288,7/7/2002,Algeria,Algiers,6,0,6,Six persons including four children were stabbed to death by Islamic extremists while grazing sheep.
289,7/7/2002,Philippines,Unknown,2,1,3,Kidnapped American missionary and Philippine nurse are killed during rescue attempt.
290,7/7/2002,India,Handwara,1,0,1,A boy is shot and killed by Muslim terrorists.
291,7/7/2002,India,Kasblari,1,0,1,The Mujahideen intrude into a residence and behead and elderly man who refuses to give up the location of his son and grandson.
292,10/7/2002,India,Surankote,1,0,1,"The body of a civilian, kidnapped and beheaded by the Mujahideen, is recovered."
293,11/7/2002,India,Warpora,1,0,1,A man is killed by the same Muslim terrorists who killed his brother two years earlier.
294,11/7/2002,India,Ghat Palhalan,2,1,3,"Islamists attack a marriage party, killing two civilians and injuring another."
295,12/7/2002,Indonesia,Kawua,1,4,5,Islamic bombers nearly crash a bus carrying Christians.  Only one passenger is killed by the explosion.
296,13/7/2002,India,Jammu,28,30,58,"Lashkar-e-Toiba terrorists staged an attack on a Hindu shantytown, killing twenty-eight and injuring more than thirty with grenades and firearms."
297,13/7/2002,Pakistan,Mansehra,0,12,12,"Twelve persons, including seven Germans, injured in a terrorist attack at an Archaeological site."
298,13/7/2002,Algeria,Algiers,10,0,10,Victims in two separate attacks by fundamentalists include four women and two children from one family.
299,13/7/2002,India,Khrew,1,0,1,Hizb-ul-Mujahideen cadres gun down a civilian in his home.
300,14/7/2002,India,Rajdhani,1,0,1,A woman is murdered in her home by Muslim terrorists.
301,15/7/2002,India,Sambora,1,0,1,A man is gunned down by the Mujahideen while traveling down a road.
302,16/7/2002,India,Sarna,1,0,1,Islamic militants kill a village headsmen in his home.
303,16/7/2002,Algeria,Wilad Alal,7,0,7,"Seven family members slaughtered by Islamic fundamentalists, including a father, mother and three children ages 4, 12, and 14."
304,17/7/2002,Israel,Tel Aviv,3,40,43,Dual Palestinian suicide attack on an Israeli convenience store leaves at least three dead and more than forty injured.
305,17/7/2002,Israel,Emmanuel,7,26,33,Palestinian attack on a bus kills at least seven and injures twenty-six.
306,17/7/2002,India,Bonkoot,3,3,6,Three security forces are killed in a Fedayeen ambush.
307,17/7/2002,India,Kashmir,3,0,3,"Three people, including a 16-year-old boy, are killed by Muslims in separate terror attacks."
308,17/7/2002,India,Aishmuqam,3,9,12,"Hizb-ul-Mujahideen kill three people and injure nine, including three women, with a mine blast."
309,19/7/2002,Indonesia,Poso,2,0,2,Two Hindus make easy marks for Muslim snipers.
310,20/7/2002,India,Hill Tak,3,0,3,"Three people are abducted by Muslims, tortured and then beheaded."
311,21/7/2002,India,Wali-Dok,1,0,1,A man abducted from his home is killed in captivity two days later.
312,22/7/2002,Indonesia,Mayoa,0,3,3,Three Christian farmers survive a brutal shooting attack by Jihad warriors.
313,23/7/2002,India,Rajouri,1,27,28,"A young girl is killed, and twenty-seven others injured when a militant Muslim throws a grenade into a city street."
314,23/7/2002,India,Halla,3,0,3,Three brothers are killed by militant Muslims while gathering firewood.
315,24/7/2002,India,Chanser,2,0,2,Two border guards are cut down by the Mujahideen.
316,24/7/2002,India,Anantnag,0,20,20,Twenty persons at a crowded bus stand sustain injuries from an Islamist grenade attack.
317,25/7/2002,India,Batmaloo,1,23,24,"A civilian is killed at a bus stand, and two dozen others injured, when a militant Muslim tosses a hand grenade."
318,26/7/2002,Israel,Hebron,4,3,7,"Four people, including a mother, father and son, were killed by gunmen while riding in two cars."
319,26/7/2002,India,Budgam,3,0,3,Three political activists are kidnapped and killed by the Mujahideen.
320,27/7/2002,India,Badgam,4,3,7,Four civilians are killed when Muslims set off a grenade blast at a market.
321,28/7/2002,India,Surankote,1,0,1,A man is abducted and brutally tortured to death by Islamic militants.
322,28/7/2002,India,Thanna Mandi,1,1,2,Lashkar-e-Toiba terrorists kill a civilian in his home in an attack that also injures his mother.
323,29/7/2002,India,Rajpura,0,15,15,Women and children are among fifteen civilians injured in a grenade attack on a city street.
324,29/7/2002,India,Mangota,1,4,5,Five civilians are abducted and tortured by the Mujahideen.  At least one succumbs to death.
325,30/7/2002,India,Kashmir,3,0,3,"Three civilians are killed in separate Mujahideen attacks, including a boy who is abducted and murdered."
326,30/7/2002,India,Anantnag,2,5,7,"Muslim terrorist attacks a car carrying Hindu pilgrims with a grenade, killing two family members."
327,30/7/2002,Israel,Jerusalem,0,7,7,Fedayeen suicide bomber injures seven civilians.
328,31/7/2002,Israel,Jerusalem,9,90,99,"Nine students, including five Americans, are killed in a bombing at a Hebrew University cafeteria. More than 90 others were injured."
329,31/7/2002,India,Shahdara Sharief,1,0,1,A youth is murdered by the Lashkar-e-Toiba.
330,31/7/2002,India,Tral,3,2,5,Jaish-e-Mohammed terrorists stage a political assassination that leaves three people dead.
331,1/8/2002,India,Raika,2,1,3,A Lashkar-e-Toiba terrorist kills two police officers in an ambush.
332,2/8/2002,India,Ichhgooza,1,0,1,A civilian is murdered in his home by the Mujahideen.
333,3/8/2002,Israel,Jerusalem,1,2,3,Palestinian gunman kills telephone truck driver and wounds two other passengers.
334,3/8/2002,India,Kashmir,2,0,2,Two civilians killed in separate attacks (Koochipora & Srinagar).
335,4/8/2002,Indonesia,Matako,0,8,8,"A Muslim mob screaming praises to Allah sweeps through a Christian village, burning homes and churches, and shooting residents."
336,4/8/2002,India,Morha Badana,1,0,1,"Hizbul Mujahideen kidnap a man, behead him, and then hang his headless body from a bridge."
337,4/8/2002,Israel,Meron Junction,8,50,58,Suicide bomber kills eight and injures over fifty in an attack on a bus.
338,5/8/2002,Pakistan,"Jhika Gali, Murree",6,4,10,Six persons killed and four others injured in terrorist attack on Christian missionary school.
339,6/8/2002,India,Nar,2,0,2,A man and his wife are killed in their home by the Mujahideen.
340,6/8/2002,India,Handwara,9,3,12,Fedayeen attack on a security camp is one of two attacks that leave nine Indians dead.
341,6/8/2002,India,Rajouri,0,12,12,Twelve civilians are injured in a militant grenade attack near a hospital.
342,6/8/2002,India,Pahalgam,9,32,41,Nine Hindu pilgrims are massacred in a senseless attack by Fedayeen.  Approximately thirty others sustain various injuries.
343,7/8/2002,Indonesia,Tentena,1,4,5,An Italian tourist is killed by Jihad terrorists. Four others are injured.
344,7/8/2002,India,Surankote,3,0,3,"Three people, including one woman, are killed in two separate attacks on residences."
345,8/8/2002,India,Bijbehara,0,15,15,A grenade tossed by an Islamist on a city street injures fifteen civilians.
346,8/8/2002,India,Patrara,4,0,4,"Two women and two children, all family members, are slaughtered in a barbaric attack by militant Muslims."
347,8/8/2002,Algeria,Algiers,6,1,7,Five persons are killed by a machine-gun fired from an open car in a drive-by. Islamists also assassinated a man in Tazrout.
348,9/8/2002,Pakistan,Taxila,3,24,27,"Three women and a terrorist are killed, and 24 others injured as terrorists attack John C. Heinrich Memorial chapel in the Mission Hospital."
349,9/8/2002,Indonesia,Malei,2,0,2,Jihad warriors attack two Christian villages and kill two people.
350,10/8/2002,Philippines,Unknown,2,4,6,Abu Sayyaf kidnap six missionaries. Two are subsequently beheaded.
351,11/8/2002,Indonesia,Kayamanya,5,0,5,"A Muslim mob attacks a bus and one other vehicle, killing five Christians, including one who was burned."
352,11/8/2002,India,Sarawa,3,0,3,Three civilians are senselessly murdered by the Mujahideen.
353,13/8/2002,India,Kulgam,1,21,22,"A militant Muslim lobs a grenade into a bus station, killing one civilian and injuring twenty-one others."
354,15/8/2002,Iraq,Baghdad,1,0,1,"A 71-year-old nun is savagely attacked and stabbed to death in a monastery by Islamic extremists, who then behead her."
355,15/8/2002,Indonesia,Manyomba,1,3,4,Fifty militants attack two Christian villages. They shoot three people and strangle a 3-year-old child to death.
356,15/8/2002,Algeria,Harshoun,26,0,26,Islamists attacked and slaughtered three families including women and children.
357,16/8/2002,India,Fatehpur,1,0,1,A man who refuses to work for the Mujahideen is abducted and killed for his principles.
358,18/8/2002,Pakistan,Skardu,1,3,4,A youth is killed and three women injured in a sectarian bombing attack.
359,18/8/2002,India,Bhat Pura,1,0,1,A woman is killed by Islamists in her home.
360,18/8/2002,India,Bana,2,0,2,A man and his son are killed by the Mujahideen in a home invasion.
361,20/8/2002,India,Gund,0,1,1,Hizb-ul-Mujahideen kill two security forces with a land mine.
362,22/8/2002,India,Lassana,2,2,4,"Militant Muslims ambush a security patrol, killing two members."
363,22/8/2002,India,Gorihakhar,2,0,2,Two civilians are abducted from their homes and murdered by the Mujahideen.
364,23/8/2002,India,Thanna Mandi,10,0,10,Lashkar-e-Toiba terrorists massacre ten civilians including three women in two separate incidents.
365,23/8/2002,India,Rajouri,4,19,23,The Mujahideen murder four civilians in separate attacks and injure nineteen with a grenade.
366,23/8/2002,India,Srinagar,2,0,2,Two civilians are gunned down at a shrine.
367,25/8/2002,India,Reka Chowk,0,12,12,Twelve civilians are injured when a Muslim tosses a grenade into a city street.
368,25/8/2002,India,Surankote,4,1,5,"Three family members are killed, and a surviving child badly injured, by a Mujahideen attack on their car."
369,26/8/2002,India,Kashmir,4,1,5,"A woman is among four victims of the Mujahideen, killed in separate attacks."
370,30/8/2002,India,Kashmir,5,2,7,Five separate Mujahideen attacks leave five civilians dead and two injured.
371,31/8/2002,India,Raie Kashte,1,0,1,The Mujahideen kill an elderly man in his home.
372,31/8/2002,India,Maalbani,3,0,3,"Muslims drag two woman and a man out of their house, then rake them with machine-gun fire."
373,31/8/2002,Indonesia,Irian Jaya,3,12,15,"Three teachers, including two Americans, are killed by Indonesian soldiers."
374,1/9/2002,Algeria,Bantous,4,6,10,Ambush of a military vehicle by armed Islamists leaves four innocents dead.
375,1/9/2002,Afghanistan,Kabul,1,3,4,"Taliban bombing kills one, injures three others."
376,1/9/2002,India,Gounthal,2,1,3,Muslim terrorists kill the two young sons of a government official in an attack that also injures his daughter.
377,2/9/2002,India,Kashmir,4,20,24,"Four Mujahideen attacks leave four civilians dead (including one who was beheaded).  A grenade attack (Hadyal Chowk) injures nineteen, including a child."
378,4/9/2002,India,Pulwama,3,0,3,Three people are killed in two attacks by the Mujahideen.
379,5/9/2002,Afghanistan,Kabul,22,65,87,"Bomb explodes in busy Kabul marketplace. At least twenty-two civilians are killed, sixty-five are taken to the hospital."
380,5/9/2002,Pakistan,North Nazimabad,1,0,1,A religious leader is killed in a sectarian attack.
381,6/9/2002,Afghanistan,Akora Khattak,1,2,3,"Muslim militants disguise a bomb as a toy.  One 6-year-old girl is killed, and her two sisters injured."
382,6/9/2002,India,Gorihakhar,4,2,6,"Jamiat-ul-Mujahideen murder four people in an ambush, including an election candidate."
383,8/9/2002,Indonesia,Galunggung,1,0,1,"A Christian is beaten, then burned to death by a Muslim mob."
384,8/9/2002,India,Kashmir,2,7,9,"Two civilians are killed, and seven injured, in three separate attacks by Islamic militants."
385,9/9/2002,India,Batmaloo,0,13,13,Thirteen civilians are injured when a Muslim tosses a grenade onto a city street.
386,9/9/2002,India,Lower Dubri,4,2,6,Four people are killed when the Mujahideen ambush a security patrol.
387,9/9/2002,India,Thanna Mandi,5,1,6,"Five members of the minority community, including two couples are massacred by militant Muslims."
388,10/9/2002,India,Kashmir,5,23,28,Five Mujahideen attacks leave five civilians dead and twenty-three injured.
389,11/9/2002,India,Surankote,12,22,34,Terrorists use grenades and arms fire to kill ten security force personnel and two civilians in an ambush.
390,11/9/2002,India,Poonch,14,22,36,Fourteen people are mowed down at an election rally by the Mujahideen.
391,11/9/2002,India,Kupwara,4,5,9,A Muslim terrorist dresses in women's clothes to sneak weapons into a political rally.  He guns down four innocents.
392,15/9/2002,Pakistan,Hyderabad,1,5,6,"One person is killed and five others, including a girl, injured in a bomb explosion in a Karachi-bound bus."
393,16/9/2002,Pakistan,Miranshah,1,1,2,A woman is killed and a child injured in a toy-bomb explosion.
394,16/9/2002,India,Seri Khwaja,1,0,1,A child is killed in an attack by Muslim militants against a polling station.
395,16/9/2002,India,Hasote,1,2,3,The Mujahideen kill a young boy and seriously injure his grandparents.
396,18/9/2002,India,Golibud,1,0,1,A forest worker is abducted and beheaded.
397,18/9/2002,India,Srinagar,2,0,2,Two political leaders are murdered by Lashkar-e-Toiba.
398,18/9/2002,India,Katarmal,10,0,10,Ten people are killed by a Mujahideen ambush.
399,19/9/2002,Israel,Tel Aviv,5,40,45,Five Israelis are massacred in a bus bombing by Palestinian terrorists that also injures more than forty others.
400,19/9/2002,India,Doda,2,0,2,The Mujahideen abduct and murder two civilians.
401,19/9/2002,India,Jamsalan,2,0,2,"Militant Muslims stage an attack on a school, killing a teacher and a student."
402,21/9/2002,USA,"Atlanta, GA",1,0,1,Muslim terrorists gun down an employee at a liquor store.
403,21/9/2002,India,Palpora,1,0,1,A man is killed in his home by Islamic terrorists.
404,21/9/2002,India,Hadipora,2,0,2,Two apple orchard workers are murdered by the Mujahideen.
405,21/9/2002,Indonesia,Kelang,2,2,4,Two Christians are killed and two wounded by Muslim gunmen.
406,21/9/2002,USA,"Montgomery, AL",1,1,2,A Muslim sniper takes down one woman and injures another.
407,23/9/2002,USA,Baton Rouge,1,0,1,Muslim sniper shoots a Korean mother in the back.
408,24/9/2002,India,Bijbehera,2,0,2,Islamists kill two civilians with a grenade.
409,24/9/2002,India,Shamdilli,1,0,1,A woman is killed inside her home by Muslim radicals.
410,24/9/2002,India,Udhyanpur,2,0,2,A man and woman are murdered by the Mujahideen in their village.
411,24/9/2002,India,Ahmedabad,31,86,117,"Hindu monks and dozens of worshippers were massacred in an attack on a Hindu temple members of Lashkar-e-Toiba, an Islamic extremist group."
412,25/9/2002,Pakistan,Karachi,7,3,10,"Seven persons are killed and three others injured in a terrorist attack on a Christian welfare organization's office - the Idara Amn-O-Insaaf (Institute for Peace and Justice). The victims were blind-folded, tied to chairs and shot in the head."
413,25/9/2002,India,Mogla,5,3,8,Five border guards are killed in an ambush by Islamic radicals.
414,26/9/2002,India,Maroti,1,2,3,The Mujahideen murder a civilian in a brutal attack.
415,26/9/2002,India,Pulwama,0,14,14,Fourteen civilians sustain injury when a militant Muslim hurls a grenade into a marketplace.
416,28/9/2002,India,Anantnag,3,4,7,Muslim terrorists use an IED to kill three civilians and injure four more on a road.
417,28/9/2002,Bangladesh,Satkhira,3,125,128,Islamic fundamentalists bomb a local cinema and also hurl bombs at female performers at a circus in two attacks that kill three and leave over one-hundred injured.
418,29/9/2002,Saudi Arabia,Riyadh,1,0,1,A terrorist car bomb kills one German national.
419,29/9/2002,India,Kashmir,2,0,2,The Mujahideen kill two civilians in separate attacks (Battal & Akhal Bhatpora)
420,29/9/2002,India,Tral,1,17,18,"One person is killed, and seventeen others injured when a Muslim tosses a grenade into the road."
421,30/9/2002,India,Graogund,7,1,8,Seven Indian security forces are killed in a landmine attack on their vehicle.
422,30/9/2002,India,Saran Khadi,1,1,2,A man and his wife are abducted by the Mujahideen.  The husband is murdered.  Fate of his wife is unknown.
423,1/10/2002,India,Hiranagar,8,10,18,"Al-Mansoor terrorists open fire on a passenger bus with automatic weapons, killing eight people and injuring ten."
424,2/10/2002,India,Manda Morh,2,22,24,"Two Hindu pilgrims, including a young girl, bleed out after Muslim terrorists detonate an IED under a bus."
425,2/10/2002,India,Pastoona,5,1,6,Five members of a bomb squad are killed when Islamists detonate a remote-controlled device as they are trying to defuse it.
426,2/10/2002,Philippines,Zamboanga,4,24,28,"Abu Sayyaf bomb outside a restaurant kills four, including an American, and injures at least two dozen more."
427,2/10/2002,USA,"Wheaton, MD",1,0,1,Muslim sniper kills 55-year-old man.
428,3/10/2002,Algeria,Wadi Shurfa,12,2,14,Twelve persons from two families are killed by Islamists. One woman is kidnapped and one child was injured.
429,3/10/2002,USA,Maryland,5,0,5,Muslim sniper kills three men and two women in five separate attacks.
430,3/10/2002,India,Doda,2,0,2,Two civilians are killed in their homes by the Mujahideen in separate attacks.
431,4/10/2002,India,Kashmir,6,0,6,Six people are killed in three separate Jihad attacks.
432,6/10/2002,Yemen,Coast,1,0,1,"al-Qaeda suicide boat detonates explosives next to French tanker, killing one crewman."
433,6/10/2002,India,Kashmir,3,1,4,Two Mujahideen attacks leave three civilians dead.  One was killed in his home for participating in an election.
434,7/10/2002,India,Kashmir,3,1,4,Three civilians are killed in three attacks.  One other person is abducted.
435,8/10/2002,Kuwait,Failaka,1,1,2,"One Marine is killed, another wounded in terrorist attack."
436,8/10/2002,Israel,Zief Junction,1,3,4,A Palestinian terrorist shoots and Israeli to death.
437,8/10/2002,India,Doda,2,5,7,"Lashkar-e-Toiba terrorists attack a polling station, killing two people."
438,9/10/2002,India,Sorabati,2,7,9,Two security forces are killed in a Jihadi landmine attack.  Six others injured.
439,9/10/2002,USA,"Manassas, VA",1,0,1,Muslim sniper kills 53-year-old man.
440,10/10/2002,Philippines,Kidapawan City,6,10,16,An Abu Sayyaf bomb at a crowded bus stop sends six souls to Allah.
441,10/10/2002,Israel,Tel Aviv,1,20,21,Muslim bomber kills a 71-year-old grandmother of fifteen.
442,11/10/2002,India,Kangan,1,6,7,A civilian is killed in a grenade attack by Muslim militants.
443,11/10/2002,USA,"Fredericksburg, VA",1,0,1,Muslim sniper kills 53-year-old man.
444,12/10/2002,Indonesia,Bali,202,300,502,"Series of Al-Qaeda bombs in nightclubs kill more than two-hundred people, injure at least three-hundred more."
445,14/10/2002,USA,"Falls Church, VA",1,0,1,A Muslim sniper takes down a 47-year-old woman.
446,15/10/2002,India,Lawaypora,3,0,3,"Radical Muslims fire on a house, killing three family members."
447,16/10/2002,India,Rajpura,2,1,3,Islamic terrorists force their way into a widow's home and kill her in an attack that also leaves her son seriously injured.  Elsewhere (Parihote) a civilian is abducted and murdered.
448,16/10/2002,Pakistan,Karachi,0,9,9,Nine people are injured in a series of Lashkar-e-Jhangvi bomb blasts.
449,16/10/2002,Algeria,al-Qantara al-Zarqa,2,0,2,Two unarmed civilians are murdered by Islamic fundamentalists.
450,16/10/2002,Algeria,Boukaat El Hadjadj,13,1,14,Early morning Islamic extremist attack on a Western Algerian village kills thirteen boys who were students at al-Fiqh and injures one.
451,17/10/2002,Philippines,Zamboanga,7,152,159,Moro Islamic Front bombings at two department stores kill seven and injure one-hundred and fifty-two.
452,18/10/2002,Philippines,Manila,2,19,21,An Abu Sayyaf bus bomb kills two passengers and injures nineteen.
453,18/10/2002,India,Kupwara,3,2,5,Three people are killed when Islamic terrorists attack a search party.
454,19/10/2002,India,Kashmir,3,5,8,"Three attacks leave three people dead, including a man who died defending his wife in his home from Jihadis."
455,20/10/2002,Philippines,Zamboanga,1,18,19,"A Roman Catholic shrine is bombed by Muslim terrorists. One killed, eighteen injured."
456,20/10/2002,India,Kashmir,2,0,2,"Two people, including a young student, are murdered by the Mujahideen."
457,20/10/2002,Pakistan,Punjab,1,20,21,"An 11-year-old girl is killed, and twenty others injured by a bomb placed in a flower vase."
458,21/10/2002,India,Tral,1,8,9,Muslim militants kill a woman with an IED.  Eight others are injured in a separate blast at Kulgam.
459,21/10/2002,Israel,Tel Aviv,16,24,40,Hamas (Islamic Resistance) car bombers kills at least sixteen people riding on a bus. More than twenty-four are injured.
460,21/10/2002,Algeria,Ain Kechra,7,5,12,Seven ordinary people have their throats slit and five more are kidnapped by armed Islamists in a rural area.
461,22/10/2002,USA,"Silver Spring, MD",1,0,1,Muslim sniper kills 35-year-old bus driver.
462,22/10/2002,India,Kashmir,5,7,12,Five civilians are murdered by the Mujahideen in four separate attacks.
463,23/10/2002,India,Danis,1,0,1,"A man is abducted by radical Muslims, who then behead him."
464,24/10/2002,Nigeria,Fajul,40,48,88,"At least forty Christians are killed by a Muslim mob of several thousand, who also rape women and burn churches."
465,24/10/2002,India,Sonargund,1,0,1,A retired teacher is murdered by the Mujahideen.
466,25/10/2002,India,Goza Mohalla,2,1,3,"Muslim terrorists attack a taxi, killing the driver and a passenger."
467,25/10/2002,Algeria,Boukaat Ouled Abdellah,21,3,24,"Twenty-one people from the same family were shot and stabbed to death, including a three-year old child. Three others survived with injuries."
468,26/10/2002,Russia,Moscow,129,150,279,Chechen Muslims storm a theater and hold 916 people hostage in appalling conditions. Several are shot and killed and others die in the rescue attempt.
469,28/10/2002,Jordan,Amman,1,0,1,An American diplomat is shot dead by two al-Qaeda terrorists while sitting in his car.
470,29/10/2002,India,Srinagar,7,0,7,Seven members of the Indian security forces are gunned down by Mujahideen members in separate incidents. Several were off-duty at the time.
471,29/10/2002,Israel,Hermesh,3,1,4,Palestinian terrorist infiltrate a settlement and kill one woman and two girls.
472,30/10/2002,Algeria,Boukaat Sidi Bouaissa,8,0,8,"Armed Muslim terrorists kill eight, including four children in a gruesome attack."
473,31/10/2002,Israel,Gaza,3,6,9,"Hamas (Islamic Resistance) bomb goes off prematurely killing three and injuring six, including a 10-year-old girl."
474,31/10/2002,Nigeria,Zaria,20,51,71,"Muslims go on a rampage against Christian students at a local college, killing twenty and injuring over fifty."
475,1/11/2002,India,Kashmir,3,2,5,"Three civilians are killed in separate attacks, including a young girl who was abducted from Shangus and tortured."
476,1/11/2002,Pakistan,Lahore,1,0,1,A Shia doctor is murdered in a sectarian attack.
477,1/11/2002,Pakistan,Quetta,2,0,2,Fundamentalists kill two policemen.
478,2/11/2002,India,Mastandara,2,2,4,"In a home invasion, Jihadis murder a man and his daughter.  Two children are injured in the attack."
479,2/11/2002,India,Naik Mohalla Palhalan,2,0,2,A man and woman are kidnapped from their home and killed in captivity by radical Muslims.
480,2/11/2002,India,Budgam,2,0,2,The Mujahideen abduct and murder two civilians.
481,2/11/2002,India,Srinagar,3,0,3,Muslim rebels assassinate an Indian politician along with two bodyguards.
482,4/11/2002,Israel,Kfar Saba,2,40,42,Jihad suicide bomber kills two mall shoppers and wounds more than forty with a powerful blast.
483,4/11/2002,India,Madaana,4,1,5,"The Mujahideen attacks a funeral party, killing four civilians and injuring at least one other."
484,4/11/2002,India,Rajouri,1,14,15,Fourteen people are injured in a bomb blast at a hotel that also kills a 5-year-old girl.
485,5/11/2002,India,Doda,3,0,3,"Three civilians are killed in separate attacks, including a village leader at a wedding."
486,6/11/2002,India,Achhabal,2,11,13,Two civilians are killed when militant Muslims hurl a grenade into a bus stand.
487,7/11/2002,Algeria,Chlef,4,6,10,"Islamic terrorists machine-gun a bus. Four civilians are killed, six are injured."
488,7/11/2002,India,Billawar,2,0,2,The Hizb-ul-Mujahideen kills two policemen who were brothers.
489,8/11/2002,India,Kashmir,5,0,5,Five people are killed in three attacks by Jaish-e-Mohammed cadres.
490,10/11/2002,Israel,Metzer,5,0,5,Palestinian gunman kills five including mother and her two children ages 4 and 5. She was in the process of reading a bedtime story.
491,11/11/2002,India,Rajouri,1,0,1,The Mujahideen kill a 6-year-old boy inside his home.
492,11/11/2002,India,Srinagar,13,5,18,Mine planted by Islamic militant kills thirteen civilians and injures five.
493,12/11/2002,Algeria,Medea,2,0,2,Islamic fundamentalist gunmen burst into a cafe and kill two patrons.
494,13/11/2002,India,Kapran-Dooru,1,0,1,A civilian is killed in his residence by the Mujahideen.
495,14/11/2002,India,Kashmir,2,2,4,Two home invasions leave two civilians dead and two women injured.
496,15/11/2002,Israel,Hebron,12,14,26,Palestinian ambush kills twelve and injures fourteen. Victims were returning from a prayer service.
497,15/11/2002,Pakistan,Hyderabad,2,9,11,Islamists bomb a bus killing two civilians and injuring nine.
498,16/11/2002,Algeria,Azeffoun,1,0,1,Policeman gunned down by armed Islamists as he was leaving his home.
499,17/11/2002,India,Gool,1,0,1,A civilian is abducted and murdered by the Mujahideen.
500,18/11/2002,Israel,Rimonim Junction,1,0,1,Woman killed by Palestinian gunmen in a drive-by.
501,19/11/2002,India,Barsoo,1,0,1,Islamists kill the widow of a man they killed four years earlier.
502,20/11/2002,Israel,Tulkarm,1,1,2,"Palestinian bomb explodes prematurely. Kills one, injures one."
503,20/11/2002,Algeria,El-Ancer,3,1,4,Islamic extremists attack a family. They kill the father and his two daughters (ages 3 and 5) then severely wound the mother.
504,20/11/2002,India,Kashmir,3,2,5,The Mujahideen kill three civilians in separate attacks.
505,21/11/2002,India,Anantnag,2,0,2,Two civilians are abducted from their homes an murdered by the Mujahideen.
506,21/11/2002,India,Sarurnagar,2,20,22,Bomb placed near Hindu temple by the Mujahideen kills two and injures at least twenty.
507,21/11/2002,Algeria,Ain Rich,6,2,8,Terrorist bombing by Islamic fundamentalists kills six and injures two.
508,21/11/2002,Israel,Jerusalem,11,50,61,Muslim bomber kills eleven and injures over fifty passengers on a bus. Most victims were high-school students.
509,21/11/2002,Kuwait,Arifjan,0,2,2,Two soldiers in Kuwait wounded by Islamist terrorist. One is shot in the face.
510,21/11/2002,Lebanon,Sidon,1,0,1,Female missionary shot three times in the head by Muslim radicals.
511,22/11/2002,India,Srinagar,6,9,15,Islamic suicide attack kills six and injures nine.
512,22/11/2002,Nigeria,Kaduna,216,521,737,"A Muslim mob, angered by an insult to Muhammad, burns 58 Christian churches and rampages through the streets stabbing, bludgeoning and burning over two hundred people to death."
513,23/11/2002,India,Lower Munda,19,34,53,"The Mujahideen kill nineteen, including three women and two children, with an IED."
514,23/11/2002,Algeria,Tizi Ouzou,9,12,21,Nine soldiers killed and twelve wounded after militant Islamic ambush.
515,24/11/2002,India,Jammu,12,45,57,Twelve Hindu worshippers are killed and more than forty-five wounded when Islamic gunmen attack two historic temples.
516,24/11/2002,India,Tral,2,1,3,"Islamic terrorists kidnap three people, including a woman, and torture two of them to death."
517,25/11/2002,India,Kashmir,3,0,3,"Three civilians, including a shop owner, are killed in separate attacks by the Mujahideen."
518,26/11/2002,India,Waterhail,3,0,3,"Muslims force their way into a home and abduct three family members, including two women.  All are tortured to death."
519,27/11/2002,India,Kashmir,2,0,2,One of two men killed by the Mujahideen refused to direct them to a police officer's home.
520,28/11/2002,Kenya,Mombasa,13,26,39,"Three suicide bombers kill twelve people, including two children. More than two dozen people were hurt. Muslim attackers also fired two missiles at an Israeli plane carrying 261 people."
521,28/11/2002,Israel,Beit Shean,6,35,41,Two Palestinian gunmen kill four Israelis who were waiting for a bus. More than two dozen people were also injured.
522,1/12/2002,India,Srinagar,1,8,9,A civilian is killed in a Mujahideen grenade attack.  Eight others are injured.
523,1/12/2002,India,Hari Mohalla,1,0,1,Disgruntled Muslims enter the home of a civilian and kill his daughter.
524,1/12/2002,India,Bilalabad Mohalla,3,3,6,Fedayeen attack kills three people.
525,2/12/2002,Algeria,Relizane,4,6,10,Armed Muslim fundamentalists kill four and wound six civilians in an attack.
526,2/12/2002,India,Ghatkopar,2,34,36,Students Islamic Movement thought responsible for Indian bus blast killing two and injuring thirty-four.
527,3/12/2002,India,Manyalan,4,0,4,Two civilians are abducted and murdered by Islamic militants.  Two others are killed in Arin and Karnah.
528,5/12/2002,India,Bhagwa,1,3,4,Islamic terrorists kill a man for refusing to hand over his son.  Three other family members are injured.
529,5/12/2002,Pakistan,Karachi,3,0,3,Macedonian embassy bombed in Karachi. Three bodies are found.
530,5/12/2002,Indonesia,Makassar,3,11,14,Bomb blast rips through a McDonald's restaurant killing three people and injuring several more.  Islamic extremists take credit.
531,6/12/2002,Bangladesh,Mymenshingh,27,200,227,Four bombs detonate concurrently at four packed movie cinemas killing twenty-seven and injuring over two-hundred.  Muslim fundamentalists had been critical of entertainment venues and those who frequented them.
532,7/12/2002,Pakistan,Shahkas,4,7,11,Four members of a family are killed by an IED.
533,12/12/2002,India,Joura,1,0,1,A man is killed in his home by Mujahideen.
534,12/12/2002,Nigeria,Rim,13,0,13,Muslim nomads attack a Christian village and kill thirteen people including a clergyman and his family.
535,12/12/2002,Israel,Hebron,2,0,2,Israeli man and woman killed in an ambush shooting attack by Palestinians.
536,12/12/2002,Algeria,Boukadir,4,16,20,Bomb blast in a market kills four and injures sixteen.
537,12/12/2002,India,Pulwama,0,26,26,Grenade attack by Muslim separatists injures twenty-six civilians.
538,13/12/2002,Chechnya,Grozny,2,2,4,Device detonated beneath a convoy escorting a water-transportation vehicle kills two and injures two.
539,13/12/2002,Algeria,Sidi Baizid,6,0,6,Three adults and three children are killed during an attack by Islamic extremists.
540,14/12/2002,Algeria,Sidi Baizid,3,0,3,"Three shepherds are abducted by Islamic militants.  They are found dead, with their throats slit."
541,16/12/2002,India,Rajouri,2,6,8,A Mujahideen grenade attack outside a pharmacy leaves two people dead and six injured.
542,18/12/2002,Algeria,Sidi Medjaded,10,0,10,Ambush by Islamic hardliners kills ten people.
543,19/12/2002,India,Kashmir,2,20,22,"Two soldiers are killed and about twenty other people, including civilians were killed in separate grenade and shooting attacks by Muslim rebels."
544,19/12/2002,Pakistan,Karachi,3,0,3,"At massive terrorist bomb explodes early, killing the bomb maker and three others."
545,20/12/2002,India,Hangal,1,0,1,A man is abducted and beheaded by the Mujahideen.
546,20/12/2002,India,Paraott,3,0,3,Muslim attackers invade the home of three young women who were not wearing veils.  They killed the three by slitting the throats of two and then shooting a third.
547,21/12/2002,Pakistan,Hyderabad,2,7,9,"Two people are killed, and seven more injured by a bus bomb."
548,22/12/2002,India,Surankote,3,2,5,"Three young boys are shot to death at point-blank range by Islamic radicals, who attack their house.  Two family members are badly injured."
549,22/12/2002,India,Reban,4,3,7,"Terrorists invade a house, force victims to recite Muslim passage, then kill four of them, including a four-year old boy.  Three other family members are wounded."
550,24/12/2002,Philippines,Cotabato,17,13,30,Islamic militants blow up bomb using remote control.  The seventeen killed include the town's mayor.  More than a dozen others were injured.
551,24/12/2002,India,Mahore,2,0,2,"Two people, including a woman, are murdered in their home by the Mujahideen."
552,24/12/2002,India,Bela Khwas,2,2,4,The Mujahideen kill two villagers and injure two more.
553,25/12/2002,India,Doda,2,0,2,A woman is among two people killed in a Jihad attack.
554,25/12/2002,India,Gopalpora,3,0,3,A teacher and his two sons are gunned down by Muslim radicals.
555,25/12/2002,Pakistan,Daska,3,14,17,Christmas grenade attack on a Christian church kills three girls and injures fourteen young women.
556,26/12/2002,Philippines,Mindanao,12,10,22,Muslim rebels ambush employees of a Canadian company.  Twelve civilians are killed and ten injured.
557,27/12/2002,Israel,Otniel,4,6,10,"Palestinian gunman breaks into a Jewish seminary and kills four students who were sitting down to Sabbath dinner, wounds six others."
558,27/12/2002,Chechnya,Grozny,80,127,207,Three Fedayeen suicide bombers kill more than eighty Russians and Chechens.  At least one-hundred and twenty-seven people are injured in the attacks.
559,28/12/2002,India,Srinagar,2,0,2,Al-Madeena terrorists gun down two police officers near a hotel.
560,28/12/2002,Algeria,Boudouaou,1,5,6,Attack by Islamic extremists leaves one policeman dead and five injured.
561,30/12/2002,Yemen,Jibla,3,1,4,Muslim gunman posing as a father carrying a child kills three American humanitarian workers at a missionary hospital and wounds one other.
562,30/12/2002,India,Bijbehara,1,0,1,The Mujahideen abduct and kill a civilian in a brutal attack.
563,31/12/2002,India,Surankote,2,4,6,A young girl is killed and her three family members injured when Muslim militants use them as human shields after attacking a security patrol.
564,31/12/2002,Philippines,Tacurong,10,20,30,Grenade hurled by Islamic fundamentalist at a crowd of people celebrating the new year kills ten and injures about twenty.
565,1/1/2003,India,Gahend,1,0,1,Islamic terrorists shoot the daughter of a civilian to death after an unsuccessful attempt to abduct her from her family.
566,2/1/2003,India,Kashmir,2,0,2,Two civilians are abducted and killed by the Mujahideen.
567,2/1/2003,Israel,Jordan Vally,1,0,1,72-year old man stoned to death by al-Aksa Martyrs Brigade.
568,2/1/2003,Israel,Menahamiya,1,0,1,Badly burnt body of a 70-year old man (father of nine) found after being kidnapped by Fatah-al-Aqsa.
569,5/1/2003,Israel,Tel Aviv,23,100,123,Twenty-three people are killed and more than one-hundred injured by twin Palestinian suicide bombers.
570,5/1/2003,Algeria,Aures Mountains,49,19,68,"Islamic ""Salafist Group for Preaching and Combat"" ambushes a security convoy and kills forty-nine, wounds nineteen."
571,5/1/2003,Algeria,Blida,13,0,13,Thirteen members of two families are killed in an attack by Islamic extremists.
572,7/1/2003,India,Srinagar,1,0,1,Prominent liquor dealer slain by Islamic fundamentalists while pumping gas.
573,7/1/2003,India,Hapatanar,3,0,3,"Mujahideen behead three villagers, including a father and son."
574,8/1/2003,Algeria,Douadiche,5,1,6,"Five people killed, one badly wounded in attack on village by Islamic extremists. Victims include a 37-year-old woman, her two children, ages 2 and 5, and her two uncles."
575,9/1/2003,India,Bandipore,2,0,2,A policeman is abducted and murdered by Islamists as the body of a civilian tortured to death by the same group surfaces.
576,9/1/2003,Algeria,Tizi Ouzou,8,0,8,Eight killed in an ambush on a security convoy.
577,10/1/2003,Chechnya,Grozny,9,3,12,Nine Russians killed by Mujahideen rocket attack.  Three others are wounded.
578,10/1/2003,India,Kashmir,2,7,9,"Three Jihad attacks leave two civilians dead and seven more injured. (Ghulam Qadir, Baramulla, Nihama)."
579,11/1/2003,India,Hari Budha,2,0,2,"The Mujahideen fire into the home of a civilian, killing his wife and son."
580,11/1/2003,England,Birmingham,1,0,1,21-year-old woman stabbed to death by Pakistani on her wedding day for rejecting an arranged Muslim marriage.
581,13/1/2003,Philippines,Zamboanga,3,0,3,Muslim gunmen kill three Christians.
582,13/1/2003,India,Panar,2,0,2,"Two sons of a civilian suspected of providing information on terrorist activities are kidnapped from their home, tortured and then shot dead."
583,13/1/2003,Israel,Moshav Gadish,1,5,6,"Two Palestinian gunmen from Jenin penetrate a farming community and open fire on random vehicles.  One civilian is killed, five are injured."
584,13/1/2003,Israel,Nitzana,1,1,2,"Gaza gunmen opens fire on two Israeli soldiers near Egyptian border.  One is killed, the other injured."
585,14/1/2003,England,Manchester,1,3,4,A police detective and father of three is stabbed to death by a Muslim terrorist.
586,14/1/2003,India,Seeldhar,3,1,4,Three civilians are abducted and murdered by militant Muslims.
587,15/1/2003,India,Patta Dhar,1,3,4,The Mujahideen kill a police officer in his home.  Three family members are injured.
588,15/1/2003,India,Doda,1,3,4,Terrorists kill a village constable and injure three other civilians.
589,17/1/2003,Israel,Givat Harsina,1,3,4,"Two Hamas gunmen open fire on a house, killing a father and injuring his four-year-old daughter along with two others."
590,18/1/2003,Bangladesh,Dariapur,8,15,23,Bomb blast at a carnival kills eight and injures fifteen.  Islamic hardliners behind the attack.
591,18/1/2003,Israel,Kiryat Arba,1,3,4,"Hamas (Islamic Resistance) terrorists kill a father of five as he is eating dinner with his family.  Three others, including a 5-year-old girl are wounded."
592,19/1/2003,India,Bandipore,3,0,3,"Hizb-ul-Mujahideen gunmen enter a house and kill a police officer, his 16-year-old son and another child."
593,19/1/2003,India,Kulgam,0,21,21,Twenty-one people are injured by a Hizb-e-Islami grenade attack on a bus.
594,20/1/2003,Bangladesh,Begungram Astana,5,0,5,Five persons are murdered in Bangladesh by members of the Jamaatul Mujahideen extremists group.
595,20/1/2003,India,Baramulla,1,0,1,Bomb planted in a rickshaw near a college kills one Indian soldier.
596,20/1/2003,India,Rajouri,1,4,5,One killed and four injured when a terrorist rocket hits a residential house.
597,20/1/2003,India,Doda,2,0,2,Terrorists kill two men belonging to a civilian defense force (established to protect villagers from Muslim terrorists).
598,21/1/2003,India,Doda,3,1,4,Two men are abducted and murdered by the Mujahideen.  The same group shoots another civilian to death on the same night.
599,21/1/2003,Kuwait,Kuwait City,1,1,2,"Gunmen fires from behind bushes at two American servicemen, waiting at a traffic light.  Both suffer multiple gunshot wounds, one is killed."
600,22/1/2003,India,Dhok,1,0,1,Mujahideen terrorists abduct and behead a villager.
601,23/1/2003,India,Shrai,2,0,2,"Islamists halt a passenger bus, then drag off two civilians and shoot them to death by the side of the road."
602,23/1/2003,Pakistan,Swat,3,0,3,"Religious extremists kill a writer who was critical of the Taliban, along with two patrons at a shop."
603,23/1/2003,Israel,Hebron,3,0,3,Hamas terrorists ambush and kill three Israeli soldiers protecting an intersection.
604,25/1/2003,India,Aeshmuqam,1,6,7,Mujahideen target a police vehicle killing one and wounding six.
605,26/1/2003,Lebanon,Beirut,1,3,4,Car bomb explodes in Christian residential area killing one and injuring three.
606,26/1/2003,Afghanistan,Nangarhar,2,1,3,"Taliban gunmen attack a UNHCR convoy, killing two and wounding one."
607,27/1/2003,India,Mumbai,1,27,28,"Group calling itself the Student Islamic Movement of India detonates bomb in a crowded area, killing a woman and injuring twenty-seven."
608,27/1/2003,Pal. Auth.,Abu Qash,1,0,1,"After being raped by her brothers, and refusing to commit suicide as her mother suggested, a teenage girl is stabbed and beaten to death by her father."
609,27/1/2003,India,Kashmir,2,0,2,Two brutal attacks leaves two civilians dead (Dangiwacha & Mawar).
610,28/1/2003,India,Udhir,2,0,2,Two men are gunned down by Hizb-ul-Mujahideen terrorists for refusing to support them.
611,28/1/2003,Israel,Gaza,3,0,3,Three Palestinians die when a home-made bomb detonates prematurely.
612,31/1/2003,Afghanistan,Kandahar,18,1,19,"al-Qaeda landmine blows up a passenger bus, killing eighteen and injuring one."
613,31/1/2003,India,Anantnag,1,15,16,"A militant Muslim kills a civilian and injures fifteen more, including women and children, with a grenade."
614,31/1/2003,India,Srinagar,1,0,1,The editor of a newspaper is assassinated by the Hizb-ul-Mujahideen.
615,31/1/2003,Pakistan,Faisalabad,2,2,4,A sectarian attack inside a mosque leaves two people dead and two injured.
616,1/2/2003,India,Bemina,1,0,1,A Jaish-e-Mohammad member kills a police officer.
617,2/2/2003,Chechnya,Grozny,2,0,2,Two Russians killed by a car-bomb blast in Grozny.
618,3/2/2003,Algeria,Hassi-Khelifa,1,0,1,"Device hidden in a stuffed toy explodes near a home's entrance, killing an 8-year-old girl."
619,3/2/2003,Pakistan,Karachi,1,2,3,"Motorcycle bomb in a commercial area kills one, injures two."
620,5/2/2003,Pakistan,Karachi,1,0,1,Head of a Sunni school assassinated by radical Shiites.
621,6/2/2003,Israel,Nablus,2,0,2,al-Aqsa gunmen attack an army outpost in the West Bank and kill two soldiers.
622,6/2/2003,Chechnya,Dyshne-Vedeno,3,3,6,"Muslim rebels ambush riot police, killing three and wounding three."
623,6/2/2003,Pakistan,Karachi,2,0,2,Two more Sunni scholars gunned down by Muslim radicals.
624,6/2/2003,India,Kalal Kas,1,1,2,"Muslim terrorists force their way into a civilian's home, killing him and injuring his brother."
625,7/2/2003,India,Frisal,2,3,5,Two civilians are killed in a Mujahideen ambush.
626,8/2/2003,Iraq,Sulaimaniyah,6,0,6,Muslim militants assassinate a top Kurdish politician and five others with automatic weapons and grenades.
627,9/2/2003,India,Varmul,1,0,1,A civilian is kidnapped from his home and murdered by Islamic radicals.
628,9/2/2003,Algeria,Drra El Mizan,3,0,3,"Two policeman were killed by Muslim extremists, who had erected a fake roadblock.  A third policeman is shot to death in El Harrach."
629,9/2/2003,Chechnya,Grozny,3,0,3,"Jihadists bomb a gas station, killing three policemen."
630,10/2/2003,Philippines,Mindanao,3,8,11,Muslim guerillas kill three soldiers and injure eight more in an ambush.  Soldiers were on a morning jog.
631,10/2/2003,Afghanistan,Naushki,7,12,19,Taliban attack on an Afghan vehicle checkpoint leaves seven dead and twelve wounded.
632,11/2/2003,Israel,Bethlehem,1,0,1,Palestinian sniper guns down Israeli soldier in front of the Church of the Nativity.
633,12/2/2003,India,Dharam,3,0,3,Hiz-ul-Mujahideen terrorists abduct and kill three civilians.
634,12/2/2003,India,Konibol,1,4,5,"Militants blow-up police vehicle, killing one and injuring four."
635,13/2/2003,India,Bonkoot,3,2,5,Five civilians are abducted from their homes by Muslim terrorists.  Three are beheaded in captivity.
636,15/2/2003,Algeria,Kabylie,2,0,2,Two security force personnel are attacked and killed while on police patrol.
637,15/2/2003,Israel,Beit Lahia,4,0,4,Hamas terrorists use a roadside bomb to kill four Israeli soldiers who were in a passing tank.
638,16/2/2003,India,Varmul,2,0,2,A man killed by radicals a few days after he lost his brother to the same group is one of two people killed in separate attacks.
639,17/2/2003,Saudi Arabia,Skaka,1,0,1,Vice Governor of a Saudi province is gunned down after angering the fundamentalist element by suggesting that Saudi royalty should take women's opinions into account.
640,18/2/2003,Philippines,Matanog,7,11,18,Ambush by Muslim rebels on a convoy kills seven soldiers and leaves eleven more injured.
641,19/2/2003,Philippines,Tubud,14,8,22,"Muslims attack a Christian village, burning and murdering at least fourteen civilians."
642,20/2/2003,Saudi Arabia,Riyadh,1,0,1,British man shot to death by Islamists while waiting at a traffic light.
643,20/2/2003,India,Baramulla,6,3,9,Six Hindu civilians are blown apart by a road-mine planted by Muslim militants.
644,20/2/2003,Philippines,Awang Airport,1,6,7,"Abu Sayyaf car bomb explodes near the airport, killing one and injuring six other civilians."
645,20/2/2003,Philippines,Kabacan,1,10,11,A 17-year old is killed and about ten others injured by a terror bombing.
646,21/2/2003,India,Srinagar,2,0,2,A photographer and a woman are murdered in separate attacks by Muslim extremists.
647,21/2/2003,Pakistan,Korangi,1,0,1,A policeman is killed by Islamists.
648,22/2/2003,India,Bandipore,1,0,1,The Mujahideen kill a young boy with a landmine.
649,22/2/2003,Pakistan,Karachi,9,8,17,Nine Shi'ite worshippers are killed in a terrorist shooting attack outside a mosque.  At least eight others are wounded.
650,22/2/2003,Algeria,Draa El Mizan,2,1,3,Two policeman are killed and one civilian is injured in a Muslim terrorist attack.
651,23/2/2003,Algeria,Ouargla,4,0,4,"Four local security guards are kidnapped by Muslim extremists, taken to the desert and then killed by having their throats slit."
652,23/2/2003,India,Gadyog,2,0,2,Two villagers are killed when Muslim terrorists break down the door to their home and spray the inside with bullets.
653,24/2/2003,India,Rai Sehot,4,3,7,Four civilians are gunned down by the Hizb-ul-Mujahideen in their village.
654,24/2/2003,Pakistan,Ghulam Hussain,2,0,2,Muslim militants are suspected in the murder of two tribesmen on a road.
655,25/2/2003,India,Punzgam,1,0,1,A man is pulled brutally from his home and killed by a group of radical Muslims.
656,25/2/2003,Algeria,Hameur El Ain,12,7,19,Armed Islamists set up bogus roadblock and then stab or shoot to death twelve civilians.  Seven others are injured in the attack.
657,25/2/2003,Afghanistan,Dilaram,1,1,2,Senior Afghan official gunned down in Taliban-sponsored attack.  His bodyguard is also injured in the shooting.
658,25/2/2003,East Timor,Aidabaleten,1,2,3,"Pro-Jakarta militiamen attack a minibus in East Timor, killing one person and injuring two pregnant women."
659,25/2/2003,Philippines,Zamboanga,2,2,4,Muslim rebels attack a logging company and kill two employees.
660,26/2/2003,Iraq,Zamaqi,3,0,3,Ansar al-Islam suicide bomber kills three Kurdish guards at a checkpoint.
661,27/2/2003,Pakistan,Joharabad,1,0,1,A man is gunned down in a sectarian attack.
662,27/2/2003,Pakistan,Karachi,2,0,2,Sunni terrorists kill two Shiites in a shooting attack at their coffee shop.
663,27/2/2003,Chechnya,Argun,3,0,3,Three Russian soldiers killed by Jihadi car-bomb in Chechnya.
664,28/2/2003,Philippines,Bukidnon,1,0,1,"Muslim rebels burn ten homes in a Christian village, killing at least one person."
665,28/2/2003,Pakistan,Islamabad,2,6,8,Islamic extremists guns down two police officers guarding a U.S. embassy.  Five other officers and a passer-by are also wounded.
666,28/2/2003,India,Shindra Mohalla Kasian,1,0,1,"Militant Muslims abduct a man from his house and take him to a forest, where he is shot to death."
667,1/3/2003,Bangladesh,Bagerhat,1,3,4,"Muslims invade the home of a Hindu farmer, chop him to death and then rape three members of his family."
668,1/3/2003,Lebanon,Ein el-Hilweh,1,2,3,Terrorist bomb kills businessman and injures two bystanders.
669,3/3/2003,India,Yaripora,1,1,2,Hizb-ul-Mujahideen terrorists invade a house and kill a woman. Another is injured.
670,4/3/2003,Philippines,Davao,21,150,171,Muslim rebels plant a bomb at a civilian airport.  Twenty-one are killed in the blast and about 150 others are injured.  Among the dead is an American missionary and several children.
671,5/3/2003,Israel,Haifa,15,30,45,"A Palestinian suicide bomber blows up a bus, killing at least fifteen and injuring thirty-seven.  A 14-year-old American girl is among the dead."
672,5/3/2003,Chechnya,Dyshne-Vedeno,2,4,6,A pro-Russian Chechen commander and one other are killed by a bomb hidden in a sofa.  Four others in an adjacent house were injured.
673,6/3/2003,Philippines,Buayan,4,0,4,Muslim rebels attack a remote village and kill four civilians.
674,7/3/2003,Philippines,Mindanao,1,2,3,Two Moro Islamic Liberation Front bomb attacks kill one and injure two at a Catholic school.
675,7/3/2003,Israel,Kiryat Arba,3,8,11,"Palestinians dressed as Jewish seminary students infiltrate a settlement and kill a husband and wife sitting down to dinner, along with one guest.  They also shoot eight other civilians."
676,10/3/2003,Israel,Hebron,1,4,5,One Israeli is killed and four more injured after roadside attack by Palestinians.
677,10/3/2003,Philippines,Pikit,2,4,6,"Muslim rebels stop a bus full of commuters, kill two, and then take dozens hostage."
678,10/3/2003,India,Kashmir,3,0,3,Three civilians are killed in separate attacks by Muslim terrorists.
679,11/3/2003,India,City Chowk,2,9,11,The Mujahideen plant a bomb at a candy shop that kills two civilians and injures nine more.
680,11/3/2003,Bangladesh,Dhaka,2,2,4,Two policemen were killed and two more badly injured by terrorist bomb in the United Arab Emirates
681,11/3/2003,Afghanistan,Kandahar,3,5,8,al-Qaeda car bomb kills three Afghani tribesmen and injures five more.
682,12/3/2003,India,Kashmir,2,2,4,Separate Mujahideen attacks in Kashmir leave two policemen dead and two more injured.
683,13/3/2003,India,Rajouri,4,33,37,"Four people, including a 6-year-old boy, are killed and thirty more injured by a bomb planted on a bus in Kashmir by an Islamic group."
684,13/3/2003,India,Poonch,2,5,7,"Islamic militants open up on a civilian vehicle, killing two and wounding five others, including an 18-month-old baby."
685,13/3/2003,India,Bombay,10,55,65,"Islamic hardliners responsible for blast on a commuter train that kills eight women, two men and leaves more than 55 injured on the tenth anniversary of another series of Islamic bombings that killed two-hundred-fifty-seven and injured more than 1000."
686,14/3/2003,India,Batmaloo,2,0,2,Two civilians are shot to death by the Mujahideen.
687,14/3/2003,India,Poonch,7,15,22,"Militant Islamics attack a hotel, take nine people hostage, spray fire and throw grenades at a crowded marketplace from an upper floor.  Seven people are killed and fifteen injured."
688,15/3/2003,India,Gool,13,5,18,"Muslims attack a remote police station and kill thirteen, including two civilians.  Two people were abducted and later found dead with slit throats.  Five others are injured in the attack."
689,17/3/2003,India,Pulwama,2,0,2,Two civilians lose their lives in brutal attacks by the Islamic militants.
690,18/3/2003,Nigeria,Kadarko,22,44,66,"Armed Muslims shouting ""we are going to finish off the infidels"" attack a Christian village and kill at least 22 villagers.  More than forty-four others were injured or missing."
691,18/3/2003,Philippines,Cotabato,0,5,5,Rebel bomb attack on a Roman Catholic church during mass injures five worshippers.
692,18/3/2003,Philippines,Baliki,1,2,3,Islamic boat attack kills one and leaves two injured.
693,18/3/2003,India,Shopian,1,0,1,A man is abducted from his home and murdered by Muslim terrorists.
694,19/3/2003,India,Kashmir,2,0,2,"The Mujahideen gun down one man on a city street, and another inside his home in separate attacks."
695,19/3/2003,Afghanistan,Sherabik,3,0,3,"Taliban attack a remote army post, capture Afghan soldiers and then stab them to death."
696,19/3/2003,Philippines,Mindanao,9,4,13,"Moro Islamic Liberation Front attacks a civilian minibus and kills nine, wounds four.  They stopped and boarded the bus, then specifically targeted non-Muslim males only."
697,20/3/2003,India,Khanyar,1,4,5,"Terrorists throw grenade into a group of security personnel, killing one and injuring four."
698,20/3/2003,Philippines,Buldon,3,2,5,"Moro Islamic Liberations Front attacks a post and kills three civilians, wounds two others."
699,20/3/2003,Lebanon,Sidon,1,13,14,Bomb kills one and leaves thirteen others injured in southern Lebanon.
700,20/3/2003,India,Srinagar,2,2,4,A grenade tossed into a street by a militant kills two civilians and injures two more.
701,21/3/2003,India,Kalalkas,2,4,6,"Militant Muslims ambush a security patrol, killing two members and injuring four."
702,22/3/2003,India,Lever,2,0,2,Two civilians are brutally abducted from their home and shot to death by Islamic terrorists.
703,22/3/2003,India,Surankote,1,2,3,"Lashkar-e-Toiba terrorists invade a police officer's home and kill a young woman, injure two more."
704,22/3/2003,Iraq,Sayed Sadiq,5,8,13,"Ansar al-Islam suicide bomber kills five, including and ABC journalist and wounds eight others at a Kurdish checkpoint."
705,23/3/2003,Kuwait,Camp Penn.,2,11,13,Muslim-American soldier throws three grenades into the tents of non-Muslim American soldiers.  Two are killed and eleven others are wounded.
706,23/3/2003,India,Nadimarg,24,0,24,"Muslims militants cleanse a village of Hindus, ordering them out of their houses and opening up with machine guns.  The twenty-four dead include eleven women and two children. Eight of the victims were over 60.  An unknown number were wounded."
707,24/3/2003,Afghanistan,Latkoo,9,6,15,"Taliban attack against a routine patrol leaves four dead and six injured.  In a separate incident in Yewar, Taliban terrorists captured five allied troops, slaughtered them and amputated their limbs."
708,25/3/2003,India,Chasana,1,3,4,A woman is killed inside her home by the Mujahideen.
709,25/3/2003,Philippines,Carmen,2,0,2,"Islamists stop a cargo truck, tie up the Christian driver and his helper then shoot them to death."
710,26/3/2003,India,Ahmadabad,1,0,1,Hindu political leader assassinated by Muslim gunmen on a motorcycle.
711,26/3/2003,Chechnya,Grozny,2,0,2,Muslim rebels stop a car driven by the brother of a government minister and kill him along with his female passenger.
712,26/3/2003,Chechnya,Grozny,4,3,7,Rebel landmine planted in a city street kills four Russians and injures three.
713,26/3/2003,India,Jammu,1,6,7,Militant bomb attack kills the driver of an oil tanker and injures six others.
714,26/3/2003,Philippines,M'lang,7,5,12,"Muslims blast Christian village with RPGs, killing seven, including a six-year-old child and injuring five others."
715,26/3/2003,Algeria,Mefta,9,0,9,Nine civilians are slaughtered by Muslim fundamentalists on an isolated road between two towns.
716,27/3/2003,India,Vilgam,2,0,2,A man and his wife are dragged from their home by the Mujahideen and killed in the street.
717,27/3/2003,India,Banihal,1,0,1,A young girl is shot to death in her home by armed Muslims.
718,27/3/2003,Algeria,Chiffa,4,4,8,"Islamic fundamentalists invade a family home, kill the parents and injure four children, then murder two youths who were outside the home at the time."
719,27/3/2003,Algeria,Chtathia,8,0,8,Islamic fundamentalists kill eight villagers.
720,28/3/2003,Algeria,Kfar Shatatiya,12,0,12,Armed fundamentalists kill twelve villagers in a late night attack.
721,28/3/2003,India,Surankote,2,6,8,"Islamic terrorists kill a man and his son after a home invasion.  Later, in Pannad, six other civilians are captured and mutilated by having their noses cut off."
722,29/3/2003,Iraq,Najaf,4,0,4,Four American soldiers are killed at a checkpoint by a suicide bomber.
723,29/3/2003,Philippines,Lambayong,4,0,4,"Another Muslim rebel attack against a civilian home, this time of a farmer, who is shot to death along with his wife and two young children."
724,29/3/2003,Philippines,Malamawi,5,4,9,"Muslim rebel throws dynamite into the house of a fisherman, killing his wife, two young children and two other relatives."
725,30/3/2003,Israel,Netanya,0,38,38,"Islamic Jihad terrorist walks into a beachfront cafe and blows himself up, injuring more than thirty civilians."
726,31/3/2003,India,Nowpora Jageer,1,0,1,Mujahideen rebels assassinate a member of the ruling political party.
727,1/4/2003,Iran,Tehran,1,0,1,Truck bomb against the British Embassy in Tehran leaves one dead.
728,1/4/2003,India,Kashmir,3,0,3,A 14-year-old girl is among three civilians murdered by the Mujahideen in separate attacks.
729,2/4/2003,India,Shopian,1,19,20,Eighteen people are injured when militant Muslims toss a grenade into a bus stand.  Elsewhere (Chewdara) a woman is killed and her daughter injured.
730,2/4/2003,Philippines,Davao,16,44,60,Moro Islamic Front terrorist bomb kills sixteen people (including several children) at a wharf and injures at least forty-four
731,2/4/2003,India,Anantnag,1,12,13,"Islamic militant lobs a grenade at a crowd of people, kills one and injures twelve."
732,3/4/2003,Philippines,Basilan,1,2,3,"Abu Sayyaf rebels ambush a village convoy, kill one and injure two."
733,3/4/2003,Afghanistan,Deh Rawood,2,0,2,Six Taliban gunmen assassinate a political figure in the Afghan government along with his nephew.
734,3/4/2003,India,Dolipora,3,0,3,"Muslim terrorists invade a residence and kill a man, his wife and their 2-year-old daughter."
735,4/4/2003,Pakistan,Karachi,1,0,1,A doctor is gunned down in a sectarian attack.
736,4/4/2003,Indonesia,Wamena,15,0,15,"Indonesian military raids Christian town, burning Bibles and churches, killing two Baptist pastors along with at least thirteen others.  Other Christians were tortured."
737,4/4/2003,Nigeria,Fobur,1,4,5,"Armed Muslims attack a village, kill a woman and burn down the houses of Christians."
738,4/4/2003,Iraq,Hadithah Dam,3,2,5,"In a particularly heinous attack, two female car bombers drive up to a U.S. checkpoint, scream for help, then kill the three soldiers rushing to their assistance.  Two others are injured."
739,4/4/2003,Chechnya,Grozny,8,10,18,Bomb attack on a passenger bus by Muslim rebels kills at least eight and leaves ten others injured.
740,5/4/2003,Philippines,Parang,0,11,11,"Another bomb planted by Muslim separatists explodes at a bus terminal, injuring eleven."
741,5/4/2003,Philippines,Tacurong,2,2,4,"Two people, including a town mayor, were killed and two more injured by a bomb which exploded in front of an electrical shop."
742,5/4/2003,Afghanistan,Jalalabad,0,5,5,Five military personnel injured by Taliban terrorist bomb attack on a headquarters.
743,5/4/2003,India,Kehlil,1,5,6,A civilian is killed in an IED blast.
744,6/4/2003,Iraq,Haswa,5,2,7,Muslim terrorists kill five civilians in a drive-by attack.
745,6/4/2003,India,Kharbatpora,1,0,1,"In a horrible attack, the Mujahideen pull a man from his home and shoot him to death in a field."
746,7/4/2003,Chechnya,Grozny,8,0,8,Landmine planted by Muslim rebels in the heart of Grozny kills five policemen riding in a car and three civilian bystanders.
747,7/4/2003,India,Kamboli Dhok,2,0,2,Two boys killed by terrorist landmine.
748,9/4/2003,India,Anantnag,1,0,1,Hizb-ul-Mujahideen assassinate a political activist.
749,10/4/2003,Iraq,Baghdad,0,4,4,Suicide bomber seriously injures four U.S. Marines guarding a checkpoint.
750,10/4/2003,Philippines,Maguindanao,13,1,14,Thirteen soldiers were killed in an ambush by members of the Moro Islamic Liberation Front.
751,10/4/2003,Iraq,Najaf,2,0,2,Mob attack inside a Mosque leaves two Shiite clerics dead.
752,10/4/2003,Israel,Moshav Bekaot,2,9,11,"Palestinian terrorists infiltrate an Israeli training camp and kill two, injure nine."
753,11/4/2003,India,Qazigund,1,31,32,"Three separate grenade attacks by Islamic militants kills a physician and injures another thirty-one people (Qazigund, Shopiyan & Anantnag)."
754,13/4/2003,India,Kasblari,1,1,2,Two Hizb-ul-Mujahideen members force their way into a civilian home and shoot a woman to death.  Her husband is injured in the attack.
755,13/4/2003,Chechnya,Roshnichu,2,0,2,Terrorist bomb kills two soldiers riding in a truck.
756,13/4/2003,Afghanistan,Khost,4,0,4,"Car bomb detonates prematurely killing the four terrorists inside, who include a former Taliban intelligence officer."
757,13/4/2003,Afghanistan,Spin Boldak,2,0,2,Two Afghan soldiers are shot to death in a terrorist attack by extremists.
758,13/4/2003,Afghanistan,Kandahar,1,2,3,One person is killed and two injured by Taliban loyalists attempting a political assassination in a motorcycle attack.
759,13/4/2003,Afghanistan,Matta Cheena,4,2,6,15-year old Muslim kills four soldiers and injures two others in a grenade attack on a vehicle.
760,14/4/2003,Philippines,Kabacan,1,7,8,Two Islamic rebels kill a political official and injure seven others in a grenade attack on a restaurant.
761,15/4/2003,India,Topa,1,0,1,The Mujahideen assassinate a political figure.
762,15/4/2003,Israel,Karni Terminal,2,7,9,Hamas gunman enters a place of business and sprays fire from an automatic weapon.  Two Israelis are killed and seven injured.
763,15/4/2003,Chechnya,Grozny,17,0,17,Mujahideen warriors kill sixteen civilians in a filmed attack on two vehicles.
764,16/4/2003,Philippines,Cotabato,0,3,3,Three women were injured by a Moro Islamic Liberation Front bomb placed on a passenger bus.
765,17/4/2003,India,Hassanwani,1,0,1,A man is yanked from his home and shot to death by Islamic radicals.
766,17/4/2003,India,Udhampur,1,2,3,"Muslim militants attack a police station, kill one and injure two."
767,17/4/2003,India,Magam,1,8,9,Muslim militants kill one and injure eight civilians in a bombing.
768,18/4/2003,Sri Lanka,Kattaiparichchan,2,14,16,Muslim grenade attack against civilians at a protest rally leaves two dead and fourteen injured.
769,18/4/2003,Eritrea,Bisha,6,0,6,British geologist murdered by Eritrean Islamic Jihad.  The same group also took credit for a landmine attack in February that killed five Eritrean soldiers on routine border patrol.
770,18/4/2003,India,Hadipora,1,0,1,The bullet-riddled body of a fruit merchant is found two days after he was abducted.
771,19/4/2003,India,Malpora,1,1,2,"Two people are abducted by the Mujahideen.  The survivor is released after his ears, nose and tongue are chopped off."
772,19/4/2003,Philippines,Alamada,6,3,9,"Six civilians, including a 12-year old girl are killed in an ambush by Islamic rebels.  Three others are badly injured."
773,22/4/2003,Nigeria,Kano,7,0,7,"Muslims set fire to a house, killing a Christian pastor and six other members of his family, including his wife and three children."
774,22/4/2003,Afghanistan,Khost,3,2,5,Taliban rocket attack on an airport kills three and leave two injured.
775,22/4/2003,India,Tral,6,12,18,Terrorist bombing attack by Muslim separatists kills six and injures more than a dozen.
776,23/4/2003,India,Gondoh,2,0,2,Terrorists abduct then kill two civilians out grazing their cattle.
777,23/4/2003,Chechnya,Grozny,6,0,6,Mujahideen fighters abduct three young men out hunting and torture them to death.  Also three government officials are shot to death while sitting in a car.
778,24/4/2003,Philippines,Lanao del Norte,12,0,12,"Islamic rebels attack a passenger bus, killing at least twelve (including the driver) and taking several hostages."
779,24/4/2003,India,Tral,1,3,4,Muslim bomb kills one policeman and injures three members of a bomb disposal unit.
780,24/4/2003,Israel,Kfar Saba,1,13,14,"al-Aqsa member detonates a bomb at a railway station, killing a 23-year old guard and injuring more than a dozen bystanders."
781,25/4/2003,India,Bandipore,6,6,12,Two separate attacks by Muslim suicide bombers in the same town kills six and injures six.
782,25/4/2003,India,Srinagar,3,34,37,Bomb thrown by Muslim separatists next to a courthouse kills three and injures at least thirty-four.
783,26/4/2003,India,Baramulla,0,11,11,"Terrorist bomb injures eleven, including two children.  The target of the bombing was a finance minister who opposed Muslim violence."
784,26/4/2003,India,Srinagar,3,7,10,Fedayeen suicide attack on a radio station kills three guards and leaves seven others injured.
785,27/4/2003,Indonesia,Jakarta,0,11,11,"Bomb set by the Jemaah Islamiyah terrorist group detonates at a Kentucky Fried Chicken restaurant in Indonesia's main airport, injuring eleven people."
786,29/4/2003,Afghanistan,Spin Boldak,3,2,5,"Muslim fundamentalists attack a government building, killing three Afghan soldiers and wounding two."
787,29/4/2003,Israel,Tel Aviv,3,55,58,"Hamas (Islamic Resistance) suicide bomber blows up a night club, killing three Israelis and injuring at least fifty-five."
788,30/4/2003,Sudan,Molli,64,0,64,An attack by the Janjaweed on a village earlier in the month leaves at least sixty-four people dead and an unknown number injured. (2003)
789,30/4/2003,India,Dodi,1,4,5,A political activist is killed and four others injured in a Mujahideen attack.
790,30/4/2003,India,Shogababa,1,3,4,"Islamic radicals attack a passenger bus, killing one and injuring three."
791,30/4/2003,India,Kala Wachi,0,5,5,"Terrorist lobs grenade at children playing in a field, injuring five of them."
792,30/4/2003,Philippines,Crossing Salvo,2,6,8,"Muslim rebels attack two houses and an army post.  Two residents are killed, including a one-year old baby, and six others are injured."
793,1/5/2003,India,Dangiwacha & Magraypora,2,0,2,Mujahideen fighters kill two Muslims suspected of being informants for an anti-terror unit.
794,2/5/2003,Philippines,Pikit,3,0,3,Moro Islamic Front rebels ambush and kill two soldiers and one civilian riding on motorcycles.
795,3/5/2003,India,Anantnag,0,15,15,Fifteen people are injured when a militant Muslim tosses a grenade at a bus stop.
796,4/5/2003,Algeria,Medea,2,3,5,Ambush by Islamic extremists on two civilian vehicles leaves two dead and three injured.
797,4/5/2003,Philippines,Siocon,27,23,50,"Muslim separatists attack a Christian village, firing on houses and a hospital.  At least twenty-seven are killed and about two dozen wounded.  Fifteen residents are taken hostage."
798,5/5/2003,India,Doda,1,17,18,"Islamic hardliners detonate small bomb in a crowded bus station, killing one and injuring seventeen civilians."
799,5/5/2003,Israel,Shilo,1,2,3,"al-Aqsa members ambush a vehicle, killing a father and seriously injuring his 6-year old daughter.  A soldier rushing to help was wounded as well."
800,6/5/2003,Algeria,Keddara,6,0,6,"Islamic fundamentalists lob a bomb into a security patrol, then proceed to stab and shoot the survivors.  Six are killed."
801,6/5/2003,India,Pulwama,1,30,31,Terrorist lobs grenade at a police vehicle near a crowd of people.  One civilian is killed and about thirty others injured.
802,7/5/2003,Chechnya,Urus-Martan,4,0,4,"Mujahideen rebels ambush a police vehicle, shooting to death all four people inside."
803,7/5/2003,Lebanon,Tripoli,1,0,1,"Bomb left at the front door of a Christian missionary couple explodes, killing one person."
804,7/5/2003,Afghanistan,Deh Rawood,1,0,1,Pro-Karzai cleric is gunned down by Taliban terrorists outside a mosque.
805,7/5/2003,India,Baramulla,2,5,7,"Al-Mansoorian terrorists ambush a search patrol, killing two and injuring five."
806,9/5/2003,India,Argi,1,0,1,The Mujahideen pull a civilian from his home and kill him after torture.
807,9/5/2003,Chechnya,Grozny,1,2,3,Terrorist bomb kills a policeman and injures two other people.
808,9/5/2003,India,Bijbehara,3,0,3,Hizbul Mujahideen militants kill three political activists of the ruling (PDP) party.
809,10/5/2003,Philippines,Koronadal,13,40,53,Abu Sayyaf suicide bomber kills thirteen and injures more than forty people in a crowded marketplace.
810,11/5/2003,India,Roulka,1,6,7,A village police officer is killed and six other people injured in a grenade attack.
811,11/5/2003,India,Khiram,1,1,2,"A civilian is killed in his home, and his sister injured by Islamic radicals."
812,11/5/2003,Israel,Ofra,1,0,1,Fatah gunmen kill a 53-year old father of six who was driving to work.
813,11/5/2003,India,Kupwara,3,7,10,Fedayeen suicide squad attack on a bank leaves three dead and seven injured.
814,12/5/2003,Chechnya,Znamenskoye,60,100,160,"At least sixty people, including seven children, are killed and more than one hundred hospitalized when three suicide bombers detonates a truck bomb outside a government building in a residential area."
815,12/5/2003,Saudi Arabia,Riyadh,35,194,229,Three groups of al Qaeda suicide bombers shoot their way into housing complexes.  The blasts leave thirty-five dead and nearly two-hundred injured.
816,12/5/2003,India,Bela,1,0,1,The Mujahideen kill an abducted civilian after keeping him hostage for ten days.
817,13/5/2003,India,Kashmir,3,0,3,Three civilians are killed by the Mujahideen in separate attacks.  One was beheaded.  Another was a homeowner's daughter.
818,14/5/2003,Yemen,Jibla,0,4,4,Terrorist bomb thrown into a courthouse where al-Qaeda militant was sentenced to death for killing three U.S. missionaries.
819,14/5/2003,Chechnya,Iliskhan-Yurt,14,145,159,Female suicide bomber kills at least fourteen civilians at a festival and leaves nearly one-hundred and fifty injured.
820,14/5/2003,India,Kashmir,2,0,2,Two civilians are killed in separate attacks.  One in his home in Nagrota.  The other after being abducted from Khawas.
821,15/5/2003,Pakistan,Faisalabad,1,11,12,A sectarian attack on a religious procession leaves one dead and eleven injured.
822,15/5/2003,India,Kashmir,4,0,4,Three separate Mujahideen attacks leave four people dead.
823,15/5/2003,Pakistan,Karachi,0,5,5,Bombs set at nineteen Shell gas stations in Pakistan injure at least five.
824,16/5/2003,Morocco,Casablanca,41,65,106,Four coordinated suicide attacks by al-Qaeda against Western and Jewish targets leave at least forty-one dead and more than sixty-five injured.
825,16/5/2003,India,Kashmir,4,3,7,Four terror attacks across the district leave four dead and at least three injured.
826,17/5/2003,Pakistan,Multan,1,0,1,A Sunni is killed in a sectarian attack.
827,17/5/2003,India,Bhadoon,1,1,2,Militant Muslims invade a home and abduct a husband and wife.  The woman is later killed and the man badly injured.
828,17/5/2003,Israel,Hebron,2,0,2,Hamas (Islamic Resistance) suicide bomber positions himself near a young married couple on a romantic stroll and kills them both.
829,17/5/2003,India,Srinagar,2,0,2,Two policeman are killed in a terrorist attack by the Muslim Hamadania Brigade.
830,17/5/2003,Algeria,Seraidi,3,4,7,"Armed Islamic group ambushes a security patrol, killing three and wounding four."
831,18/5/2003,Israel,Jerusalem,7,20,27,"Muslim suicide bomber, dressed in Jewish religious garb as a disguise, boards a passenger bus and kills seven.  About twenty others are hospitalized."
832,18/5/2003,India,Mehratop,6,0,6,A shepherd family of five is attacked and killed in their home by Muslim militants.  Victims include four children and two women.  Most were beheaded.
833,18/5/2003,India,Kupwara,2,0,2,Two civilians are murdered by the Mujahideen.
834,19/5/2003,India,Chamror,3,0,3,Jihadis ambush a security patrol killing two members and a civilian.
835,20/5/2003,India,Tral,1,0,1,A civilian is shot to death by the Mujahideen.
836,20/5/2003,India,Gujjarpati Aargam,2,0,2,Muslim radicals force their way into a home and slit the throats of a woman and her daughter.
837,20/5/2003,Israel,Afula,3,70,73,Hamas (Islamic Resistance) and Islamic Jihad vie for responsibility of a bombing in a shopping mall that kills three and injures over seventy.
838,21/5/2003,India,Sangam & Chogal,2,0,2,In separate incidents Muslim separatists abduct and kill two civilians.
839,21/5/2003,India,GoI Chakri,1,3,4,Terrorist attack on a Intelligence Bureau vehicle kills one and injures three.
840,21/5/2003,India,Anantnag,1,1,2,Muslim grenade attack on a Christian convent kills one female teacher and injures another.
841,22/5/2003,Sudan,Longochok,59,0,59,"Islamic troops attack a Christian village, burning homes and killing at least fifty-nine villagers.  They also take captive several women and children (some of whom are killed later)."
842,23/5/2003,Pakistan,Karachi,1,8,9,A sectarian clash leaves a 15-year-old boy dead and eight others injured.
843,23/5/2003,Israel,Gaza,0,8,8,Hamas detonates pipe bomb under a bus.  Eight passengers are hospitalized.
844,24/5/2003,Chechnya,Grozny,14,0,14,The Mujahideen ambush a convoy and slaughter fourteen people.
845,25/5/2003,India,Jul-Sheeri,2,0,2,Two people are killed inside their home after Muslim radicals force entry.
846,25/5/2003,Algeria,Boukaat El Maqam,8,0,8,Armed Islamic militants kill eight people in western Algeria.
847,25/5/2003,India,Rajouri,5,0,5,"Muslim rebels kill five members of a shepherd family, including a mother and three of her children."
848,26/5/2003,Algeria,Chlef,14,0,14,"Islamics kill fourteen people, all from the same family.  The victims, who include children aged 18-months to 17-years all had their throats slit."
849,26/5/2003,India,Bandipore,3,0,3,Muslim rebels invade a home and kill three members of a family.
850,27/5/2003,India,Arin Dardpora,3,0,3,"The Mujahideen invade a home and kill a man, his wife and elderly father."
851,27/5/2003,India,Tararan Wali,1,2,3,"A man is killed, and his wife and son seriously injured when Islamists open fire on their home."
852,29/5/2003,Philippines,Cotabato,5,0,5,"Moro Islamic fighters raid three Christian villages, killing five civilians."
853,29/5/2003,Indonesia,Marowo,1,1,2,Muslim terrorists gun down a man for traveling with his Christian brother-in-law.
854,30/5/2003,India,Kashmir,4,3,7,Four civilians are killed in three separate Mujahideen attacks.
855,30/5/2003,India,Karyot,2,0,2,Two school students are killed in a mine attack by militant Muslims.
856,30/5/2003,India,Hiltak & Kandi,3,0,3,"Jihad terrorists kill three, including a father and son."
857,30/5/2003,Chechnya,Khankala,7,15,22,"Muslim rebels explode a bomb under a bus, killing seven and injuring fifteen."
858,31/5/2003,Pakistan,Quetta,1,1,2,"Sunni motorcyclists open fire on the car of a Shiite cleric, wounding him and killing his son."
859,31/5/2003,Saudi Arabia,Turba,2,2,4,"Two al-Qaeda members throw a bomb at Saudi security personnel, killing two and injuring two."
860,1/6/2003,India,Bhatta Dhar,3,0,3,Militant Muslims abduct and kill three civilians.  Two were brothers grazing their cattle at the time.
861,2/6/2003,India,Jammu,4,0,4,"Four civilians are killed in separate attacks by Islamic terrorists, including one who is beheaded."
862,2/6/2003,Indonesia,Kapompa,1,1,2,Muslim attack on a Christian village leaves one dead and at least one other injured.
863,3/6/2003,Kosovo,Obilic,3,0,3,"Three members of a Serb family, including an elderly couple, are beaten to death in their beds by Muslim attackers."
864,3/6/2003,India,Kishtwar,2,0,2,"A man is killed in his home by the Mujahideen, who had abducted and murdered a second person earlier."
865,4/6/2003,India,Malat,1,0,1,Lashkar-e-Toiba terrorists shoot a civilian to death in captivity.
866,4/6/2003,Algeria,Boumedefaa,12,2,14,Twelve people are murdered and two more injured by Islamic extremists on a remote highway.
867,4/6/2003,Algeria,Beni Douala,8,0,8,Islamic militants kill eight policeman in an ambush.
868,5/6/2003,Afghanistan,Kandahar,9,0,9,Nine people are killed by a Taliban attack.
869,5/6/2003,Chechnya,North Border,17,12,29,Female Fedayeen suicide bomber blows up a bus containing civilians and military personnel.  At least seventeen are killed and more than a dozen injured.
870,7/6/2003,India,Samot,3,1,4,"Muslim terrorists ambush a wedding party, killing three civilians and critically wounding a fourth."
871,7/6/2003,Turkey,Yaylim,1,0,1,A young woman finally dies after clinging to life for seven months in a coma following a stoning for becoming pregnant.
872,7/6/2003,India,Chrung,1,3,4,An AK-47 attack on a group of civilians by Lashkar-e-Toiba terrorists leaves at least one civilian dead.
873,8/6/2003,Nigeria,Numan,1,0,1,Female Christian pastor stabbed to death by a radical Muslim as she was returning home from work (2003).
874,8/6/2003,India,Machipora-Handwara,1,0,1,Radical Muslims force their way into the home of a widow and shoot her to death.
875,8/6/2003,India,Bhillwar,4,0,4,Muslim militants kidnap and brutally execute four Hindu villagers.
876,8/6/2003,Pakistan,Quetta,12,9,21,"Sunni terrorists on motorcycles pull along side a truck full of policemen from the minority Shiite faith and spray them with automatic weapons.  Twelve are killed, nine injured."
877,8/6/2003,India,Pasri Adda,1,0,1,Hizb-ul Mujahideen terrorists responsible for the murder of a government worker.
878,8/6/2003,Israel,Erez,5,4,9,"Gunmen from three different Islamic terrorist groups, disguised as IDF soldiers, open fire on a checkpoint in Gaza, killing four soldiers and wounding four others.  A fifth soldier is killed in Hebron."
879,8/6/2003,Afghanistan,Kabul,5,11,16,Suicide bombing attack against a bus carrying international peacekeepers kills four Germans and injures at least a dozen more. One passerby was also killed.
880,9/6/2003,Chechnya,Dyshne-Vedeno,2,9,11,Mujahideen bomb attack kills two policeman and injures nine more.
881,9/6/2003,India,Kashmir,2,0,2,Two civilians are abducted and murdered by the Mujahideen in separate incidents (Karoos & Wanigam-Tragbal).
882,10/6/2003,India,Kasbrari,1,0,1,A government official is assassinated by Islamists.
883,11/6/2003,Israel,Jerusalem,16,112,128,"Hamas (Islamic Resistance) bomber, disguised as an Orthodox Jew blows up a bus, killing sixteen and injuring at least one-hundred and twelve."
884,12/6/2003,India,Pazalpora,3,0,3,Two civilians are abducted and slaughtered by the Mujahideen.  Another civilian suffers the same fate in Angmattipora.
885,12/6/2003,Afghanistan,Terin Kot,9,6,15,Nine Sunni Muslims were killed and at least six others wounded in a religiously motivated attack by followers of the Shiite Muslim faith.
886,12/6/2003,Algeria,M'sila,2,0,2,"Two people, including a deputy mayor are assassinated by armed Islamists."
887,12/6/2003,Algeria,Batna,3,0,3,Islamic extremists slit the throats of three captured civilians.
888,12/6/2003,Pakistan,Karachi,2,0,2,In separate incidents a Sunni activist and a civil engineer are killed in sectarian violence.
889,12/6/2003,India,Kokernag,2,5,7,Terrorist blast kills two Indian soldiers and injures five more.
890,13/6/2003,India,Kupwara,3,1,4,"Mujahideen militants kill three civilians, including two women, after forcing their way into a home."
891,14/6/2003,Algeria,El-Youssoufia,8,2,10,Attack by armed Islamic group leaves eight security force personnel dead and two wounded.
892,16/6/2003,India,Mangota,1,0,1,Terrorists invade a home and kill one of the women living there.
893,16/6/2003,Algeria,Tizi N'Tleta,4,1,5,"Four policemen are killed, and another injured, by terrorist bombing."
894,17/6/2003,Israel,Kibbutz Eyal,1,3,4,"Palestinian gunmen open fire on a civilian car, killing a 7-year old girl and wounding her 3-year old sister along with her brother and grandfather."
895,17/6/2003,India,Khiram & Shopian,3,3,6,"In separate incidents, Muslim militants assassinate the son of a local politician in his home then kill two more people by setting a bomb in a market district."
896,18/6/2003,India,Jameri,2,0,2,"Hizb-ul-Mujahideen goes on a rampage in a village, setting homes on fire and killing two people, including a teenage boy."
897,18/6/2003,Chechnya,Grozny,4,1,5,Shooting attack on a car by Muslim militants leaves four dead and one wounded.
898,19/6/2003,Iraq,Baghdad,1,2,3,Fedayeen attack on an ambulance kills one American and injures two more.
899,19/6/2003,Algeria,El Ancer,4,0,4,Four people killed by armed Islamic extremists in an attack on a civilian vehicle.
900,19/6/2003,Israel,Moshav Sde Terumot,1,0,1,Father of six working in his grocery is killed by an Islamic Jihad suicide bomber.
901,20/6/2003,Pakistan,Quetta,1,0,1,Shia leader gunned down by Sunni rivals.
902,20/6/2003,India,Pulwama,0,27,27,Mujahideen grenade attack in a crowded marketplace injures twenty-seven.
903,20/6/2003,Chechnya,Grozny,6,36,42,Suicide bombing by two Muslims kills six policeman and injures at least three dozen civilians.
904,20/6/2003,Israel,Ofra,1,3,4,Israeli-American is killed by Hamas (Islamic Resistance) gunmen when driving through the West Bank with his elderly parents (also shot) and his wife.
905,20/6/2003,Algeria,Theniet El-Abed,1,3,4,One killed and three others injured by a bomb set by Islamic fundamentalists.
906,20/6/2003,India,Dodi & Samot,2,0,2,"In separate incidents, two women are abducted and killed by Muslim terrorists.  One was shot to death and the other had poison injected into her."
907,21/6/2003,Algeria,Merjet el-Abed,5,0,5,"Five members of the same family, including three children were slaughtered by Islamic fundamentalists in an attack on a village."
908,22/6/2003,India,Shopian,3,0,3,"Three civilians are murdered by Muslim radicals, including a 34-year-old woman who is tortured before being killed."
909,23/6/2003,India,Sam Samad,1,0,1,"A 20-year-old woman is abducted, sexually assaulted, and murdered by Mujahideen, who say that she was an informer."
910,23/6/2003,India,Pulwama,2,33,35,"Muslim militants explode a bomb near a crowded bus, killing two civilians and injuring thirty-three others."
911,23/6/2003,Israel,Gaza,4,4,8,"Four are killed, four others injured when a bomb carried by the Al Aqsa Martyrs Brigade explodes prematurely."
912,23/6/2003,India,Lassipora,3,1,4,Terrorists invade the home of an 80-year old man and kill him along with his son and daughter-in-law.
913,24/6/2003,Iraq,Amarah,6,8,14,Six British military policemen are murdered by a Shiite mob.  Eight others are wounded in the attack.
914,25/6/2003,Afghanistan,Spin Boldak,2,1,3,Taliban ambush a military vehicle in route and kill two of the occupants with point-blank machine gun fire.
915,25/6/2003,India,Kulgam,2,1,3,Muslim terrorist attack on a remote army camp kills two and injures one.
916,25/6/2003,Algeria,Tablat,8,1,9,"Islamic fundamentalists kill eight villagers, including six children.  They also kidnap a 24-year old woman."
917,25/6/2003,India,Wagbal & Kishtwar,2,0,2,Two civilians are killed by Muslim terrorists in separate incidents.  One involved a home invasion and the other was a shepherd who was abducted while grazing his cattle.
918,26/6/2003,Iraq,Baghdad,1,1,2,Explosive device near a truck carrying Iraqi electrical workers kills one and injures one.
919,26/6/2003,Israel,Baqa al-Gharbiya,1,0,1,Israeli security guard is shot and killed by an Arab youth sent by al-Aqsa martyrs brigade.
920,28/6/2003,India,Jammu,12,8,20,Fedayeen suicide attack on a military barracks kills twelve men and injures seven.  Most of the victims were sleeping when attacked.
921,28/6/2003,India,Chalpora Wadipora,1,0,1,"Civilian kidnapped, tortured and killed by Muslim terrorists."
922,28/6/2003,Algeria,El Milia,1,0,1,"Former Islamist, who renounced extremists views, is kidnapped by Islamists and is murdered by having his throat cut."
923,29/6/2003,India,Kharoosa,1,0,1,A man is killed in his home by the Mujahideen.
924,30/6/2003,Iraq,Fallujah,5,15,20,Explosives hidden in a Mosque for use against American explode prematurely killing at least five and injuring more than fifteen.
925,30/6/2003,Chechnya,Starye Atagi,4,8,12,Terrorist attack on an administrative building leaves four dead and eight wounded.
926,30/6/2003,Israel,Jenin,1,0,1,"One day after agreeing to a cease-fire, Fatah gunmen open up on a truck carrying foreign construction workers.  One Bulgarian is killed."
927,30/6/2003,India,Seri Chawana,2,1,3,"Two civilians killed by Muslim terrorists, one other is injured."
928,30/6/2003,India,Swara Chalil,1,0,1,Radical Muslims drag a 19-year-old girl out of her home and shoot her to death in the street.
929,1/7/2003,India,Doda,1,10,11,"A civilian is gunned down by the Mujahideen, who injure ten civilians in a separate grenade attack."
930,2/7/2003,India,Balas Dharam,1,1,2,"A man is killed, and his wife injured in a Jihad attack on their home."
931,2/7/2003,India,Handwara,2,0,2,Two civilians are kidnapped and executed by Muslim radicals.
932,2/7/2003,India,Shopian,2,0,2,The Jaish-e-Mohammed abducts and murders two police officers.
933,3/7/2003,Iraq,Baghdad,1,0,1,U.S. soldier guarding the National Museum is gunned down by a sniper.
934,4/7/2003,India,Larnu,4,20,24,"Islamic terrorists toss a grenade and open fire into a political meeting, killing two people and wounding twenty.  Two others later die of injuries."
935,4/7/2003,Pakistan,Quetta,53,60,113,"Sunni attack on a Shia Mosque, involving suicide bombers and automatic weapons, leaves fifty-three worshipers dead and at least sixty more injured."
936,5/7/2003,Pakistan,Ranala Kot,1,0,1,"Catholic priest, who received death threats from fundamentalist Muslims, is shot and killed in his home."
937,5/7/2003,Iraq,Ramadi,7,40,47,Jihad terrorist bombing leaves seven Iraqi police recruits dead.  More than forty are injured.
938,5/7/2003,Russia,Moscow,14,24,38,"Two Fedayeen suicide bombers, both female, kill fourteen young people and injure at least two dozen others attending a rock concert."
939,5/7/2003,Iraq,Baghdad,1,0,1,24-year old British journalist shot in the back of the head by Fedayeen assassin outside a museum.
940,5/7/2003,Algeria,Tizi Ouzou,3,0,3,Three government officials killed by Islamic fundamentalists at a roadblock
941,5/7/2003,India,Doda,2,0,2,Two civilians are gunned down in separate Mujahideen attacks.
942,6/7/2003,India,Baramulla,3,1,4,"Three people, including two children, are killed in two separate incidents."
943,6/7/2003,Iraq,Baghdad,1,0,1,U.S. soldier guarding Baghdad University is shot in the back and killed.
944,6/7/2003,Israel,Ramallah,1,0,1,Palestinian terrorists shoot and kill a 35-year old man suspected of being an Israeli collaborator.
945,6/7/2003,Chechnya,Grozny,3,2,5,Bomb planted by Muslim rebels in a passenger car kills three policemen and injures two.
946,7/7/2003,India,Nowshera,5,1,6,"Three Islamic gunmen open fire on a group of Hindu villagers, killing five, including two women, and critically injuring one."
947,8/7/2003,Israel,Kfar Yavetz,1,3,4,Suicide bomber identified as Islamic Jihad kills a 65-year old grandmother of twenty watching TV in her house.  Three of her grandchildren are injured.
948,9/7/2003,India,Kulgam,1,0,1,Hizbul Mujahideen terrorists assassinate political activist.
949,10/7/2003,Iran,Tehran,1,0,1,"The Iranian government beats a Canadian journalist to death, who was imprisoned for taking pictures of student protesters."
950,10/7/2003,India,Khara,1,0,1,The Hizb-ul-Mujahideen kill a civilian at his village.
951,10/7/2003,India,Doda,2,0,2,Muslim militants kill a civilian and one of their own who was attempting to surrender.
952,10/7/2003,Russia,Moscow,1,0,1,Security officer attempting to defuse a female Fedayeen bomb is killed.
953,10/7/2003,Philippines,Koronadal,3,29,32,"Three people, including two children, are killed and about two dozen others wounded by a Moro Islamic terrorist bombing in a marketplace."
954,10/7/2003,Indonesia,Sulawesi,1,0,1,Muslims attack and shoot a Christian to death as he was working his farm.
955,10/7/2003,Indonesia,Kawua,0,5,5,A Christian-owned restaurant is bombed.  Five people suffer injuries including a child.
956,11/7/2003,Pakistan,Karachi,2,0,2,Two office workers are killed in Islamic bombing attack against a Crown Plaza building.
957,12/7/2003,India,Kashmir,1,8,9,"The Mujahideen kill a civilian in Doda and injure eight others, including five women, in a Baramulla grenade attack on a bus."
958,12/7/2003,India,Chak Banola,1,3,4,"A militant Muslim group attacks a police station, killing one of the officers and injuring three others."
959,12/7/2003,Chechnya,Alkhan-Kala,3,2,5,Three sappers are killed in a terrorist bombing attack.
960,12/7/2003,Chechnya,Benoi-Vedeno,3,3,6,Terrorist landmine kills three Russian servicemen and leaves another three injured.
961,12/7/2003,Chechnya,Shatoi,9,5,14,Fedayeen fighters ambush a patrol vehicle with a landmine then rush in with automatic weapons and grenades.  Nine Russians are dead and five injured.
962,13/7/2003,India,Machil,2,0,2,Militant Muslim attack on a security patrol leaves two SF personnel dead.
963,13/7/2003,India,Surankote and Mendhar,3,0,3,Three civilians are killed in their homes by Muslim militants.
964,14/7/2003,India,Hapat Nar,2,3,5,An ambush on a security patrol leaves two dead and three injured.
965,14/7/2003,Afghanistan,Kandahar,5,2,7,Taliban attack on a police station with automatic weapons kills five and injures at least two.
966,14/7/2003,Algeria,Tizi Ouzou,3,0,3,Islamic extremists ambush a truck and kill three bank employees riding inside.
967,15/7/2003,India,Bomthan,4,0,4,"Islamic terrorists kill four civilians in four separate encounters (Bomthan, Zadoora, Tampora and SM Pura) on the same day."
968,15/7/2003,Israel,Tel Aviv,1,2,3,"al-Aqsa Fatah terrorist stabs three civilians, including one woman.  The Israeli killed used his body to successfully shield the woman from the Muslim's knife."
969,16/7/2003,Pakistan,Hyderabad,0,11,11,Islamic fundamentalists thought to be behind a bombing at a hospital that injures eleven.
970,16/7/2003,India,Beerwah,1,1,2,"A man is killed inside his home by the Mujahideen, who also injure his young son in the attack."
971,16/7/2003,India,Guzarbal Bonkoot,2,0,2,A woman is among two people kidnapped from their home by Islamic radicals and murdered in captivity.
972,16/7/2003,Iraq,Haditha,2,0,2,"Pro-American mayor is shot to death, along with his son, while sitting in his car."
973,17/7/2003,Algeria,Skikda,4,0,4,Four civilians killed by Islamic extremists at a roadblock.
974,17/7/2003,India,Harong,3,0,3,"Hizb-ul-Mujahideen terrorists drag three Hindu villagers, including a woman, out of their houses and execute them."
975,17/7/2003,Chechnya,Khasavyurt,4,15,19,"Two police personnel, a pregnant woman and a child were killed in a terrorist bombing by Muslim rebels.  Fifteen others were injured."
976,17/7/2003,Dagestan,Unknown,3,0,3,"Terrorist bombing near a police station kills at least three people, including a pregnant woman."
977,18/7/2003,India,Shopian,2,0,2,"Two people, including a young girl, are shot to death in their homes by the Mujahideen."
978,18/7/2003,Afghanistan,Khost,8,1,9,Eight Afghan soldiers are killed by Taliban militants in a mine explosion.
979,18/7/2003,Iraq,Fallujah,1,0,1,Homemade terrorist bomb kills U.S soldier.
980,19/7/2003,India,Nag Batra & Khour,2,1,3,In two separate attacks Islamic terrorists kill two villagers and injure a young girl.
981,19/7/2003,India,Tral,0,19,19,Nineteen people are injured when Muslim militant hurls grenade into a crowded marketplace.
982,21/7/2003,Chechnya,Assinovskya,1,4,5,Bus bombing kills one policeman and seriously injures four others.
983,21/7/2003,Iraq,Baghdad,2,3,5,Sunni attack kills a soldier and an interpreter.  Three others are injured.
984,22/7/2003,Iraq,Hilla,1,1,2,Shooting attack on a plainly marked Red Cross vehicle kills one staff member and injures the driver.
985,22/7/2003,India,Banganga,7,42,49,Brazen terrorist attack by Muslim militants on a crowd of Hindu villagers who had gathered to receive food kills at least seven and injures more than forty.
986,22/7/2003,India,Aknoor,8,12,20,Fedayeen suicide attack on an Indian army camp kills eight and wounds at least a dozen.
987,25/7/2003,Kosovo,Kosovska Mitrovica,1,4,5,Grenade attack on police station kills one and injures four.
988,25/7/2003,India,Kashmir,4,0,4,"In separate incidents (Saliya, Khandaypora, Kathsoo, Barath) Muslim terrorists target and kill four civilians."
989,25/7/2003,Sudan,Shoba East,42,10,52,"Government troops and Arab militias loot and destroy two African villages, killing at least forty-two civilians."
990,25/7/2003,India,Morha Bachchai,2,4,6,"Jihadis ambush a security patrol, killing two and injuring four."
991,26/7/2003,India,Narkote,1,0,1,A civilian is abducted and brutally killed by the Mujahideen.
992,26/7/2003,Iraq,Baqubah,3,4,7,Sunni terrorist throws grenade into crowd of soldiers guarding a children's hospital from looters.  Three are killed and four badly injured.
993,26/7/2003,Chechnya,Grozny,1,1,2,"Muslim militants attempt a political assassination, leaving one dead and one injured."
994,27/7/2003,Pakistan,Miranshah,0,9,9,Islamic fundamentalists detonate a bomb under a vehicle at a crowded bazaar.  Nine people are injured.
995,27/7/2003,Afghanistan,Girishk,6,0,6,Six afghan policeman are killed in an al-Qaeda attack on their vehicle.
996,27/7/2003,India,Thanna Mandi,1,12,13,A village headsmen is killed by the Mujahideen.  Twelve civilians sustain injuries from an Anantnag grenade attack on a bus stop.
997,28/7/2003,India,Surankote,1,1,2,"A girl is killed in her home, in an attack that also injures her mother."
998,28/7/2003,Pakistan,Saidgai,3,4,7,"Three people, including a woman, are killed in an Islamist bombing at a residence."
999,28/7/2003,India,Mumbai,2,47,49,"Lashkar-e-Taiba terrorists plant a bomb on a passenger bus, killing two and injuring at least forty-seven."
1000,29/7/2003,Afghanistan,Nakhohni,1,0,1,Religious cleric assassinated by Taliban gunmen.
1001,29/7/2003,India,Bandipore,1,1,2,Militant Muslims invade a civilian's home.  They kill one of the resident's daughters and injure another.
1002,29/7/2003,Algeria,Sahara,1,0,1,"German woman, one of fifteen hostages held by Islamic fundamentalists in the Sahara desert, dies of heat stroke."
1003,29/7/2003,Chechnya,Ingushetia,5,0,5,Terrorist landmine kills five Russians.
1004,29/7/2003,Afghanistan,Spin Kotal,1,1,2,Taliban elements attack an international relief agency vehicle and kill the driver.
1005,29/7/2003,Philippines,Patikul,3,0,3,Three civilians are gunned down by Abu Sayyaf terrorists in the Philippines.
1006,29/7/2003,Pal. Auth.,West Bank,1,0,1,"Muslim extremists abduct a Christian convert, butcher him and then return his body to his children in pieces."
1007,30/7/2003,India,Kokernag,1,0,1,"In a brutal attack, the Mujahideen kidnap and kill a civilian."
1008,30/7/2003,Afghanistan,Paktika,1,2,3,A civilian was killed in his home by a Taliban bombing that also injured two policemen.
1009,31/7/2003,Algeria,Jijel,3,3,6,Islamic fundamentalists attack a group of civilians.  Three are killed and three injured.
1010,31/7/2003,Chechnya,Pervomayskoy,4,0,4,Four federal investigators are killed by a terrorist attack in Chechnya.
1011,31/7/2003,India,Shopian,1,0,1,A man is shot to death by the Mujahideen.
1012,1/8/2003,India,Khablan,1,1,2,The Mujahideen invade a home and beat a young girl to death.  Her sister is severely injured as well.
1013,1/8/2003,Russia,Mozdok,50,100,150,Muslim suicide bomber drives into a hospital and kills at least fifty.  More than one hundred are injured in the blast.
1014,2/8/2003,Iraq,Baghdad,3,3,6,Two soldiers and an interpreter are killed when Sunni terrorist detonate a landmine under their vehicle.
1015,3/8/2003,Algeria,Chlef,3,0,3,"Islamic extremists stop a civilian vehicle, spray it with machine-gun fire, then slit the throats of the three occupants."
1016,3/8/2003,Israel,Jerusalem,0,4,4,Palestinian gunmen open up on a car carrying a mother and three children.  All were wounded in the attack.
1017,3/8/2003,India,Buntrchan,1,0,1,A man is killed in his home by the Mujahideen.
1018,4/8/2003,India,Mahore,2,0,2,"Terrorists kill two people, including a teacher attending a wedding."
1019,5/8/2003,Iraq,Tikrit,1,0,1,American oil worker killed by remote-controlled bomb.
1020,5/8/2003,Indonesia,Jakarta,14,100,114,A successful Jemaah Islamiyah suicide attack on a Western hotel in Jakarta kills ten and injures over one hundred people.
1021,6/8/2003,USA,"Houston, TX",1,0,1,"After undergoing a religious revival, a Saudi college student slashes the throat of a Jewish student with a 4"" butterfly knife, nearly decapitating the young man."
1022,6/8/2003,India,Sangrampora,2,0,2,A man and his son are pulled out of their home and beheaded by Jihadis.
1023,7/8/2003,India,Tral & Dhok,3,0,3,"Islamic militants abduct and kill two citizens from Tral.  In Dhok, they kill another civilian in his house."
1024,7/8/2003,Ingushetia,Border,6,7,13,Jihad ambush on a vehicle kills six soldiers on routine patrol and injures another seven.
1025,7/8/2003,Afghanistan,Desho,7,0,7,Six Afghan soldiers and a driver are killed by a Taliban attack on a government building.
1026,7/8/2003,India,Srinagar,2,5,7,Militant Islamic grenade attack on a military vehicle in a crowded marketplace kills two and injures at least five.
1027,7/8/2003,Iraq,Baghdad,16,43,59,At least sixteen people are confirmed dead and more than forty injured by a terrorist car bomb that exploded outside the Jordanian embassy.
1028,9/8/2003,India,Kasblari,2,0,2,The Mujahideen force their way into a house and kill a young man and his father.
1029,9/8/2003,Pakistan,Karachi,5,0,5,Five brothers shot to death in an armed attack outside a mosque.
1030,10/8/2003,Pakistan,Lahore,5,0,5,Five women were murdered in their home by a man who 'doubted their modesty (Muslim 'honor' killing).
1031,10/8/2003,India,Kupwara,2,0,2,"Two civilians are murdered by Muslim terrorists.  One is shot in his home (Drubgam), the other is abducted and later killed (Kandi Khas)."
1032,11/8/2003,India,Kandi,1,0,1,A woman is killed inside her home by the Mujahideen.
1033,11/8/2003,Israel,Shlomi,1,4,5,Hezbollah rocket attack on a village kills a 16 year-old and leaves four other civilians injured.
1034,12/8/2003,Afghanistan,Ghazni,2,3,5,"Two Red Crescent aid workers are killed and three others wounded when their ambulance (bearing the insignia of the Red Cross, however) is attacked by Taliban loyalists."
1035,12/8/2003,Israel,Ariel,1,2,3,Hamas suicide bomber kills one Israeli civilian and injures two others
1036,12/8/2003,Israel,Tel Aviv,1,10,11,Fatah suicide bomber kills a 42 year-old father of two in a shopping mall.  Several others are injured.
1037,12/8/2003,India,Budhan,1,0,1,A civilian is abducted and killed by Islamic terrorists.
1038,13/8/2003,India,Poonch,2,0,2,"Two civilians are killed in separate Jihad attacks, including one in a bombing at his shop."
1039,13/8/2003,India,Bandipore,3,48,51,Al-Mansoorain terrorists kill three people and injure nearly fifty others with an IED.
1040,13/8/2003,Afghanistan,Lashkargah,15,5,20,"Taliban bomb on a passenger bus kills fifteen, including six children."
1041,13/8/2003,Saudi Arabia,Riyadh,3,2,5,al-Qaeda gunmen kill three security force personnel and injure two in a shootout.
1042,13/8/2003,Afghanistan,Kabul,2,1,3,Two Islamic university students are killed and another injured when a bomb that they were making for a terrorist attack explodes prematurely.
1043,13/8/2003,Chechnya,Vedeno,5,3,8,Five Russians are killed and three injured in IED attack.
1044,13/8/2003,Kosovo,Gorazdevac,2,4,6,Kosovo Muslims waiting in the bushes with automatic weapons ambush Serbian boys (ages 10 to 20) who were returning from a swimming trip.  Two are killed and four injured.
1045,14/8/2003,Chechnya,Samachki,2,10,12,Two Russian soldiers are killed and ten others wounded in attack by Fedayeen terrorists.
1046,14/8/2003,Iraq,Zubayr,1,2,3,Terrorist attack on a military ambulance kills one British soldier and leaves two others badly injured.
1047,14/8/2003,India,Khudwani,1,7,8,"Grenade lobbed by Muslim terrorists at a police station bounces into passersby, killing one and injuring another seven."
1048,14/8/2003,India,Bandipore,2,40,42,Muslim militants plant a bomb on a bicycle that goes off killing at least two and injuring more than forty.
1049,14/8/2003,India,Kashmir,2,0,2,Two civilians are murdered in their homes by the Mujahideen (Thamlot & Kandi).
1050,15/8/2003,India,Pakherpora,0,16,16,Sixteen civilians are injured when militant Muslims toss a grenade into the street.
1051,16/8/2003,Pakistan,Karachi,2,0,2,"Two Shia, both career professionals, are gunned down by Sunni assassins.  Interestingly, the Shiites retaliate against KFC."
1052,16/8/2003,Iraq,Baghdad,6,59,65,Six Iraqis are killed and nearly sixty injured by attempted terrorist attack on a U.S. position using mortar bombs.
1053,16/8/2003,India,Kashmir,3,0,3,Three civilians are murdered in separate attacks by the Mujahideen.
1054,17/8/2003,India,Rajouri,1,0,1,Muslims kidnap and cut off the head of a civilian.
1055,17/8/2003,Afghanistan,Barmal (Patika),7,0,7,A large-scale attack on a police station in southeastern Afghanistan by Taliban insurgents leaves seven Afghans dead.
1056,18/8/2003,India,Kashmir,3,0,3,"In separate incidents, Muslim terrorists kill three civilians, including the elderly father of a police constable. (Damhal Khushipora, Morha Handa, Bumlakhi)."
1057,18/8/2003,Afghanistan,Kharwar,10,0,10,"Ten Afghan policeman, returning from a funeral, were ambushed and killed by Taliban fundamentalists."
1058,19/8/2003,Israel,Jerusalem,20,100,120,"Hamas (Islamic Resistance) take credit for blowing up a civilian bus killing at least twenty, including five children and a mother of thirteen (along with her five-month old baby), and injuring more than one hundred, including about forty children."
1059,19/8/2003,Iraq,Baghdad,23,100,123,"At least twenty-three people are killed, and more than one-hundred injured, by Fedayeen suicide bombing attack on a hotel."
1060,19/8/2003,India,Baramulla,2,0,2,A fruit merchant is abducted and killed in one of two terror attacks.
1061,19/8/2003,Pakistan,Rajouri,1,0,1,A doctor is gunned down in a sectarian attack.
1062,20/8/2003,India,Naristan,1,0,1,Islamic militants kidnap an 85-year-old man and kill him in captivity.
1063,20/8/2003,Iraq,Tikrit,1,2,3,"An American interpreter is killed by a Sunni sniper and RPG attack, two others are injured."
1064,21/8/2003,Chechnya,Grozny,9,2,11,Muslim car bomb kills nine Russian soldiers and injures two more.
1065,22/8/2003,India,Badikote,1,0,1,The body of a young woman is found two days after she is kidnapped by the Mujahideen.
1066,22/8/2003,Pakistan,Hyderabad,0,5,5,Five people injured by a bomb placed under a restaurant.
1067,22/8/2003,Philippines,Barangay Matarling,1,4,5,Abu Sayyaf gunmen attack the house of a 37-year old Christian woman.  They kill her and injure four members of her family.
1068,23/8/2003,Iraq,Basra,3,1,4,"Fedayeen gunmen ambush a British vehicle with a flatbed truck, kill three and wound one."
1069,23/8/2003,Afghanistan,Dai Chupan,5,0,5,Taliban attack on a truck carrying government soldiers leaves at least five dead.
1070,24/8/2003,Iraq,Najaf,3,10,13,"Terrorists bomb the house of a Shi'ite leader, targeted for his moderate views.  The cleric survived, but three others are killed and ten injured."
1071,25/8/2003,India,Katarmal,3,0,3,"Lashkar-e-Toiba terrorists force their way into a home and kill a man, his wife, and his daughter-in-law."
1072,25/8/2003,Russia,Krasnodar,3,17,20,Three people were killed in a series of bombings at a cafe and bus stop by Muslim terrorists.
1073,25/8/2003,India,Mumbai,51,156,207,Two terrorist bombs in civilian areas kill at least fifty-one people and injure more than one-hundred and fifty.  Muslim student group behind the attack.
1074,26/8/2003,Chechnya,Grozny,3,0,3,Three policemen were killed in a terrorist RPG attack.
1075,27/8/2003,Dagestan,Makhachkala,1,1,2,Islamic extremists place bomb on the roof of a car carrying a Russian minister.  The minister is killed and his driver badly injured.
1076,28/8/2003,India,Srinagar,4,0,4,"Three civilians were killed, along with a security officer, and an unknown number injured when Islamic terrorists attack a Hotel with grenades and firearms."
1077,28/8/2003,India,Bijbehara,1,2,3,"Militant Muslim lobs a grenade at a police vehicle, it misses, killing a bystander instead and injuring two others."
1078,28/8/2003,Afghanistan,Spin Boldak,3,0,3,Three Afghan soldiers killed by a Taliban attack on a remote checkpoint.
1079,29/8/2003,Israel,Ramallah,1,1,2,Israeli couple is attacked by Palestinian gunmen while driving.  The husband is killed and his 24-year old pregnant wife badly injured.
1080,29/8/2003,Iraq,Najaf,85,142,227,At least eighty-five people are killed in a car bombing by radical Islamists for the purpose of assassinating a moderate Shi'ite cleric.  At least one-hundred forty others are injured.
1081,30/8/2003,India,Kashmir,3,0,3,"Two civilians are killed in Budgam by the Mujahideen, and another in his home in Kulgam."
1082,31/8/2003,Sudan,Habila,30,0,30,"The Muslim Republic drops bombs on an African village earlier in the month, killing at least thirty civilians. (2003)"
1083,31/8/2003,India,Handwara,4,0,4,"Lashkar-e-Toiba a search team, killing four members."
1084,31/8/2003,India,Jugnu,1,0,1,A woman is murdered inside her home by the Mujahideen.
1085,31/8/2003,Kosovo,Gnjilane,1,5,6,"Terrorist grenade attack kills one Serbian, leaves five others injured."
1086,1/9/2003,India,Jawahar Tunnel,1,3,4,"Bomb disposal specialist is killed, and three other people wounded, while attempting to defuse terrorist bomb."
1087,1/9/2003,Iraq,Baghdad,2,1,3,Sunni roadside bomb kills two military policemen and injures one other.
1088,2/9/2003,India,Awantipora,1,20,21,"Terrorist bombing of a bus kills the driver and injures twenty passengers, including three women."
1089,2/9/2003,Pakistan,Karachi,2,0,2,Two political activists murdered in a shooting attack by Islamic radicals.
1090,2/9/2003,India,Udhampur,4,0,4,"Four civilians, including a father and his two sons, are shot to death by militant Muslim terrorists."
1091,2/9/2003,India,Alla Kala,3,0,3,"Hizb-ul-Mujahideen terrorists kill three members of the same family in a home invasion, including a mother and her 14-year old son."
1092,2/9/2003,Iraq,Baghdad,1,10,11,"One Iraqi policeman was killed, and at least ten bystanders were injured when a car bomb exploded outside a police station."
1093,3/9/2003,Iraq,Ramadi,1,2,3,Fedayeen suicide bombing kills an Iraqi interpreter and injures two U.S. soldiers.
1094,3/9/2003,India,Chamalwas,5,0,5,Militant Muslims break up a wedding party and kill five members of the same family including a child.
1095,3/9/2003,Russia,Kislovodsk,5,29,34,Mujahideen terrorist bombing of a commuter train leaves five civilians dead and about thirty injured.
1096,4/9/2003,Pakistan,Karachi,5,0,5,Five people attending a funeral for two slain political activists are shot to death in a terrorist attack.
1097,4/9/2003,Israel,Jenin,1,4,5,Palestinian gunmen kill an Israeli soldier and injure four more.
1098,4/9/2003,India,Poonch,1,2,3,"An Indian woman is killed, and her two children injured, in a failed Fedayeen suicide attack on a military building."
1099,5/9/2003,Iraq,al-Shab City,0,3,3,Three Sunnis are injured by Shia shooting attack on a mosque.
1100,5/9/2003,Afghanistan,Nangrahar,2,19,21,Two people are killed and another nineteen injured when terrorists throw grenades at a wedding party.
1101,5/9/2003,Iraq,Mosul,1,1,2,A dedicated humanitarian and father of three is killed in a Sunni terrorist ambush while working for a charity organization that was working to clear mines in civilian areas.
1102,5/9/2003,Algeria,Mizrana Forest,2,3,5,Islamic fundamentalists kill two Algerian soldiers and injure three others in a bombing.
1103,6/9/2003,India,Srinagar,7,37,44,Muslim car-bombing in a fruit market kills at least seven and injures over thirty-seven.
1104,6/9/2003,India,Udhampur,3,6,9,A Jihad attack on a remote police station leaves three people dead and six injured.
1105,8/9/2003,India,Sarmarg,1,0,1,A woman is shot to death by radical Muslims.
1106,8/9/2003,Afghanistan,Shah Wali Kot,5,5,10,Taliban attack on a pick-up truck kills five Afghan soldiers and leaves another five injured.
1107,8/9/2003,Afghanistan,Ghazni,4,1,5,Taliban insurgents stop a Danish relief vehicle carrying aid workers for a refugee project.  They tie up five of them and then execute four with AK-47s.
1108,9/9/2003,Iraq,Arbil,3,41,44,"Three Iraqis, including a 12-year old boy, are killed and more than forty others injured by a suicide bomber."
1109,9/9/2003,Israel,Jerusalem,7,50,57,Hamas (Islamic Resistance) bomber detonates explosives outside a cafe.  Seven patron are killed and at least fifty injured.
1110,9/9/2003,Israel,Tel Aviv,8,15,23,Eight people are killed and fifteen injured when a Hamas (Islamic Resistance) bomber dressed as an Israeli soldier detonates a suicide bomb at a bus stop.
1111,9/9/2003,India,Doda,1,7,8,One young girl is killed and seven other people injured in a grenade attack by militant Muslims on a market.
1112,9/9/2003,India,Sopat,1,1,2,Muslim terrorists attempt to assassinate a political figure.  One bodyguard is killed and another injured.
1113,11/9/2003,England,Bradford,1,0,1,A 17-year-old girl is strangled by her family for resisting an arranged marriage.
1114,11/9/2003,India,Srinagar,2,14,16,"al-Umar Mujahideen hurl a grenade into a busy market, killing a woman and injuring at least fourteen other people.  One of the injured later dies in hospital."
1115,13/9/2003,India,Bijbehara,2,14,16,"Two civilians are killed, and another fourteen injured, by a IED explosion set by militant Muslims."
1116,13/9/2003,India,Neelidori,4,6,10,"Four security force personnel are killed, and five more wounded, in a Fedayeen attack."
1117,13/9/2003,India,Hajan,3,8,11,"Three people, including a former member of parliament, are killed and eight wounded in a terrorist attack."
1118,14/9/2003,India,Sam Samad,2,0,2,"Two government teachers are killed by militant Muslims, one of whom was abducted and beheaded."
1119,15/9/2003,Iraq,Mosul,1,13,14,"Militants hurl grenade at Albanian soldiers, one is killed and thirteen Iraqi bystanders are injured."
1120,15/9/2003,Iraq,Khaldiya,1,2,3,Iraqi police chief killed in a Sunni ambush.  Two others badly injured.
1121,15/9/2003,Russia,Magas,3,25,28,Fedayeen truck bombing kills at least three people and injures more than twenty-five others.
1122,15/9/2003,Philippines,Campo Uno,2,0,2,"Muslim rebels ambush a group of civilians, killing a teacher and his student."
1123,16/9/2003,India,Khanyar,1,7,8,One civilian is killed in a blast engineered by a Muslim terrorist group.  Seven other people are injured.
1124,17/9/2003,Algeria,Oued Djemaa,9,0,9,Nine Algerian soldiers are killed in an ambush by Islamic fundamentalists.
1125,17/9/2003,India,Chak Nutnusa,2,1,3,"Terrorists invade a home and open fire on a family.  A man and his son are killed, his daughter is injured."
1126,17/9/2003,India,Laam,2,1,3,Hizb-ul-Mujahideen terrorists attack a security patrol with an IED.  The device kills two and injures one other.
1127,18/9/2003,Afghanistan,Ghazni,4,0,4,Taliban car bomb kills four in front of the home of a local police commander.
1128,18/9/2003,India,Kashmir,4,0,4,"Four civilians are killed in separate Mujahideen attacks, including one who was beheaded."
1129,19/9/2003,India,Kashmir,5,0,5,Five civilians are killed in separate attacks by Islamic radicals.
1130,19/9/2003,Algeria,Boumerdes,1,0,1,Man who repented his Islamic beliefs killed by armed Islamists.
1131,21/9/2003,India,Rajouri,4,27,31,"Bomb planted by Muslim terrorists in a video camera explodes in a marketplace, killing four and injuring twenty-seven."
1132,21/9/2003,Iraq,Baghdad,2,13,15,Terrorist mortar bombing of a prison kills two U.S. military policemen and injured thirteen others.
1133,21/9/2003,India,Thanna Mandi,2,0,2,"Muslim terrorists invade a home, dragging out the husband and wife inside, then hanging them."
1134,22/9/2003,Israel,Jerusalem,2,16,18,A female suicide bomber motions over two Israeli policemen and then kills them.  Sixteen passersby are also injured.
1135,22/9/2003,Iraq,Baghdad,1,16,17,Suicide bomber kills one other person and injures sixteen in an explosion outside UN headquarters.
1136,23/9/2003,India,Chak Banola,2,0,2,Militant Muslims kill a man and his son in their home.
1137,24/9/2003,Iraq,Baghdad,1,18,19,Bus bombing kills one civilian and injures eighteen.
1138,24/9/2003,Iraq,Mosul,2,8,10,Grenade attack on a cinema kills two patrons and injures eight.
1139,24/9/2003,Afghanistan,Helmand,2,1,3,The Taliban attack and kill two local humanitarian aid workers.
1140,25/9/2003,Iraq,Baghdad,1,2,3,"One Somali is killed, and two other civilians injured, by a bomb placed at a hotel housing Western journalists."
1141,25/9/2003,Iraq,Baghdad,1,2,3,Female member of the Iraqi governing council dies five days after terrorists ambush her vehicle.  Her two bodyguards were severely injured.
1142,26/9/2003,Iraq,Baqubah,9,15,24,Mortar attack on a crowded marketplace kills nine and injures at least fifteen.
1143,26/9/2003,Bangladesh,Fatullah,1,10,11,One businessman is killed and ten others people are injured in an attack by militant fundamentalists (Hizbut Touheed).
1144,26/9/2003,Israel,Negahot,2,2,4,"Palestinian gunman infiltrates a settlement, randomly picks a house, and then proceeds to shoot the residents, including an infant girl."
1145,27/9/2003,India,Mahore,4,0,4,A 2-year-old child is among four members of a family slaughtered by the Mujahideen in a heinous attack.
1146,27/9/2003,Afghanistan,Sangin,7,0,7,Taliban attack kills seven Afghan bodyguards of local governor.
1147,27/9/2003,Pakistan,Karachi,0,10,10,Ten people are injured when a bomb goes off on a bus.
1148,28/9/2003,Kosovo,Bresje,2,39,41,"Albanian Muslims shoot grenades into a Serbian marketplace, killing two and injuring thirty-nine."
1149,30/9/2003,India,Srinagar,0,19,19,Nineteen people are injured when militant Muslims throw a grenade into a bus stop.
1150,30/9/2003,Dagestan,Unknown,5,0,5,Jihad attack on police vehicle leaves five dead.
1151,30/9/2003,India,Surankote,2,3,5,Lashker-e-Toiba Fedayeen attack on a police station kills two and injures three.
1152,30/9/2003,Algeria,Montgorno,8,3,11,Islamic fundamentalists ambush Algerian military convoy.  Eight soldiers are killed and three injured.
1153,1/10/2003,India,Thuru,1,1,2,"Hizb-ul-Mujahideen terrorists shoot and kill an unarmed youth, whose brother was also injured in the attack."
1154,1/10/2003,Iraq,Tikrit,1,2,3,A female driver is killed and two U.S. soldiers are injured by a roadside bomb in the Sunni triangle.
1155,1/10/2003,Indonesia,Pandiri,1,0,1,A 44-year-old man murdered for leaving Islam and embracing Christianity.
1156,2/10/2003,India,Kreeri Bazaar,1,0,1,The Mujahideen kill a shopkeeper in his store.
1157,2/10/2003,India,Budhan,1,0,1,Terrorists haul a man out of his house and shoot him to death.
1158,2/10/2003,Somalia,Borama,1,0,1,Islamic fundamentalists shoot an Italian aid worker to death on the grounds of the TB hospital she helped to found.
1159,2/10/2003,Chechnya,Shali,2,0,2,Muslim extremists open fire on a vehicle carrying a local mayor and his son.  Both are killed in the attack.
1160,3/10/2003,India,Pulwama,3,0,3,"Militant Muslims kill three civilians in separate incidents (Budhan, Kreeri Bazaar, Wudar Bala)"
1161,3/10/2003,Afghanistan,Kabul,2,3,5,"Two Canadian peacekeepers are killed, and three injured, by Taliban landmines targeting the patrol."
1162,3/10/2003,Iraq,Baghdad,0,5,5,"Five Iraqis, including four teenagers, are injured by Sunni grenade attack."
1163,3/10/2003,Iraq,Tikrit,2,0,2,Two Iraqis are killed by a bomb placed in a traffic circle.
1164,3/10/2003,Pakistan,Karachi,6,8,14,Motorcycle shooting attack by Sunnis on a bus carrying Shiites on their way to worship leaves at least six dead and eight injured.
1165,3/10/2003,Philippines,Midsayap,4,20,24,At least four people are killed and over twenty injured when a Muslim separatist hurls a grenade into a Mosque hosting government officials.
1166,3/10/2003,Pakistan,Quetta,1,2,3,Rocket attack by fundamentalists on a train kills the engine driver and injures two other employees.
1167,4/10/2003,India,Suidhar,2,1,3,"Militant Muslims open fire on a group of civilians, killing two and injuring one."
1168,4/10/2003,India,Rowshera,0,6,6,Six Hindus are injured when Muslim terrorists open fire on them as they were returning from temple.
1169,4/10/2003,Israel,Haifa,19,55,74,Nineteen people are killed and more than fifty wounded by a Islamic Jihad bomber in a restaurant.  Three children were among the dead.
1170,5/10/2003,Somalia,Borama,1,0,1,"60-year old Italian medical missionary, a woman honored by the U.N. for her work with refugees, is shot twice in the head while leaving a hospital."
1171,5/10/2003,Algeria,Beni Bouateb,1,0,1,Armed Islamic extremists kill a communal guard for a small village.
1172,5/10/2003,Afghanistan,Lashkargah,2,3,5,Taliban attack on an Afghan military post kills two and injures three.
1173,5/10/2003,Pakistan,Islamabad,5,0,5,"Five people riding in a government vehicle, including a Sunni leader, are assassinated by gunmen."
1174,6/10/2003,Israel,Metulla,1,1,2,Hezbollah snipers fire from southern Lebanon and kill an Israeli soldier.
1175,7/10/2003,Philippines,Manila,3,3,6,Jailed Abu Sayyaf terrorist kills three policemen who were attempting to negotiate the release of hostages.
1176,7/10/2003,Lebanon,Israeli Border,1,0,1,"A Lebanese boy is killed when Hezbollah missiles, intended for Israel, fall short."
1177,7/10/2003,Iraq,Kirkuk,1,1,2,"One Iraqi employee is killed, and another injured, by al-Qaeda mortar attack on a government building."
1178,7/10/2003,Iraq,Baghdad,4,3,7,Four people are killed in a terrorist ambush.
1179,7/10/2003,India,Ganeshphora,3,2,5,"Explosive device planted by militant Muslims detonates on a bridge, killing two BSF and injuring three."
1180,8/10/2003,Iraq,Kirkuk,1,1,2,"One Iraqi policeman is killed, and another badly wounded, by a terrorist RPG attack on their checkpoint."
1181,9/10/2003,Israel,Tulkarm,1,2,3,"One dead, two injured, by a 17-year old suicide bomber sent from the al-Aqsa Martyrs Brigade."
1182,9/10/2003,Iraq,Baghdad,1,0,1,Spanish diplomat assassinated by Muslim terrorists.
1183,9/10/2003,Iraq,Baghdad,8,32,40,"Eight Iraqis are killed when two Fedayeen drive their car, packed with explosives, into a police station.  More than thirty are injured."
1184,9/10/2003,Indonesia,Poso,2,0,2,Armed Muslims kill at least two Christian villagers and burn homes.
1185,9/10/2003,Algeria,Batna,1,0,1,Algerian policeman has his throat slit by Islamic extremists at a roadblock.
1186,10/10/2003,Iraq,Baiji,2,4,6,Roadside bombing against a bus kills two oil company employees and seriously injures four more.
1187,11/10/2003,Indonesia,Sulawesi,8,24,32,"Muslim gunmen attack Christian villagers, killing eight, injuring dozens more and burning at least one church."
1188,11/10/2003,India,Nagbal,1,0,1,A man is abducted from his home and killed in captivity by the Mujahideen.
1189,12/10/2003,Iraq,Fallujah,2,0,2,Two Iraqi Christians murdered by Holy Warriors.
1190,12/10/2003,Iraq,Baghdad,6,32,38,Six people are killed by Fedayeen car-bombing of a hotel.  At least thirty-two others are injured.
1191,12/10/2003,Afghanistan,Zabul,8,2,10,"80 Taliban fighters on motorbikes attack two government buildings, killing eight people and injuring at least two."
1192,13/10/2003,Chechnya,Shatoi,9,0,9,Militant Muslim attacks on outposts and a convoy leave nine Russians dead and an unknown number injured.
1193,13/10/2003,Iraq,Baiji,1,1,2,"One American is killed, and another injured, by landmine while on patrol at oil refinery."
1194,13/10/2003,India,Chalas,2,2,4,"Muslim separatists fire a rocket into a family home, killing a Hindu woman and her 4-year old child.  Two other family members were injured."
1195,14/10/2003,Iraq,Baghdad,1,3,4,Fedayeen car bomber kills a bystander and injures at least three others outside the Turkish embassy.
1196,14/10/2003,India,Jabri,1,1,2,Islamists kill a 75-year-old man in a shooting attack and leave his wife badly injured.
1197,15/10/2003,India,Choontimulla,1,5,6,"The Mujahideen ambush a security patrol, killing one."
1198,15/10/2003,Israel,Gaza,3,1,4,Three American security guards are killed by a terrorist bombing on their car in Gaza.
1199,15/10/2003,Algeria,Barber,1,2,3,"One municipal guard is killed, and two others injured by terrorist bomb set by fundamentalists."
1200,16/10/2003,Iraq,Karbala,5,7,12,Five policemen (including three Americans) were killed and seven wounded by terrorists in an RPG attack and gun battle.
1201,16/10/2003,Chechnya,Achkoy-Martan,0,4,4,"Four people are injured, one seriously, by terrorist bombing of a cafe."
1202,17/10/2003,India,Srinagar,3,11,14,"Islamic militants attack the residence of a district prime minister, killing a civilian and two security personnel and injuring two civilians.  Nine policemen are injured in the ensuing gun battle."
1203,17/10/2003,Chechnya,Grozny,1,1,2,A government official is killed after Muslim rebels place a bomb in his car.
1204,18/10/2003,Afghanistan,Helmand,2,2,4,"Two government troops are killed, and two wounded by a Taliban roadside bombing attack."
1205,19/10/2003,Afghanistan,Asadabad,4,5,9,"A civilian pick-up truck is bombed by Taliban insurgents, killing the driver, his brother, and two children."
1206,19/10/2003,Israel,Ein Yabrud,3,1,4,Fatah gunmen ambush an Israeli unit guarding a settlement.  Three are killed and one is injured.
1207,20/10/2003,India,Srinagar,1,50,51,One person is killed and more than fifty injured when a Muslim throws a grenade into a crowded bus terminal.
1208,21/10/2003,India,Kulgam,0,17,17,"Militant Muslim throws a grenade into a bus stand, injuring seventeen civilians."
1209,21/10/2003,Somalia,Sheikh,2,0,2,A British couple who dedicated their lives to teaching in Africa are murdered by Islamic terrorists while sitting in their home.
1210,22/10/2003,Israel,Hebron,0,2,2,Two settlers are injured in a gun battle with Palestinian infiltrators.
1211,24/10/2003,Israel,Netzarim,3,2,5,Two Hamas (Islamic Resistance) terrorists infiltrate a Jewish settlement and then enter a barracks to go room from room shooting female soldiers as they slept.
1212,24/10/2003,Iraq,Mosul,2,4,6,Sunni grenade attack kills two children and injures four others.
1213,24/10/2003,Iraq,Amarah,1,0,1,Police chief is gunned down by Muslim terrorists as he leaves a mosque.
1214,25/10/2003,Iraq,Habbaniya,3,2,5,Three civilians are killed and two others injured by Sunni bombing and small arms attack on their vehicle in the Sunni triangle..
1215,25/10/2003,Afghanistan,Shkin,2,0,2,Two American contractors are killed in a Taliban ambush.
1216,26/10/2003,Thailand,Narathiwat,3,0,3,"Muslim separatists kill a policeman and two defense volunteers, two days before a larger attack was planned."
1217,26/10/2003,India,Bijbehara,0,14,14,At least fourteen people are injured when Islamic militants hurl a grenade at a security patrol along a busy road.
1218,26/10/2003,Iraq,Baghdad,1,0,1,Baghdad's deputy mayor assassinated in a drive-by shooting.
1219,26/10/2003,Iraq,Baghdad,1,15,16,Jihad rocket attack on a hotel injures 15 people and leaves a U.S. soldier on guard duty dead.
1220,26/10/2003,India,Kishtwar,1,9,10,"Muslim militant hurls grenade into a bus stop, killing one civilian and injuring nine others."
1221,27/10/2003,Iraq,Baghdad,16,94,110,Fedayeen bombing attacks on the first day of Ramadan on three Iraqi police stations kills at least sixteen and leaves nearly one hundred injured.
1222,27/10/2003,Iraq,Baghdad,11,20,31,"At least eleven people are killed, and more that twenty injured, when a Fedayeen bomber targets the International Red Cross, a humanitarian organization helping Iraqis meet basic needs."
1223,27/10/2003,Philippines,Tawi Tawi,5,0,5,Abu Sayyaf rebels abduct six foreign tourists from a Malaysian resort then use them as human shields in a gun battle.  Five are killed.
1224,27/10/2003,India,Gaghwal,4,9,13,"First day of Ramadan in Kashmir sees Islamic terrorists blow up a railroad bridge, narrowly missing a civilian passenger train.  Subsequent small arms leaves two civilians and two soldiers dead."
1225,27/10/2003,Indonesia,Sulawesi,1,0,1,Christian farmer killed by Jemmah Islamiah terrorists while working his field.
1226,28/10/2003,India,Srinagar,3,32,35,"Islamic rebels lob a grenade into a telegraph office, killing at least three civilians and injuring more than thirty."
1227,28/10/2003,India,Khilani,3,7,10,"Three members of a security patrol are killed, and seven others injured in bombing and small arms ambush by militant Muslims."
1228,28/10/2003,Iraq,Fallujah,3,6,9,"Three people, including school children, are killed and an six injured by a Fedayeen car bombing."
1229,28/10/2003,Philippines,Cotabato,0,5,5,Five people are injured when suspected Jemaah Islamiah members bomb a Catholic church.
1230,28/10/2003,Iraq,Mosul,1,0,1,Editor of a pro-democracy newspaper gunned down by Islamists.
1231,28/10/2003,Algeria,Adekar,2,0,2,Two Algerian soldiers are killed by a landmine planted by the country's Islamic fundamentalists during Ramadan.
1232,28/10/2003,India,Aknoor,2,8,10,"Last surviving Muslim terrorist involved in the bridge bombing at Akhnoor opens indiscriminate fire on a family, killing two children and injuring eight."
1233,29/10/2003,Iraq,Mosul,3,0,3,"Three Iraqi civilians killed, and at least two others injured in RPG terrorist attack on police station."
1234,29/10/2003,Algeria,Tipaza,3,0,3,Islamic extremists kill three civilians after stopping them on a road during Ramadan.
1235,29/10/2003,India,Anantnag,0,20,20,Twenty people sustain injuries when a Muslim terrorist tosses a grenade into a crowd.
1236,30/10/2003,India,Kashmir,2,1,3,Two civilians are abducted from their homes and killed by the Mujahideen (Shopian & Sopore).
1237,31/10/2003,India,Kashmir,3,16,19,Three civilians are killed in separate Mujahideen attacks.
1238,1/11/2003,Bangladesh,Jessore,1,3,4,The leader of a Ahmadiyya religious group is killed by radical Muslims in an attack that also injures several others.
1239,2/11/2003,India,Surankote,1,0,1,A civilian is abducted and murdered by radical Muslims.
1240,2/11/2003,Iraq,Fallujah,2,0,2,Two civilian contractors are killed by bomb in their vehicle.  Muslim mob celebrates.
1241,2/11/2003,Israel,Nablus,1,5,6,"Islamic Jihad bombing of a jeep, kills 1 Israeli soldier and leaves five others injured."
1242,3/11/2003,Saudi Arabia,Mecca,2,1,3,At least two killed and one wounded in militant Islamic shooting attack in Mecca.
1243,3/11/2003,Iraq,Karbala,2,4,6,Car bomb kills two Iraqis and injures four near a Shiite shrine.
1244,4/11/2003,India,Hari Budda,3,2,5,"Militant Muslims bomb a security patrol, then use small arms fire to kill at three and injure two others."
1245,4/11/2003,Iraq,Mosul,2,0,2,Christian judge is assassinated in shooting attack.  This occurs a day after another judge is  kidnapped and murdered in Najaf
1246,5/11/2003,India,Tangmarg,3,0,3,"Militant Muslims invade three homes and kill three civilians, including a mother."
1247,5/11/2003,Iraq,Mosul,3,9,12,"Three Iraqis are killed, and at least nine other people are injured in two separate terrorist grenade attacks.  The dead include a 10-year old boy."
1248,5/11/2003,India,Srinagar,1,0,1,A wildlife officer is shot to death by the Mujahideen.
1249,6/11/2003,India,Baramulla,3,0,3,"Three civilians, including a woman, are killed in a brutal attack by Islamic terrorists."
1250,7/11/2003,Iraq,Baghdad,6,0,6,Six U.S. soldiers and judicial workers are killed when their helicopter is shot down during transport.
1251,8/11/2003,Saudi Arabia,Riyadh,17,122,139,"Seventeen people, including five children are killed and one-hundred and twenty-two injured by al-Qaeda suicide bombing in a residential neighborhood."
1252,8/11/2003,Algeria,Bouira,0,4,4,Four people are injured by Islamic extremists in two separate attacks using small-arms fire and a landmine.
1253,8/11/2003,Sudan,Darfur,42,0,42,"At least forty-two people are killed, and an unknown number wounded when Jihad militias attack 32 villages, burning houses and setting fire to crops."
1254,9/11/2003,India,Awantipora Chowk,5,0,5,Political activist gunned down by Islamic rebels - is the fifth political activist assassinated within the past week.
1255,10/11/2003,Philippines,Basilan,1,3,4,"Abu Sayyaf rebels ambush a routine patrol, killing one and injuring three."
1256,10/11/2003,India,Badgam,2,0,2,"Militant Muslims kill two civilians in their homes.  One was a photographer, the other a farmer."
1257,11/11/2003,Iraq,Basra,6,9,15,"Six Iraqi civilians are killed, and nine injured in a car bomb blast in the Shiite city of Basra.  School children were among the injured."
1258,11/11/2003,India,Quil Muqam,2,0,2,"Two civilians, including a woman, were killed by Islamic terrorists, who used them as human shields in a gun battle."
1259,12/11/2003,Iraq,Nasiriyah,31,80,111,"Over thirty people are killed, and about eighty injured when Fedayeen suicide bombers crash their cars through the gates of an Italian compound and detonate the explosives."
1260,12/11/2003,Afghanistan,Kunar,4,3,7,Taliban car bombing kills four and injures at least three Afghans.
1261,13/11/2003,Iraq,Balad,1,1,2,"Sunni terrorists shoot a civilian contractor to death, and injure another in an attack on their vehicle."
1262,14/11/2003,Ingushetia,Troitskaya,5,10,15,"Terrorists detonate bomb as Russian soldiers are conducting a house search.  Five are killed and ten injured, three critically."
1263,14/11/2003,India,Kashmir,3,0,3,"Three civilians, including a woman, are killed by Muslim terrorists in separate incidents (Gotapora, Srinigar, Pattan)."
1264,15/11/2003,Turkey,Istanbul,23,257,280,"Islamics attack two synagogues with car bombs, killing at least twenty-three and injuring over two-hundred and fifty.  The victims included children and at least one pregnant woman."
1265,15/11/2003,India,Hazratbal,2,6,8,"Six worshippers are injured by bomb blast at one of India's holiest shrines.  Elsewhere, in northern Kashmir, a man and his teen-age daughter are killed by militant Muslims."
1266,15/11/2003,Indonesia,Sulawesi,2,0,2,A church official and his nephew are shot to death by radical Muslims.
1267,16/11/2003,Indonesia,Sulawesi,1,0,1,A Christian man is dragged from his motorcycle and beaten to death by a Muslim mob.
1268,16/11/2003,India,Gole Chakri,3,4,7,"Terrorists lob a grenade into a military jeep on a crowded street.  One SF personnel is killed and four other people, including two civilians, sustain injuries.  Another ambush in Briyali leaves two SF dead."
1269,16/11/2003,Afghanistan,Ghazni,1,0,1,Taliban terrorists shoot a female French aid worker to death in a motorbike attack.
1270,17/11/2003,India,Tatagaon,3,0,3,"Three civilians are killed in separate incidents (Anantnag & Tatagaon) by militant Muslims, including a young girl who was tortured and then killed."
1271,18/11/2003,Israel,Gush Etzion Tunnel,2,0,2,"Palestinian (al-Aqsa) gunman approaches checkpoint with an AK-47 concealed in a prayer mat, which he then uses to shoot two Israeli soldiers to death at point-blank range.  He then flees."
1272,18/11/2003,India,Srinagar,1,5,6,"At least one person is killed, and more than five others injured when Islamic terrorists attack a hotel with bombs and automatic weapons."
1273,19/11/2003,Bangladesh,Chittagong,11,0,11,"Eleven members of a Hindu family, including seven women and a newborn baby are burned alive by a Muslim mob that surrounded their home in the early morning hours."
1274,19/11/2003,France,Paris,2,0,2,Two Jews are brutally murdered by Muslims in separate attacks in Paris.  One has his throat slit and eyes gouged while a 53-year old mother is stabbed 27 times in the neck and chest.
1275,19/11/2003,Iraq,Ramadi,2,1,3,Saddam calls again for Holy War.  A child and one other person are then killed by a car bomb aimed at a pro-American Sunni leader.
1276,19/11/2003,Jordan,Israeli Border,1,5,6,"Jordanian truck driver fires rifle across the border into Israel, killing an Ecuadorian women and injuring four of her tourist companions."
1277,19/11/2003,Algeria,Henchir Toumeghni,2,3,5,"Armed Islamists open fire in a cafe, killing a policeman and injuring several patrons.  Elsewhere (El Aouana) a rural watchman dies in an ambush."
1278,19/11/2003,Afghanistan,Khost,14,23,37,Sustained Taliban rocket attack on an airport kills fourteen Afghans and injures at least twenty-three.
1279,20/11/2003,Iraq,Kirkuk,4,6,10,"At least four civilians are killed, and at least a half dozen injured, by bomb blast in Kurdish political headquarters."
1280,20/11/2003,Turkey,Istanbul,31,400,431,"Coordinated Fedayeen suicide truck bombings, one near a British bank and the other outside the British consulate, kill more than thirty and injure over four-hundred people.  Al-Qaeda and another Islamic group claim responsibility for the killing."
1281,21/11/2003,India,Budgam,2,0,2,Two citizens are shot dead by Muslim militants.  One in his house and the other as he was returning home from worship.
1282,22/11/2003,Israel,Jerusalem,2,0,2,Two Israelis are shot dead while guarding a construction site.
1283,22/11/2003,Iraq,Baqubah,9,15,24,Six Iraqi policeman and three civilians are killed in a Fedayeen car bombing.  More than fifteen others were injured.
1284,22/11/2003,Iraq,Khan Bani Saad,9,10,19,Fedayeen suicide bomber kills nine Iraqis and injures ten at a police station.  A subsequent explosion in the same area injures at least two children.
1285,22/11/2003,Iraq,Baghdad,4,20,24,Four people were killed when Islamists hurled a grenade into a market stall that was selling alcohol.  One of the dead was an 11-year old boy.  Some twenty others were injured.
1286,23/11/2003,India,Mitrigam,1,0,1,A civilian is shot to death inside his home by the Mujahideen.
1287,23/11/2003,Iraq,Mosul,2,0,2,"A Muslim mob throws a concrete block in the way of a military vehicle, causing it two crash.  The mob then drags the two soldiers out, beats them and then slits their throats."
1288,25/11/2003,Israel,Nablus,1,0,1,"Assassination attempt by Palestinian gunmen on Nablus mayor, said to be working with Jews, leaves his brother dead."
1289,25/11/2003,India,Anantnag,2,4,6,An assassination attempt on a Hindu politician by Muslim radicals leaves two people dead and four injured.
1290,27/11/2003,Philippines,Barira,5,4,9,"Five people in the middle of planning a wedding were killed, and four others injured when Moro Islamic Front terrorists strafe their house with gunfire."
1291,27/11/2003,India,Srinagar,1,12,13,"One person was killed, and twelve others injured when militants hurl a grenade into a busy intersection."
1292,28/11/2003,India,Shaashi,1,0,1,A man is gunned down inside his home by Islamic terrorists.
1293,28/11/2003,Algeria,Djelfa,9,3,12,"Nine people, including a Saudi prince, are ambushed and killed by Islamic extremists while on a hunting trip in the desert."
1294,29/11/2003,Iraq,Suwayrah,7,1,8,"Fedayeen ambush kills seven Spanish intelligence agents, riding in two cars, with grenades and automatic weapons."
1295,29/11/2003,India,Wadna,1,4,5,"Militant Muslims fire at a passenger vehicle, killing one and injuring four."
1296,29/11/2003,Iraq,Tikrit,3,0,3,"Two Japanese diplomats, and their Iraqi driver are shot and killed by Fedayeen terrorists."
1297,30/11/2003,Indonesia,Poso,2,0,2,Two Hindu migrants are gunned down as they sat outside their house.
1298,30/11/2003,India,Jammu,4,8,12,"At least four people are killed, and eight injured when Muslim militants defy a brokered cease-fire and hijack two civilian vehicles."
1299,30/11/2003,Iraq,Tikrit,2,2,4,"Two South Korean engineers are killed, and two others seriously wounded by Fedayeen terrorists while traveling in their vehicle."
1300,2/12/2003,USA,"Chicago, IL",1,0,1,A Muslim doctor deliberately allows a Jewish patient to die from an easily treatable condition.
1301,2/12/2003,India,Srinagar,0,21,21,Nineteen policeman and two civilians are injured when militant Muslims attack their station with grenades.
1302,3/12/2003,Philippines,Muti,4,0,4,"Abu Sayyaf terrorists round up four villagers, line them up on a road and shoot them."
1303,4/12/2003,Yemen,al-Baidah,1,1,2,"Regional governor survives assassination attempt by Islamic extremists, with injuries.  His brother is murdered."
1304,4/12/2003,Afghanistan,Bukwakay,1,11,12,A UN worker was killed by a Taliban attack while conducting a census.  Eleven others were injured.
1305,5/12/2003,Russia,Yessentuki,44,150,194,"Mujahideen suicide bomber detonates explosive on a Russian commuter train carrying civilians to work.  At forty-four people, including children eventually die and about one-hundred and fifty others are injured."
1306,5/12/2003,Iraq,Baghdad,4,13,17,"At least three Iraqis and one U.S. soldier are killed by a roadside bomb on a crowded street.  Thirteen others, including eleven Iraqis are injured."
1307,6/12/2003,Afghanistan,Kandahar,0,18,18,"Eighteen Afghan civilians, including three children are injured by a bomb detonated from a parked bicycle.  The Taliban takes credit for the attack."
1308,6/12/2003,Algeria,Bouira,1,0,1,24-year old police officer is gunned down in a store by Islamic extremists.
1309,8/12/2003,India,Anantnag,0,10,10,"Ten people, including civilians and policemen are injured in Mujahideen grenade and shooting attacks in Kashmir."
1310,8/12/2003,Chechnya,Itum Kale,4,1,5,Four Russian soldiers are killed while investigating an explosion at a school.  Another is taken hostage.
1311,8/12/2003,Afghanistan,Muqur,2,0,2,Taliban ambush kills two Pakistani engineers working to restore country's infrastructure.
1312,9/12/2003,Iraq,Mosul,1,2,3,Drive-by shooting attack leaves one American hospital guard dead and two others injured.
1313,9/12/2003,Iraq,Baghdad,3,2,5,"Bombers target a mosque, killing two and injuring three."
1314,9/12/2003,Iraq,Mosul,0,62,62,Fifty-nine U.S. soldiers and at least three Iraqis sustain mostly light injuries when an Islamic suicide car bomber attempts an attack.
1315,9/12/2003,Russia,Moscow,6,14,20,"Female Fedayeen suicide bomber kills six people near the Kremlin and injures at least fourteen, including several college students."
1316,10/12/2003,India,Poonch,3,15,18,"Muslim terrorists lob a grenade into a bus station and then fire indiscriminately into the crowd, killing three and injuring at least fifteen."
1317,10/12/2003,Iraq,Mosul,2,4,6,Militant Sunnis kill two U.S. soldiers on guard duty at two gas stations in drive-by shootings.  Four others are injured.
1318,11/12/2003,Iraq,Ramadi,1,14,15,Three Fedayeen suicide bombers in a furniture truck blow themselves up at the gates of a U.S. military base.  One guard is killed and fourteen others wounded.
1319,12/12/2003,Israel,Nablus,0,7,7,Palestinian gunmen ambush a van carrying Israeli worshippers on their way home from a prayer service.  Seven are injured.
1320,12/12/2003,Pakistan,Quetta,1,0,1,Young boy is killed by a bomb while sifting through garbage outside a house owned by President Karzai of Afghanistan.
1321,14/12/2003,Philippines,North Cotabato,4,3,7,Ambushes by the Moro Islamic Front leave four villagers dead and two wounded.
1322,14/12/2003,Iraq,Khaldiya,17,33,50,"Seventeen city workers, policemen, and civilian bystanders are killed, and another thirty-three injured by Fedayeen suicide blast."
1323,15/12/2003,Dagestan,Shauri & Mokok,9,0,9,At least nine border guards are murdered by Muslim rebels who crossed over from Chechnya to attack a hospital.
1324,15/12/2003,Iraq,Ameriyah,0,7,7,Another Fedayeen suicide bomber kills himself and injures seven Iraqi policemen.
1325,15/12/2003,Iraq,Baghdad,8,10,18,Fedayeen suicide bomber drives car bomb to gates of a police station.  Eight Iraqis are killed in the explosion and at least ten injured.
1326,16/12/2003,Algeria,Medea,2,0,2,Islamic extremists shoot and kill two policemen.
1327,16/12/2003,Philippines,Datu Piang,4,12,16,Government troops seeking refuge in a mosque are attacked by Moro Islamic Front terrorists.  Four are killed and twelve are missing.
1328,17/12/2003,Iraq,Baghdad,2,1,3,A Shiite leader is gunned down near his home by Sunni loyalists.
1329,17/12/2003,India,Gagarsula,1,4,5,Terrorists shoot dead one civilian and abduct four others from a remote village.
1330,18/12/2003,India,Rajouri,2,3,5,Fedayeen attack on a police station kills two officers and leaves three more injured.
1331,19/12/2003,Iraq,Baghdad,1,5,6,Terrorist blast kills one woman working for the main Shiite party in their office building.  At least five others are injured.
1332,20/12/2003,Afghanistan,Khaima,5,2,7,Taliban terrorists attack a remote security post with machine guns and kill five Afghan soldiers as they are eating their evening meal.
1333,21/12/2003,India,Kulgam,0,14,14,Fourteen people are injured in a grenade attack against a police station by militant Muslims.
1334,22/12/2003,Iraq,Mosul,1,0,1,Top level judge shot six times in the back by Fedayeen loyalists.
1335,22/12/2003,Israel,Kfar Darom,2,2,4,Two Israelis are killed when members of the al-Aksa Martyrs Brigade open up on a security patrol with grenades and automatic weapons.
1336,22/12/2003,Iraq,Baghdad,3,2,5,Roadside bomb in the Sunni Triangle kills two Americans and an Iraqi translator.  Two others are wounded.
1337,23/12/2003,India,Bandipore,0,10,10,Ten people are injured when Muslim militants lob a grenade at a security patrol near a hospital.
1338,24/12/2003,Sudan,Darfur,24,25,49,"Government-sponsored militias in this Islamic Republic, kill another two dozen villagers - adding to a toll of more than two million over 20 years."
1339,24/12/2003,Iraq,Irbil,3,12,15,A suicide car bomber kills three other people and injures at least a dozen innocents.
1340,24/12/2003,Iraq,Baghdad,1,2,3,Civilian bus is bombed by Sunni terrorists.  The driver is killed and two passengers are injured.
1341,25/12/2003,Israel,Tel Aviv,4,18,22,"Suicide bomber kills four Israeli civilians, including a teenage girl and injures at least eighteen more at a bus stop."
1342,25/12/2003,Pakistan,Rawalpindi,17,46,63,"Assassination attempt on Pakistani President by Muslim extremists, involving several car bombs, leaves seventeen dead and at least forty injured."
1343,26/12/2003,India,Singhpora,1,11,12,"A 13-year-old girl is killed, and eleven other people are injured when Muslim terrorists trigger a roadside bomb against a transport vehicle."
1344,27/12/2003,India,Tral,1,8,9,An irrigation department employee is killed by the Mujahideen and eight others suffer injuries in a Shopian grenade attack.
1345,27/12/2003,Iraq,Karbala,12,37,49,"Islamic Fedayeen terrorists kill twelve, including four Bulgarians, two Thai engineers and six civilians in three separate suicide attacks.  At least thirty-seven others are injured."
1346,28/12/2003,Afghanistan,Kabul,6,0,6,Six Afghan policemen are killed by two suicide bombers being transported for investigation.
1347,28/12/2003,Iraq,Baghdad,3,5,8,Two Iraqi children and one American are killed by a roadside bomb on a crowded street.  Five others are injured.
1348,28/12/2003,India,Surigam,1,0,1,A man is lynched by Islamists.
1349,29/12/2003,India,Bamkote,1,0,1,A man is pulled from his house and killed just outside his village.
1350,29/12/2003,Afghanistan,Spin Boldak,5,3,8,Five Afghan soldiers are killed when their post is attacked by Taliban terrorists.  Three are injured.
1351,29/12/2003,India,Jammu,0,10,10,Muslim terrorists injure ten people waiting for a bus with a grenade.
1352,30/12/2003,Iraq,Baghdad,1,3,4,"One Iraqi is killed, and three others injured in a roadside bomb attack."
1353,30/12/2003,India,Lawaypora,0,34,34,Thirty-four personnel are injured when Hizbul Mujahideen militants bomb a military patrol.
1354,31/12/2003,Iraq,Baghdad,8,35,43,"A car bomb rips through a restaurant, killing eight people and injuring at least thirty-five."
1355,1/1/2004,Nigeria,Damaturu,1,0,1,A group called the Muhajirun attacks a police station and kills an officer.
1356,1/1/2004,India,Rainawari,0,7,7,"A terrorist is killed, and seven civilians sustain injuries when a bomb being carried on a bicycle detonates prematurely."
1357,1/1/2004,India,Srinagar,1,6,7,Islamic rebels detonate a bomb near a site hosting a peace rally.  One civilian is killed and six others injured.
1358,3/1/2004,India,Jammu,4,15,19,"Four people are killed, and more than fifteen injured when militant Muslims attack a railway station with grenades and small-arms fire."
1359,4/1/2004,Philippines,Parang,22,81,103,Twenty-two people at a political rally for a Christian mayor in a predominately Muslim region are killed by a bomb blast.  More than eighty are injured.  Two Muslims later identified and charged..
1360,4/1/2004,Thailand,Narathiwat,4,0,4,Muslim extremists raid a government armory and then set fire to 18 secular schools in a rampage that leaves at least four soldiers dead and an unknown number injured.
1361,5/1/2004,Egypt,Patmos Center,1,2,3,"One Christian is killed, and two others injured when elements of the Egyptian army burn down a church."
1362,5/1/2004,Thailand,Pattani,2,0,2,Two policemen are killed while trying to defuse a bomb on a parked motorcycle.
1363,5/1/2004,Pakistan,Khanewal,1,0,1,Christian priest shot dead by Islamic terrorists as he was boarding a train.
1364,6/1/2004,Iraq,Fallujah,2,1,3,Two French civilians are gunned down by Sunni insurgents.
1365,6/1/2004,Afghanistan,Kandahar,15,15,30,Bicycle bombing by the Taliban (former religious leaders) along a crowded street kills fifteen people and injures more than fifteen.  Eight children were among the dead.
1366,7/1/2004,Iraq,Baghdad,1,30,31,Rocket attack by Sunni terrorists on a U.S. logistical base leaves one soldier dead and about thirty wounded.
1367,8/1/2004,Iraq,Fallujah,9,0,9,"A medivac helicopter, clearly marked with a red cross, is downed by a missile in the Sunni Triangle, killing all nine U.S. soldiers aboard."
1368,8/1/2004,Pakistan,Adam,4,0,4,Rocket attack on a military base near the Afghan border kills four Pakistani soldiers.
1369,9/1/2004,Iraq,Baqubah,4,36,40,"Four Shiite worshippers are killed, and thirty-six others injured by a car bombing at a mosque in a predominately Sunni town."
1370,9/1/2004,India,Jammu,0,20,20,At least twenty people are injured when a militant hurls a grenade at two police officers.  The blast carries into a local shop.
1371,10/1/2004,Indonesia,Palopo,4,2,6,"Four people are killed, and at least two injured by a bomb blast at a karaoke cafe.  Islamist terrorist attacks killed nearly a dozen Christians there in November."
1372,10/1/2004,India,Lurgam,2,0,2,Man and his wife killed by Mujahideen terrorists outside their home.
1373,11/1/2004,Chechnya,Dyshne-Vedeno,1,1,2,A Jihad attack on a security patrol leaves one Russian serviceman dead and another injured.
1374,11/1/2004,Israel,Talmon,1,2,3,Palestinian gunmen kill a father of five as he is traveling in his car.  Two others are shot and injured.
1375,11/1/2004,Afghanistan,Gerdi Sari,1,0,1,An Afghan civilian is murdered by the Taliban.
1376,12/1/2004,Chechnya,Shali,4,0,4,Muslim militants enter a house and butcher four people.
1377,12/1/2004,India,Anantnag,1,14,15,Grenade attack on a demonstration kills a police officer and injures fourteen other people.
1378,12/1/2004,Afghanistan,Kashrud,4,0,4,Four government soldiers are killed when Taliban extremists attack their post with knives and assault rifles.
1379,12/1/2004,Bangladesh,Mazar,3,36,39,Jamaat-e-Islami fundamentalists place bomb at a shrine that kills three and injures thirty-six.  Ten-year old boy among the dead.
1380,14/1/2004,Algeria,Zaouia,1,1,2,A mother and daughter heading out to harvest olives are hit by a bomb blast.  The mother is killed and the daughter seriously wounded.
1381,14/1/2004,Israel,Gaza,4,10,14,"Female suicide bomber kills herself and four others at a checkpoint for Palestinians entering Israel to work.  Ten others are injured in the blast.  The mother-of-two pretended to fall over, then detonated her bomb against those rushing to help her."
1382,14/1/2004,Iraq,Baqubah,2,12,14,"At least two civilians are killed, and a dozen other people, including children injured by a Fedayeen suicide car bombing attack."
1383,15/1/2004,Pakistan,Karachi,0,12,12,At least a dozen people are injured when a car bomb explodes outside the local headquarters of the Christian Bible Society.
1384,16/1/2004,India,Srinagar,0,7,7,Hezb-ul-Mujahedeen car bombing injures seven members of a security detail.
1385,17/1/2004,Iraq,Tikrit,5,2,7,Two Iraqis and three U.S. soldiers were killed by a remote-controlled bomb planted in a culvert.  Two others were injured.
1386,18/1/2004,Iraq,Baghdad,23,61,84,"At least twenty-three Iraqis are killed, and more than sixty others injured by a Fedayeen suicide bomber who used day laborers as a cover for gaining entrance to a secured zone.  All eight were among the dead."
1387,18/1/2004,Algeria,Leghdira,1,2,3,"Islamic fundamentalists kills a ""repentant"" with a bomb that also injures two police officers."
1388,19/1/2004,Afghanistan,Manzalbath,15,58,73,"The country's former religious leaders detonate a bomb near two schools, killing fifteen innocents, including children."
1389,19/1/2004,Israel,Lebanese Border,1,2,3,Israeli bulldozer hit with a Hezbollah rocket attack.  One soldier was killed and two injured.
1390,21/1/2004,Iraq,Fallujah,4,1,5,"Four Christian Iraqi women, who were laundry workers for the coalition, are attacked and killed while riding in a minivan.  The male driver was injured."
1391,21/1/2004,Iraq,Fallujah,4,5,9,"Sunni terrorists attack a police checkpoint with grenades and automatic weapons.  Three Iraqi policemen and a civilian are killed, with another five injured."
1392,21/1/2004,Indonesia,Maranatha,1,0,1,The 56-year-old head of a local Christian community is killed by Muslim villagers. (2004)
1393,21/1/2004,Afghanistan,Uruzgan,5,1,6,The Taliban take down five civilians with a landmine.
1394,22/1/2004,Thailand,Narathiwat,1,0,1,A Buddhist monk is murdered by Islamic extremists.
1395,22/1/2004,Iraq,Baghdad,2,1,3,Two members of the Communist party are killed by a bomb in their office.
1396,23/1/2004,India,Kashmir,4,0,4,"Militant Muslims kill four people in Baramulla and Bandipora, all suspected of being politically active."
1397,23/1/2004,Thailand,Narathiwat,1,0,1,A policeman is murdered by Islamists.
1398,24/1/2004,Iran,Khatoun Abad,2,2,4,Two mine workers are cut down by government troops at a peaceful demonstration.
1399,24/1/2004,Thailand,Yala,2,1,3,Two Buddhist monks are hacked to death while begging for food in a Muslim neighborhood.  Another is seriously injured in the machete attack.
1400,24/1/2004,Iraq,Samarrah,4,36,40,Roadside bombing in the Sunni Triangle kills four Iraqi civilians and injures another thirty-six people..
1401,25/1/2004,Iraq,Ramadi,4,0,4,Three policemen and a civilian are killed in a terrorist attack on a highway checkpoint.
1402,26/1/2004,Iraq,Baghdad,2,2,4,"IED device set on a busy highway explodes, killing two civilians and injuring two others."
1403,26/1/2004,Chechnya,Sharoi,4,4,8,Jihad attack on a convoy leaves four Russians dead and four injured.
1404,26/1/2004,Iraq,Al-Amiriyah,2,3,5,Two policemen are killed in a drive-by Fedayeen shooting attack on a checkpoint.  Two civilians and a third policeman were injured.
1405,27/1/2004,Iraq,Baghdad,2,1,3,Two CNN employees are killed in a shooting attack as terrorists open up on the car in which they are riding.
1406,27/1/2004,Algeria,Tizi Ouzou,3,0,3,Islamic fundamentalists (Salafist Group for Preaching and Combat) kill two soldiers and one security guard in an ambush.
1407,27/1/2004,Iraq,Baghdad,5,4,9,Two Iraqi civilians are among five killed by two roadside bombs set to go off in succession in the Sunni Triangle.
1408,27/1/2004,Afghanistan,Kabul,2,11,13,Taliban suicide bomber throws himself on a patrol vehicle in downtown Kabul and kills one Canadian peacekeeper and a civilian.  Eleven others were injured.
1409,27/1/2004,Iraq,Samarrah,3,4,7,"Three Iraqis killed, and four injured when truck bomb explodes outside a courthouse."
1410,28/1/2004,Afghanistan,Kabul,1,4,5,One British Peacekeeper is killed by a Fedayeen suicide bomber in a taxi.  Four others are injured in the blast.
1411,28/1/2004,Iraq,Baghdad,4,17,21,"At least four people, including a South African national are killed by a Fedayeen car bombing outside a hotel.  Some seventeen others are killed."
1412,29/1/2004,Dagestan,Makhachkala,2,2,4,Muslim militants thought responsible for a shooting attack on a police car.
1413,29/1/2004,India,Handwara,4,0,4,Muslim gunmen invade a home and shoot to death a resident and a guest.  Two women are killed in a similar manner in Pulwama Rajouri.
1414,29/1/2004,Israel,Jerusalem,11,50,61,"Eleven people are murdered, and at least fifty others injured by a Palestinian suicide bombing inside a passenger bus.  Al-Aksa martyrs brigade claims responsibility."
1415,30/1/2004,Saudi Arabia,Riyadh,7,1,8,Six security guards and a civilian are killed by radical Islamists operatives while attempting to break up a terrorist cell.
1416,31/1/2004,Sudan,Surra,250,30,280,"Final tally from the genocidal attack on an African village earlier in the month is about two-hundred and fifty people slaughtered, mostly women and children.  An unknown number were injured and thirty are still missing. (2004)"
1417,31/1/2004,Iraq,Mosul,9,45,54,Nine people are killed and about forty-five injured by a Fedayeen suicide car bombing outside a police station.
1418,1/2/2004,Afghanistan,Deh Rawood,8,5,13,"An Afghan mayor and seven of his family members, including three children are killed by a Taliban roadside bomb attack. Five others are injured."
1419,1/2/2004,Chechnya,Alleroi,5,0,5,Five security guards are killed when grenade-wielding gunmen burst into a government building intent on a political assassination.
1420,1/2/2004,Iraq,Arbil,117,133,250,Two Ansar al-Islam suicide bombers dresses as Muslim clerics kill more than one-hundred people and injure about one-hundred and thirty in attacks on two buildings housing Kurdish political officials.
1421,2/2/2004,India,Srinagar,1,1,2,A police officer is gunned down outside a mosque.
1422,3/2/2004,India,Chewdara,3,0,3,"Hizbul Mujahideen terrorists invade a home and kill the couple inside, along with another family member."
1423,3/2/2004,Russia,Vladikavkaz,2,10,12,"Two people, including a woman are killed, and at least ten others injured by a car bomb near the Chechen border."
1424,4/2/2004,Thailand,Yarang,1,0,1,Government employee is slashed to death in a machete attack similar to the manner in which three Buddhist monks were killed last month.
1425,5/2/2004,Algeria,Tizi Ouzou,5,0,5,Five police are murdered by armed Islamic extremists in the regional capital.
1426,5/2/2004,India,Salar,4,7,11,Four Indian security forces are killed by a landmine planted by Muslim rebels in Kashmir.  Seven others are injured.
1427,5/2/2004,Chechnya,Grozny,7,11,18,Seven servicemen and police officers are killed in three separate incidents by Mujahideen rebels over a 24-hour period.
1428,6/2/2004,Russia,Moscow,40,134,174,Forty people are murdered by a female Fedayeen suicide bomber as they were commuting to work on a Moscow subway.  About one-hundred and thirty-four are injured.
1429,7/2/2004,Egypt,Cairo,0,3,3,"An Australian and two Norwegian tourists are injured in a knife attack by a man ""angered"" at Israel."
1430,8/2/2004,Philippines,Mangosatubig,2,1,3,"Moro Islamic Front terrorists attack a fishing village, killing two and injuring one."
1431,8/2/2004,Algeria,Miliana,2,0,2,Two policemen are murdered at point blank range by two fundamentalist youth who stopped their car on the pretext of seeking information.
1432,8/2/2004,Iraq,Sawaryah,3,11,14,Bombing attack on the offices of a deputy police chief leaves three dead and eleven wounded.
1433,9/2/2004,Iraq,Mosul,2,0,2,Two Christian family members murdered by radical Jihadists.
1434,10/2/2004,Thailand,Narathiwat,1,0,1,Buddhist official killed by Muslim gunmen.
1435,10/2/2004,Iraq,Baghdad,4,0,4,Four police officers (two cousins and two brothers) are killed in drive-by shootings as they travel to work.
1436,10/2/2004,Iraq,Iskandariya,53,150,203,At least fifty-three people are killed by a massive truck bomb outside a police station.  Some one-hundred and fifty others are injured.
1437,10/2/2004,Algeria,Jijel,4,3,7,Islamic extremists kill four patrons at a roadside cafe.  Three are shot and one has his throat slit.
1438,10/2/2004,Chechnya,Grozny,6,0,6,Six security forces are killed by Jihadist remote-controlled IED.
1439,10/2/2004,Chechnya,Oktyabrsky,3,0,3,Jihad fighters strip three Russian soldiers of their weapons then shoot them to death.
1440,11/2/2004,Afghanistan,Khost,1,0,1,Suicide Taliban attacker kills senior Afghan intelligence official.
1441,11/2/2004,Iraq,Baghdad,47,75,122,Fedayeen suicide bomber kills forty-seven people waiting in line for jobs and injures nearly one-hundred.
1442,12/2/2004,Algeria,Toudja,7,3,10,Armed Islamic extremists ambush and kill seven policemen.  Three others are injured in the attack.
1443,13/2/2004,Afghanistan,All Shaire,2,6,8,A shopkeeper and Afghan soldier were killed by a Taliban terrorist bomb that also injured six others.
1444,13/2/2004,Dagestan,Bamnatbekyurt,3,4,7,"Three police officers were killed, and four wounded by Muslim rebels in a village ambush."
1445,13/2/2004,Afghanistan,Bala Buluk,4,0,4,"Four Afghan aid employees, working to rid the countryside of landmines are shot to death by Taliban extremists."
1446,14/2/2004,Thailand,Narathiwat,2,0,2,Muslim gunmen on a motorcycle kill two workers as they are on their way to a job site.
1447,14/2/2004,Iraq,Fallujah,21,33,54,"'There is no god but Allah!' shout gunmen who storm a police prison, killing more than twenty and injuring at least thirty-three others."
1448,15/2/2004,Iraq,Baghdad,1,4,5,"A Christian pastor is killed, and four others are injured when a vehicle pulls alongside their car and fires into the cabin."
1449,16/2/2004,India,Hyderpora Chowk,3,0,3,A political activist and two policemen are gunned down by Islamists.
1450,16/2/2004,India,Budgam,2,0,2,Muslim rebels kill two villagers.
1451,17/2/2004,India,Dada,2,0,2,Muslim terrorists invade a house and shoot a civilian and his son to death.
1452,17/2/2004,Sudan,Anka,15,8,23,"Government troops and the Janjaweed attack and destroy a village, killing fifteen civilians. (2004)"
1453,18/2/2004,Thailand,Deage,1,0,1,A man is murdered by Islamists.
1454,18/2/2004,Iraq,Hilla,8,106,114,"Eight Iraqis, including five children are killed and more than one-hundred others injured by twin Fedayeen suicide car bombers who were stopped by coalition forces."
1455,18/2/2004,Kosovo,Staro,2,0,2,"Muslim terrorists shoot two civilians, a man and a woman, to death as they were sitting in their car."
1456,19/2/2004,Nigeria,Jos,4,0,4,Muslim gunmen ambush a police vehicle and kill the four passengers.
1457,19/2/2004,Philippines,Jolo,1,1,2,Abu Sayyaf gunmen abduct a 7-year old girl at a Roman Catholic school after killing her driver.
1458,20/2/2004,Iraq,Baghdad,2,1,3,"In two separate attacks, a Muslim cleric and an Iraqi translator are gunned down by assassins."
1459,22/2/2004,Afghanistan,Thalogan,1,1,2,"A Muslim gunman attacks a helicopter on a humanitarian mission, killing the Australian pilot and injuring an American woman helping to set up health clinics in the area."
1460,22/2/2004,Israel,Jerusalem,8,61,69,"An al-Aksa suicide terrorist blows up another civilian bus during rush hour, killing eight passengers and injuring over sixty."
1461,23/2/2004,Chechnya,Grozny,1,0,1,The Mujahideen kill a traffic cop.
1462,23/2/2004,India,Gagarsula,2,3,5,"One security force personnel is killed, and three injured by a remote-controlled bomb.  Elsewhere (Kremshore) a civilian is shot dead outside his shop."
1463,23/2/2004,India,Dadsara,1,4,5,"A 10-year old child is killed, and four others critically wounded when an Islamic militant throws a grenade onto a playground."
1464,23/2/2004,Iraq,Kirkuk,8,35,43,"Eight Iraqi policemen are killed in a Fedayeen suicide car bombing.  Thirty-five others, including two children were hurt."
1465,24/2/2004,Iraq,Mosul,3,0,3,Two Iraqi translators and a technician are shot to death by Sunni terrorists as they drove to work at a coalition military base.
1466,25/2/2004,Nigeria,Yelwa,49,0,49,Forty-nine members of a farming community are slaughtered by Muslim Fulanis after taking refuge in a local church.  Most of the Christians were brutally hacked to death.  The number of injured is unknown.
1467,26/2/2004,Afghanistan,Sarobi,5,3,8,"Five aid workers, involved in a project to build roads and provide clean water, are ambushed and killed by the Taliban.  Three are injured."
1468,26/2/2004,Chechnya,Assinovskaya,14,0,14,Jihadis kill fourteen people with a roadside bomb.
1469,27/2/2004,Bangladesh,Dhaka,0,1,1,An author and scholar barely survives a brutal assassination attempt by Islamists wielding machetes and knives.
1470,27/2/2004,India,Beerwah,1,3,4,Militant Muslims fire on a political rally with RPGs.  One woman is killed and two other women hurt.
1471,27/2/2004,Israel,Lahav,2,0,2,"Palestinian gunmen open fire on a civilian vehicle, killing two young Jewish parents of a two-year old daughter."
1472,27/2/2004,Algeria,Boukerdane,2,0,2,Two off-duty soldiers are executed by Islamic extremists after being stopped at a fake checkpoint.
1473,27/2/2004,Philippines,Mariveles,186,12,198,"Abu Sayyaf, the Muslim extremist group, claims responsibility for an explosion on a ferry that kills nearly two-hundred people."
1474,28/2/2004,Pakistan,Islamabad,0,4,4,"Suicide bomber attacks a Shia mosque.  His is the only fatality, although he did manage to cause serious injury to two children."
1475,28/2/2004,India,Bijbehara,0,13,13,Five security personnel and eight civilians are injured in a grenade attack.
1476,29/2/2004,India,Srinagar,0,8,8,Eight civilians are injured when militant Muslims stage grenade attack on a security camp.
1477,1/3/2004,Eritrea,Teseney,3,12,15,"The Islamic Salvation Group plants two bombs at a hospital, killing three people and injuring a dozen others."
1478,1/3/2004,Thailand,Mayoh,1,0,1,Muslim separatists shoot a policeman to death as he is driving to work.
1479,1/3/2004,India,Pulwama,3,0,3,Militant Muslims kill a civilian and his son in their home.  They also return to the scene of an earlier murder and kill the victim's wife.
1480,2/3/2004,Iraq,Karbala,123,340,463,"al-Qaeda bombers, including one Fedayeen, kill at least one-hundred and twenty Shias gathered for a religious festival.  About three-hundred others are injured."
1481,2/3/2004,Iraq,Baghdad,58,233,291,Three Sunni Fedayeen suicide bombers kill themselves and about fifty-eight worshippers at a Shia shrine and injure more than two-hundred.
1482,2/3/2004,Pakistan,Quetta,42,160,202,"Sunni terrorists invade a Shia religious procession.  They throw grenades, then fire weapons into the crowd, and finish it off by blowing themselves up.  At least forty-two are killed and more than one-hundred and sixty injured."
1483,3/3/2004,India,Jammu,7,12,19,Lashker-e-Toiba ultras storm a high-security central jail in an effort to free other terrorists.  The dead include policemen and civilians.
1484,4/3/2004,Afghanistan,Pakistani Border,7,0,7,Seven Afghan troops are killed by a Taliban rocket and machine-gun attack on their post.
1485,4/3/2004,Iraq,Baghdad,3,5,8,"Three members of a family are killed, and five others injured, by a rocket attack on their car."
1486,5/3/2004,Afghanistan,Shay Joy,2,2,4,Taliban gunmen kill an Afghan guard and a Turkish engineer.  They abduct two others.
1487,6/3/2004,Sudan,Tawila,75,350,425,"Arabs kill seventy-five Africans, rape 100 women and then abduct about two-hundred children and a further one-hundred and fifty women."
1488,6/3/2004,Sudan,al-Kureinik,15,0,15,"Government-supported militia group raids a refugee camp and kills fifteen Christian civilians, including a child."
1489,6/3/2004,Afghanistan,Nokhaiz,1,0,1,Taliban gunmen kill an aid worker driving home.
1490,6/3/2004,Yemen,Zammar,5,30,35,"Gunman tosses grenades and opens fire outside a mosque, killing five and injuring thirty."
1491,6/3/2004,Israel,Erez,3,9,12,"Three Palestinian policemen were killed, and nine injured in a botched attack by three terrorists against an Israeli border checkpoint."
1492,7/3/2004,Dagestan,Makhachkala,1,1,2,An anti-terror official is gunned down by Muslim radicals.
1493,7/3/2004,Iraq,Mosul,2,2,4,Terrorist RPG attack on a police station kills two civilians and injures two more.
1494,7/3/2004,Algeria,Kabylie,2,4,6,Bombing attack by Islamic extremists leaves two Algerian soldiers dead and four injured.
1495,8/3/2004,Sudan,Aish Barra,12,0,12,"Twelve civilians, including three children are killed by a militia group supported by the Muslim government."
1496,8/3/2004,Chechnya,Grozny,9,5,14,Nine Russian soldiers are killed in separate Jihad attacks over a 24-hour period.
1497,9/3/2004,India,Budgam,3,35,38,Attempted abduction goes awry with a terrorist killing himself and three others with a grenade.  Thirty-five are injured.
1498,9/3/2004,Turkey,Istanbul,2,7,9,Suspected al-Qaeda terrorists use an explosive device and weapons fire against the restaurant of a Masonic lodge.
1499,9/3/2004,Iraq,Hilla,3,0,3,"Two American civilians, including a female human rights worker, along with an Iraqi translator are executed after being stopped at a phony checkpoint."
1500,10/3/2004,Algeria,El Harrach,1,0,1,The Salafist group for Preaching and Combat gun down a local cleric.
1501,10/3/2004,Iraq,Basra,2,0,2,"Two Iraqi women, on their way home from working laundry at a coalition base, are shot to death."
1502,11/3/2004,Afghanistan,Khost,2,3,5,Taliban bomb kills two Afghan soldiers and injures another three.
1503,11/3/2004,Indonesia,Maranatha,1,5,6,Brutal machete attack on a Christian village leaves a mother of two dead and five others injured.
1504,11/3/2004,Iraq,Baghdad,2,1,3,"Shia cleric survives assassination attempt, but his son and son-in-law are killed in the shooting ambush"
1505,11/3/2004,Spain,Madrid,201,1841,2042,Ten coordinated al-Qaeda bomb blasts on commuter trains during the rush hour leave over two-hundred people dead and some fifteen hundred injured.
1506,12/3/2004,India,Pulwama,13,12,25,"Muslim militants hole up inside a girl's school after a gun battle with police.  Thirteen people are killed, and at least a dozen wounded in this and incidents in a 24-hour period."
1507,12/3/2004,Algeria,Tebessa,4,0,4,Four Algerian soldiers are killed in an attack by Islamic fundamentalists (Salafist Group for Preaching and Combat).
1508,14/3/2004,Scotland,Glasgow,1,0,1,"Five Pakistani immigrants abduct, torture and then burn alive a 15-year-old Scottish teen in a horrendous attack.  Three later flee the country."
1509,14/3/2004,Israel,Ashdod,10,19,29,"Two 18-year old suicide bombers kill ten port workers, and injure about twenty more.  Al-Aqsa takes credit and says its intended target, chemical tanks, would have caused far greater civilian casualties."
1510,15/3/2004,Kosovo,Pristina,1,0,1,Serbian youth is killed in a drive-by shooting by Muslim terrorists.
1511,15/3/2004,Chechnya,Grozny,9,22,31,Nine Russian soldiers and police are killed in eighteen separate Jihad attacks over a two-day period.
1512,15/3/2004,Iraq,Mosul,4,1,5,Four Christian missionaries working on a humanitarian clean water project for Iraqis are gunned down by Fedayeen terrorists while riding in their vehicle.
1513,16/3/2004,Russia,Arkhangelsk,58,12,70,"Fifty-eight innocent people, including nine children are killed when Chechen terrorists remove the gas caps and cause an explosion in an apartment building."
1514,16/3/2004,Iraq,Baghdad,2,11,13,"Two separate rocket attacks in Baghdad, leave two children dead and about eleven wounded."
1515,16/3/2004,Iraq,Mosul,1,2,3,An Iraqi translator is killed in a shooting ambush in the Sunni Triangle.  Two of his family members are injured.
1516,16/3/2004,Iraq,Mussayib,2,0,2,Two more humanitarian aid workers (German) on a clean water project are gunned down by Fedayeen (Holy Warriors).
1517,17/3/2004,Iraq,Baghdad,7,51,58,"al-Qaeda car bomb rips through a hotel, killing seven and injuring over fifty."
1518,17/3/2004,Iraq,Baghdad,3,9,12,Two separate mortar attacks on U.S. bases leave three dead and nine wounded.
1519,17/3/2004,Algeria,Berrouaghia,8,2,10,"Armed Islamic Group (GIA) attack two ambulances in the desert with machine-gunfire, killing eight people and injuring two."
1520,18/3/2004,Iraq,Baghdad,4,1,5,"Muslims barge into a Christian home and kill the two children they find there.  There mother is also killed, as well as their grandfather."
1521,18/3/2004,Iraq,Basra,3,1,4,Fedayeen suicide bomber kills three other Iraqis and injures at least one outside a hotel.
1522,18/3/2004,Iraq,Baqubah,3,10,13,Sunni gunmen open fire on a bus carrying Iraqi journalists and crew of a local TV station funded by Americans.  Three are killed and ten injured.
1523,19/3/2004,Chechnya,Achkoy-Martan,2,3,5,Two people are killed and three injured when the Mujahideen fire on a car carrying utility workers.
1524,19/3/2004,Pakistan,Karachi,1,6,7,"Islamic radicals spray a police car with automatic weapons fire, killing one and injuring six others, including four passersby."
1525,19/3/2004,Somalia,Hergeysa,2,0,2,Two aid workers shot to death in Somalia by anti-Western extremists.
1526,19/3/2004,Israel,Jerusalem,1,0,1,al-Aqsa Brigade apologizes after the jogger that it gunned down in cold blood turns out to be Arab.
1527,20/3/2004,India,Manasbal,2,40,42,"Two soldiers were killed by a remote-controlled bomb.  Thirty-eight others, along with two civilians were injured in the terrorist attack."
1528,21/3/2004,India,Tanka,3,4,7,Hizb-ul-Mujahideen terrorists kill two children (ages 4 and 5) in their residence with an IED.  Four other family members are injured in the attack.  The same group also killed an off-duty policeman elsewhere in the Doda district.
1529,21/3/2004,Thailand,Pattani,3,0,3,A Buddhist policeman is hacked to death by militant Muslims.  One other policeman and a village chief are shot to death in separate attacks within a 24-hour span.
1530,21/3/2004,Iraq,Baghdad,4,12,16,A rocket attack on a U.S. compound kills two Iraqi civilians.  Elsewhere a roadside bombing kills one civilian and one soldier.
1531,22/3/2004,Pakistan,Islamabad,11,12,23,Two al-Qaeda ambushes claim the lives of eleven Pakistani soldiers.
1532,22/3/2004,Iraq,Baghdad,2,0,2,Two Finnish businessmen are shot and killed by Fedayeen terrorists.
1533,22/3/2004,Iraq,Balad,2,25,27,Car bomb inside a tunnel kills two Iraqi civilians and injures twenty-five others.
1534,22/3/2004,Iraq,Baghdad,2,0,2,Islamists bind and cut the throats of an Assyrian (Christian) couple in their home. (2004)
1535,23/3/2004,Thailand,Yala,1,0,1,A policeman is murdered by Islamists.
1536,23/3/2004,Kosovo,Kuzmin,2,1,3,Albanian terrorists kill two police officers and injure and English translator in Kosovo.
1537,23/3/2004,Chechnya,Grozny,10,13,23,Ten servicemen and police officers are killed in several different terrorist attacks by Jihadists over a 24-hour period.
1538,23/3/2004,Iraq,Mosul,2,6,8,Fedayeen rocket attack kills two civilians and injures six others.
1539,23/3/2004,Iraq,Kirkuk,2,2,4,Drive-by shooting kills two police officers and injures two others.
1540,23/3/2004,Iraq,Hilla,9,2,11,"Sunni gunmen open up on a minibus carrying police and recruits with automatic weapons fire, killing nine and injuring at least two."
1541,23/3/2004,Pakistan,Bannu,4,4,8,Package bomb and Russian-made rocket attack kill at least four.
1542,24/3/2004,India,Rajouri,1,1,2,Militant Muslims kill a 15-year-old girl in an IED attack that also injures her mother.
1543,24/3/2004,Iraq,Baghdad,3,6,9,"Terrorists kill a 3-year-old boy, his grandmother, and another relative with a roadside bomb targeting infidels."
1544,25/3/2004,Iraq,Mosul,1,0,1,Sunni gunmen kill a Christian Assyrian police officer.
1545,26/3/2004,Pakistan,South Waziristan,8,0,8,"Eight injured soldiers, captured by al-Qaeda, are executed in cold blood.  Bodies are recovered by local tribesmen."
1546,26/3/2004,Iraq,Fallujah,8,25,33,"Eight civilians, including three children are killed by Sunni extremists in gun battles and mortar attacks with U.S. troops."
1547,26/3/2004,Pakistan,Zam Cham,2,12,14,"Two civilians are killed, and more than a dozen injured when al-Qaeda remnants fire a rocket into their village."
1548,27/3/2004,Indonesia,Poso,1,0,1,A 27-year-old Christian is gunned down by Muslim terrorists. (2004)
1549,27/3/2004,Thailand,Sungai Kolok,0,28,28,Twenty-eight people are injured when a bomb hidden on a motorcycle explodes outside a karaoke bar.
1550,27/3/2004,Iraq,Mosul,2,0,2,Mujahideen gunmen shoot two British security guards at an oil well then set their vehicle on fire.
1551,27/3/2004,Iraq,Mosul,2,19,21,"Rocket attack on a city hall kills two civilians and injures nearly twenty, including a child."
1552,27/3/2004,Afghanistan,Khost,0,6,6,"Six civilians, including a young child are injured by a Taliban rocket attack on a restaurant."
1553,28/3/2004,Afghanistan,Deh Rawood,2,13,15,"Taliban attack on a military post leaves two people dead, three wounded and ten missing."
1554,29/3/2004,Uzbekistan,Tashkent,19,49,68,"Nineteen people, including children, police officers and civilians are killed in a series of suicide bombings by Muslim extremists in central Uzbekistan.  Nearly fifty are injured."
1555,30/3/2004,Indonesia,Tomura,1,1,2,A Christian pastor is fatally wounded by Muslim gunmen in front of his wife at his church.  One other person is also injured in the attack.
1556,30/3/2004,Uzbekistan,Tashkent,4,0,4,A civilian and three police officers killed in a series of self-induced explosions and gun battles with terrorists.
1557,31/3/2004,Iraq,Ramadi,6,5,11,Six civilians killed by a car bomb.  Five injured.
1558,31/3/2004,Iraq,Fallujah,4,0,4,"In a very brutal attack, a mob of Muslims stop two cars carrying American civilians escorting a food-providing convoy, kill the occupants, set their vehicles on fire, disfigure the bodies and then drag them through the streets."
1559,31/3/2004,Iraq,Baqubah,0,10,10,Six civilians and four police are injured by a car bomb in the Sunni Triangle.
1560,31/3/2004,Sudan,Deleig,120,0,120,Troops from the Muslim Republic descend on a village earlier in the month and haul away about one-hundred and twenty men selected for execution. (2004)
1561,1/4/2004,Chechnya,Gudermes,2,6,8,Jihad warriors kill two people and injure another six in a landmine attack.
1562,2/4/2004,Iraq,Baqubah,3,3,6,"Attackers yell ""Allah Akbar,"" then kill three policemen riding in a vehicle with a hand grenade.  Three others are injured."
1563,2/4/2004,Uzbekistan,Bukhara,1,0,1,Female suicide bomber kills a policeman and critically injures herself.
1564,2/4/2004,Pakistan,Lahore,1,0,1,Christian pastor is gunned down by Muslim extremists in front of his wife and four children.
1565,3/4/2004,Spain,Madrid,1,11,12,"Seven terrorists responsible for the deaths of more than two-hundred train commuters, recite the Qur'an and then blow themselves up.  One policeman is killed."
1566,3/4/2004,Israel,Avnei Hefetz,1,0,1,Father of six shot dead by a Hamas terrorist outside his home after spending the evening with his children.
1567,3/4/2004,India,Kashmir,8,7,15,Mujahideen militants kill two Indian soldiers and six civilians in separate attacks.  Some of the bodies are mutilated.
1568,4/4/2004,Pakistan,Karachi,5,1,6,"Terrorists attack a Pakistani police station, force five captured officers to chant from the Qur'an, then execute them."
1569,4/4/2004,Iraq,Baghdad,9,24,33,"A mob of Shiite radicals storm through a neighborhood, killing nine coalition soldiers sent to protect citizens from violent attack.  Twenty-four others are injured."
1570,4/4/2004,Iraq,Mahmudiyah,2,0,2,Shooting ambush kills Iraqi police chief and his driver.
1571,5/4/2004,Somalia,Berbera,1,1,2,Somaliland government admits that the killers of a Kenyan aid worker were from an al-Qaeda faction.  A German aid worker was seriously injured by the same terrorists.
1572,5/4/2004,India,Srinagar,0,60,60,"About sixty people, including women and children are injured when a militant Muslim hurls a grenade into a busy intersection."
1573,6/4/2004,Iraq,Kut,1,0,1,Radical Shiites enter a house and shoot a South African contractor to death.
1574,6/4/2004,Pakistan,Karachi,3,0,3,At least three people are shot to death by gunmen riding motorcycles.
1575,7/4/2004,India,Parigam,1,0,1,Muslim terrorists enter a civilian's home and shoot his young daughter to death.
1576,7/4/2004,India,Choornar Forest,4,16,20,"Four security force personnel are killed, and sixteen injured when Lashkar-e-Toiba terrorists detonate an IED under their vehicles."
1577,8/4/2004,Afghanistan,Tirin Kot,1,2,3,The Taliban kidnap three men and brutally kill one in captivity.
1578,8/4/2004,Iraq,Fallujah,1,5,6,RPG fired from a mosque injures five Marines.  Another is killed in the ensuing gun battle.
1579,8/4/2004,India,Uri,11,68,79,"Four people are killed immediately (seven others die in hospitals), and sixty-eight injured at a political rally by a Fedayeen suicide bomber."
1580,9/4/2004,Iraq,Baghdad,3,0,3,Three U.S. civilian truck drivers are killed in an attack on their convoy by Fedayeen gunmen.  Their bodies are subsequently mutilated.
1581,10/4/2004,Pakistan,Karachi,1,6,7,"The 'Harakat ul Mujahidin' group sets off a bomb at a golf club, killing one patron."
1582,10/4/2004,Indonesia,Poso,0,7,7,Radical Muslims fire on a group of Christians gathered for Easter service.
1583,10/4/2004,Thailand,Had Yai,1,35,36,Bomb planted by Muslim separatists at a railway station kills a 7-year-old boy and injures thirty-five others.
1584,10/4/2004,Iraq,Hit,4,12,16,"British security guard protecting electrical contractors is shot dead.  Elsewhere, an attack on a fuel convoy leaves three dead and twelve injured."
1585,11/4/2004,Philippines,Sabah,3,0,3,Abu Sayyaf terrorists attack a tugboat and take three crew members hostage.  All three are later executed.
1586,11/4/2004,Iraq,Baghdad,2,0,2,Helicopter shot down by Jihad militants.  Both crew members are killed.
1587,11/4/2004,Pakistan,Karachi,1,9,10,Car bomb set by Islamists at a music concert kills a 23-year-old man and injures nine others.
1588,11/4/2004,Indonesia,Sulawesi,0,7,7,"Islamic gunmen open fire on an Easter church service, wounding seven worshippers."
1589,11/4/2004,Nigeria,Rwang Doka and Jenkur,3,0,3,"Muslim militia attacks two Christian villages and kills three people, in addition to burning homes."
1590,12/4/2004,Chechnya,Ishkhoi-Yurt,7,0,7,At least seven policemen were killed in a terrorist attack by Jihad fighters on their vehicles.
1591,13/4/2004,Saudi Arabia,Um Sedrah,4,2,6,Militants gun down four Saudi police officers at a checkpoint.
1592,13/4/2004,USA,Raleigh,1,4,5,Mental health problems behind member of tight-knit Muslim community deliberately running down five strangers with a vehicle?  One died.
1593,14/4/2004,Afghanistan,Khost,2,2,4,"Taliban elements ambush an Afghan military patrol, leaving two dead and two injured."
1594,14/4/2004,India,Banihal,2,22,24,"Terrorist hurls grenade at a political rally, killing one and injuring twenty-two.  Another soul dies of injuries four days later."
1595,14/4/2004,Iraq,Mosul,4,6,10,"Four civilians, including two women are killed and six others injured by a Fedayeen mortar attack on a crowded market."
1596,15/4/2004,Sudan,Darfur,32,0,32,Thirty-two villagers are massacred by government-backed militias violating a cease-fire.  There were also several homes torched and people injured.
1597,15/4/2004,USA,"Scottsville, NY",1,2,3,"In an honor killing, a Muslim father kills his wife and attacks his two daughters with a knife and hammer because he feared that they had been sexually molested."
1598,15/4/2004,Iraq,Baghdad,2,0,2,"An Italian hostage is executed on videotape after being interviewed by an Arabic news crew.  Elsewhere, an Iranian diplomat is shot to death by Sunni extremists."
1599,15/4/2004,Afghanistan,Chinarto,10,0,10,A local police chief and nine bodyguards are killed in a Taliban ambush on their vehicles.
1600,16/4/2004,Iraq,Mosul,8,17,25,Fedayeen mortar attack leaves eight Iraqi civilians dead and seventeen injured.
1601,16/4/2004,Afghanistan,Del Aram Road,8,0,8,Eight Afghan soldiers at a checkpoint are killed in an overnight rocket attack by Taliban miscreants.
1602,17/4/2004,Israel,Erez,1,3,4,Hamas takes credit for a suicide bombing that kills a 20-year-old border guard then complains loudly when it's own leader is taken out with a missile a few hours later.
1603,17/4/2004,Kosovo,Mitrovica,2,10,12,Jordanian shoots two American women to death who were working as prison guards.  He also injures ten others in the attack.
1604,17/4/2004,Algeria,Baghlia,2,7,9,"Bomb planted by Islamic fundamentalists explodes on a road, killing two Algerian security personnel and injuring seven."
1605,18/4/2004,Thailand,Sungai Padi,1,0,1,Railway worker shot and killed by Muslim separatists while he was on his way to work.
1606,19/4/2004,Chechnya,Grozny,3,0,3,"A woman and her young son are gunned down by Jihadis, along with one other."
1607,19/4/2004,Algeria,Tipaza,3,0,3,Three people killed by Islamic fundamentalists who set up a fake road block to snag the victims.
1608,19/4/2004,Afghanistan,Spin Boldak,1,1,2,Afghan driver is killed in a Taliban ambush on his oil truck.
1609,20/4/2004,India,Srinagar,16,24,40,"Militant Muslims kill at least sixteen, including a female journalist and a taxi driver, in an attempt to disrupt elections.  At least two dozen others are injured."
1610,20/4/2004,Iraq,Baghdad,22,90,112,"Muslim terrorists mortar Abu Ghraib, killing twenty-two prisoners and injuring over ninety."
1611,21/4/2004,India,Udhampur,2,2,4,"One civilian is killed in his home (Doda), another abducted and later shot dead.  Muslim militants also cut off the ears of two other people for participating in the elections."
1612,21/4/2004,Saudi Arabia,Riyadh,6,148,154,"al-Qaeda suicide bomber blasts his way to Allah, taking six others, including an 11-year-old girl, with him in the car bomb explosion.  One-hundred and forty-eight innocents are injured."
1613,21/4/2004,Iraq,Basra,68,100,168,"Five suicide bombings kill sixty-eight people, including eighteen children who burned to death in their school bus.  More than one-hundred other civilians were injured in the ""Holy Warrior"" blasts."
1614,22/4/2004,Thailand,Rayang,3,0,3,"Muslim separatists set fire to fifty government buildings, then kill two firefighters trying to put out the blazes.  The next day they shoot an army officer dead in his driveway while he is washing his car."
1615,22/4/2004,Afghanistan,Sperah,1,0,1,Taliban ambush kills an Afghan.
1616,22/4/2004,Iraq,Baghdad,1,0,1,South African civilian is shot twice in the head and back while on his way to buy meat for a barbecue.
1617,22/4/2004,India,Srinagar,2,6,8,Two people are killed and six injured in grenade attacks by Islamists attempting to disrupt the elections.
1618,23/4/2004,India,Srinagar,0,23,23,"Two separate grenade attacks on political offices leave at least twenty-three people injured, mostly civilians."
1619,23/4/2004,India,Surankote,1,2,3,"Militants open fire on a police station, killing one officer and injuring two others."
1620,24/4/2004,Thailand,Pattani,2,1,3,Two village guards are murdered by Islamists.
1621,24/4/2004,India,Bazipora,2,0,2,Militant Muslims enter the home of a police officer while he is on duty and behead his wife and 8-year-old daughter.
1622,24/4/2004,Iraq,Iskandariya,14,11,25,Fourteen passengers are killed when a bus hits a roadside bomb.  Another eleven are injured in the explosion.
1623,24/4/2004,Iraq,Baghdad,5,6,11,Five soldiers are killed in a rocket attack launched from a residential neighborhood.  Six are wounded.
1624,24/4/2004,Iraq,Tikrit,4,16,20,Roadside bomb kills four - two police and two civilians.  Sixteen others were injured.
1625,24/4/2004,Iraq,Baghdad,12,25,37,Twelve people in a market are killed when Jihadists launched mortar rounds into the crowded area.
1626,24/4/2004,Iraq,Basra,2,4,6,Two U.S. sailors were killed after a boat they boarded exploded.  Two other boats with suicide bombers were intercepted before they could do harm.
1627,25/4/2004,Indonesia,Ambon,38,24,62,"Islamic radicals go on a rampage against Christians, killing more than thirty (some in sniper attacks) and then setting a UN building on fire."
1628,25/4/2004,Iraq,Mosul,2,10,12,Jihad rocket attack on a hospital kills two medics and injures ten other civilian workers.
1629,25/4/2004,India,Kulgam,3,46,49,Militant Muslims attempt to assassinate a female political figure in a grenade attack.  Three are killed and forty-six injured.
1630,25/4/2004,Israel,Migdal Oz,1,2,3,Palestinian gunmen kill a border policeman and wound two others in a sniper attack from a residential section.
1631,26/4/2004,Afghanistan,Panjwayi,3,2,5,Taliban members walk into a humanitarian office and shoot several employees to death.  The office was established to help Afghanis with their basic needs.
1632,27/4/2004,Syria,Damascus,2,0,2,A female civilian and a policeman are killed in a shooting and bombing attack on the British embassy in Damascus by four Islamic radicals.
1633,28/4/2004,Turkey,Istanbul,1,0,1,Two family members are arrested after strangling a 14-year-old girl for having fallen victim to rape.
1634,28/4/2004,Iraq,Kut,2,1,3,Two Ukrainian soldiers are killed an RPG attack on their convoy while on security patrol.
1635,28/4/2004,Iraq,Mosul,9,0,9,Series of Sunni attacks in Mosul kills eight Iraqi policemen and one civilian.
1636,28/4/2004,India,Srinagar,2,55,57,"Two people are killed, and fifty-five others injured in a terrorist explosion at an election rally."
1637,28/4/2004,Thailand,Yala,5,15,20,Thai Muslims storm 15 government buildings in a coordinated attack and kill at least five.  An unknown number are injured.
1638,29/4/2004,Iraq,Mahmudiyah,8,4,12,A suicide car bombing kills eight U.S. soldiers and injures four others.
1639,29/4/2004,Iraq,Basra,1,0,1,South African civilian is killed by Muslim extremists in a drive-by shooting.
1640,29/4/2004,Afghanistan,Thaloqan,6,0,6,Six Afghan soldiers traveling on motorcycles are attacked by Taliban terrorists and killed.
1641,30/4/2004,Iraq,Fallujah,2,6,8,Suicide car bomber kills two U.S. soldiers and injures six.
1642,30/4/2004,Algeria,Relizane,2,0,2,Two hunters fall victim to Islamic extremists in western Algeria.
1643,30/4/2004,Iraq,Mosul,2,5,7,Two foreign security guards are killed in a bomb attack.  Five others are injured.
1644,1/5/2004,Sudan,Akobo,204,70,274,"Khartoum-backed militia kills over two-hundred people, many women and children in a raid on their camp.  Sudan recently criticized the U.S. for abusing prisoner rights."
1645,1/5/2004,Saudi Arabia,Yanbu,7,25,32,Three Saudi employees of an oil company use their access to the building to systematically shoot as many Westerners as possible in a room-by-room attack.  At six are killed on the spot and a seventh man dies two weeks later in a Houston hospital.
1646,1/5/2004,Algeria,Sabounet,3,1,4,A mother and her two children are slaughtered by Islamic extremists in an attack on their village in the Algerian desert.
1647,2/5/2004,Chechnya,Oktyabrskiy,1,2,3,Islamic terrorists kill on person with a roadside bomb.
1648,2/5/2004,Israel,Gush Katif,5,3,8,Palestinian gunmen ambush a vehicle and kill four Jewish children and their pregnant mother who were in the process of entering their community.  Islamic Jihad takes credit for the brutal attack.
1649,2/5/2004,Algeria,Algiers,2,0,2,Two police officers are gunned down by Islamists while on-duty.
1650,2/5/2004,Algeria,Medea,3,1,4,Three community guards are killed by Islamists.  A fourth is kidnapped.
1651,2/5/2004,Algeria,Chrea Forest,2,4,6,Two soldiers are killed when a bomb planted by Islamic extremists explodes under their car.  Four others are injured.
1652,2/5/2004,Iraq,Ramadi,6,0,6,Sunni mortar attack on a U.S. base kills five sailors and one soldier.
1653,3/5/2004,Afghanistan,Zabul,10,0,10,Separate Taliban attacks in southern Afghanistan leave ten security officers dead.
1654,3/5/2004,Pakistan,Gawadar,3,11,14,Pakistani radicals bomb a bus carrying Chinese engineers to a port project.  Three are killed and eleven injured.
1655,4/5/2004,Indonesia,Pekanbaru,2,4,6,"Jemaah Islamiya set a bomb at a grocery store, killing two people and injuring four others."
1656,4/5/2004,Afghanistan,Nuristan,3,0,3,"Two British civilians, working to register Afghans for upcoming elections, are killed along with their translator in a suspected Taliban ambush."
1657,5/5/2004,India,Anantnag Lok Sabha,1,2,3,"Militant Muslim lobs a grenade at a polling booth, killing one and injuring two."
1658,5/5/2004,Indonesia,Maluku,2,3,5,"Muslim gunmen in a speedboat kill a Christian man and an 11-month-old baby.  Three others are also shot, but manage to survive."
1659,5/5/2004,Egypt,Taha al-Aamida,3,0,3,"Muslim police take three Christians, including a priest, into custody as they are repairing a church wall.  All three are then murdered."
1660,6/5/2004,Chechnya,Oktyabrsky,3,1,4,Islamic terrorists kill three police officers in an IED attack.
1661,6/5/2004,Iraq,Baghdad,6,25,31,Suicide car bomber kills five civilians and one soldier at a checkpoint.  Twenty-three other civilians injured in the blast.
1662,6/5/2004,Iraq,Kirkuk,2,1,3,"Car carrying a government official is attacked by Sunni extremists, killing him and the driver, and wounding his wife."
1663,7/5/2004,Pakistan,Toba Tek Singh,1,0,1,Catholic student abducted by Muslim school refuses to convert to Islam and is tortured to death.
1664,7/5/2004,Iraq,Mosul,4,1,5,Roadside terrorist bombing kills four Iraqi policeman.
1665,7/5/2004,Iraq,Latifiya,2,1,3,"An award-winning Polish journalist is shot to death, along with an Algerian colleague by Sunni insurgents in a drive-by attack."
1666,7/5/2004,Pakistan,Karachi,13,80,93,"Thirteen worshippers are killed, and more than eighty others injured when a suicide bomber detonates his explosives inside a Shiite mosque."
1667,7/5/2004,Thailand,Pattani,2,0,2,"Two people are gunned down in separate attacks by Islamic separatists, including a man riding home on a motorcycle."
1668,9/5/2004,Philippines,Zamboanga,6,0,6,Islamic militants are suspected in an ambush that leaves six campaign workers dead.
1669,9/5/2004,Afghanistan,Kabul,2,0,2,"Two foreigners, one a Swiss citizen, are stoned to death in a public park."
1670,9/5/2004,India,Doda,1,15,16,"Militant Muslim lobs a grenade at a hospital, killing one and injuring fifteen others."
1671,9/5/2004,Chechnya,Grozny,24,60,84,"Jihadists assassinate the Chechen President and at least twenty-three others in a stadium blast that leaves more than fifty, including elderly and children severely injured."
1672,9/5/2004,Iraq,Baghdad,7,13,20,Terrorists kill a child and six others by exploding a bomb in a crowded market.  Thirteen others are injured.
1673,10/5/2004,Iraq,Kirkuk,3,0,3,Radicals shoot two foreign civilians and one Iraqi to death in front of their house.
1674,10/5/2004,Iraq,Mosul,1,4,5,Insurgents kill a four-year-old girl in a rocket strike.
1675,11/5/2004,Iraq,Baghdad,2,3,5,"""Allahu Akbar"" shout jubilant al-Qaeda members as they cut off the head of an American (civilian) prisoner on video.  Elsewhere in the city, a Russian contractor is killed and two others abducted."
1676,11/5/2004,Israel,Gaza,6,0,6,"Hamas terrorists trigger a land mine blast under an APC, killing six young Israeli soldiers.  Hamas also takes the body parts to prevent their recovery."
1677,11/5/2004,Nigeria,Kano,11,0,11,At least eleven Christians are burned to death by a Muslim mob that also sets two churches on fire.
1678,12/5/2004,Philippines,Jolo,1,14,15,Abu Sayyaf terrorists kill a fifteen-year-old Catholic girl with a grenade - fourteen others are also injured in the attack.
1679,12/5/2004,Nigeria,Kano,30,44,74,Muslim rampage against Christians continues in Kano with at least another thirty people losing their lives.
1680,12/5/2004,Iraq,Balad,1,4,5,"Philippine warehouse worker is killed, and four other civilian employees injured in a mortar attack on a U.S. base from a residential neighborhood."
1681,12/5/2004,Israel,Rafah,5,0,5,Another remote-controlled landmine attack by Islamic Jihad on an APC kills five additional Israeli soldiers attempting to block off tunnel used by Palestinian terrorists.
1682,14/5/2004,Israel,Rafah,2,2,4,Hamas snipers kill an Israeli soldier as he was in the process of bringing food to an elderly Palestinian woman's house.  A soldier attempting to help the first was killed as well.
1683,14/5/2004,Pakistan,Lahore,7,0,7,"Seven members of a Shia' family, including two women and two children (one a 7-year-old girl) are bound and executed in their home with a bullet to each head.  'Shiites are Infidels' is found written on the wall."
1684,15/5/2004,Dagestan,Makhachkala,2,0,2,Terrorists gun down two police officers returning home from work.
1685,15/5/2004,Iraq,Mosul,4,17,21,"Four civilians were killed, and seventeen others injured by a mortar attack on a recruitment office."
1686,16/5/2004,Iraq,Mahmudiyah,1,1,2,Iraqi woman working as a translator for the coalition is killed in her home.
1687,16/5/2004,Iraq,Baghdad,3,1,4,"Muslim radical opens fire on a minibus carrying Christian women, forcing them to the side of the road.  He then tosses an explosive in the vehicle, killing three, including the driver."
1688,17/5/2004,Iraq,Baghdad,7,8,15,Fedayeen suicide bomber kills the Iraqi governing council president and at least six others.  Eight were reported to be injured in the blast.
1689,17/5/2004,Thailand,Narathiwat,1,3,4,"Muslims bomb three Buddhist temples on Sunday, injuring two.  The next day they shoot a police officer in the head, as he is riding to work."
1690,17/5/2004,Chechnya,Grozny,12,3,15,Three separate Jihad attacks leave twelve Russian servicemen dead and at least three injured or kidnapped.
1691,18/5/2004,Pakistan,Karachi,4,0,4,Four members of Pakistan's Christian minority are targeted and killed by Islamists.  One was a kidnapped youth and two others were on their way to a picnic.
1692,18/5/2004,Israel,Rafah,2,0,2,Palestinian bombs take the lives of two Arab teenagers - a sixteen-year-old girl and her 13-year-old brother - who were washing clothes on the roof of their house when hit by the shrapnel.
1693,18/5/2004,Algeria,Setif,2,13,15,"Salafist Group for Preaching and Combat, an Islamic extremist group kills two Algerian soldiers and injures thirteen others in two bombing ambushes."
1694,18/5/2004,Nigeria,Gidan Sabo,18,0,18,"Muslim Nigerians kill eighteen Christian villagers - mostly farmers, women and children."
1695,19/5/2004,Thailand,Narathiwat,3,2,5,"Islamists fire indiscriminately into a crowd at a pavilion, killing three civilians and injuring two."
1696,19/5/2004,Nigeria,Bakin Ciyawa,24,0,24,Jihadists kill twenty-four Christian villagers.
1697,19/5/2004,Nigeria,Sabo Gida,10,0,10,"Ten Christian villagers are killed by armed Muslims.  An unknown number are injured by the attackers, who also burned churches and houses."
1698,20/5/2004,India,Chadoura,3,22,25,"Hizb-ul-Mujahideen terrorists kill three, including two children, and injure about two dozen with a bomb planted on a bicycle."
1699,20/5/2004,Iraq,Mosul,1,4,5,Bomb blast kills one Iraqi civilian and injures four others.
1700,21/5/2004,Iraq,Baqubah,4,1,5,Jihadists kill four Iraq security personnel manning a road block by driving up and then unloading with RPGs and weapons fire.
1701,21/5/2004,Bangladesh,Sylhet,2,50,52,"At least two people are killed by a bomb blast at a shrine.  Some fifty others, including a British diplomat are injured."
1702,21/5/2004,Nigeria,Saminaka,7,0,7,"In the latest of a series of attacks on Christian villagers, seven more are killed by Nigerian Jihadists as they sought refuge in their homes."
1703,21/5/2004,Nigeria,Jiram,15,0,15,Fifteen Christian villagers are massacred by Jihadists.
1704,22/5/2004,Thailand,Narathiwat,1,0,1,Muslim separatists shoot a police corporal to death as he is walking home.
1705,22/5/2004,Israel,Nablus,0,4,4,A 19-year-old suicide bomber kills himself and injures four others at a checkpoint.
1706,22/5/2004,Saudi Arabia,Riyadh,1,0,1,"A German caterer is shot in the head and body, execution-style, on the sidewalk outside a shopping mall."
1707,22/5/2004,Iraq,Baghdad,6,10,16,"Fedayeen suicide bomber kills six other Iraqis and injures at least ten.  In addition to improving the bomber's afterlife, the blast was intended to kill a ministry official and his wife."
1708,22/5/2004,Sudan,Abga Rajil,56,24,80,Arab militia kill fifty-six African villagers in a raid.  The government-supported terrorists targeted black civilians in their attack.
1709,23/5/2004,Chechnya,Grozny,5,6,11,Five Russians are killed when Jihadists blow up their vehicle and then open fire with assault rifles.
1710,23/5/2004,India,Srinagar,33,4,37,"Hizb-ul-Mujahideen militants trigger a bomb under a bus carrying security personnel and their families.  Thirty-three people, including six women and three children are killed."
1711,23/5/2004,Afghanistan,Waza Khwa,3,1,4,Three Afghan security personnel are killed in a Taliban ambush while they are escorting a food and medical supply shipment to an impoverished area.
1712,23/5/2004,Iraq,Baqubah,2,1,3,"Terrorists fire on a vehicle, killing a university student and a police official."
1713,23/5/2004,Iraq,Basra,5,0,5,"Five members of a family, including two children (ages 4 and 7), are killed in an insurgent mortar attack."
1714,24/5/2004,Iraq,Baghdad,2,1,3,Islamic terrorists kill two British civilians in a rocket attack on their vehicle.
1715,25/5/2004,Indonesia,Ambon,1,13,14,Bomb blast in the Christian sector of the city kills one and injures thirteen.  A second bomb is found near a church and defused.
1716,25/5/2004,Iraq,Baghdad,1,4,5,"An Iraqi boy is killed, and four other civilians injured when a car bomb explodes outside a hotel, near the Australian consul's office."
1717,26/5/2004,Nigeria,Wase,3,6,9,"Fulani militia attacks a government building, killing three workers and injuring at least six.  They also burned houses."
1718,26/5/2004,Chechnya,Vedeno,4,4,8,"Four policemen are killed, and four others injured in an attack by Muslim rebels."
1719,26/5/2004,Pakistan,Karachi,1,22,23,Twin Jihadist car bombings outside the Pakistan-American cultural center kill one and injure at least twenty-two others.
1720,26/5/2004,Iraq,Baghdad,5,6,11,Two Russian civilian contractors and two Iraqi civilians are killed in a shooting attack on their bus as it is pulling out from a power plant.  This follow the 5/10 beating death of another Russian civilian.
1721,27/5/2004,Uzbekistan,Isfara,1,0,1,"A Baptist pastor gunned down by members of the Islamist group, Bayrat."
1722,27/5/2004,Iraq,Najaf,2,0,2,Fedayeen insurgents attack a vehicle carrying a member of the Iraqi governing council.  Her son and bodyguard are killed.
1723,27/5/2004,India,Jammu,5,2,7,"In five separate attacks in the J&K, militant Muslims assassinate four civilians and one former SP officer.  Two others are abducted and missing."
1724,28/5/2004,Nigeria,Langtang,3,0,3,Assault by armed Muslims leaves three Christians dead and several hundred homeless after their village is burned.
1725,28/5/2004,Sudan,Tabit,20,17,37,"Sudanese warplanes bomb a Christian village, killing at least twenty."
1726,28/5/2004,Iraq,Mahmudiyah,2,0,2,"Two Japanese journalists on their way to pick up a 10-year-old blinded child for treatment in Japan are attacked by a Muslim mob, dragged out of their car and beaten to death."
1727,28/5/2004,India,Beerwah,3,0,3,"Five Islamic terrorists invade a home and kill an elderly man, a 2-year-old boy, and the boys mother.  All are shot to death."
1728,28/5/2004,Eritrea,Barentu,7,88,95,"At least seven people are killed, and more than eighty injured in a bomb blast.  The government in neighboring Sudan is suspected of funding the Islamic groups responsible for these attacks."
1729,28/5/2004,Pakistan,Lahore,1,0,1,"Pakistani Christian who was attacked with a hammer by a policeman for violating the State's blasphemy laws dies of his injuries.  The killer claimed he wanted to ""earn a spot in Paradise."""
1730,29/5/2004,Indonesia,Palu,1,0,1,"A Christian prosecutor, working to keep three Bali bombers in jail, is assassinated by Jemaah Islamiah extremists in his car."
1731,29/5/2004,Thailand,Pattani,1,0,1,"Muslim radicals kidnap a Buddhist civilian and decapitate him.  They leave the body with a note attached, warning other Buddhists of the same fate."
1732,29/5/2004,Saudi Arabia,Khobar,22,45,67,"""Are you Christian or Muslim,"" ask al-Qaeda militants as they shoot twenty-two infidels to death, including a 10-year-old boy, and take over forty-five hostages in an attack on an office complex."
1733,30/5/2004,Afghanistan,Musa Qala,4,8,12,"Taliban assassins riding motorbikes swoop into a town and shoot up a government building, killing four and injuring eight."
1734,30/5/2004,Pakistan,Karachi,1,4,5,"Senior Sunni cleric, age 72, is assassinated in an ambush by Shia radicals."
1735,31/5/2004,Iraq,Baghdad,4,25,29,Four Iraqis are killed in a car bombing.  Another twenty-five are injured.
1736,31/5/2004,Pakistan,Karachi,19,35,54,Sunni suicide bomber targets a Shia mosque.  Nineteen worshippers are killed and at least thirty-five others injured.
1737,31/5/2004,Pakistan,Turbat,1,12,13,"Fundamentalists target a Minster of Education who proposed reduced Islamist influence in a new curriculum.  She survives the rocket attack, but a 14-year-old boy is killed and a dozen others injured."
1738,1/6/2004,Algeria,Theniet El-Abed,3,11,14,"Islamic fundamentalists ambush a security patrol, killing three Algerians and wounding eleven."
1739,1/6/2004,Iraq,Baghdad,3,20,23,"Three are killed, and more than twenty injured by a car bombing targeting the minority Kurds, who are seen as infidels by the other Muslim sects."
1740,1/6/2004,Iraq,Baiji,11,26,37,Car bombing by Sunni terrorists kills eleven Iraqis and injures twenty-six.
1741,2/6/2004,Syria,Damascus,2,0,2,Attack by gunmen on the former UN headquarters leaves a policeman and a civilian dead.
1742,2/6/2004,Algeria,Bejaia,11,44,55,"The Islamic Salafist Group for Preaching and Combat attack an Algerian security convoy, killing at least eleven."
1743,2/6/2004,Iraq,Baghdad,5,37,42,Five people rushing to help an injured woman are killed by a car bomb.  Thirty-seven others are injured in the terrorist blast.
1744,2/6/2004,Afghanistan,Khair Khana,5,0,5,"Five members of Doctors Without Borders, the international aid group that provides medical assistance to the impoverished are killed by the Taliban in an ambush on their vehicle."
1745,3/6/2004,Pakistan,North Waziristan,1,2,3,al-Qaeda suicide bomber kills a border guard and injures two others.
1746,3/6/2004,India,Kellar Pahalgam,2,0,2,A political activist is assassinated by militant Muslims.  Another civilian his killed in his home in a separate attack (Kishtwar).
1747,4/6/2004,Chechnya,Grozny,1,1,2,Islamic fundamentalists explode a bomb outside a movie theater.
1748,4/6/2004,Russia,Samara,10,39,49,"Ten people are killed in a bomb explosion in an outdoor market.  Another forty are injured by the blast, which is attributed to militant Muslims."
1749,4/6/2004,Chechnya,Itum-Kalinskiy,4,5,9,"Jihadists attack a Russian convoy, killing four and injuring five with grenades and automatic weapons."
1750,5/6/2004,Algeria,Jijel,3,0,3,Islamic extremists ambush and kill a policeman and two village guards.
1751,5/6/2004,India,Mawar,2,0,2,Hezb-ul-Mujahedeen gunmen invade a home and kill a 55-year-old woman and her daughter.
1752,5/6/2004,Iraq,Mosul,0,17,17,Militants fire RPGs at jobseekers lining up outside a recruitment office.  Seventeen are injured.
1753,5/6/2004,Bangladesh,Dhaka,9,25,34,"At least nine people, including an infant and two women are killed when a state bus is set on fire by organized Islamic terrorists.  About thirty others are hospitalized for serious burns."
1754,5/6/2004,Iraq,Musayyib,7,0,7,"Jihadists disguise themselves as police officers to gain entrance to a police station, then proceed to kill seven officers in cold blood."
1755,5/6/2004,Iraq,Baghdad,4,1,5,Mujahideen gunmen kill four civilian contractors in an ambush - two Americans and two Poles.
1756,6/6/2004,Iraq,Baghdad,9,48,57,"Two suicide bombers, belonging to a group calling itself the 'Unification and Jihad Group' kill nine Iraqis and injure forty-eight others."
1757,6/6/2004,Kosovo,Gracanica,1,0,1,17-year-old Christian teenager is shot to death in a restaurant by Muslim terrorists.
1758,6/6/2004,Pakistan,Dera Ghazi Khan,1,1,2,Female Shia doctor is gunned down by Sunni radicals outside a hospital.  Her driver is seriously wounded in the attack.
1759,6/6/2004,Saudi Arabia,Riyadh,1,1,2,Islamist shoots a Briton to death on the sidewalk.  One other is injured in the attack.
1760,7/6/2004,Iraq,Baghdad,4,0,4,"In the same Christian neighborhood as the morning drive-by, Islamic extremists murder four, including three women returning from work."
1761,7/6/2004,Iraq,Baghdad,4,3,7,Islamic terrorists target Christian workers in a morning shooting attack that leaves four dead and several wounded.
1762,7/6/2004,Thailand,Pattani,2,0,2,"Muslim gunmen shoot a Buddhist teacher to death on the street, one of two Buddhist civilians killed in separate attacks."
1763,7/6/2004,Afghanistan,Logar,2,0,2,Two policemen are killed in a Taliban attack on their station.
1764,8/6/2004,Iraq,Suwayrah,6,0,6,Six European coalition troops are killed by a mortar fired at their base.
1765,8/6/2004,Iraq,Baqubah,6,24,30,"A Fedayeen suicide bomber kills six, including five civilians, and injures over two dozen with his attack, which took place on a busy road at rush hour."
1766,8/6/2004,Iraq,Mosul,10,58,68,Ten Iraqis are killed by a car bombing.  Dozens of others are injured in the terrorist attack.
1767,8/6/2004,Saudi Arabia,Riyadh,1,0,1,American civilian gunned down by Islamists at his home in Saudi Arabia.
1768,9/6/2004,Chechnya,Grozny,10,5,15,Jihad attacks leave nine Russian soldiers and one policeman dead over a 24-hour period.
1769,9/6/2004,England,Brixton,1,0,1,A 21-year-old man is stabbed to death by Muslim gang members for refusing to convert to Islam.
1770,10/6/2004,Iraq,Baghdad,1,0,1,A Christian man is attack and murdered by Islamists in his home.
1771,10/6/2004,India,Udhampur,4,0,4,"Militant Muslims shoot four members of a family to death, including two women and a 6-year-old child."
1772,10/6/2004,Pakistan,Karachi,11,10,21,"Islamic militants ambush a convoy in a busy residential neighborhood.  The intended target escapes the shooting attack, but eleven others are killed."
1773,10/6/2004,Afghanistan,Kunduz,11,4,15,Taliban attack a construction site and shoot to death eleven Chinese nationals working there. Four others are injured.
1774,10/6/2004,USA,"Atlanta, GA",0,4,4,A man riding on an Atlanta commuter train mutters Qur'anic verses then attacks an army officer for no other apparent reason.  An elderly woman and two arresting officers are hurt as well.
1775,11/6/2004,Iraq,Fallujah,3,0,3,al-Qaeda members kill three hostages kidnapped the day before by cutting their throats.  The three were employees of a telecommunications company.
1776,11/6/2004,Chechnya,Grozny,3,1,4,"Jihadis explode a bomb under a police vehicle, killing three occupants."
1777,12/6/2004,Algeria,Skikda,1,3,4,Islamic fundamentalists detonate an IED as four civilians walking by.
1778,12/6/2004,Chechnya,Grozny,2,1,3,Two policemen are killed in a Jihad bombing attack.
1779,12/6/2004,Philippines,Jolo,1,2,3,Abu Sayyaf place a bomb outside a restaurant which kills one person.
1780,12/6/2004,India,Pahalgam,5,28,33,"Islamist kills five tourists, including two children with a grenade lobbed inside a crowded hotel.  Twenty-eight others are injured."
1781,12/6/2004,Saudi Arabia,Riyadh,1,1,2,al-Qaeda kills an American civilian as he is parking his car outside his home and kidnaps another American.
1782,13/6/2004,India,Handwara,1,22,23,"Twenty-two civilians are injured, four critically by an Islamist who threw a grenade into a busy street.  One victim later dies in the hospital (6/14/04)."
1783,13/6/2004,Iraq,Baghdad,13,12,25,A Fedayeen suicide bomber kills thirteen Iraqis and injures at least a dozen with a car bomb.
1784,13/6/2004,Iraq,Baghdad,2,0,2,Extremists assassinate two government officials in separate shooting attacks.
1785,13/6/2004,India,Baramulla,2,1,3,"Islamic militant hurls a grenade at the house of a retired government official, killing the man, his sister and seriously injuring his son."
1786,14/6/2004,India,Rajouri,2,0,2,A father and son are shot to death in their home by Muslim terrorists.
1787,14/6/2004,Iraq,Baghdad,13,61,74,"A suicide bomber targets foreign civilian contractors working to restore the country's power plants.  Thirteen people, other than this religious man, were killed immediately and more than sixty injured."
1788,15/6/2004,Thailand,Yala,1,0,1,A rubber farmer is murdered by Muslim terrorists while riding in his truck.
1789,15/6/2004,Iraq,Kirkuk,4,1,5,"Four people assassinated in as many days by Fedayeen.  The civilian victims are an oil company executive, a cleric, district mayor and the father of a policeman."
1790,16/6/2004,Afghanistan,Kanduz,4,1,5,"Four citizens, including two children and an elderly man are killed by a Taliban remote-control bomb."
1791,16/6/2004,Thailand,Narathiwat,3,7,10,"Muslim separatists kill an 18-year-old college student, a school janitor and a police officer in a drive-by shooting attacks.  They also bomb a police check-point, injuring five."
1792,17/6/2004,Iraq,Baghdad,35,145,180,'Holy Warrior' suicide bomber kills at least thirty-five Iraqi civilians and injures nearly one-hundred and fifty other innocents who happened to be on a busy street near a recruiting center.  The vehicle used was apparently packed with artillery rounds.
1793,17/6/2004,Iraq,Balad,6,4,10,Car bombing by Sunni insurgents kills six member of the Iraqi Defense Forces and injures four.
1794,18/6/2004,Saudi Arabia,Riyadh,1,0,1,"Family members of captured hostage appeal to kidnappers humanity with children and grandchildren.  Islamists quote from the Qur'an, praise Allah and then cut the victim's head off."
1795,18/6/2004,Sudan,Babanousa,3,12,15,"The Islamic government kills two student demonstrators, along with a 50-year-old shop owner."
1796,19/6/2004,Thailand,Yala,1,3,4,A Buddhist teacher is shot to death by Muslim extremists.
1797,19/6/2004,Iraq,Basra,3,0,3,Remote-controlled bomb kills two oil workers and one Iraqi security personnel.
1798,19/6/2004,Thailand,Pattani,1,4,5,"Militant Muslims spray a police car with an AK-47, killing the driver.  The same group injures four others with a bomb."
1799,20/6/2004,Iraq,Diyala,2,0,2,"Husband and wife are killed when ""holy"" warriors fire rocket into their home."
1800,21/6/2004,Sudan,Golo,6,0,6,Government-backed militia burns several villages and kill six civilians.  More than a thousand are displaced.
1801,21/6/2004,Iraq,Baghdad,10,0,10,Sunni extremists kill ten civilians and police in a mortar attack.
1802,21/6/2004,Afghanistan,Kandahar,1,3,4,"A policeman is killed and an election worker, along with four others are injured in a Taliban motorcycle attack."
1803,21/6/2004,Ingushetia,Nazran,57,60,117,"Jihad fighters rampage through a town, shooting in cold blood or burning to death at least fifty-seven people and injuring another sixty."
1804,21/6/2004,Israel,Kfar Darom,1,0,1,"Palestinian terrorists attack a Jewish settlement, killing a greenhouse worker from Thailand."
1805,21/6/2004,Algeria,Algiers,0,11,11,Eleven are injured in a fundamentalist car bombing of a power plant.
1806,22/6/2004,Thailand,Narathiwat,1,0,1,A religious teacher is gunned down by Islamic separatists in his home.
1807,22/6/2004,Iraq,Baghdad,3,6,9,"Car bomb explodes in a residential neighborhood, killing three, including a 3-year-old girl and injuring another six civilians."
1808,22/6/2004,Iraq,Baghdad,1,0,1,"al-Qaeda group ""Monotheism and Jihad"" beheads a Korean hostage in front of a banner praising Allah."
1809,22/6/2004,Iraq,Mosul,2,0,2,Islamists stab a female law professor to death on her doorstep.  Her husband is killed in the same manner.
1810,23/6/2004,Iraq,Baghdad,3,2,5,A mother and her child are among three killed by a roadside bomb.  Two other civilians are wounded in the blast.
1811,23/6/2004,Iraq,Basra,2,0,2,"As their father waited at home for their return, two Christian sisters are gunned down by Muslim extremists in a particularly heinous and senseless murder."
1812,23/6/2004,Ingushetia,Nazran,35,58,93,Thirty-five more bodies are found from the attack on a town by Jihad terrorists.  The number injured doubles to one-hundred nineteen.
1813,23/6/2004,Afghanistan,Spin Boldak,5,2,7,"Taliban extremists shoot a rocket at an Afghan military vehicle on security patrol.  Five killed, two injured."
1814,24/6/2004,Algeria,Medea,5,0,5,Islamic fundamentalists stop a car on a remote road carrying members of a family and slit the throats of all five - ages 8 to 50.
1815,24/6/2004,Iraq,Mosul,112,320,432,"Series of coordinated terrorist attacks, including suicide bombings and other Fedayeen tactics kill over one-hundred Iraqis and injure hundreds more across the country.  Recorded message says 'killings will continue until Islamic rule back on earth.'"
1816,24/6/2004,Thailand,Cho Airong,1,2,3,"Muslim separatists attack an army base, killing one Thai soldier and injuring two others."
1817,25/6/2004,Afghanistan,Zabul,16,0,16,"The Taliban stops a bus in a remote area, kidnaps sixteen people carrying voter registration cards, then kills them in brutal fashion."
1818,25/6/2004,Chechnya,Grozny,1,1,2,"Government official shot to death as he left a restaurant with his wife, who was badly injured in the assassination."
1819,25/6/2004,India,Tiali Kathamara,12,12,24,"Twelve people, including a woman and five children are killed by militant Muslim gunmen who enter a remote village and force the people out of their homes.  Ethnic cleansing appears to be the motive."
1820,26/6/2004,Iraq,Baqubah,3,20,23,"Car bombing kills one, injures twenty.  In Erbil, a shooting and grenade attack on a Shiite political office leaves two guards dead."
1821,26/6/2004,Afghanistan,Jalalabad,3,11,14,"Two female election workers and one child are killed, and nine other women and two children are badly injured when a Taliban-planted bomb explodes on a bus."
1822,26/6/2004,India,Zainapora,2,0,2,"Lashkar-e-Toiba terrorists kidnap two Hindus (a railway engineer and his brother) on Wednesday, then slit their throats."
1823,26/6/2004,Iraq,Hilla,23,58,81,Twenty-three civilians are killed by two car bombings near a Shiite mosque in Hilla.  About sixty others are injured in the blasts.
1824,27/6/2004,Chechnya,Grozny,1,3,4,"Islamic terrorist explode a bomb near a roadside cafe, killing one civilian."
1825,27/6/2004,Thailand,Narathiwat,1,6,7,"Muslim group plants a bomb under a soccer field to kill off-duty policemen, who were inaugurating a youth league."
1826,27/6/2004,Israel,Gaza,1,5,6,"al-Aqsa terrorist group digs a 350-meter tunnel under an Israeli guard post, detonates explosives, then uses assault rifles to prevent ambulance crews from rescuing the victims."
1827,27/6/2004,Algeria,Blida,3,0,3,"Islamic fundamentalists kidnap two civilians, then kill them by cutting their throats.   They place a bomb under one of the bodies that kills an investigating medical worker."
1828,27/6/2004,Iraq,Baqubah,6,4,10,"Sunni extremists attack a checkpoint with automatic weapons and rockets, killing six Iraqi guardsmen."
1829,27/6/2004,Iraq,Baghdad,2,8,10,"Insurgents drop a mortar on a soccer field, killing two children and injuring another eight."
1830,28/6/2004,Israel,Sderot,2,12,14,"Palestinian militants fire a rocket into a residential area, killing two, including a 3-year-old boy.  The murdered child's mother was among a dozen injured."
1831,29/6/2004,Israel,Beit Rima,1,0,1,Palestinian sniper guns down a 63-year-old Israel truck driver.  Arafat's al-Aqsa takes credit.
1832,29/6/2004,Iraq,Mahmudiyah,2,0,2,"Extremists cite Qur'anic verses then attack a police station with assault rifles, killing an officer and a civilian."
1833,29/6/2004,Thailand,Pattani,1,0,1,Muslim terrorists on motorcycles shoot a Buddhist policeman to death as he is driving to work.
1834,29/6/2004,Iraq,Baghdad,1,0,1,al-Jazeera airs a videotape of a U.S. hostage being executed by al-Qaeda.
1835,30/6/2004,India,Pulwama,1,0,1,Islamists kill a schoolteacher with a grenade.
1836,30/6/2004,Afghanistan,Jalalabad,1,26,27,"One man was killed and twenty-six others, including five children, were injured by two Taliban bombs hidden in fruit carts."
1837,30/6/2004,Afghanistan,Ghazni,1,0,1,"A convert to Christianity (and father of four daughters) is dragged out of his home by the Taliban, who then slit his throat."
1838,1/7/2004,Chechnya,Grozny,2,0,2,Two civilians are murdered by the Mujahideen.
1839,1/7/2004,Thailand,Pattani,1,1,2,"Muslim separatists kill a police informer and, in a separate attack, shoot a food vendor several times in the back."
1840,1/7/2004,Iraq,Baghdad,2,3,5,"Two civilians are killed, and three badly injured, as Sunni extremists detonate a bomb near a hospital."
1841,1/7/2004,Iraq,al-Khadra'a,3,2,5,Three civilians are killed as they pass over a bomb in their vehicle.
1842,1/7/2004,Ingushetia,Malgobek,2,1,3,"Two policemen are killed, and one injured, as the were attempting to arrest the terrorists behind the 6/23 attacks that left over ninety people dead."
1843,2/7/2004,India,Mughal Maidan,5,15,20,"Pakistani-backed Islamic militants bomb a string of police cars, killing at least five and injuring over fifteen."
1844,3/7/2004,India,Srinagar,2,66,68,"Two citizens are killed, and more than sixty injured by two Islamist planted bombs, hidden handcarts, near a tourist center."
1845,3/7/2004,Iraq,Mahmudiyah,7,5,12,Seven Iraqi National Guardsmen are gunned down at a checkpoint by Sunni extremists.
1846,3/7/2004,Afghanistan,Jalalabad,1,0,1,Third woman dies from injuries sustained in the Taliban grenade attack against election workers.
1847,4/7/2004,Pakistan,Mata Banda,3,7,10,"Three people, including a woman are killed, and seven injured when armed militants fire on a passenger bus."
1848,4/7/2004,Iraq,Baqubah,3,1,4,"Fedayeen ""holy warrior"" suicide car bombing leaves three dead."
1849,4/7/2004,Israel,Yabad,1,1,2,"Palestinian gunmen stop a car, confirm that the occupants are Jewish civilians, then open up with automatic weapons, killing a man and injuring his wife."
1850,6/7/2004,Iraq,Baqubah,14,25,39,Fourteen mourners at a funeral for a man killed by terrorists are themselves victims of a Fedayeen suicide car bombing.  Dozens of others are injured.
1851,7/7/2004,Iraq,Baghdad,0,6,6,"Extremists fire mortars at the residence of the new Iraqi Prime Minister, injuring six."
1852,8/7/2004,Bangladesh,Harinakundu Bazaar,1,1,2,Bangladeshi terrorists kill a policeman (father of two) returning to the station after patrol.
1853,8/7/2004,Iraq,Samarrah,7,30,37,"al-Qaeda use a residential neighborhood as a staging area for firing mortars, killing five U.S. soldiers and two Iraqis."
1854,8/7/2004,Afghanistan,Chakaw,6,4,10,Taliban ambush kills six Afghan soldiers and injures another four.
1855,8/7/2004,Iraq,Ramadi,3,0,3,An Iraqi civilian and two policemen are shot at point-blank range after their car is stopped by extremists.
1856,8/7/2004,Thailand,Pattani,1,0,1,A hospital worker is murdered by Islamists.
1857,9/7/2004,Russia,Moscow,1,0,1,An American journalist of Forbes magazine is assassinated by Islamic separatists.
1858,9/7/2004,Chechnya,Znamenskoye,11,10,21,"A village elder, who opposed Jihadist attempts to recruit young men, was executed by them.  Jihad terrorist attacks also killed ten others (mostly Russian servicemen)."
1859,9/7/2004,Afghanistan,Nangarhar,1,2,3,"The Taliban continues to target women who work to register voters for the election.  One is killed in the blast, and two others badly injured."
1860,9/7/2004,Iraq,Baghdad,1,3,4,Sunni militants kill a child and injure three others in a mortar attack on a hotel.
1861,10/7/2004,India,Mattan Adda,0,34,34,Thirty-four people are injured when a militant Muslim tosses a grenade onto a crowded road.
1862,10/7/2004,Iraq,Baqubah,1,0,1,Islamists bomb five shops selling alcohol.  A passing taxi driver is killed in one of the explosions.
1863,10/7/2004,Israel,Gaza,1,0,1,"Three members of a Palestinian ""resistance"" group (billing itself as non-violent) are killed when the bomb they are transporting goes off earlier than expected.  A passerby is also killed."
1864,10/7/2004,Chechnya,Goity,1,0,1,The Mujahideen murder the wife of a police officer.
1865,11/7/2004,Iraq,Baghdad,2,0,2,"In a particularly senseless attack, Islamic fundamentalists enter the home of a Christian family and stab two girls (ages 16 and 6) to death."
1866,11/7/2004,Israel,Tel Aviv,1,34,35,A woman waiting for a bus is murdered in an al-Fatah bombing.  Thirty-four others are injured.  The bomb was packed with metal bolts.
1867,11/7/2004,Afghanistan,Herat,5,33,38,"Five people, including a 12-year-old boy are killed in a packed marketplace by a Taliban terrorist bombing.  More than thirty others are injured."
1868,11/7/2004,Thailand,Yala,2,1,3,Islamic separatists kill two more civilians in southern Thailand.
1869,12/7/2004,Chechnya,Avtury,8,12,20,Jihad fighters kill eight Chechen security personnel and take another dozen hostage.  Hostages are typically executed after a reading from the Qur'an.
1870,12/7/2004,Philippines,Buldon,2,0,2,Moro Islamic Front members kill two farmers on their land with automatic weapons.
1871,12/7/2004,Pakistan,Shakai,2,0,2,Two children die of injuries suffered from an al-Qaeda attack in the west Pakistani mountains.
1872,12/7/2004,Iraq,Musayyib,1,0,1,Regional Shiite political leader is assassinated by extremists.
1873,12/7/2004,Afghanistan,Kandahar,4,5,9,"Taliban members attack and burn a district police headquarters, killing four and injuring five."
1874,12/7/2004,Sudan,Donki Dereisa,150,90,240,"Arab militia, supported by the Islamic government's fixed-wing aircraft raid a village and kill one-hundred and fifty civilians, including six children.  The children were captured during the assault and burned alive the next day."
1875,13/7/2004,Sudan,Tabaldiat,80,39,119,Another raid by armed Arab militias leave eighty villagers dead - including children - and their homes burned to the ground.
1876,13/7/2004,India,Bhaderwah,3,1,4,Islamic terrorists kill three construction workers and injure another in a senseless terrorist attack on a road-building project.
1877,13/7/2004,India,Srinagar,2,12,14,Militant Muslims kill two persons and injure twelve in a street bombing.
1878,13/7/2004,Chechnya,Grozny,1,3,4,"Jihad terrorists attempt to assassinate the acting President in a motorcade bombing, killing a guard and injuring three others."
1879,13/7/2004,Iraq,Mosul,1,0,1,al-Qaeda militants execute a Bulgarian truck driver that they had taken hostage.
1880,14/7/2004,Thailand,Narathiwat,1,1,2,Muslim motorcycle attack kills a police officer as he is driving to work.  Another is injured.
1881,14/7/2004,Iraq,Baghdad,10,41,51,"Ten people, mostly civilians, are killed and more than forty injured when a Fedayeen suicide car bomber detonates his explosives along a busy road."
1882,14/7/2004,Iraq,Mosul,3,0,3,"Militants ambush a car carrying a government official, killing three."
1883,15/7/2004,Afghanistan,Kabul,1,0,1,A Christian is beaten to death for studying the Bible.
1884,15/7/2004,India,Mendhar,2,1,3,Islamic militant kills two policeman with a grenade and injures a third.
1885,15/7/2004,Iraq,Haditha,10,27,37,"Ten Iraqis, including seven civilians are killed in a Fedayeen car bombing.  Another twenty-seven innocents are injured."
1886,16/7/2004,Pakistan,South Waziristan,3,4,7,"Three civilians are killed, and four others suffer injury after an al-Qaeda attack on a fortified structure."
1887,17/7/2004,Iraq,Mahmudiyah,2,22,24,"Fedayeen bomber blows himself to Allah, taking the lives of two people and injuring another twenty-two who were waiting in line for jobs."
1888,17/7/2004,Iraq,Baghdad,4,7,11,'Jihad and Unification' terrorist group uses a car bomb to kill four and injure seven in an attempted assassination of an Iraqi minister.
1889,18/7/2004,Afghanistan,Kabul,1,1,2,"The Taliban fire a rocket into the city center, killing a woman and injuring a man."
1890,18/7/2004,Afghanistan,Kabul,1,1,2,"Taliban terrorists fire a rocket into the city, killing a local."
1891,18/7/2004,Iraq,Mosul,1,2,3,"A political figure is assassinated in a drive-by shooting.  His 7-year-old son was shot as well, but survived."
1892,18/7/2004,Indonesia,Palu,1,4,5,"Radical Muslims fire into a church service, killing a female pastor and injuring four Christian worshippers."
1893,18/7/2004,Chechnya,Shali,1,0,1,A woman is murdered in her home by Islamic radicals.
1894,19/7/2004,Russia,Voronezh,2,5,7,"Islamic terrorists blow up a bus stop, killing two civilians and injuring five more."
1895,19/7/2004,Iraq,Mosul,1,1,2,Islamists kill the Christian owner of a restaurant selling food to Americans.  They also blind and cut off both hands of his Muslim business partner.
1896,19/7/2004,Iraq,Baghdad,9,62,71,"Religious fanatic kills himself and nine others by blowing up a truck filled with fuel on a busy street.  Sixty-two others are injured, including many who are badly burned."
1897,19/7/2004,India,Kapran,6,50,56,"Six people, including two women were killed, and more than fifty others sustained injuries when Muslim terrorists attacked a political rally with grenades."
1898,19/7/2004,Indonesia,Palu,2,3,5,Islamic gunmen enter a church and kill the female pastor and a 17-year-old girl.  Three other teenage worshipers were also shot.
1899,19/7/2004,Israel,Tel Aviv,1,0,1,Arafat's al-Aqsa Martyrs Brigade takes credit for killing an Israeli judge at close range as he was driving home.
1900,20/7/2004,Iraq,Basra,3,1,4,"Sunni extremists assassinate a council member, along with two others."
1901,20/7/2004,India,Rajauri,5,0,5,"Islamists wipe out five members of a family, after invading their home in the middle of the night.  Two women and a 3-year-old boy were among those murdered."
1902,20/7/2004,Israel,Syrian Border,2,0,2,Hezbollah snipers kill two IDF members as they are repairing an antennae.
1903,20/7/2004,India,Koti,4,0,4,Lashkar-e-Taiba militants kill four policemen as they are investigating a previous crime in a remote village.
1904,21/7/2004,Sudan,Kalma,11,0,11,Eleven more villagers killed by an Arab militia supported by the Islamic government.
1905,21/7/2004,Afghanistan,Helmand,11,0,11,Taliban ambush a convoy of cars with rockets.  Eleven are killed.
1906,21/7/2004,Iraq,Ramadi,4,14,18,"At least four people, including three brothers are killed by a car bombing.  Fourteen others are injured."
1907,22/7/2004,Iraq,Baghdad,3,2,5,"Muslim insurgents car bomb a residential neighborhood, killing at least three and hurting at least two others."
1908,22/7/2004,Iraq,Baghdad,2,4,6,"Sunni extremists fire a missile into a hospital, killing two."
1909,23/7/2004,Afghanistan,Kabul,1,0,1,A Christian is stabbed to death by the Taliban over praying in the name of Jesus.
1910,23/7/2004,Chechnya,Grozny,1,3,4,A civilian is killed in a marketplace bombing by Islamic separatists.
1911,23/7/2004,Iraq,Baiji,1,0,1,"al-Qaeda members kill a Bulgarian truck driver, taken hostage several weeks earlier, by cutting off his head."
1912,23/7/2004,Israel,Beit Hanun,1,3,4,al-Aqsa militants shoot a 16-year old boy to death and injure other three members of his family who object to the terrorists using their backyard for launching missiles into Israel.
1913,24/7/2004,Pakistan,Karachi,1,7,8,Bus bombing kills at least one and injures seven.  Bus was carrying teachers and an electrician.
1914,24/7/2004,Iraq,Latifiya,2,1,3,Group calling itself 'Lion of God' takes an Egyptian hostage.  Elsewhere gunmen stage an assassination attempt that kills two bodyguards.
1915,24/7/2004,Dagestan,Makhachkala,1,2,3,Islamic militants thought responsible for a bombing that leaves one person dead.
1916,25/7/2004,Chechnya,Grozny,1,1,2,Islamists kill a man and injure his wife with a bomb.
1917,25/7/2004,Pakistan,Ghuzdarra,2,0,2,al-Qaeda attack on a remote border post leaves two dead.
1918,25/7/2004,Chechnya,Samashki,3,1,4,"Three cannery workers are killed, and another wounded in a terrorist bombing on their vehicle."
1919,25/7/2004,India,Daraj,3,1,4,"Militant Muslims invade a home and cut off the heads of a 65-year-old man and his two children, one a teenage girl.  They attempt to cut the head off his wife, but she survives the attack."
1920,26/7/2004,India,Baramulla,1,29,30,"One citizen is killed, and nearly thirty others injured when militant Muslim throws grenade into the street outside a hospital."
1921,26/7/2004,Iraq,Basra,2,3,5,Muslim extremists open fire on a private vehicle carrying workers.  Two women are killed and another three injured.
1922,26/7/2004,Iraq,Mosul,3,5,8,"Fedayeen suicide bomber kills three, including two civilians and causes another five to suffer critical burns."
1923,27/7/2004,India,Satoora,2,0,2,Police recover the body of a woman abducted by Lashkar-e-Toiba terrorists.  Her husband had also been killed by the same group.
1924,27/7/2004,Afghanistan,Ghazni,6,2,8,"The Taliban bombs an election station at a mosque, killing six workers and injuring two."
1925,27/7/2004,India,Dal Lake,5,2,7,Fedayeen militants kill five Indian security force personnel and injure two in an attack on a resort.
1926,27/7/2004,Iraq,Baghdad,2,0,2,Group calling itself the 'Islamic Army' brutally executes two Pakistani civilians taken hostage.
1927,27/7/2004,Chechnya,Dyshni-Vedeno,1,0,1,Islamic militants kill a police officer at sunrise.
1928,28/7/2004,Afghanistan,Kabul,1,0,1,A married father is stabbed to death after being discovered associating with other Christians.
1929,28/7/2004,Chechnya,Grozny,2,0,2,Two police officers are murdered in a landmine attack by Muslim separatists.
1930,28/7/2004,Iraq,Baqubah,68,56,124,"An Islamist kills himself and sixty-eight others, including twenty-one passengers on a passing bus, and injures dozens more in a suicide bombing at a marketplace."
1931,28/7/2004,Iraq,Fallujah,4,1,5,Four policemen are killed by a homemade bomb while on routine patrol.
1932,29/7/2004,India,Bafliaz,2,1,3,"Mujahideen invade a home, kill a mother and father and injure their young child in the process."
1933,30/7/2004,Pakistan,Fateh Jang,6,25,31,Fedayeen suicide bomber kills six and injures at least twenty-five others.  Pakistani finance minister was the target.
1934,30/7/2004,Uzbekistan,Tashkent,3,5,8,Three suicide bombers kill three others and injure five in synchronized attacks on the U.S and Israeli embassies.
1935,31/7/2004,Pakistan,Karachi,2,0,2,"Hard-line fundamentalists bomb car dealership, killing two people."
1936,31/7/2004,Thailand,Narathiwat,1,5,6,"Muslim gunmen on motorcycles shoot a 39-year-old woman four times in the chest.  In a separate attack, a bomb hidden under a street bench, injures five."
1937,31/7/2004,Afghanistan,Helmand,5,2,7,A local Afghan official and four bodyguards are shot to death by the Taliban.
1938,1/8/2004,Afghanistan,Baraki Barak,3,0,3,Three children are blown up by a bicycle bomb placed by religious extremists.
1939,1/8/2004,Pakistan,Khuzdar,6,2,8,"Islamists use automatic weapons at point-blank range to ambush a car carrying soldiers and civilians, killing six."
1940,1/8/2004,Iraq,Baghdad,2,2,4,Terrorist bombing near a hotel kills two civilians and badly injures two others.
1941,1/8/2004,Iraq,Mosul,4,32,36,A suicide bomber kills at least four people and injures between thirty and fifty in a residential neighborhood.
1942,1/8/2004,Iraq,Baghdad,11,61,72,"Islamic radicals bomb five Catholic churches, murdering nearly a dozen Christians and injuring close to one-hundred people."
1943,1/8/2004,Algeria,Ziama Mansouria,3,1,4,Bombing by the Salafist Group for Preaching and Combat leaves three security company employees dead and one critically injured.
1944,2/8/2004,Iraq,Baghdad,1,0,1,"al-Qaeda members place a hood over the head of a cleaner taken hostage, then shoot him three times while praising Allah."
1945,2/8/2004,Pal. Auth.,Gaza,3,0,3,Palestinian terrorists shoot three suspected informants to death in their hospital beds.
1946,3/8/2004,Israel,Rafah,3,10,13,"Attempted bombing of an Israeli bulldozer backfires.  Three Palestinian bystanders are killed and ten others, including journalists, are injured."
1947,3/8/2004,Saudi Arabia,Riyadh,1,0,1,Two al-Qaeda gunmen shoot an Irish engineer four times in the chest at his office.
1948,3/8/2004,Iraq,Baqubah,4,6,10,Suicide bomber kills four Iraqi National Guardsmen at a roadside checkpoint.  Six others are injured.
1949,4/8/2004,Afghanistan,Gardez,2,0,2,Taliban radicals ambush and murder two charity workers.
1950,5/8/2004,England,West Bromwich,1,0,1,"Shopkeeper is brutally beaten to death by members of a Muslim family upset over the presumed ""taboo"" relationship between his son and their Pakistani daughter."
1951,5/8/2004,Bangladesh,Sylhet,1,15,16,"Fundamentalists bomb two cinemas, killing a 13-year-old boy."
1952,5/8/2004,Iraq,Mahawil,5,18,23,Islamic extremists kill five policemen in a shooting attack followed minutes later by a suicide minibus bombing.
1953,5/8/2004,India,Srinagar,9,8,17,"Muslim terrorists attack a police building in the heart of Srinagar, killing eight officers."
1954,5/8/2004,Iraq,Filfil,1,0,1,Gunmen stop a truck convoy and kill a Turkish father of three who is unable to recite prayers on command.
1955,6/8/2004,India,Gundana,1,0,1,Suspected Jaish-e-Mohammed terrorists invade a woman's home and kill her in cold blood.
1956,6/8/2004,Afghanistan,Uruzgan,2,1,3,The Taliban kill two humanitarian election workers and take another hostage in an attack on their convoy.
1957,6/8/2004,Chechnya,Grozny,2,0,2,Two police officers manning a checkpoint are cut to pieces by Islamists with automatic weapons.
1958,6/8/2004,Chechnya,Kargalinskaya,1,1,2,"Islamic gunmen fire into a building, killing a police officer."
1959,7/8/2004,Afghanistan,Awdand,1,0,1,Islamic radicals murder a 40-year-old 'well-educated' man for converting to Christianity.
1960,8/8/2004,Iraq,Kirkuk,1,3,4,Roadside bomb kills a 7-year-old child and injures three others.
1961,8/8/2004,Algeria,Boukaid,2,0,2,Two local security guards are shot to death by Islamic fundamentalists.
1962,8/8/2004,Iraq,Baghdad,1,16,17,"A 10-year-old boy is killed, and sixteen others, including a 13-year-old girl, badly injured when Sunnis mortar-bomb a pickup truck in a residential neighborhood."
1963,8/8/2004,Pakistan,Karachi,8,42,50,"Two bombs, staggered to cause maximum casualties, rip through a Pakistani restaurant near a Sunni school leaving at least eight dead and dozens injured."
1964,9/8/2004,Iraq,Khaldiya,4,4,8,Civilian minibus is the target of another Fedayeen bombing.  Four are killed and four injured.
1965,9/8/2004,Iraq,Balad Ruz,7,14,21,"In another case of ""killing for Allah,"" a Fedayeen suicide bomber destroys seven Iraqi policemen and injures another fourteen people."
1966,9/8/2004,Chechnya,Grozny,1,2,3,Jihadis use a landmine to kill a policeman.
1967,10/8/2004,Philippines,North Cotabato,3,0,3,MILF terrorists murder three farmers in a rocket attack.
1968,11/8/2004,Iraq,Mosul,4,0,4,"Islamic insurgents spray a car with machine-gun fire, killing four occupants, including a woman and child."
1969,11/8/2004,Israel,Jerusalem,2,16,18,Unsuccessful suicide car bombing at an Israeli checkpoint kills two Palestinians and injures sixteen.
1970,11/8/2004,Iraq,Khan Bani Saad,6,10,16,"Muslim terrorists bomb a busy marketplace in a small town, killing six people and injuring at least 10 others."
1971,12/8/2004,India,Watapora Beerwah,2,0,2,Mujahideen abduct and later shoot dead two civilians from a remote village.
1972,13/8/2004,Israel,Itamar,1,1,2,Palestinian gunman murders an Israeli driver outside a settlement.
1973,14/8/2004,India,Galothi,2,0,2,Mujahideen terrorists shoot a young couple to death as they beg for their lives.
1974,15/8/2004,Iran,Neka,1,0,1,Iranian Mullah publicly hangs a 16-year-old girl for having a 'sharp tongue.'
1975,15/8/2004,Iraq,Baghdad,1,5,6,Bus station bombed with mortars - at least one killed and five injured.
1976,15/8/2004,Afghanistan,Maiwand,6,0,6,Taliban extremists attack an Afghan army post and kill six soldiers.
1977,16/8/2004,Iraq,Baqubah,5,4,9,"Mortar attack kills two civilians and injures four.  In the same city, a roadside bomb kills three Iraqi Guardsmen."
1978,17/8/2004,Dagestan,Makhachkala,3,2,5,Two separate terrorist attacks staged by Muslim rebels leave a civilian and two anti-terrorist agents dead.
1979,17/8/2004,Iraq,Baghdad,6,32,38,"Islamic insurgents fire a mortar round into a crowded street outside a barbershop, killing six, including two children, and injuring at least thirty others."
1980,17/8/2004,Algeria,Bouira,2,0,2,Two Algerian village guards are killed by Islamic fundamentalists in separate bombings.
1981,18/8/2004,India,Udhampur,4,0,4,"Islamic separatists invade a family's home and then massacre the father, his daughter and two sons."
1982,18/8/2004,India,Rajouri,2,0,2,Mujahideen militants - led by a Pakistani national - abduct and then cut off the heads of a man and his son.
1983,19/8/2004,Pakistan,Lahore,1,0,1,Muslim mob takes 26-year-old Christian from his home then tortures him to death.
1984,19/8/2004,Iraq,Najaf,8,30,38,Radical Shiites kill eight and injure thirty in the Holy City of Najaf in a mortar attack on a police station.
1985,19/8/2004,Afghanistan,Farah,0,7,7,Seven people are hurt when the Taliban detonate several bombs inside an electoral commission building.
1986,21/8/2004,Thailand,Pattani,1,0,1,Islamic radicals kill a high-ranking security official.
1987,21/8/2004,Chechnya,Grozny,66,11,77,"Sixty-six people, including policemen and other civilians are killed in several terrorist attacks by Muslim separatists in the capital city and across the country."
1988,21/8/2004,Bangladesh,Dhaka,19,300,319,Nineteen people are killed and over 300 injured when Islamists throw more than a dozen grenades into an opposition political rally.
1989,22/8/2004,Iraq,Baqubah,2,4,6,Fedayeen suicide bomber attempts a political assassination.  Two guards are killed.
1990,23/8/2004,Algeria,Boumerdes,7,13,20,"Seven security force members are killed in an ambush by Islamic fundamentalists, who lured them by setting fire to a children's center.  Several children were injured."
1991,23/8/2004,Yemen,Saada,11,0,11,Eleven Yemeni soldiers are killed in an ambush by followers of a radical Shiite cleric in that country.
1992,24/8/2004,Iraq,Baghdad,5,15,20,'Holy Warrior' suicide bombers kill themselves and five others in twin blasts.  More than a dozen Iraqi civilians are injured.
1993,24/8/2004,India,Safarwaw Gund,4,0,4,"Four civilians are gunned down by the Mujahideen, two at a picnic spot and two others in Pulwama, after abducting them from their homes."
1994,24/8/2004,Russia,Moscow,89,0,89,"Militant Muslims hijack two Russian passenger airliners, then murder all eighty-nine people, including women and children on board the two planes.  The terrorist group Islambouli Brigade claims responsibility."
1995,24/8/2004,India,Kara,2,0,2,"In a heinous attack, a Muslim ""freedom fighter"" hurls a grenade at two children in a remote village, killing the 3-year-old girl and her 5-year-old brother."
1996,25/8/2004,Thailand,Narathiwat,1,30,31,"Muslim separatists bomb a food market, killing one and injuring at least thirty others."
1997,26/8/2004,Algeria,Zemmouri,1,2,3,"Two members of the Salafist Group for Preaching and Combat sneak up to two guards at a beach.  They shoot one to death and severely injure another, along with a female bather."
1998,26/8/2004,Sudan,Yassin,64,156,220,"Arab militia, supported by the Islamic government, burn down an African village and kill sixty-four civilians.  Some one-hundred and fifty-six others survive with injuries."
1999,26/8/2004,Iraq,Kufa,75,376,451,Clashes between supporters of rival Shiite clerics results in at least seventy-five deaths and more than three-hundred injuries.
2000,26/8/2004,Iraq,Mosul,1,0,1,A Christian man is murdered by Muslim terrorists.
2001,27/8/2004,Dagestan,Khasavyurt,2,0,2,"Two civilians, including a child, are killed in a bombing attack."
2002,27/8/2004,Iraq,Najaf,1,0,1,"In a crime so barbaric that even al-Jazeera declined to air the video, an Italian journalist, pacifist, and father of two is taken hostage and murdered by an Islamic group."
2003,28/8/2004,Afghanistan,Zormat,10,15,25,A bomb planted by the Taliban at a school kills nine children and one adult.  Fifteen other youngsters were injured in the attack.
2004,29/8/2004,Afghanistan,Kabul,9,24,33,"The Taliban kill at least nine people, including one child with a remote-controlled truck bomb on a busy street in the capitol city."
2005,29/8/2004,Iraq,Baqubah,6,11,17,Six police officers manning a checkpoint are gunned down by Islamic terrorists in two minibuses.
2006,30/8/2004,Pakistan,Qalat,3,10,13,Three are killed and ten injured by a bomb planted near a food stand.
2007,31/8/2004,Iraq,Bartella,3,0,3,Three young Christian women are slaughtered by Islamic extremists in a small Iraqi village.
2008,31/8/2004,India,Pulwama,1,26,27,"Muslim militant hurls a grenade into a road, killing a school teacher and injuring twenty-six other people."
2009,31/8/2004,Israel,Be'er Sheva,16,98,114,"Hamas (Islamic Resistance) suicide bombers murder sixteen people, including a 3-year-old child riding two passenger buses.  About one-hundred others are injured in the explosions."
2010,31/8/2004,Russia,Moscow,11,51,62,A female suicide bomber kills eleven rush-hour commuters at a subway station in Moscow.  Fifty-one others are injured.
2011,31/8/2004,Iraq,Baghdad,12,0,12,An Islamist group called Jaish Ansar al-Sunna slowly beheads a Nepali hostage while eleven other hostages are shot through the back of the head in front of a Qur'anic banner.
2012,1/9/2004,Russia,Beslan,16,14,30,"At least sixteen people are killed as Mujahideen terrorists invade a school, taking more than a hundred children hostage.  Children are made to stand in windows with suicide bombers behind them."
2013,1/9/2004,Iraq,Baghdad,1,0,1,A 43-year-old Christian man is killed by Jihadists just after leaving a hospital where he was treated for injuries following an earlier attack.
2014,2/9/2004,Iraq,al-Mayasa,2,0,2,"Islamic terrorists gun down two Christian brothers, known for advocating the rights of minorities."
2015,2/9/2004,India,Barhi Draman,1,3,4,Mujahideen kill a young boy and injure three members of his family for their refusal to send the boy to a terrorist training camp.
2016,2/9/2004,Iraq,Baghdad,3,0,3,"The Tawhid wal Jihad (Unity and Holy War ) Islamic group forces three Turkish hostages to kneel before a video camera, then shoots each in the chest."
2017,3/9/2004,Russia,Beslan,344,600,944,"Islamic militants shoot fleeing children in the back, then blow them up, along with their mothers and teachers with nail-packed bombs.  Others are crushed or burned to death from the effects of the bombs.  More than three-hundred  innocents slaughtered."
2018,3/9/2004,Afghanistan,Kandahar,2,4,6,"Two people, including a teenager are killed by a bomb, placed by the Taliban under a truck."
2019,3/9/2004,Thailand,Yala,1,2,3,Islamists shoot and kill a hospital employee in a drive-by.
2020,4/9/2004,Iraq,Kirkuk,15,41,56,Fedayeen suicide bomber kills at least fifteen people and injures another forty with a car bomb.
2021,5/9/2004,Saudi Arabia,Buraida,3,0,3,Islamic extremists walk up to a police car and shoot three officers to death.
2022,6/9/2004,Iraq,Fallujah,10,6,16,Seven U.S. Marines and three Iraqis are killed by a Fedayeen ('Holy Warrior') suicide car bomber who plowed right into their convoy.
2023,8/9/2004,Iraq,Baghdad,3,2,5,Three Iraqis are killed by a roadside bomb.
2024,9/9/2004,Indonesia,Jakarta,9,173,182,At least nine are killed when the Jemaah Islamiyah terrorist group detonates a suicide car bomb outside the Australian embassy in a business district.  More than one-hundred and seventy others are treated for injuries.
2025,9/9/2004,India,Futlipora,1,0,1,"Suspected Harkat-ul-Jehadi-e-Islami members abduct a 52-year-old man from his orchard, then march him to the top of a nearby hill where he is executed."
2026,9/9/2004,Pakistan,Somyani,2,1,3,"Two are killed, and one injured when militants bomb a State-run space research center."
2027,10/9/2004,Pakistan,Quetta,1,0,1,Two Sunni gunmen on a motorcycle kill a prominent Shiite academic as he is driving home.
2028,11/9/2004,India,Srinagar,3,7,10,Suicide attack on a heavily-guarded tourist hotel leaves three security personnel dead and seven others injured.
2029,11/9/2004,India,Kupwara,1,20,21,"Mujahideen militants toss a grenade into a crowded marketplace, killing one civilian and injuring twenty others."
2030,12/9/2004,Iraq,Hilla,3,3,6,"In a senseless attack, terrorists kill three Polish sappers who were working to clear the country of landmines."
2031,13/9/2004,Pakistan,Gilgit,2,0,2,"Two people, including a seminary teacher are killed in Muslim sectarian violence."
2032,13/9/2004,Iraq,Baghdad,1,2,3,"Group ""Unification and Jihad"" beheads a Turkish truck driver in front of a video camera.  Elsewhere, two Italian women are taken hostage."
2033,13/9/2004,India,Kalmund-Bachana,3,0,3,"Lashker-e-Toiba members, invade a house, torture three family members with sharp instruments, then shoot them to death."
2034,14/9/2004,Iraq,Baghdad,2,0,2,Two Canadian (Arab) Christians are chased by a mob of Muslims and beaten to death.
2035,14/9/2004,Iraq,Baghdad,47,114,161,A Fedayeen suicide bomber fervently practices his religion by killing himself and forty-seven others in a car bombing on a busy street next to a line of police recruit hopefuls.  Over one-hundred others are injured in the attack.
2036,14/9/2004,Iraq,Baqubah,12,3,15,"Sunni insurgents spray a police van, carrying officers and civilians, with automatic weapons, killing twelve and injuring three."
2037,15/9/2004,Iraq,Kirkuk,4,13,17,Two Iraqi workers are ambushed and shot to death in Kirkuk.  A car bombing in Baghdad kills two and injures ten.  Three Western civilians there are also kidnapped.
2038,15/9/2004,Saudi Arabia,Riyadh,1,0,1,British man gunned down by terrorists in the parking lot of a shopping center.
2039,15/9/2004,Iraq,Al Dijail,3,0,3,"The headless bodies of three people, two of who were Assyrian Christians, are found in a field with Qur'anic inscriptions carved into them."
2040,16/9/2004,Algeria,Tebessa,4,0,4,Islamic fundamentalist plant a bomb that kills four village guards.
2041,17/9/2004,Thailand,Pattani,1,0,1,A Buddhist judge is shot to death by Muslim gunmen after dropping his children off at school.
2042,17/9/2004,Iraq,Baghdad,8,41,49,Fedayeen suicide bomber murders eight people in a shopping district.  Forty-one others survive with injuries.
2043,18/9/2004,Thailand,Pattani,1,0,1,A cleric is gunned down by Muslim radicals.
2044,18/9/2004,Bangladesh,Jamalpur,1,0,1,A Christian convert from Islam has his throat slashed by Muslim fundamentalists.
2045,18/9/2004,Iraq,Kirkuk,19,39,58,Nineteen people waiting in line for jobs are blown to bits by a Fedayeen suicide car bomber.
2046,18/9/2004,Iraq,Mosul,5,4,9,"Gunmen pull beside two cars carrying oil executives.  Five are shot to death, four wounded."
2047,18/9/2004,Algeria,Kalous,4,1,5,Armed Islamic extremists set up a fake road block on a remote road.  They shoot to death four people that stop there and also abduct a woman.
2048,19/9/2004,Iraq,Samarrah,6,7,13,"Three young Kurdish party members are captured by 'Ansar al-Sunna' terrorists and beheaded.  Elsewhere, a suicide car bombing kills three."
2049,20/9/2004,Nigeria,Bama,10,0,10,"Armed Nigerian militants, shouting 'Allahu Akbar' invade two towns and kill ten people, including seven civilians."
2050,20/9/2004,Afghanistan,Zabul,3,0,3,Taliban militants stop a taxi carrying three unarmed Afghan soldiers (out of uniform).  They pull them out of the car and behead all three on the side of the road.
2051,21/9/2004,Iraq,Baghdad,2,0,2,Two American civilians are beheaded on videotape by an al-Qaeda group called 'Jihad and Unification.'
2052,21/9/2004,Pakistan,Ratta Kalachi,3,1,4,Three members of a Shia family are slaughtered in a sectarian attack.  One young girl survived with injuries.
2053,22/9/2004,Iraq,Baghdad,6,54,60,Six people are murdered by an Islamic suicide bomber outside a photocopy shop.  Nearly sixty others are admitted to the hospital.
2054,23/9/2004,Chechnya,Katyr-Yurt,1,0,1,A government employee is killed by Islamic terrorists.
2055,23/9/2004,Chechnya,Mairtup,2,0,2,Two people are killed in a Mujahideen automatic-weapons attack on their vehicle.
2056,23/9/2004,Israel,Morog,3,1,4,"Palestinian gunmen attempt to infiltrate a Jewish settlement.  They are stopped by Israeli troops, but manage to kill three."
2057,24/9/2004,Iraq,Baghdad,3,20,23,"Jihad militants mortar bomb a city street, killing three civilians and injuring fourteen.  Elsewhere, six Egyptian mobile-phone company workers are kidnapped."
2058,24/9/2004,Israel,Neve Dekalim,1,0,1,"Palestinians fire a mortar into a Jewish residential neighborhood, killing a 22-year-old woman."
2059,25/9/2004,Afghanistan,Helmand,9,0,9,Nine Afghan soldiers are killed by Taliban militants who ambush their SUV convoy.
2060,25/9/2004,Saudi Arabia,Jedda,1,0,1,Islamists shoot a French resident to death as he is walking to his car in a supermarket parking lot.
2061,25/9/2004,Pakistan,Quetta,3,3,6,"Lashkar-e-Jhangvi radicals ambush a policeman near his home, killing him and two others."
2062,25/9/2004,India,Anantnag,1,5,6,Victim of the 9/22 grenade attack - a man waiting for a bus - succumbs to his injuries.
2063,25/9/2004,Chechnya,Alleroi,0,2,2,"Heavily-armed Mujahideen attack a village, burning residences and badly injuring an 8-year-old girl and at least one other."
2064,25/9/2004,Iraq,Baghdad,6,0,6,"In a tragic and senseless attack, Islamic insurgents kill murder six young men in a minivan who had just signed up as police recruits."
2065,25/9/2004,Chechnya,Grozny,4,0,4,Four Russian police are killed at a traffic stop by Jihad terrorists.
2066,26/9/2004,Thailand,Yala,1,9,10,"Islamic separatists kill the owner of a fruit orchard.  Elsewhere, a grenade attack leaves nine injured."
2067,26/9/2004,Afghanistan,Charchino,1,3,4,A local official is killed and three other people injured when the Taliban attacks their vehicle in a remote area.
2068,27/9/2004,Chechnya,Grozny,1,1,2,A judge is gunned down by Jihadis.
2069,27/9/2004,Pakistan,Sarokai,3,6,9,al-Qaeda militants use an IED to kill three Pakistani soldiers riding in a convoy.
2070,27/9/2004,Iraq,Fallujah,7,7,14,"Two explosions, at least one a Fedayeen suicide bombing, is responsible for the deaths of seven Iraqi Guardsmen in Fallujah and Mosul."
2071,27/9/2004,Thailand,Pattani,2,0,2,Muslims use motorbikes to stage two shooting attacks that leave a government official and one police officer dead.
2072,28/9/2004,Philippines,Lamitan,2,0,2,Abu Sayyaf terrorists shoot two policemen to death as they ride by on a motorcycle.
2073,28/9/2004,Iraq,Basra,2,0,2,"Shia gunmen prevent the rescue of two injured British soldiers, who later die from wounds suffered in a terrorist ambush."
2074,28/9/2004,Algeria,Ain Defla,6,0,6,Islamic fundamentalists slaughter six civilian village defense force volunteers.
2075,28/9/2004,Chechnya,Grozny,1,4,5,"Islamic gunmen ambush a police vehicle, killing one officer."
2076,29/9/2004,Philippines,Cotabato,1,3,4,Islamic militants are thought responsible for a grenade attack on a residential area that kills a child.
2077,29/9/2004,Iraq,Tal Afar,4,16,20,An Islamic insurgent car bombing kills four civilians and injures at least sixteen others.
2078,29/9/2004,India,Anantnag,2,0,2,Muslim militants shoot a government official and bodyguard to death as they are waiting at a traffic light.
2079,29/9/2004,Afghanistan,Zabul,12,0,12,"Taliban terrorists attack a government post, killing twelve Afghan soldiers."
2080,30/9/2004,Israel,Eley Sinai,2,0,2,Palestinian gunmen kill a female jogger - and the medic trying to save her life.
2081,30/9/2004,Iraq,Baghdad,51,230,281,"At least fifty people, including thirty-five children are killed by a series of car bombings.  More than two-hundred others are injured.  The main target was a ceremony marking the opening of a new sewage system."
2082,30/9/2004,Israel,Sderot,2,15,17,Two small children (ages 2 and 4) are killed by a Palestinian rocket while playing in the front yard of their home.  Hamas (Islamic Resistance) claims responsibility.
2083,1/10/2004,Pakistan,Bangashwala,4,1,5,A homemade al-Qaeda bomb kills four teenagers between the ages of 15 and 18.
2084,1/10/2004,Pakistan,Sialkot,31,50,81,Sunni suicide bomber kills at least thirty-one worshippers at a Shia mosque.  More than fifty others injured in the blast.
2085,1/10/2004,Lebanon,Beirut,1,5,6,Pro-Syrian terrorists use a car bomb in an attempted political assassination.
2086,3/10/2004,India,Baramulla,1,3,4,Grenade attack injures three civilians and one policeman.  A civilian later dies of injuries (10/6/04)
2087,3/10/2004,Iraq,Yusufiyah,2,0,2,"Islamists tie a man up and cut off his head.  Another hostage, female, is shot through the head.  Both bodies dumped in the same area."
2088,4/10/2004,Iraq,Baghdad,24,96,120,"Three suicide car bombings, two in Baghdad and one in Mosul, kill at least twenty-four and injure nearly one-hundred.  The casualties are mostly civilians as the attacks occurred on city streets."
2089,5/10/2004,Iraq,Mosul,1,0,1,Jihadists kidnap and then behead a 15-year-old Christian boy.  They then burn his body.
2090,5/10/2004,Iraq,Ramadi,4,2,6,Sunni car bombing kills four and injures at least two.
2091,5/10/2004,Iraq,Mosul,3,0,3,Jihadists kill three more hostages by means of decapitation.  Bodies found with hands bound.
2092,5/10/2004,Iraq,al-Mahmodeyah,10,1,11,Ten policemen are killed by Jihad fighters in three separate attacks.  One is bound and beheaded.
2093,5/10/2004,Iraq,Baqubah,4,5,9,Ansar al-Sunna radicals kill four Kurds in a shooting attack on their minivan.
2094,6/10/2004,Afghanistan,Zabol,6,0,6,"The Taliban plant a bomb in a car, killing six civilians."
2095,6/10/2004,Chechnya,Grozny,1,0,1,Islamists gun down a policeman standing guard at a market.
2096,6/10/2004,Thailand,Southern Provinces,2,7,9,A series of attacks by Islamic militants leaves two government workers dead.
2097,6/10/2004,Afghanistan,Faizabad,2,5,7,The Taliban kills two people with a bomb at an election rally.  Five others sustain injuries.
2098,6/10/2004,Iraq,Anah,12,25,37,"Suicide bomber blows himself to Allah, taking twelve Iraqi Guardsmen at a checkpoint with him.  Twenty-five others are injured."
2099,6/10/2004,Afghanistan,Kandahar,7,0,7,Taliban militants kill seven Afghan policemen with a landmine.
2100,6/10/2004,Pakistan,Karachi,2,1,3,Two constables are killed outside a mosque in a shooting attack by Islamists.
2101,7/10/2004,Pakistan,Multan,41,100,141,Forty-one Sunnis are targeted by rival Shiites in two car bomb blasts as the victims are holding a rally.
2102,7/10/2004,Egypt,Ras a-Satan,4,40,44,"Two explosions kills three Israelis and one Egyptian.  ""Brotherhood of International Islamists"" takes responsibility."
2103,7/10/2004,Egypt,Taba,33,149,182,"At least thirty-three people, most of them Jewish tourists, are killed by a massive suicide car bombing at an Egyptian resort hotel.  About one-hundred and fifty others are among the injured.  Several Muslim groups scramble to claim responsibility."
2104,7/10/2004,Iraq,Baghdad,1,0,1,"In front of a banner proclaiming ""One God and Jihad"" kidnappers slice the head off of a 62-year-old British engineer."
2105,8/10/2004,Nigeria,Kala-Balge,3,0,3,Three police officers are killed by the Nigerian 'Taliban.'  Twelve others were taken prisoner.
2106,8/10/2004,France,Paris,0,10,10,"An Islamic extremist group plants a bomb outside the Indonesian embassy in Paris, injuring ten."
2107,8/10/2004,Thailand,Pattani,1,0,1,Muslims kill a 38-year old Buddhist soldier with an assault rifle as he is walking home.
2108,9/10/2004,Thailand,Pattani,1,0,1,"In another motorcycle attack, Muslims shoot a 23-year old Buddhist student to death."
2109,9/10/2004,India,Pattan,5,45,50,"Jaish-e-Mohammad militants use a suicide car bombing against a mini-bus, killing five and injuring some forty-five civilians and soldiers."
2110,9/10/2004,Pakistan,Karachi,2,0,2,Two Sunni clerics are gunned down by Shia terrorists in the street.
2111,10/10/2004,Iran,Mahabad,2,0,2,A militant Shiite group called Ali-Ilahi opens fire on a police station.
2112,10/10/2004,Pakistan,Lahore,3,6,9,A suicide bomber walks up to a Shiite mosque and kills a young boy and two guards who intercepted him before he could kill other worshippers.
2113,10/10/2004,Iraq,Baghdad,11,16,27,Two suicide bombers kill at least eleven (mostly Iraqi women) and injure sixteen.
2114,11/10/2004,Iraq,Mosul,3,24,27,Two civilians and one American soldier are killed in a Fedayeen suicide car bombing.
2115,11/10/2004,Chechnya,Grozny,1,0,1,A policeman is murdered by Islamic militants.
2116,12/10/2004,Thailand,Narathiwat,2,0,2,Two people are brutally gunned down by Islamists while shopping at a market.
2117,12/10/2004,Thailand,Pattani,2,9,11,Muslim gunmen storm a police station with firearms and grenades.  An officer and a civilian are killed.
2118,12/10/2004,Iraq,Baghdad,1,0,1,Ansar al-Sunnah takes a Shiite hostage then cuts off his head on video.
2119,13/10/2004,Pakistan,Jalala,4,35,39,"Islamist throws a grenade at a wedding party in an Afghan refugee camp, because they were listening to music, which was forbidden under the Taliban."
2120,13/10/2004,Iraq,Mosul,2,5,7,Suicide car bombing leave two U.S. soldiers dead and five injured.
2121,13/10/2004,India,Poonch,1,2,3,A 23-year-old is killed by the Mujahideen.  Elsewhere in the district a mother and her son are abducted.  Their fate is unknown.
2122,13/10/2004,Indonesia,Jono Oge,2,0,2,"Sword-wielding Muslim mob kills two Christians on a busy street in an Indonesian province.  One dies at the scene, another at the hospital."
2123,13/10/2004,Indonesia,Sulawesi,1,2,3,Lashkar Jihad gunmen kill a Hindu woman and injure two Christian men by opening fire on their houses.
2124,13/10/2004,Bangladesh,Bagerhat,2,0,2,Muslim invaders kill a Hindu husband and wife in their home.
2125,14/10/2004,Pakistan,Jandola,1,1,2,Uzbeki militants affiliated with an Islamic terror cell kidnap two Chinese engineers and execute one.
2126,14/10/2004,Iraq,Baghdad,5,0,5,"A female reporter, Iraqi judge and two South African civilian contractors are murdered in three separate shooting attacks.  A Chinese hostage is also shot to death by al-Qaeda terrorists.."
2127,14/10/2004,Iraq,Baghdad,5,18,23,A suicide bomber kicks off the Muslim holy month of Ramadan by killing five civilians at a cafe.  Eighteen others are injured.
2128,14/10/2004,Iraq,Baghdad,1,0,1,Small Christian girl kidnapped and killed by Muslims who had demanded ransom from her family.
2129,15/10/2004,Afghanistan,Kunar,4,0,4,"The Taliban sets a truck on fire, then detonates a remote-controlled bomb after a crowd gathers.  Three children are among the dead."
2130,15/10/2004,Iraq,Baghdad,10,4,14,Jihad car bombing kills four palm grove laborers and a family of four that was passing by in a car.  Two other bystanders were killed as well.
2131,16/10/2004,Syria,Hasaka,2,0,2,"An Assyrian Christian is beaten and killed by Muslim attackers, who then mutilate his body and dump it in the Christian quarter of town.  A friend coming to help is shot and killed."
2132,16/10/2004,Iraq,Qaim,4,0,4,Suicide car bomber kills one civilian and three Americans.
2133,16/10/2004,Iraq,Latifiya,9,0,9,Jihadists ambush a minivan carrying nine police recruits traveling from Jordan.  All are shot to death.
2134,17/10/2004,Chechnya,Grozny,1,6,7,"The Mujahideen detonate a car-bomb outside a hospital, killing at least one person."
2135,17/10/2004,Iraq,Baghdad,6,26,32,Car bombing near a cafe kills six and injures twenty-six.  Police and civilians among the casualties.
2136,17/10/2004,India,Mandli,1,14,15,An Islamic terrorist lobs a grenade at a village defense committee trying to guard a bus station.
2137,17/10/2004,India,Mohammadpora,1,5,6,The Mujahideen kill a 22-year-old man and badly injure five members of his family who were trying to prevent his murder.
2138,18/10/2004,Afghanistan,Paktika,5,0,5,"Religious fundamentalists kill five, including an election worker, in a landmine attack."
2139,19/10/2004,Pakistan,Spin Kairakzai,3,9,12,Three security officials are killed in an attack by the same religious fundamentalists that recently massacred eleven Chinese workers.
2140,19/10/2004,Iraq,Baghdad,6,80,86,Jihadists behead two Macedonian hostages on video.  They also kill four Iraqi Guardsmen standing in formation and injure more than eighty with a mortar attack.
2141,20/10/2004,Iraq,Samarrah,4,20,24,Islamic insurgents kill four children with a car bomb.  Twenty others are injured.
2142,21/10/2004,Afghanistan,Uruzgan,1,2,3,"An election official is murdered by the Taliban, who injure his two sons as well."
2143,21/10/2004,Indonesia,Poso,1,0,1,Muslim gunmen kill the security guard at a Catholic church.
2144,21/10/2004,Iraq,Baghdad,2,1,3,Two women and their driver are shot to death by Muslim insurgents as they are driving to work.
2145,21/10/2004,Iraq,Baghdad,4,11,15,"Islamists stage a shooting ambush a bus carrying airline workers, killing four women, and injuring at least eleven others."
2146,22/10/2004,India,Anantnag,1,1,2,The Mujahideen assassinate a prominent moderate politician and critically injure his bodyguard.
2147,22/10/2004,Algeria,Medea,16,13,29,Armed Islamic extremists stop cars carrying young people to a soccer game at a phony roadblock.  They then use knives and small-arms to kill sixteen.  Thirteen others are missing.
2148,23/10/2004,Iraq,Baghdad,10,48,58,Muslim zealot kills ten policemen and injures forty-eight people in a powerful suicide bombing.
2149,23/10/2004,Afghanistan,Kabul,2,6,8,"A Taliban extremist straps six grenades to his body then detonates them on a city street, killing a 12-year-old Afghan girl and an American woman."
2150,24/10/2004,India,Salbala,3,2,5,"Mujahideen terrorists invade a home.  They shoot two members of a family to death and kidnap another member, whom they later behead."
2151,24/10/2004,Algeria,Boumerdes,1,1,2,Armed Islamists kill a security guard and injure a civilian in eastern Algeria.
2152,24/10/2004,Iraq,Basra,48,0,48,"A very heinous attack by ""Unification and Jihad"" leaves forty-eight unarmed police recruits dead.  Their three minibuses were stooped by the Jihadists, who forced the men out by the side of the road and executed each with a shot to the head."
2153,24/10/2004,India,Anantnag,1,1,2,Mujahideen attempt another political assassination at a funeral.  A passerby is killed in the mine attack.
2154,25/10/2004,Iraq,Mosul,1,0,1,"An Assyrian Christian woman, mother of three children, is murdered in her home by Jihad warriors."
2155,25/10/2004,Iraq,Mosul,6,12,18,A series of Fedayeen suicide bombings in Mosul and Baghdad kill six Iraqi civilians and leave at least a dozen injured.
2156,26/10/2004,Pakistan,Spinkai Raghazai,9,5,14,al-Qaeda kill nine tribesmen with rockets in western Pakistan.  At least five others are critically injured.
2157,26/10/2004,Algeria,Tizi Ghenif,5,2,7,Algerian Islamists kill five more people at fake roadblocks in two remote areas.  Three are beheaded.
2158,26/10/2004,India,Senabathi,1,1,2,"The Mujahideen invade another house and kill two teenagers, including an 18-year-old girl."
2159,27/10/2004,Pakistan,Karachi,6,2,8,"A vicious killing by Islamists, who barge into a Christian charity office, tie up six men, then execute six by shooting them in the back of the head."
2160,28/10/2004,Thailand,Sungai Kolok,3,20,23,Local Muslims gun down a Buddhist orchard owner and bomb a bar.  The bomb kills two people and injures twenty others.
2161,28/10/2004,Iraq,Hilla,11,0,11,"Eleven Iraqi Guardsmen are taken hostage by Ansar al-Sunnah.  All eleven are bound and then executed, some with a shot to the head others with a slow beheading.  The killers admonish the video audience to ""Repent to Allah."""
2162,29/10/2004,Thailand,Yala,1,24,25,"A remote-controlled bomb is set off by Islamic extremists near a tea shop, killing one person and injuring twenty-four others."
2163,29/10/2004,India,Kukurgaon,2,3,5,Two Muslim clerics are killed by the other's followers in a religious dispute.  Woman and two young girls injured.
2164,30/10/2004,Iraq,Anbar,8,10,18,'Holy Warrior' suicide car bomber kills eight U.S. Marines and injures ten others on routine patrol.
2165,30/10/2004,Iraq,Baghdad,8,19,27,Fedayeen car bombing on an Arabic TV station leaves seven dead and nineteen badly injured.
2166,30/10/2004,India,Mahore,2,1,3,Mujahideen assassinate a politician and his 12-year-old son after invading their home.  The dead boy's mother is severely injured in the attack.
2167,31/10/2004,Sudan,Mallaga,18,6,24,"The Janjaweed attack an African village earlier in the month, killing eighteen civilians and injuring another six."
2168,31/10/2004,Iraq,Tikrit,15,8,23,"Jihadists fire a rocket at a hotel, killing fifteen civilians and injuring eight others."
2169,31/10/2004,Iraq,Baghdad,1,0,1,Qur'anic quoting militants bound a Japanese hostages arms then cut off his head.
2170,31/10/2004,Thailand,Narathiwat,5,0,5,"Muslim separatists kill a Buddhist construction worker, a police officer, two agricultural workers, and one other civilian."
2171,1/11/2004,Iraq,Baqubah,2,1,3,Two high-ranking government officials are assassinated in separate ambushes.
2172,1/11/2004,Israel,Tel Aviv,3,38,41,Two Jewish women and a man are murdered at a cheese deli in an open market by a 16-year-old who let the Abu Ali Mustafa terrorist network strap explosives to his chest.
2173,1/11/2004,India,Shopian,0,21,21,"Harkat-ul-Ansar terrorist hurls a grenade into a busy market, injuring over twenty people."
2174,2/11/2004,Iraq,Baghdad,2,2,4,"A Christian family is ambushed in their car by Muslim gunmen, who manage to kill the father and his 10-year-old son."
2175,2/11/2004,Thailand,Mamong,1,0,1,Muslim agitators murder a 58-year-old Buddhist village chief by cutting off his head.
2176,2/11/2004,Iraq,Baghdad,6,29,35,Terrorists kill six people outside a Ministry of Education building with a car bombing.
2177,2/11/2004,Netherlands,Amsterdam,1,1,2,Dutch filmmaker (Grandnephew of painter Van Gogh) shot to death by a 26-year-old Moroccan after making a film critical of Islam.
2178,3/11/2004,Pakistan,Karachi,1,2,3,"Shia gunmen open fire on a Sunni mosque, killing one and injuring two."
2179,3/11/2004,Iraq,Baghdad,4,0,4,Four more Iraqis kidnapped and beheaded.
2180,4/11/2004,Indonesia,Poso,1,0,1,The Mujahideen kidnap and decapitate the Christian leader of an Indonesian village.
2181,4/11/2004,Thailand,Pattani,9,2,11,"Muslim terrorists kill nine Buddhists over a 24-hour period in separate attacks.  At least one monk survived with injuries, as well as a young boy."
2182,4/11/2004,Afghanistan,Orgun,4,1,5,Four civilians are killed by a homemade Taliban bomb as they were passing by in their vehicle.
2183,4/11/2004,Iraq,Baghdad,4,8,12,"'Holy Warrior' suicide bomber kills three British soldiers manning a checkpoint, along with their translator."
2184,4/11/2004,Iraq,Dujail,3,7,10,Car bombing kills three Iraqis and injures seven.
2185,5/11/2004,Iraq,al-Muqdadiya,2,4,6,Jihadists kill a 3-year-old boy and a 12-year-old girl with a rocket.
2186,5/11/2004,Algeria,Relizane,2,0,2,Algerian Islamists ambush and kill two policemen.  The fundamentalists have killed about thirty civilians thus far during Ramadan.
2187,6/11/2004,Iraq,Samarrah,34,66,100,"Thirty-four people, mostly civilians, are blown up by Fedayeen suicide bombers [looking to curry favor with Allah] in several coordinated attacks."
2188,6/11/2004,Thailand,Narathiwat,2,0,2,"Two Buddhists, one a grocery store owner, are gunned down by militant Muslims."
2189,6/11/2004,India,Srinagar,2,2,4,"Mujahideen terrorists throw a grenade at two off-duty soldiers shopping in a retail district, killing them and injuring two civilians."
2190,7/11/2004,Iraq,Basra,2,0,2,Two Scottish civilians are killed by Shia militants.  One of them is a father of two.
2191,8/11/2004,Indonesia,Sulawesi,1,0,1,Laskar Jihad terrorists kill the driver of a public minibus.
2192,8/11/2004,Iraq,Baghdad,3,45,48,"Muslim extremists bomb two Christian churches, killing three and injuring over forty, including women and children."
2193,8/11/2004,Iraq,Samarrah,6,0,6,"Ansar al-Islam terrorists set two tanker trucks on fire, burning the Turkish drivers alive.  Elsewhere, four Iraqi civilians are killed when gunmen ambush their car and set it on fire."
2194,8/11/2004,Iraq,Zubayr,2,0,2,Car bombing kills two British and South African civilians.
2195,8/11/2004,Iraq,Baghdad,13,60,73,"Jihadists car bomb the emergency unit of a hospital, killing thirteen civilians and injuring at least sixty."
2196,8/11/2004,Afghanistan,Arghandab,3,2,5,"Taliban extremists machine-gun Afghan soldiers at a checkpoint, killing three and injuring two."
2197,9/11/2004,Thailand,Yala,1,0,1,A teacher is murdered by terrorists.
2198,9/11/2004,Russia,Moscow,2,1,3,"Islamic terrorists set off a car-bomb on a city street, killing two civilians."
2199,9/11/2004,Russia,Aul Kumysh,7,0,7,Local Islamists are tied to the burned bodies of seven missing persons.
2200,9/11/2004,India,Wagora,2,1,3,The Mujahideen stage an attack on the home of a politician.  A neighbor and a security guard are killed.
2201,9/11/2004,Thailand,Narathiwat,1,0,1,Thai Muslims cut the head off of a 60-year-old Buddhist plantation worker.
2202,10/11/2004,Iraq,Fallujah,5,0,5,"Group calling itself the ""Islamic Secret Army"" takes five civilians hostage to use as human shields, then summarily executes them when no longer needed."
2203,11/11/2004,Iraq,Baghdad,19,24,43,"A Fedayeen blows himself to Allah, taking at least nineteen people with him that happened to be passing by on a packed city street.  Women and children are among the victims."
2204,12/11/2004,Iraq,Baghdad,2,0,2,Sunni gunmen kill two American civilians in an ambush.
2205,12/11/2004,Thailand,Narathiwat,1,14,15,"A Buddhist teacher is gunned down by Islamic militants.  They also plant a bomb in a restaurant, which injures fourteen."
2206,13/11/2004,England,London,1,0,1,A 30-year-old computer worker is brutally assaulted and slain by three Pakistanis.
2207,13/11/2004,Indonesia,Sulawesi,5,4,9,Muslim terrorists kill five and injure four with a bomb hidden on a public bus.  Two of the dead are women.
2208,13/11/2004,Algeria,Algiers,2,3,5,Armed fundamentalists kill two Algerian soldiers in separate terror attacks.
2209,13/11/2004,India,Malikpora Bandipora,2,2,4,"The Mujahideen invade two houses, killing the wife of one occupant.  The owner of the other house is kidnapped and then has his throat slit."
2210,13/11/2004,Thailand,Tharnto,1,6,7,"Militant Muslims explode a bomb in the middle of a marketplace, killing one person instantly and leaving at least six others critically injured."
2211,13/11/2004,Thailand,Yala,2,0,2,Muslims gun down two civilians - one in his home and another who happened on the attack.
2212,14/11/2004,Pal. Auth.,Gaza,2,6,8,Palestinian extremists kill two people guarding the new PA leader.  Six bystanders are wounded.
2213,14/11/2004,India,Chakarbathi Bala,3,0,3,"Three people, including a husband and wife, are burned to death when the Mujahideen set fire to their home."
2214,14/11/2004,India,Nadimarg,3,0,3,Jaish-e-Mohammed militants kill three policemen assigned to protect a minority Indian ethnic group after a horrific massacre last year.
2215,15/11/2004,India,Patnazi,2,1,3,Two civilians are gunned down by the Mujahideen while collecting wood in a forest.
2216,15/11/2004,Iraq,Fallujah,1,0,1,Body of a Polish female kidnapped by Islamists is found.  Her throat had been slit and she had been disemboweled with a knife.  She was identified by her long blond hair.
2217,15/11/2004,Thailand,Krong Pinang,2,0,2,"Militants attack a home, killing a retired man and a teenage family member."
2218,16/11/2004,Afghanistan,Kajaki,6,0,6,"The Taliban attack a remote outpost near a hydro-power dam, killing six guards."
2219,16/11/2004,Bangladesh,Chittagong,1,0,1,Hindu minority leader gunned down in his home.
2220,16/11/2004,Iraq,Baghdad,1,0,1,"A 59-year-old humanitarian aid worker, kidnapped by Islamists last month, is executed on video with a bullet to the back of her head."
2221,16/11/2004,India,Budgam,6,0,6,"Militant Muslims invade a residence and kill six members of a family, including two women."
2222,16/11/2004,Afghanistan,Deh Rawood,4,6,10,The Taliban kill four policemen in a landmine attack.  Six others are injured.
2223,17/11/2004,Philippines,Zamboanga,0,1,1,"24-year-old Christian man is attacked by Muslim activists, badly beaten and left for dead."
2224,17/11/2004,Iraq,Baiji,15,22,37,"Suicide car bomber kills fifteen, including six women and six children.  The attack took place in the middle of a crowded street."
2225,17/11/2004,Pakistan,Mingora,2,29,31,"Bomb explodes in the back of a cinema, killing two people and injuring about thirty."
2226,18/11/2004,Algeria,Mahrane,1,0,1,A civilian is killed in a Salafist Group landmine attack.
2227,18/11/2004,Iraq,Baiji,4,0,4,"The Fedayeen kill two women, a man and a child in a bombing attack on their car."
2228,18/11/2004,Iraq,Baghdad,4,4,8,"Jihadists kill three Iraqis, including a woman, with a suicide car bombing.  In Balad they kidnap and behead a native contractor."
2229,18/11/2004,Belgium,Antwerp,1,0,1,Synagogue worker gunned down on the streets of Antwerp.
2230,19/11/2004,India,Surankote,3,1,4,Three people are killed when the Mujahideen bomb their vehicle.
2231,19/11/2004,Indonesia,Sulawesi,5,5,10,"Jemaah Islamiyah set off a bomb on a minibus outside a market, killing five people and injuring five others."
2232,20/11/2004,England,Oxford,1,0,1,A Bangladeshi man and his two sons stab a 19-year-old to death in his car in an honor killing after an affair with their daughter.
2233,20/11/2004,Iraq,Baghdad,4,0,4,Jihadists chase down a car carrying public works employees on their way to work and machine-gun all four to death.
2234,20/11/2004,Iraq,Mosul,9,0,9,"Nine policemen are captured by Islamists, then murdered with bullets to the back of the head."
2235,20/11/2004,Iraq,Mosul,2,0,2,"Two Iraqi Kurds are captured by Ansar Al-Sunna, tortured for seven days and then executed."
2236,21/11/2004,Iraq,Ramadi,8,15,23,Sunni terrorists kill eight policemen and injure fifteen in a shooting ambush.
2237,23/11/2004,Afghanistan,Totai,3,0,3,Taliban gunmen murder three persons in a shooting attack.
2238,23/11/2004,Sudan,Adwa,30,100,130,"More than thirty civilians, including women and children are killed by the government in a ground attack on their village.  More than a hundred others are raped or injured."
2239,23/11/2004,Nigeria,Jigawa,2,10,12,Muslim extremists attack a group of Christian evangelists.  Two people are beaten to death and at least ten others injured.
2240,23/11/2004,India,Kashmir,3,3,6,"Muslim militants stage two attacks against border guards, killing three and injuring three."
2241,24/11/2004,Iraq,Baghdad,2,3,5,"Suicide car bomber kills at least two civilians, including one woman."
2242,24/11/2004,Pakistan,Islamabad,2,2,4,"Pakistani Islamists attack a police vehicle, killing two occupants."
2243,26/11/2004,India,Doda,3,0,3,"Hizb-ul-Mujahideen kill two Hindu travelers on a road, along with a college student dragged of his house."
2244,27/11/2004,Sudan,Kossa,15,6,21,Attack by Arab militias leaves fifteen African villagers dead and six injured.
2245,27/11/2004,Iraq,Mosul,15,0,15,Fifteen more bodies of executed hostages are found in Mosul.
2246,27/11/2004,Iraq,Baghdad,7,30,37,Sunni extremists kill three Iraqi and four British civilians with three bombings over a 24-hour period.
2247,27/11/2004,Chechnya,Grozny,1,3,4,"An Islamic militant attacks a cafe, killing one person."
2248,28/11/2004,Algeria,Mascara,1,3,4,"In a brutal attack, a civilian is killed and three others injured by members of the Salafi Daawa terrorist group."
2249,28/11/2004,Iraq,Samarrah,5,4,9,Five civilians are killed in a roadside bomb attack by Jihadists.
2250,28/11/2004,Afghanistan,Delaram,3,3,6,The Taliban attack an NGO office and machine-gun three aid workers to death.  Three others are injured.
2251,29/11/2004,India,Srinagar,0,12,12,"Mujahideen hurl a grenade into the center of a commercial district, injuring a dozen civilians."
2252,29/11/2004,Iraq,Baghdad,7,9,16,"Seven policemen, lining up for pay, are killed in a suicide bombing by Sunni extremists."
2253,30/11/2004,Pakistan,Quetta,0,10,10,Chechen Mujahideen hurls two grenades at Pakistani police attempting an arrest.  Ten are injured.
2254,30/11/2004,Sudan,Itou,65,0,65,Sixty-five civilians are reported dead after an air force bombing of their village by the Islamic government.  An unknown number are injured.
2255,30/11/2004,Thailand,Yala,1,2,3,Two separate shooting attacks by Muslim missionaries from the back of a motorcycle leave a teacher dead and two other civilians injured.
2256,30/11/2004,Iraq,Baghdad,4,19,23,Fedayeen suicide bomber takes four civilians on to Allah with him.  Nineteen others are injured in the attack.
2257,1/12/2004,Iraq,Iskandariya,1,7,8,Another suicidal extremist kills one civilian and injures seven others with a car bombing.
2258,2/12/2004,Iraq,Mosul,1,0,1,Islamic terrorists kidnap and decapitate a 29-year-old Christian man.
2259,2/12/2004,Iraq,Baqubah,3,5,8,"Extremists lob an explosive into a house, killing three children and injuring another five.  All of the kids were from the same family."
2260,3/12/2004,India,Sopore,5,5,10,al-Mansoorain terrorists stage a suicide attack on a police camp.  At least five officers are killed.
2261,3/12/2004,Iraq,Baghdad,14,19,33,Four suicide bombers drive a minibus loaded with explosives into a Shiite mosque.  Fourteen civilians are killed and at least nineteen others critically injured.
2262,3/12/2004,Iraq,Baghdad,16,5,21,"al-Qaeda militants attack a police station with RPGs and small arms, killing sixteen officers and injuring five."
2263,3/12/2004,Jordan,Border,2,0,2,A suicide bomber kills two Americans near the Jordanian-Iraqi border.
2264,4/12/2004,Chechnya,Tazen-Kale,1,2,3,Jihadis kill a civilian with an IED.
2265,4/12/2004,Iraq,Baghdad,16,38,54,Sunni extremists murder sixteen people and injure thirty-eight with two suicide car bomb blasts on a commercial street in the heart of the city.
2266,5/12/2004,India,Pulwama,11,0,11,"Eleven people are blown to bits by the Hizbul Mujahideen terrorist group on a road, while traveling to a security camp."
2267,5/12/2004,Iraq,Tikrit,17,13,30,"Islamic insurgents pull aside two buses carrying civilians and open fire at point-blank range, machine-gunning seventeen to death and injuring at least thirteen others."
2268,5/12/2004,Thailand,Pattani,1,0,1,A public prosecutor is killed by Islamists while working his farm.
2269,6/12/2004,Afghanistan,Balabolok,1,2,3,The Taliban gun down a police officer in a heinous attack.
2270,6/12/2004,Saudi Arabia,Jedda,5,2,7,"al-Qaeda members attack the U.S. consulate in Saudi Arabia with grenades, killing at least five international contractors and injuring several Americans."
2271,7/12/2004,Israel,Karni,1,4,5,One Israeli soldier is killed by a bomb at a border crossing.  Four are others injured.
2272,7/12/2004,Chechnya,Grozny,6,9,15,"Muslim separatists murder four civilians, including a teenager in separate attacks that also claim the lives of two Russian soldiers.  Seven others are injured and two taken hostage."
2273,8/12/2004,Dagestan,Semender,0,21,21,Twenty-one people are injured when Islamic rebels bomb a gas pipeline.
2274,8/12/2004,Nigeria,Bauchi,1,0,1,Muslim students at an African university abduct and kill a Christian student.
2275,8/12/2004,Iraq,Ramadi,1,0,1,Islamic terrorists kill a Christian doctor as he is attending to (Muslim) patients in a hospital.
2276,8/12/2004,Iraq,Taji Camp Road,2,0,2,"Two American civilians are gunned down by a group calling itself the ""Jihad Brigade."""
2277,8/12/2004,Iraq,Baghdad,3,0,3,Three Shia election workers are gunned down by Sunni activists.
2278,8/12/2004,Iraq,Samarrah,4,5,9,Sunni insurgents kill four civilians and injure several more with a terrorist bombing in the city center.
2279,8/12/2004,India,Anantnag,0,36,36,Thirty-six people are injured by a grenade thrown by the Mujahideen on a busy street.
2280,9/12/2004,India,Shopian,2,5,7,Mujahideen murder two cops in an ambush.  Five others are injured.
2281,9/12/2004,Iraq,Baghdad,3,5,8,Three civilians are killed and five injured when Jihadists lob mortar bombs into a residential neighborhood.
2282,10/12/2004,India,Magani,4,0,4,Heavily-armed Mujahideen ambush on a police patrol and slaughter all four Indian cops.
2283,10/12/2004,Pakistan,Quetta,11,27,38,"Bomb attached to a bicycle rips through a marketplace, killing more than ten people and injuring about two dozen."
2284,10/12/2004,Chechnya,Grozny,1,3,4,"Islamic gunmen fire on a civilian vehicle, killing at least one occupant."
2285,11/12/2004,Philippines,Jolo,1,0,1,Abu Sayyaf gunmen assassinate a government official.
2286,11/12/2004,Israel,Neveh Dekalim,0,4,4,"Hamas (Islamic Resistance) lobs several rockets into an Israeli neighborhood.  Four, including three children, are seriously injured."
2287,12/12/2004,Indonesia,Sulawesi,0,3,3,"Muslims open fire on churches in Indonesia, injuring three Christians."
2288,12/12/2004,Philippines,General Santos,15,59,74,Abu Sayyaf suspected of a mall bombing that kills fifteen Christmas shoppers.  Nearly sixty others are injured.
2289,12/12/2004,Israel,Rafah,5,6,11,Five Israeli soldiers are killed when Hamas terrorists set off a bomb under a checkpoint.  Six others hospitalized.
2290,13/12/2004,Iraq,Baghdad,13,15,28,Fedayeen suicide car bomber murders more than a dozen civilians and seriously injures another fifteen in a blast designed to maximize human casualty.
2291,13/12/2004,Chechnya,Grozny,1,2,3,"Islamists ambush a security patrol, killing at least one member."
2292,14/12/2004,Chechnya,Grozny,2,0,2,Two policemen manning a checkpoint are cut to pieces by Islamic gunmen.
2293,14/12/2004,Thailand,Narathiwat,1,1,2,A Buddhist teacher is gunned down by two Muslims in a motorcycle attack.  His wife is injured.
2294,14/12/2004,Kabardino-Balk.,Nalchik,4,0,4,Wahhabi terrorists attack a government building and kill the four security staff members on duty.
2295,14/12/2004,Iraq,Baghdad,7,13,20,Another Muslim takes his life in a suicide car blast that also kills seven civilians and injures at least thirteen.
2296,15/12/2004,Iraq,Karbala,10,40,50,"Sunni extremists bomb a Shia mosque, eventually killing ten and injuring forty people in the mosque and on the street."
2297,15/12/2004,Israel,Khan Yunis,1,2,3,Hamas militants kill a foreign agriculture worker at an Israeli settlement and injure two more with mortars.
2298,15/12/2004,Thailand,Narathiwat,2,0,2,"Two more Buddhist civilians, both in their 50's, are shot to death by Muslim extremists.  One was selling ice-cream from his vending bike at the time."
2299,15/12/2004,Iraq,Baghdad,17,20,37,"Sunni insurgents ambush a police convoy, killing four people on the spot.  Thirteen officers are taken prisoner and subsequently executed."
2300,15/12/2004,Thailand,Songkhla,1,0,1,Muslims gun down a civilian as he is on his way to pick up his wife.
2301,16/12/2004,Afghanistan,Khost,4,2,6,Religious extremists murder four policemen with a car-bomb.
2302,17/12/2004,Iraq,Mosul,4,0,4,Grisly murder of four men traveling in a car through Mosul (three are foreigners).  Bodies are mutilated and set aflame.
2303,18/12/2004,India,Shingru,2,0,2,Muslim terrorists shoot and kill a 70-year-old political activist and abduct and kill a youth (Kanir).
2304,18/12/2004,Iraq,Baghdad,5,1,6,"Three people are dragged from a car, forced to kneel, and then shot by ""holy warriors.""  Elsewhere, a husband and wife are shot to death in their homes for supporting ""infidels.""  (Son is kidnapped as well)."
2305,19/12/2004,Iraq,Baghdad,2,0,2,Two Christians are kidnapped and then murdered by Jihadists.
2306,19/12/2004,Iraq,Karbala,16,37,53,Sixteen people are killed by Fedayeen suicide car bomber and about forty injured in the attack on a Shia holy site.
2307,19/12/2004,Iraq,Najaf,52,142,194,An Islamic extremist plows his car into a Shia funeral procession and detonates it near a mosque.  Over fifty people are killed and about one hundred and fifty injured in the suicide attack.
2308,20/12/2004,Afghanistan,Maywand,4,4,8,"Taliban insurgents ambush a security checkpoint, killing four policemen."
2309,21/12/2004,Iraq,Mosul,22,69,91,"Twenty-two people, including several civilians are killed and about seventy injured when an Ansar al-Sunnah terrorist blows himself up in the middle of the lunch hour at a mess hall."
2310,21/12/2004,Israel,Moshov,1,0,1,A 39-year-old Israeli woman is stabbed to death by Palestinian terrorists.
2311,22/12/2004,Thailand,Pattani,1,0,1,A village chief is murdered by Islamists.
2312,22/12/2004,India,Sangam,1,14,15,"One person is killed and fourteen others, mostly civilians are injured when Mujahideen militant hurls a grenade into the road."
2313,22/12/2004,Israel,Hebron,1,0,1,Palestinians snatch a rifle from an Israeli guard and then shoot him to death with it.
2314,24/12/2004,Iraq,Baghdad,9,19,28,"An explosives-rigged fuel truck detonates in a residential neighborhood, killing nine, including seven members of the same family.  ""Shahid"" suicide bombing."
2315,24/12/2004,Bangladesh,Dhaka,1,0,1,Religious fundamentalists finally murder an economics professor on campus after several unsuccessful attempts
2316,24/12/2004,Thailand,Narathiwat,2,7,9,"Islamic separatists plant a bomb on a motorcycle, outside a bank, and kill two people, injuring at least seven."
2317,25/12/2004,India,Pakherpora,2,28,30,Islamic separatists kill two and injure twenty-eight in a grenade attack on a busy street.
2318,25/12/2004,Pakistan,Chitral,2,0,2,Armed fundamentalists kill two employees of an international aid foundation and set fire to vehicles.
2319,26/12/2004,Thailand,Chana,3,1,4,Three Thai policemen are killed by Muslims in a motorcycle terror attack as they are passing by.
2320,27/12/2004,Iraq,Baghdad,15,48,63,"A 'Holy Warrior' detonates explosives in front of a Shia party headquarters, killing himself and at least fifteen other.  Several dozen are injured, many suffering burns and missing limbs."
2321,28/12/2004,Thailand,Yala,1,0,1,Islamic extremists kill a school teacher in front of a market.
2322,28/12/2004,Algeria,Algiers,7,0,7,Seven Algerian civilians are gunned down by al-Salafeyah extremists.
2323,28/12/2004,Iraq,Tikrit,17,26,43,"In two attacks (Tikrit and Baqubah), Jihadists slaughter twelve Iraqi police officers by slitting their throats and murder five National Guardsmen a bomb."
2324,28/12/2004,Iraq,Muradiya,5,31,36,Five civilians are killed by a Sunni car bomb.  About thirty more are injured.
2325,29/12/2004,India,Kashmir,9,0,9,The Mujahideen shoot nine people to death in separate attacks.  One is the leader of the youth wing of a political party.
2326,29/12/2004,Pakistan,Wana,1,0,1,al-Qaeda members assassinate a local political figure in a drive-by with ties to the Afghan President.
2327,29/12/2004,Saudi Arabia,Riyadh,1,2,3,Saudi militants kill one person in two car bomb blasts.
2328,29/12/2004,Iraq,Baghdad,29,58,87,"At least twenty-nine, including two dozen civilians are killed when Islamic radicals blow up several houses near one being searched by police with a massive bomb."
2329,29/12/2004,Algeria,Algiers,3,0,3,A man and his two teenage daughters bleed to death after their throats are cut by Islamic fundamentalists in their home.
2330,29/12/2004,Thailand,Yala,1,0,1,A second teacher is gunned down in as many days by Muslim separatists.
2331,29/12/2004,Saudi Arabia,Riyadh,1,0,1,Islamic extremists kill a civilian with a car-bomb.
2332,30/12/2004,Dagestan,Makhachkala,3,0,3,"Three people, including a man and his wife, are slaughtered at point-blank range by Islamic gunmen."
2333,30/12/2004,Philippines,Malisbong,1,0,1,Abu Sayyaf terrorists kill a 68-year-old man execution style.
2334,30/12/2004,India,Waspora,2,1,3,Two citizens are shot dead in their home after the Mujahideen barge in.  Another relative is injured.
2335,31/12/2004,Iraq,Baiji,7,0,7,Suicide bomber kills seven and injures an unknown number of people.
2336,1/1/2005,Ingushetia,Vezhariy-Yurt,1,0,1,An off-duty policeman is murdered by Islamic rebels.
2337,2/1/2005,Israel,Erez,1,2,3,Hamas rockets kill a 25-year-old man working in the industrial zone. Two others are injured.
2338,2/1/2005,Iraq,Samarrah,4,1,5,Radical Sunnis machine-gun four cops to death as they sit in their car.
2339,2/1/2005,Iraq,Balad,23,6,29,"Fedayeen suicide bomber kills twenty-three people, mostly Iraqi National Guardsmen in a terrorist attack."
2340,3/1/2005,Iraq,Mosul,2,2,4,"Ansar al-Sunna Islamists kidnap and decapitate an Iraqi, then booby-trap the headless body with a bomb that kills a police officer."
2341,3/1/2005,Iraq,Tikrit,16,43,59,"Three suicide bombers blow themselves to Allah in separate attacks, taking sixteen other souls with them.  Over forty others sustain burns, open wounds and lost limbs."
2342,3/1/2005,Algeria,Biskra,18,0,18,"Algeria's Salafist Group for Preaching and Combat bombs a convoy then rakes it with machine-gun fire, killing eighteen people and injuring an unknown number."
2343,4/1/2005,Pakistan,Vinnoi,5,0,5,"A husband and wife, their son and two other relatives are murdered in their home in an 'honor killing' by a group of armed men."
2344,4/1/2005,Thailand,Narathiwat,1,0,1,Muslims murder a Thai village official from the back of a motorcycle as he is driving to work.
2345,4/1/2005,Iraq,Baghdad,10,60,70,"Fedayeen 'Holy Warrior' rams a checkpoint with a truck full of explosives, killing ten and injuring at least sixty, including women and children."
2346,4/1/2005,Iraq,Baghdad,7,0,7,"Iraqi governor, an advocate for democracy, is gunned down along with six of his guards by Islamic theocrats."
2347,5/1/2005,Iraq,Hilla,20,44,64,Fedayeen suicide car bomber kills at least twenty outside a police graduation ceremony.  About four dozen others are badly hurt.
2348,5/1/2005,Chechnya,Grozny,17,25,42,"A series of Mujahideen attacks across the country leaves seventeen dead, nineteen wounded and six others, including two college students kidnapped."
2349,5/1/2005,India,Srinagar,0,6,6,Four civilians and two Indian police suffer injuries when the Mujahideen hurl a grenade into a city street.
2350,6/1/2005,Iraq,Baqubah,6,13,19,al-Qaeda group sends a suicide bomber into a security point.  Six dead and thirteen injured.
2351,7/1/2005,Thailand,Yala,1,0,1,Terrorists assassinate a shop owner in a bloody attack.
2352,7/1/2005,Iraq,Mosul,18,0,18,The bodies of eighteen Shia laborers abducted and shot execution style by Sunni radicals are unearthed in a field.
2353,7/1/2005,Israel,Nablus,1,3,4,"An Israeli motorist is killed by a Palestinian sniper.  Three others are injured, two critically."
2354,7/1/2005,India,Srinagar,3,2,5,"Fedayeen militants from the al-Mansoorian outfit storm a government building with grenades, leaving at least four dead."
2355,8/1/2005,Pakistan,Gilgit,2,2,4,Sunni attack on the vehicle of a Shia cleric leaves two of his guards dead.
2356,9/1/2005,Israel,Shebaa Farms,1,3,4,"An Israeli officer is killed, and three others injured, in a Hezbollah rocket attack along the Lebanese border."
2357,9/1/2005,Pakistan,Gilgit,6,0,6,Shia burn six Sunnis alive after herding them into a house in a revenge for an earlier attack on a Shiite leader.
2358,10/1/2005,Iraq,Suwayrah,9,10,19,"Eight Ukrainian bomb sappers, and one Kazakh are killed by the 'Islamic Army' in a terrorist bombing attack."
2359,10/1/2005,Philippines,Mamasapano,8,5,13,"Moro Islamic Front stages a surprise attack on government post, killing eight Philippine soldiers."
2360,10/1/2005,Kuwait,Kuwait City,2,2,4,Islamic gunmen kill two security guards outside a government building.
2361,10/1/2005,Iraq,Tikrit,8,12,20,"Fedayeen suicide bombing leave six police dead and a dozen injured.  Police chief also assassinated in Baghdad, along with his son."
2362,10/1/2005,Thailand,Yala,1,0,1,A school security guard is murdered by Islamists.
2363,11/1/2005,Chad,Goz Beida,15,1,16,Janjaweed militias murder fifteen villagers in a raid.
2364,11/1/2005,Iraq,Yusufiyah,7,0,7,Seven Iraqi civilians are killed when militants destroy their minibus with a roadside bomb.
2365,12/1/2005,Israel,Morag,1,3,4,Palestinians use explosives and arms fire to murder an Israeli officer in the process of constructing a security fence.
2366,12/1/2005,Afghanistan,Helmand,6,0,6,Six Afghan soldiers are kidnapped and executed by the Taliban.
2367,12/1/2005,Chechnya,Vedeno,4,0,4,Mujahideen attack on a government car leaves four civilians dead.
2368,12/1/2005,Iraq,Salman,6,0,6,"Radical Sunnis shoot a Shia cleric and his son to death on the street, along with four of their bodyguards."
2369,12/1/2005,Somalia,Mogadishu,4,9,13,"Islamic fundamentalists throw a hand grenade into a cinema showing a soccer game, killing four innocents."
2370,13/1/2005,Kosovo,Prizren,1,0,1,Muslim militants thought responsible for the bombing of a bus station.
2371,13/1/2005,Thailand,Yala,2,1,3,Terrorists kill two civilians and severely injure a 5-year-old girl.
2372,13/1/2005,Israel,Karni Crossing,6,4,10,"Three Palestinian suicide bombers infiltrate the security wall, via an explosion, and murder six Israelis.  Four others are wounded."
2373,13/1/2005,Iraq,Khan Bani Saad,7,30,37,"A car bomb outside a Shia mosque kills seven people and injures another thirty, some critically."
2374,13/1/2005,Iraq,Baghdad,5,1,6,Islamic gunmen riddle a civilian minivan with machine-gun fire as it is picking up a Turkish businessman.
2375,14/1/2005,India,Yarbug Panzla,1,0,1,The Mujahideen enter a civilian's house and kill his 20-year-old daughter.
2376,15/1/2005,India,Srinagar,2,0,2,Al-Mansoorian terrorists storm a passport office and kill two government employees.
2377,15/1/2005,Dagestan,Kaspiisk,4,1,5,Islamic terrorists kill four policemen in two separate shootouts in Dagestan (Kaspiisk & Makhachkala).
2378,15/1/2005,India,Srinagar,2,17,19,Grenade thrown into an election rally by the Mujahideen kills two people and injures seventeen.
2379,15/1/2005,Bangladesh,Natore,3,89,92,"Islamic militants set off bombs at two different carnivals killing three and injuring about ninety others, including stage performers."
2380,16/1/2005,Thailand,Yala,1,59,60,"Muslims plant a bomb in a Thai restaurant, killing the owner and injuring sixty others."
2381,17/1/2005,Thailand,Pattani,1,0,1,A civilian is gunned down by Muslim militants.
2382,17/1/2005,Iraq,Ramadi,3,9,12,Three civilians are killed as a dedicated Muslim blows himself to Allah.  Nine others injured.
2383,17/1/2005,Iraq,Baiji,8,25,33,"Eight people are killed by a suicide bomber, with another 25 injured, some critically."
2384,17/1/2005,Iraq,Buhriz,8,4,12,"Jihadists attack a police checkpoint with machine-guns, killing eight."
2385,17/1/2005,Iraq,Ramadi,4,0,4,"The bodies of three civilians and one soldier are found in a field, brutally slain, with handwriting declaring them to be traitors to the cause of Allah."
2386,18/1/2005,Iraq,Baghdad,2,9,11,Sunni takes two members of a Shia political party with him to 'paradise.'  Car bombing injures nine others as well.
2387,18/1/2005,Israel,Sderot,1,1,2,17-year-old Israeli girl dies trying to protect her 10-year-old brother from a Hamas rocket attack (on 1-15).
2388,18/1/2005,Thailand,Narathiwat,3,0,3,At least three killed as militant Muslims go on a wild shooting and arson spree.
2389,18/1/2005,Israel,Gush Katif,1,7,8,Palestinian suicide bomber murders a father of three and injures seven others.
2390,19/1/2005,Algeria,Adekar Kebouche,1,0,1,Salafists slit the throat of a motorist stopped at a phony roadblock.
2391,19/1/2005,Sudan,Hamada,105,0,105,"The Islamic government bombs a village in Darfur, killing more than a hundred people, mostly women and children.  An unknown number are wounded."
2392,20/1/2005,Afghanistan,Spin Boldak,3,0,3,Pakistani fuel truck driver and two assistants are murdered by the Taliban in a senseless attack.
2393,20/1/2005,Iraq,Baghdad,26,25,51,Three al-Qaeda suicide bombings leave more than two dozen dead and scores of civilians badly injured.  One of the targets was the Australian embassy.
2394,21/1/2005,Algeria,Blida,3,5,8,Three people are killed by Islamic fundamentalists in a cemetery.  Five others are injured.
2395,21/1/2005,Iraq,Yusufiyah,12,38,50,"Suicide bomber drives an ambulance full of explosives into a Shia wedding party, slaughtering a dozen, including women and children and injuring dozens more including the bride and groom."
2396,21/1/2005,Iraq,Baghdad,14,42,56,"Radical Sunnis car bomb a Shia mosque as the victims celebrate a religious holiday.  Fourteen are killed, and about forty injured."
2397,21/1/2005,India,Anantnag,1,3,4,"The Mujahideen kidnap three civilians and torture two of them, eventually killing one."
2398,22/1/2005,Iraq,Baghdad,2,0,2,Two truck drivers are kidnapped and beheaded on a public street as executioners chant 'Allah Akbar.'
2399,22/1/2005,Afghanistan,Uruzgan,4,0,4,"Four people, including a police chief and two relatives, are killed by a Taliban roadside bomb."
2400,23/1/2005,Algeria,Tizi Ghenif,2,1,3,Islamic fundamentalists attack a security patrol killing two police and injuring one civilian.
2401,23/1/2005,Sudan,Darfur,12,0,12,"Janjaweed militia attack several villages, burning houses and killing a dozen innocents."
2402,24/1/2005,Thailand,Narathiwat,1,0,1,Muslim gunmen kill a policeman.
2403,24/1/2005,Thailand,Yala,1,0,1,A government worker is murdered by Islamists.
2404,24/1/2005,India,Kulgam,2,6,8,The Mujahideen gun down an orchard worker (Shopian) and toss a grenade into a bus stop.
2405,25/1/2005,Iraq,Baghdad,16,12,28,"Islamic insurgents kill sixteen people in various shooting attacks, including the 5-year-old daughter of a policeman."
2406,26/1/2005,Iraq,Kirkuk,7,3,10,Seven Iraqis are killed by two Jihad car bombings.
2407,26/1/2005,Iraq,Sinjar,15,31,46,"Sunni radicals pack a tractor with explosives and detonate it outside a Kurdish political office, killing at least a dozen."
2408,27/1/2005,Philippines,Bitaras,1,0,1,A civilian is brutally tortured to death by MILF terrorists.
2409,27/1/2005,Bangladesh,Habiganj,4,0,4,"Four people, including a 73-year-old man are assassinated by Muslim radicals in a grenade attack as they leave a public meeting."
2410,27/1/2005,Nigeria,Numan,1,0,1,A Christian woman is shot to death by Muslim troops in the troubled African province.
2411,27/1/2005,India,Kremshora,2,0,2,The Mujahideen abduct and kill an Indian government employee and his son.
2412,27/1/2005,India,Pampore,0,26,26,"Two grenades tossed by the Mujahideen at an election office injure twenty-six people, almost all civilians."
2413,27/1/2005,Iraq,Samarrah,3,0,3,"Three civilians, including two women, are killed in a Jihad bombing attack."
2414,27/1/2005,Bangladesh,Habiganj,5,100,105,"Islamic fundamentalists lob a grenade into an opposition political rally, killing a former finance minister and at least four others.  About one hundred people are injured, some badly."
2415,27/1/2005,Iraq,Mahmudiyah,3,7,10,"Three civilians are killed, and seven injured by a Sunni bomber."
2416,28/1/2005,Iraq,Baghdad,4,4,8,Four Iraqis are killed by a Fedayeen suicide car bomber.
2417,28/1/2005,Chechnya,Alkhan-Yurt,9,0,9,Jihad suicide bomber kills nine Chechen policemen after crashing his car into theirs at full speed.
2418,29/1/2005,Iraq,Baghdad,2,4,6,"Islamic militants hit the U.S. embassy with a rocket, killing two Americans."
2419,29/1/2005,Afghanistan,Spin Boldak,9,1,10,Nine Afghan soldiers are blown to bits by the Taliban while riding in a pickup truck near the Pakistani border.
2420,30/1/2005,Iraq,Baghdad,44,67,111,A string of suicide attacks by theocratic fanatics kill over forty Iraqis in an effort to prevent the citizenry from exercising their right to vote in elections.
2421,30/1/2005,Kuwait,Kuwait City,2,4,6,Islamic militants kill two people in a shootout.
2422,31/1/2005,Bangladesh,Chittagong,1,0,1,Jamaat-e-Islami terrorists kill a business man with a bomb in a shopping center.
2423,31/1/2005,India,Anantnag,2,1,3,"The Mujahideen break into a house and kill a woman, then kidnap and hang her student son."
2424,31/1/2005,India,Nathali-Bagwa,4,3,7,"Four members of a family, including three children and their mother, are killed when the Mujahideen hurl a grenade into a house after knocking down the door."
2425,31/1/2005,Thailand,Narathiwat,1,0,1,Muslims kill a civilian in front of his home.
2426,1/2/2005,Somalia,Mogadishu,1,0,1,A former school administrator is gunned down by Islamic militants.
2427,1/2/2005,Philippines,Datu Paglas,4,0,4,"MILF terrorists attack a security patrol, killing four members."
2428,2/2/2005,Thailand,Yala,3,0,3,A school teacher is one of three civilians killed in three separate shooting attacks by Islamic terrorists.
2429,2/2/2005,Dagestan,Makhachkala,4,0,4,Dagestani Islamists kill a high-ranking government official and three others in a shooting ambush on their vehicle.
2430,2/2/2005,Iraq,Kirkuk,12,2,14,Takfir wa Hijra (Islamist) terrorists stop a bus full of unarmed Iraqi recruits.  Twelve are dragged off and shot execution-style.
2431,3/2/2005,Iraq,Balad,2,0,2,Two people are shot to death by Sunni radicals for voting in the election.
2432,4/2/2005,Nigeria,Demsa,36,0,36,"Militant Muslims attack a Christian village in Nigeria, killing at least three dozen and displacing some three thousand others."
2433,4/2/2005,India,Taryath,1,2,3,"Two people escape after being kidnapped from their village by the Mujahideen, but another is executed."
2434,7/2/2005,Thailand,Narathiwat,1,0,1,A defense volunteer is murdered by Islamic extremists.
2435,7/2/2005,Germany,Berlin,1,0,1,A 23-year-old woman is killed by her youngest brother at a bus stop because she 'dishonored' the family by refusing to marry her cousin.
2436,7/2/2005,Iraq,Mosul,12,4,16,"Suicidal extremist kills a dozen police who were guarding a teaching hospital, by pretending to need assistance from the officers."
2437,7/2/2005,Iraq,Baqubah,15,17,32,Fedayeen suicide bomber kills himself and at least fifteen others who were seeking jobs outside a police station.
2438,7/2/2005,Philippines,Panamao,12,15,27,"Muslim separatists attack Philippine troops, killing a dozen."
2439,7/2/2005,Pakistan,Wana,2,2,4,al-Qaeda militants ambush four journalists riding in a car.  Two are murdered.
2440,8/2/2005,Iraq,Baghdad,21,27,48,"Shaheed suicide bomber blows himself to paradise, along with nearly two dozen others.  About thirty are seriously wounded in the street attack."
2441,9/2/2005,Somalia,Mogadishu,1,0,1,A BBC director dies of her wounds suffered in an attack by Islamic gunmen.
2442,9/2/2005,Thailand,Narathiwat,1,2,3,"Thai Islamists set off a bomb in a market stall, killing one villager and injuring two others."
2443,9/2/2005,Iraq,Basra,2,0,2,Shiite radicals gun down an Iraqi journalist and his 3-year-old son in front of their home.
2444,10/2/2005,Iraq,Suwayrah,21,0,21,The decomposing bodies of twenty-one Iraqi truck drivers hauling food are found two days after their convoy was ambushed by Islamic radicals.  They had all been burned inside their vehicles.
2445,11/2/2005,Thailand,Yala,2,24,26,"Thai Muslims shoot a Buddhist shopkeeper to death, then trigger a bomb that kills another person and injures two dozen."
2446,11/2/2005,Iraq,Balad Ruz,13,40,53,"Suicidal fanatic detonates a massive bomb using a vegetable truck outside a Shia mosque, killing over a dozen and injuring more than forty."
2447,11/2/2005,Iraq,Baghdad,11,0,11,"Sunni gunmen block off a street with their cars and then mow down Shia patrons at a bakery, killing eleven and injuring a unknown number of others."
2448,12/2/2005,Thailand,Yala,1,0,1,A policeman is gunned down by Islamists.
2449,13/2/2005,Iraq,Nasiriyah,2,0,2,An Iraqi translator and his son are gunned down by Islamists near their home.
2450,14/2/2005,Lebanon,Beirut,15,120,135,A powerful Hezbollah suicide bomb blast kills the former Lebanese Prime Minister and fourteen others.  One-hundred and twenty are injured in the blast.
2451,14/2/2005,Iraq,Baghdad,3,0,3,"Sunni extremists spray the inside of a passenger car with automatic weapons, killing an Iraqi officer and two companions."
2452,14/2/2005,Philippines,Davao,1,8,9,A 12-year-old boy is killed in an Abu Sayyaf bombing at a bus stop.  Eight others are injured.
2453,14/2/2005,Thailand,Narathiwat,1,1,2,"Muslim separatists shoot a 48-year-old man off of a motorcycle, injuring his wife as well."
2454,14/2/2005,India,Shopian,0,25,25,Twenty-five people are injured when the Mujahideen toss a grenade into a crowded street.
2455,14/2/2005,Philippines,General Santos,5,36,41,An bomb outside a shopping mall kills five shoppers and injures at least three dozen others.  Abu Sayyaf claims responsibility.
2456,14/2/2005,Philippines,Manila,3,79,82,"The Abu Sayyaf terrorist group detonates a bomb in the Philippine capital outside a crowded bus terminal, setting three buses on fire and killing at least three."
2457,15/2/2005,Indonesia,Ambon,2,2,4,"Muslims shoot two people, including a teenage girl, to death in an attack on a karaoke club."
2458,15/2/2005,Pakistan,Noorpur Shahan,3,14,17,Sectarian shooting attack leaves three dead Sunnis and fourteen others injured.
2459,16/2/2005,Dagestan,Kizlyar,3,4,7,Three people are killed in an IED attack by Islamic separatists.
2460,16/2/2005,India,Kishtwar,2,7,9,"Mujahideen toss a grenade into a bus stop, killing one and injuring seven.  Elsewhere (Rajouri) they kidnap and kill a 60-year-old man."
2461,17/2/2005,Iraq,Zakho,1,0,1,Christian taxi driver gunned down after refusing to convert back to Islam.
2462,17/2/2005,Somalia,Mogadishu,2,5,7,Bombing kills two and injures five near a hotel.
2463,17/2/2005,Jordan,Al Karamah,3,0,3,Three truck drivers are murdered by Islamic terrorists.
2464,18/2/2005,Chechnya,Kurchaloi,5,0,5,Three civilians are among five people murdered at point-blank range by Jihad gunmen.
2465,18/2/2005,Iraq,Baghdad,2,8,10,Two people in a religious procession are killed by a Fedayeen suicide bomber on a city street.
2466,18/2/2005,Thailand,Sungai Kolok,6,44,50,Muslim separatists kill six people near a hotel hosting a wedding reception with a powerful car bomb.
2467,18/2/2005,Iraq,Baghdad,10,20,30,"Another suicide bomber blows himself to Allah outside a Shia mosque, taking at least ten others with him."
2468,18/2/2005,Iraq,Baghdad,15,23,38,Suicide bomber kills fifteen Shia worshippers inside a mosque just as Friday prayers are beginning.  Another two dozen are injured.
2469,18/2/2005,Lebanon,al-Shuwayfat,2,0,2,"Islamists bomb a Christian-owned gas station, killing two people."
2470,19/2/2005,Algeria,Batna,4,0,4,The Salafist Group for Preaching and Combat ambush and kill four soldiers in remote Algeria.
2471,19/2/2005,Iraq,Baqubah,42,91,133,"Eight suicide attacks by Fedayeen 'Holy Warriors' (including one on a bicycle), along with a bus explosion kill at least forty innocent people and injure over one-hundred."
2472,20/2/2005,Thailand,Narathiwat,1,0,1,Militants gun down a civilian outside a hospital.
2473,21/2/2005,Thailand,Yala,1,0,1,A school headmaster is murdered by Islamists.
2474,21/2/2005,Thailand,Narathiwat,1,2,3,A village head is murdered by Islamists.
2475,21/2/2005,Chechnya,Grozny,9,2,11,Nine Russian servicemen are killed in an attack by the Mujahideen in the capital's suburbs.
2476,22/2/2005,Afghanistan,Sangin,2,0,2,The Taliban stop a vehicle carrying two humanitarian aid workers then execute each with a shot to the back of the head.
2477,22/2/2005,Iraq,Baghdad,4,30,34,"Suicide bomber rams his car into a police convoy, killing four and injuring about thirty."
2478,23/2/2005,Iraq,Mosul,2,14,16,Jihad car bombing kills two Iraqis and leaves fourteen others injured.
2479,24/2/2005,Dagestan,Untsukul,2,0,2,Two men sitting in a car are machine-gunned to death by Islamic separatists.
2480,24/2/2005,India,Srinagar,5,2,7,The Mujahideen kill five people and injure at least two others in a suicide assault on a government building in the region's capital.
2481,24/2/2005,India,Sopore,0,12,12,"Militant Islamist hurls a grenade into a crowd of people, injuring at least ten civilians."
2482,24/2/2005,Iraq,Tikrit,15,22,37,"Islamic suicide bomber drives an explosive-packed vehicle into a police compound, killing fifteen and leaving another two dozen in various stages of agony."
2483,24/2/2005,Thailand,Yala,7,0,7,Muslim terrorists kill seven people over a two day stretch that includes a Buddhist grocery store owner and a village chief.
2484,24/2/2005,Iraq,Iskandariya,3,8,11,"A young girl is among the three people killed by a Sunni car bombing.  Eight others are injured, two critically."
2485,24/2/2005,Afghanistan,Chakul,9,0,9,The Taliban ambush and murder nine Afghan police officers.
2486,25/2/2005,Israel,Tel Aviv,5,49,54,"Three weeks after a truce-signing, a Palestinian suicide bomber kills five Israelis outside a nightclub.  Forty-nine others in line are injured."
2487,25/2/2005,Thailand,Narathiwat,1,0,1,Islamists murder a civilian in a coconut plantation.
2488,25/2/2005,Nigeria,Sokoto,3,0,3,Shia extremists kill three Sunnis as they are walking out of a mosque.
2489,26/2/2005,Thailand,Narathiwat,1,0,1,A man is gunned down as he is walking to a local market.
2490,27/2/2005,Algeria,Souk El-Khemis,2,0,2,Two people in a small Algerian town are killed when religious fundamentalists set off a bomb.
2491,27/2/2005,Iraq,Mosul,12,2,14,"Car bomber kills eight people and Jihad gunmen kill another four in a separate incident, also in Mosul."
2492,28/2/2005,India,Surankote,1,0,1,The Mujahideen kidnap a 17-year-old boy from his home and then kill him.
2493,28/2/2005,Iraq,Hilla,135,141,276,"A Fedayeen suicide car bomber blows his way to paradise by driving into a crowd of unemployed Iraqis, taking the lives of more than one-hundred souls, most of whom were Christian."
2494,28/2/2005,Sudan,Toray,17,14,31,Arab militias with the support of the Islamic government attack a village and kill seventeen civilians and injure a dozen others including several women who were raped.
2495,28/2/2005,India,Matribugh,2,0,2,"Hizb-ul-Mujahideen terrorists capture, disarm and then execute two Indian soldiers."
2496,28/2/2005,Afghanistan,Takhar,2,0,2,Two Afghan cops are gunned down by the Taliban.
2497,1/3/2005,Thailand,Pattani,1,1,2,A government official is killed in a shooting attack by militant Muslims.
2498,1/3/2005,Thailand,Pattani,3,1,4,Muslim terrorists murder three civilians in separate random shooting attacks.
2499,1/3/2005,Chechnya,Sernovodskiy,1,16,17,"One policeman is killed, and sixteen others injured when the Mujahideen attack their station."
2500,2/3/2005,Iraq,Baghdad,13,30,43,"Two suicide car bombings kills thirteen Iraqis and wound thirty.  In a separate attack, a judge and his son are gunned down."
2501,2/3/2005,Bangladesh,Narsingdi,0,10,10,Militant Muslims injure ten people with a bomb outside a shrine.
2502,2/3/2005,Thailand,Narathiwat,1,3,4,"Islamic terrorists fire on a pickup carrying four people, killing one."
2503,3/3/2005,Thailand,Narathiwat,1,1,2,A man is shot off of his motorcycle by Muslim militants.
2504,3/3/2005,Iraq,Baghdad,5,7,12,Five people are killed by two Fedayeen suicide bombers outside a government building.
2505,3/3/2005,Iraq,Baqubah,1,3,4,Jihad car bombing kills one civilian and injures three.
2506,6/3/2005,Thailand,Narathiwat,2,0,2,Two young civilians are gunned down by Islamic militants in a motorcycle attack.
2507,6/3/2005,Thailand,Narathiwat,2,0,2,"Gema’ah Islamiyah terrorists, disguised as fully-veiled Muslim women open fire on a police checkpoint, killing two Thai officers."
2508,7/3/2005,Iraq,Balad,12,21,33,"Jihadists murder a dozen people, mostly civilians with a car bombing in a residential neighborhood."
2509,7/3/2005,Iraq,Baqubah,15,17,32,al-Qaeda suicide bomber accounts for most of the fifteen people dead in four attacks.  At least twenty-six others are injured.
2510,7/3/2005,Afghanistan,Kabul,1,0,1,British national gunned down by a Taliban terrorist while waiting at a traffic light.
2511,7/3/2005,Israel,Hebron,0,2,2,Two Israelis are wounded by a Palestinian sniper.
2512,7/3/2005,Thailand,Pattani,3,0,3,"Three people, including two Buddhists and a businesswoman are murdered in three separate attacks by Muslim terrorists."
2513,8/3/2005,Bangladesh,Jalalpur,1,0,1,Christian pastor attacked and beheaded by Muslim extremists as he is returning home from work.
2514,8/3/2005,Pakistan,Danyore,1,0,1,Sunni government official shot to death by Shia militants while waiting for a bus.
2515,9/3/2005,Iraq,Al-Rumana,41,0,41,"The bodies of forty-one people, massacred by Jihadists, are found.  All had been executed, many were beheaded, including several women and young children."
2516,9/3/2005,Iraq,Baghdad,2,40,42,"Two suicide bombers drive a garbage truck packed with explosives into a hotel, killing two others and injuring several dozen."
2517,10/3/2005,Iraq,Mosul,50,86,136,"Devout Sunni blows himself up inside a Shiite mosque, taking fifty lives and leaving about a hundred other people badly injured."
2518,11/3/2005,Philippines,Sulu,5,4,9,"The Moro Islamic Front attacks a military patrol, killing five and injuring four."
2519,12/3/2005,Algeria,Bouira,2,2,4,"Islamic extremists set up a fake roadblock, then machine-gun two policemen to death in their vehicle."
2520,13/3/2005,Iraq,Hilla,2,1,3,Muslims kill two American security contractors with a roadside bomb.
2521,13/3/2005,Iraq,Mosul,6,1,7,Sunni Jihadists kill a police officer's wife and two young children then shoot three other policemen attending the funeral a day later.
2522,14/3/2005,Iraq,Baghdad,6,10,16,"Three car bombings kill a total of four civilians, including two farmers."
2523,14/3/2005,India,Baramulla,2,0,2,"The Mujahideen ambush a search party, killing at least one person.  They also kill a civilian at his home (Gagrot Piri)."
2524,14/3/2005,Philippines,Manila,3,3,6,Abu Sayyaf militant grabs a gun and shoots three prison guards to death.
2525,15/3/2005,India,Tangmarg,2,0,2,"A leader of the terrorist group, Hizb-ul-Mujahideen, kills two people in making an escape from jail."
2526,15/3/2005,India,Poonch,0,7,7,Seven people standing outside a bank are injured when the Mujahideen hurl a grenade at them.
2527,15/3/2005,Iraq,Baghdad,1,4,5,Suicide bomber successfully kills a young child and injures four others.
2528,15/3/2005,Iraq,Baghdad,4,7,11,Jihad car bombing kills four civilians and injures seven.
2529,15/3/2005,Thailand,Yala,1,3,4,A policeman is killed and three other people injured when Muslim separatists set off a bomb at a railway station.
2530,16/3/2005,Iraq,Baqubah,3,8,11,"al-Qaeda suicide bomber kills three soldiers and injures eight other people, including civilians."
2531,17/3/2005,Thailand,Pattani,1,0,1,A school principal is gunned down by Islamic radicals.
2532,17/3/2005,Nigeria,Benue,1,0,1,Two Muslim men rape a Christian girl and then poison her.
2533,17/3/2005,Afghanistan,Kandahar,5,32,37,"The Taliban detonate a roadside bomb targeting a humanitarian convoy that kills two women, two men and one Afghan child.  Thirty-two others are injured."
2534,17/3/2005,India,Rajouri,3,24,27,Three people are killed when the Mujahideen hurl a grenade at a restaurant.
2535,18/3/2005,India,Bandipore,1,6,7,The Mujahideen kill an 8-year-old boy by tossing a grenade into a school.  Six of his classmates sustain critical injuries.
2536,19/3/2005,Qatar,Doha,1,16,17,"Egyptian suicide bomber slams his car into a theatre, killing a British national and injuring sixteen others in the Qatari capital."
2537,19/3/2005,Lebanon,Beirut,2,11,13,"Syrian-backed terrorists set off a car bomb in a Christian neighborhood, killing two innocents."
2538,19/3/2005,Thailand,Narathiwat,2,2,4,"Three separate shooting attacks by Islamic militants leave at least two villagers dead, including a Buddhist man shot in the back of the head while sitting in his tea shop."
2539,19/3/2005,Iraq,Kirkuk,4,5,9,"Jihad insurgents gun down a police officer, then kill three others at his funeral procession."
2540,20/3/2005,Afghanistan,Khost,2,0,2,Two civilians are murdered in a Taliban attack.
2541,20/3/2005,Pakistan,Fatehpur,39,55,94,"Radical Sunni suicide bomber blows up a Shia religious festival near a Pakistani shrine, killing about three dozen and injuring many more."
2542,20/3/2005,Iraq,Mosul,5,14,19,"A suicide bomber walks into a government building and kills three others.  Jihadists then open fire on the subsequent funeral, killing two others."
2543,20/3/2005,Thailand,Yala,1,13,14,"One civilian is killed, and thirteen other people injured by two bombs placed by Islamic separatists, one near a river pavilion."
2544,21/3/2005,Thailand,Songkhla,1,3,4,"Islamic separatists open fire on a restaurant, killing one customer and injuring three others."
2545,21/3/2005,Iraq,Aziziyah,7,0,7,A roadside bombing rips through the bodies of four women and three children riding in a vehicle.
2546,21/3/2005,Iraq,Sammarah,3,6,9,"Three people, including two women, are murdered in a Jihad car bombing."
2547,22/3/2005,Iraq,Mosul,10,0,10,"Roadside blast kills four civilians.  Elsewhere (in Kut), the bodies of six captured soldiers are found bound and executed."
2548,22/3/2005,Chechnya,Grozny,1,0,1,A guard is killed by Islamic militants.
2549,23/3/2005,Afghanistan,Gereshk,2,1,3,Two government employees are shot to death by the Taliban.
2550,23/3/2005,Thailand,Pattani,1,0,1,A former village headsman is assassinated by terrorists.
2551,23/3/2005,Thailand,Narathiwat,1,0,1,A rubber plantation owner has his life cut short by Islamic radicals.
2552,23/3/2005,India,Srinagar,1,5,6,The Mujahideen kill a civilian and injure several other people with a car bomb in a shopping district.
2553,23/3/2005,Lebanon,Jounieh,3,3,6,Three people are killed when Muslim terrorists detonate an 80kg bomb in a shopping center in a Christian area north of Beirut.
2554,24/3/2005,Thailand,Yala,0,4,4,"Four people, including an elderly Buddhist monk are injured by a bomb that Islamic militants trigger with a cell phone."
2555,24/3/2005,Iraq,Baghdad,5,0,5,Jihad gunmen open up on a van carrying cleaning women from their job at an American base.  Five women are shot to death.
2556,24/3/2005,India,Bakhipora,2,0,2,"Hizb-ul-Mujahideen invade a civilian's home, kidnap his son and nephew then execute them in captivity."
2557,24/3/2005,Chechnya,Petropavlovskaya,1,0,1,Islamic terrorists assassinate a government official.
2558,24/3/2005,Iraq,Basra,2,0,2,A female Christian college student is kidnapped and beaten to death by Shiite radicals.  A man coming to her rescue is murdered as well.
2559,25/3/2005,Afghanistan,Oruzgan,2,0,2,A judge is one of two people murdered by religious extremists in separate attacks.
2560,25/3/2005,Chechnya,Proletarskiy,2,0,2,"Two civilian, including an elderly man, are beaten and shot to death in their home by Islamic rebels."
2561,25/3/2005,Iraq,Karbala,2,19,21,"Two Shia pilgrims are killed, and nineteen others injured by a Sunni suicide bomber as they are marching to the shrine city."
2562,25/3/2005,Iraq,Ramadi,11,14,25,Fedayeen suicide bomber kills eleven police officers at a checkpoint and injures another fourteen.
2563,25/3/2005,India,Manwa-Dangal,1,0,1,Muslim terrorists abduct a civilian then slit his throat a day later.
2564,26/3/2005,Lebanon,Beirut,0,5,5,Bomb in a predominately Christian suburb injures five.
2565,26/3/2005,Iraq,Tal Afar,4,6,10,"Four policemen are killed, and six wounded, in an attack on their station by radical Sunni."
2566,26/3/2005,India,Srinagar,1,16,17,Sixteen people are injured and one killed when the Mujahideen lob a grenade near a crowded bus stop.
2567,26/3/2005,Thailand,Narathiwat,2,0,2,Two railway worker are murdered by Muslim radicals as they are taking a break.
2568,27/3/2005,Afghanistan,Laghman,4,0,4,Four Afghan military guards are blown to bits in a Taliban rocket attack on a government building.
2569,27/3/2005,Iraq,Baghdad,2,2,4,"Religious fanatic blows himself up, also killing two U.S. soldiers."
2570,27/3/2005,Thailand,Narathiwat,0,15,15,Bombing and shooting attack on a train by Muslim separatists results in more than a dozen casualties.
2571,27/3/2005,India,Udhampur,4,0,4,"Mujahideen militants set fire to a civilian's house after killing his mother, wife and infant daughter.  They also murder a neighbor."
2572,27/3/2005,Iraq,Abu Tamir,6,3,9,Six Iraqis are killed by Jihadists in and around Baqubah in several shooting attacks.
2573,27/3/2005,Pakistan,Khambay,1,6,7,"Four Islamic militants open fire on an church Easter service, killing at least one Christian and injuring six other worshippers."
2574,28/3/2005,Yemen,Saada,4,0,4,Islamic extremists ambush and kill four Yemeni policemen.
2575,28/3/2005,India,Machan,2,8,10,"Muslim terrorists ambush a local security patrol, killing two and injuring eight."
2576,28/3/2005,Iraq,Karbala,7,9,16,Sunni extremist kills seven Shia pilgrims at a religious event with a suicide car bombing.  At least nine others are injured.
2577,29/3/2005,Afghanistan,Anar Darah,4,0,4,The Taliban ambush and kill four policemen in a remote area.
2578,29/3/2005,India,Biwilian,1,0,1,Lashkar-e-Toiba terrorists kill a boy who refuses to courier money for them.
2579,29/3/2005,Iraq,Mussayib,5,5,10,"Suicide bicycle bomber pedals his way to Paradise, taking five other souls with him including three civilians."
2580,29/3/2005,Algeria,Thenia,1,0,1,The Salafist Group for Preaching and Combat kidnaps a 32-year-old man then slits his throat.
2581,30/3/2005,Iraq,Mosul,6,8,14,"Four Jihadi gunmen open fire on a street, killing six people and injuring another eight in what appeared to be a suicide attack."
2582,30/3/2005,Iraq,Mahawil,1,2,3,"Sunni extremists open fire on Shiite pilgrims making their way to a religious festival, killing at least one person."
2583,31/3/2005,Iraq,Tuz Khormato,5,14,19,"Fedayeen suicide bomber murders five others, including a child, outside a shrine."
2584,31/3/2005,India,Thanna Mandi,5,5,10,The Mujahideen kidnap and kill two villagers from their home.  Elsewhere in Kashmir three other civilians are killed in separate attacks.
2585,31/3/2005,India,Sonabrari,3,0,3,The bodies of three shepherds abducted and executed by the Mujahideen two days earlier are found.
2586,1/4/2005,Pakistan,Lahore,1,3,4,Sunni gunmen kill a Shiite cleric in his car in an attack that also injures his young daughter and two of her friends.
2587,1/4/2005,Afghanistan,Spin Boldak,3,0,3,Taliban extremists kill three truck drivers and then burn their vehicles.
2588,1/4/2005,Lebanon,Broummana,0,12,12,Bomb placed outside a shopping center in a Christian resort village by Syrian-backed terrorists injures a dozen.
2589,1/4/2005,Afghanistan,Peyazkar,2,0,2,Civilians standing near a tractor are murdered in a Taliban bombing.
2590,2/4/2005,Thailand,Narathiwat,1,0,1,A Buddhist man is murdered by Muslims while sitting in his pick-up truck with his children.
2591,2/4/2005,Afghanistan,Kandahar,4,5,9,"The Taliban kill four people, including two children, in two bomb attacks (the second in Mazar-i-Sharif)."
2592,2/4/2005,Iraq,Baghdad,6,5,11,Car bomb kills five Iraqis and injures another five.  A government minister of education is gunned down in a separate attack.
2593,3/4/2005,Algeria,Boumerdes,3,2,5,Three farmers are killed when Islamic fundamentalists with suspected ties to al-Qaeda set off a roadside bomb in Algeria.
2594,3/4/2005,Thailand,Songkhla,5,86,91,"Islamic militants set off three bombs, killing five and injuring at least eighty.  The fatalities were from the bomb set at the airport.  The other two bombs were at a hotel and a department store."
2595,3/4/2005,Afghanistan,Helmand,9,3,12,"Muslim extremists attack a government building, killing nine Afghan soldiers."
2596,3/4/2005,Chechnya,Sernovodsk,3,1,4,One man is murdered in an IED attack by Muslim separatists. Two sappers are blown apart in a separate bombing.
2597,3/4/2005,Algeria,Chlef,1,0,1,The Salafist Group for Preaching and Combat stab and shoot a shepherd to death.
2598,4/4/2005,Algeria,Boumerdes,5,11,16,"Islamic fundamentalists stage an ambush on a police convoy, massacring five officers."
2599,5/4/2005,India,Jammu,2,3,5,"Pakistani Fedayeen take Indian border guards by surprise, killing two Hindus and injuring three before fleeing."
2600,5/4/2005,Thailand,Narathiwat,2,0,2,Two village guards are murdered by Islamic radicals while riding in their truck.
2601,6/4/2005,Thailand,Pattani,1,0,1,Islamists kill a village headsman.
2602,6/4/2005,Afghanistan,Charchino,3,0,3,Three civilians are murdered by the Taliban.
2603,6/4/2005,India,Hanjivira,0,7,7,"Mujahideen bomb intended for a passenger bus explodes early, injuring seven civilians."
2604,6/4/2005,Iraq,Mosul,2,0,2,"Video posted on the Internet showing two young men brutally stabbed to death as assailants yell ""Allah Akbar."""
2605,7/4/2005,Pakistan,Peshawar,2,0,2,"A priest and his Christian driver are detained then stabbed to death by Muslim extremists, who also cut off the hands, noses and ears of the victims."
2606,7/4/2005,Sudan,Khor Abeche,17,0,17,"Arab militia raids an African village, killing at least seventeen and torching homes.  A small mosque was one of only two structures spared."
2607,7/4/2005,Algeria,Oued Djerma,14,0,14,Algerian fundamentalists set up a fake roadblock then slaughter the trapped victims and set fire to their cars.
2608,7/4/2005,India,Srinagar,0,7,7,Fedayeen suicide attack on the bus terminal housing elderly 'freedom riders' is largely unsuccessful.  Two attackers are killed.
2609,7/4/2005,Egypt,Cairo,3,18,21,"Islamist detonates a nail-packed bomb in a shopping area, killing a French woman and two others, including an American tourist.  Eighteen others are injured."
2610,8/4/2005,Iraq,Baqubah,10,0,10,"The bodies of ten civilians, abducted, bound and executed by Jihadis are found."
2611,8/4/2005,Iraq,Baghdad,4,0,4,Roadside bomb kills four children.
2612,8/4/2005,Iraq,Latifiya,15,0,15,"In a senseless killing, members of the ""Islamic Army"" stop a vehicle carrying non-uniformed Iraqi soldiers and machine-gun them to death."
2613,8/4/2005,Algeria,Jijel,2,0,2,Two civilians are shot to death by Islamic fundamentalists.
2614,9/4/2005,Thailand,Yala,1,0,1,Muslim separatists kill a policeman.
2615,9/4/2005,Iraq,Mosul,2,13,15,"Islamic insurgents detonate a roadside bomb, killing two civilians and injuring thirteen others."
2616,9/4/2005,Afghanistan,Qalat,1,0,1,The Taliban murder a government official taken hostage two days earlier.
2617,10/4/2005,Nigeria,Benue,14,4,18,Fourteen Christians are killed in an attack on their villages by Muslim militants in the large African nation.
2618,10/4/2005,India,Shopian,2,20,22,"Islamic militant hurls a grenade into a group of pedestrians, killing two and injuring twenty."
2619,10/4/2005,India,Srinagar,4,3,7,The Mujahideen kill four people in four separate shooting attacks across the region and take three policemen hostage.
2620,11/4/2005,Iraq,Qaim,0,0,0,"Three remarkably inefficient suicide bombers manage to send themselves to Allah, but not anyone else."
2621,11/4/2005,Iraq,Samarrah,3,22,25,"Fedayeen suicide bomber blows his pickup truck to pieces in a crowded market, killing three civilians an injuring more than twenty others."
2622,11/4/2005,Thailand,Pattani,1,0,1,"Muslim terrorists kill a civilian, then burn his body."
2623,11/4/2005,Thailand,Narathiwat,2,0,2,Two civilians are murdered by Islamic gunmen in separate attacks.
2624,12/4/2005,Philippines,Tagaya,4,2,6,An ambush by MILF terrorists leave four people dead.
2625,12/4/2005,India,Shopian,1,0,1,The Mujahideen shoot a woman to death in front of her house.
2626,12/4/2005,Iraq,Mosul,5,12,17,Fedayeen suicide bomber murders five civilians on a city street.
2627,12/4/2005,Iraq,Tal Afar,5,8,13,A suicide car bomber manages to kill five Iraqis and injure eight.  Most of the victims were children.
2628,13/4/2005,Dagestan,Makhachkala,1,2,3,A policeman is killed and two others injured as Islamic militants plant a bomb on a road leading to the airport.
2629,13/4/2005,Iraq,Kirkuk,12,3,15,Muslim terrorists plant a decoy bomb near another live one that kills a dozen policemen while they are trying to defuse the decoy.
2630,13/4/2005,Algeria,Relizane,2,5,7,Two civilians are shot to death in an ambush by religious fundamentalists.  Five others are injured in the attack.
2631,13/4/2005,Algeria,Tebessa,3,3,6,Religious fundamentalists kill three security guards and injure three others in three different bombings.
2632,14/4/2005,Iraq,Mahawil,4,6,10,Suicide bomber takes four Iraqi with him.  Six others are badly injured.
2633,14/4/2005,Iraq,Kirkuk,6,0,6,Ansar al-Sunnah terrorists gun down five police officers and one civilian in a single attack.
2634,14/4/2005,Iraq,Baghdad,18,36,54,"al-Qaeda sets off two car bombs on a crowded city street, massacring eighteen people and injuring about forty others."
2635,15/4/2005,Afghanistan,Deh Rawod,2,2,4,"Religious extremists bomb a hotel, killing two civilians."
2636,16/4/2005,Iran,Ahvaz,3,24,27,"Three people are killed, and several dozen injured in sectarian rioting."
2637,16/4/2005,Iraq,Baghdad,3,6,9,"Religious extremist blows himself up, killing three other civilians and wounding six.  One of the women killed was described as 'Angel of Mercy.'"
2638,16/4/2005,Iraq,Baqubah,9,12,21,"Radical Sunnis detonate a bomb in a restaurant, killing nine patrons and injuring over a dozen."
2639,17/4/2005,Pakistan,Kandahar,1,3,4,"One truck driver is killed, and three others injured when Taliban extremists attack their oil convoy with rockets."
2640,17/4/2005,Chechnya,"Nozhai-Yurt,",1,0,1,The Mujahideen kill a young boy with an IED.
2641,18/4/2005,Somalia,Mogadishu,1,2,3,"Suspected Islamists open fire on a Swedish humanitarian aid vehicle, killing an aid worker and injuring two others."
2642,18/4/2005,Thailand,Narathiwat,1,0,1,Radical Muslims gun down a man sitting in a tea shop.
2643,19/4/2005,Iraq,Baghdad,2,4,6,Two American soldiers are killed by a Fedayeen suicide bomber.
2644,19/4/2005,Iraq,Baghdad,4,38,42,"Islamist blows himself to Allah in a green minivan, taking four Iraqi police recruits with him and injuring thirty-eight others"
2645,19/4/2005,Dagestan,Makhachkala,1,1,2,"Islamic terrorists detonate a bomb at a busy intersection, killing a civilian."
2646,19/4/2005,Thailand,Pattani,1,0,1,A man is murdered by Muslim terrorists while leaving a tea shop.
2647,20/4/2005,Thailand,Narathiwat,1,0,1,A gentle Buddhist man is shot to death by Muslim radicals.
2648,20/4/2005,Thailand,Pattani,1,0,1,A hospital gardener is murdered by Islamic terrorists.
2649,20/4/2005,Pakistan,Nowshera,1,0,1,Pakistani mob chases a 'blasphemer' up a tree before lynching him.
2650,20/4/2005,India,Sopore,2,10,12,The Mujahideen take out a vegetable vendor and another innocent woman in a grenade attack on a shopping district.
2651,20/4/2005,Iraq,Baghdad,4,13,17,"Three terrorist attacks, including an ambush on a truck convoy, leave four civilians dead and at least thirteen injured, some critically."
2652,20/4/2005,Iraq,Haditha,19,0,19,Jihadis mark the birth of Muhammad by abducting nineteen Iraqi soldiers in civilian clothes heading home to celebrate the holiday with their families.  The men are then executed at a soccer stadium.
2653,21/4/2005,Saudi Arabia,Mecca,2,0,2,Saudi Islamists kill two Saudi policemen.
2654,21/4/2005,Iraq,al-Taji,11,0,11,"Yelling ""Allah Akbar"" Islamists bring down a civilian helicopter with a missile, killing ten.  The lone survivor is helped to is feet, then shot to death."
2655,21/4/2005,Iraq,Suwayrah,57,0,57,Women and children are amply represented among the more than fifty bodies pulled out of a river after having their throats cut by Islamist kidnappers.
2656,21/4/2005,Thailand,Narathiwat,1,0,1,A man is murdered by Muslims while driving to work.
2657,22/4/2005,Afghanistan,Maywand,1,0,1,A government employee is murdered by the Taliban.
2658,22/4/2005,Dagestan,Makhachkala,1,1,2,Muslim militants kill a civilian with a bomb hidden in a garbage can.
2659,22/4/2005,Algeria,Bir El Ater,2,0,2,Two Algerian civilians die in a bomb attack by Islamic fundamentalists.
2660,22/4/2005,Iraq,Baghdad,12,26,38,"Twelve people, including a 10-year-old boy, are killed when religious extremists bomb a Shia mosque.  Twenty-six others are badly injured."
2661,22/4/2005,Iraq,Baqubah,1,1,2,Radical Sunnis murder a 7-year-old girl with a roadside bomb.
2662,22/4/2005,India,Baramulla,2,0,2,Two youths are killed in separate attacks by the Mujahideen.  One has his throat slit.
2663,23/4/2005,Iraq,Baghdad,13,30,43,"Multiple bombings by Jihadis, including at least one suicide attack, leave thirteen Iraqis dead and at least thirty injured."
2664,23/4/2005,Algeria,Ain Defla,4,4,8,"The Salafist Group for Preaching and Combat shoots two family members to death, then kills two community guards in separate attacks."
2665,23/4/2005,England,Southall,1,0,1,A woman is brutally stabbed to death by her brother and cousin after refusing an arranged marriage.
2666,23/4/2005,Thailand,Pattani,1,0,1,A civilian is killed by Islamic terrorists.
2667,24/4/2005,Chechnya,Shelkovskaya,1,0,1,Islamic terrorists kill an imam who turned them away.
2668,24/4/2005,Indonesia,Sulawesi,6,0,6,At least six Christian villagers are killed by their Muslim neighbors after refusing to 'return to Islam.'
2669,24/4/2005,Thailand,Narathiwat,2,3,5,Militant Muslims kill two Thai policemen with a remote-controlled bomb that injures three civilians as well.
2670,24/4/2005,Iraq,Tikrit,6,33,39,Jihadis murder six policemen with two bombs.  Nearly three dozen others are injured.
2671,24/4/2005,Iraq,Baghdad,15,40,55,"Sunni extremists plow a car into a crowd of people outside an ice cream shop in a Shia neighborhood, then detonate the vehicle as others rush to help the victims."
2672,24/4/2005,Afghanistan,Kandahar,2,0,2,"The Taliban attack a government building, killing two security staff."
2673,25/4/2005,India,Khurhama,1,0,1,A political activist is kidnapped by the Mujahideen and then shot to death.
2674,25/4/2005,Yemen,Sanaa,2,2,4,"Followers of a radical Shiite throw a bomb from a car window, killing two, including a student and injuring two others."
2675,25/4/2005,Philippines,Jolo,2,5,7,Abu Sayyaf terrorists kill two Philippine soldiers with a bomb.  Five others are badly injured.
2676,26/4/2005,Afghanistan,Dishu,4,2,6,Four police officers are killed in an ambush by Taliban terrorists on their convoy.
2677,26/4/2005,Afghanistan,Paktia,1,0,1,A civilian is murdered by the Taliban.
2678,27/4/2005,Thailand,Pattani,1,1,2,Muslims kill a teacher and injure his nephew.
2679,27/4/2005,India,Pahalgam,1,0,1,The Mujahideen abduct and murder an Indian school teacher.
2680,27/4/2005,Iraq,Najaf,1,0,1,Shiite cleric gunned down on his way to work.
2681,28/4/2005,Algeria,Sidi Daoud,2,0,2,Algerian fundamentalists kill two soldiers in a terror bombing.
2682,29/4/2005,Thailand,Narathiwat,1,0,1,A government employee is killed by armed Muslims.
2683,29/4/2005,Thailand,Pattani,1,0,1,A man is murdered by Muslim terrorists.
2684,29/4/2005,Kabardino-Balk.,Nalchik,4,2,6,A Russian cop and three civilians are killed by Islamic militants.
2685,29/4/2005,Iraq,Baghdad,41,120,161,Seven separate suicide bombings by Muslim extremists leave more than forty people dead and at least one-hundred and twenty injured.  Women and children are among the victims.
2686,30/4/2005,Egypt,Cairo,0,9,9,"Two women in veils stage a shooting attack on a tour bus.  They are the only fatalities, but nine innocents are injured."
2687,30/4/2005,Iraq,Baghdad,11,36,47,A series of five bombings kills at least eleven and injures dozens.
2688,1/5/2005,Iraq,Baghdad,4,5,9,A Jihad car bomb kills four civilians and injures another five.
2689,1/5/2005,Iraq,Baghdad,5,0,5,Iraqi policemen are shot to death by al-Qaeda operatives at a checkpoint.
2690,1/5/2005,Afghanistan,Baghlan,3,0,3,"The Taliban kill three women, at least one of whom was an aid worker."
2691,1/5/2005,Iraq,Tal Afar,25,51,76,"A Kurdish funeral is the target of a suicidal religious fanatic, who kills at least twenty-five others and injures about fifty mourners."
2692,1/5/2005,Israel,Tzieda,1,1,2,Islamic Jihad kills a 21-year-old Israeli soldier.
2693,2/5/2005,Thailand,Yala,1,0,1,Militant Muslims murder a civilian working in his field.
2694,2/5/2005,Thailand,Narathiwat,1,1,2,Islamic radicals fire on a man and his wife as they are returning from working in an orchard.
2695,2/5/2005,India,Harni,1,4,5,"The Mujahideen attack a security patrol, killing one personnel."
2696,2/5/2005,Afghanistan,Shah Wali Kot,2,4,6,Taliban fundamentalists kill two police officers with a terrorist bomb.
2697,2/5/2005,Iraq,Mosul,23,50,73,"Twenty-three Iraqis, including children are killed in eight car bombings by Muslim extremists.  More than fifty are badly injured."
2698,3/5/2005,India,Pattan,5,0,5,"A political figure is assassinated by the Mujahideen, along with three civilians and a police officer."
2699,3/5/2005,India,Pulwama,0,14,14,Fourteen people are injured when an Islamic terrorist lobs a grenade into the road near a bus stop.
2700,3/5/2005,Thailand,Pattani,1,0,1,A postal worker is murdered by Islamists.
2701,4/5/2005,Thailand,Narathiwat,1,1,2,Muslims disguised as Islamic preachers kill a Muslim married to a Buddhist woman.
2702,4/5/2005,Iraq,Erbil,60,150,210,"A Fedayeen suicide bomber walks into a crowd of Iraqi civilians standing in line to apply for jobs with the police and detonates his explosives, killing sixty and injuring about three times that number."
2703,5/5/2005,Afghanistan,Shah Wali Kot,9,3,12,"Taliban fundamentalists ambush a military patrol with a landmine and automatic weapons, killing nine Afghans."
2704,5/5/2005,India,Udhampur,3,22,25,"Mujahideen militants lob a grenade then open fire on a Hindu wedding party, killing two teenage girls (ages 15 and 17) and injuring twenty-two others."
2705,5/5/2005,Iraq,Baghdad,22,43,65,"Three separate attacks, including another suicide bomber at a recruitment station, leave twenty-two Iraqis dead and at least that many injured."
2706,6/5/2005,Iraq,Baghdad,14,0,14,"Assyrian Christians are thought to be among the fourteen, bound corpses of torture victims found in a city garbage dump."
2707,6/5/2005,Iraq,Suwayrah,16,36,52,"Sixteen Iraqis shopping at a marketplace are murdered by a Fedayeen, who wades into the crowd before detonating explosives strapped to his body.  At least thirty-six are injured."
2708,6/5/2005,Iraq,Tikrit,7,8,15,"A suicidal religious extremist blows his car up next to a minivan taking Iraqi police to work, killing seven and injuring eight."
2709,6/5/2005,Afghanistan,Charcheno,1,0,1,A civilian is kidnapped and murdered by the Taliban.
2710,6/5/2005,Afghanistan,Andar,2,0,2,Two civilians are killed in their car by Sunni extremists.
2711,6/5/2005,Thailand,Pattani,2,0,2,"Two people, including a health care worker, are murdered by Islamists in separate attacks."
2712,7/5/2005,Thailand,Yala,1,0,1,Radical Muslims kill a man as he is leaving his school.
2713,7/5/2005,Iraq,Baghdad,22,36,58,Suicidal Sunnis target a civilian convoy at a busy intersection.  Twenty-two are killed in the blast and dozens lay injured in the circle of mutilated bodies.
2714,7/5/2005,Yemen,Sanaa,0,5,5,Five solider are injured when Yemeni fundamentalists throw a grenade at them from a passing car.
2715,7/5/2005,Lebanon,Jounieh,2,28,30,Two people are killed by a bomb set in a commercial district of a Christian town.
2716,8/5/2005,India,Kuligam-Lalpora,1,2,3,A 12-year-old girl is killed by a bomb that also injures her father and sister.
2717,8/5/2005,Afghanistan,Kabul,2,6,8,A suicide bomber in a cafe kills two civilians and injures six in a horrific blast.
2718,9/5/2005,Iraq,Baghdad,4,8,12,"A grisly scene as a suicidal Sunni rams his car into two police vehicles, burning the occupants to death."
2719,9/5/2005,India,Chakka,3,0,3,"The Mujahideen open fire on civilians exiting a mosque, killing three and injuring an unknown number."
2720,9/5/2005,Thailand,Narathiwat,1,0,1,A health care worker is murdered by Islamists.
2721,10/5/2005,Dagestan,Makhachkala,2,4,6,Two people are killed when Muslim extremists bomb a police station.
2722,10/5/2005,Thailand,Yala,1,0,1,A postal worker is murdered by Islamists.
2723,10/5/2005,Thailand,Pattani,2,0,2,A teacher and medical worker are shot to death by Muslim terrorists in separate attacks.
2724,10/5/2005,Algeria,Boghni,1,1,2,"Fundamentalists open fire on policemen manning a checkpoint, killing one."
2725,10/5/2005,Iraq,Baghdad,7,16,23,Seven civilians are blasted and burned to death by Fedayeen suicide car bomber on a busy street.
2726,11/5/2005,India,Srinagar,1,40,41,The Al-Nasreen terrorist group claims responsibility for a powerful car bombing at a busy intersection.
2727,11/5/2005,Iraq,Baghdad,4,14,18,Three separate Jihad attacks leave four dead and fourteen injured.
2728,11/5/2005,Iraq,Tikrit,27,75,102,A suicide car bomber swerves his vehicle into a crowd of people on a sidewalk.  At least Twenty-seven are killed in the explosion.
2729,11/5/2005,Iraq,Hawija,30,37,67,"A Fedayeen straps explosives to his chest then wades into a group of unemployed civilians waiting to apply for government jobs.  At least thirty are blown to bits, with another forty suffering injuries."
2730,11/5/2005,Afghanistan,Shindand,3,2,5,Three police officers are killed in a bombing by Sunni extremists.
2731,11/5/2005,Thailand,Pattani,1,0,1,Radical Muslims gun down a cop in front of his home.
2732,12/5/2005,Thailand,Narathiwat,1,0,1,A civilian is shot and killed by Islamic terrorists.
2733,12/5/2005,India,Srinagar,2,46,48,"The Mujahideen target a school with grenades, killing two women and injuring about fifty others, including eleven children."
2734,12/5/2005,Iraq,Baghdad,17,65,82,"Jihad terrorists detonate a car bomb outside a market and a cinema, killing seventeen people and injuring nearly seventy, some with severe burns and internal injuries."
2735,13/5/2005,Iraq,Baqubah,3,6,9,"Fedayeen suicide bomber plows into a troop transport, killing two Iraqi soldiers and one civilian."
2736,13/5/2005,India,Sangdan,1,0,1,A government teacher is dragged out of a high school class and shot to death on the sidewalk by the Mujahideen.
2737,13/5/2005,Chechnya,Ishkhoi-Yurt,2,3,5,Islamists kill two policemen in an ambush.  Three others are injured.
2738,13/5/2005,Iraq,Baiji,5,0,5,Car bomb kills five Iraqis.
2739,14/5/2005,Iraq,Baghdad,4,10,14,Civilians are victimized by another suicidal car bomber looking for a ticket to paradise.
2740,14/5/2005,India,Kalakote,4,1,5,The Mujahideen murder a father and his three sons as they are returning from their work in a coal mine.
2741,14/5/2005,Iraq,Jurf al-Sakhar,3,0,3,Three beheaded corpses are found with signs of torture.
2742,14/5/2005,India,Srinagar,1,0,1,A businessman is gunned down by Muslim militants.
2743,15/5/2005,Iraq,Iskandariya,34,0,34,"The bodies of thirty-four people, some in handcuffs, are found dumped in three locations.  Jihadis tortured and beheaded many of them."
2744,15/5/2005,Iraq,Baqubah,5,20,25,"Two suicide bombers, one in a car the other following on foot, attempt an assassination.  Five innocents are blown apart - another twenty badly injured."
2745,15/5/2005,Thailand,Narathiwat,1,5,6,"After burning down in elementary school in Yala, Muslim extremists bomb a government vehicle, killing one Thai and injuring five others."
2746,15/5/2005,Iraq,Latifiya,6,0,6,"Three Kuwaiti TV journalists, two Iraqi assistants and their driver are forced off the road by Jihadis then forced to kneel as their throats are cut."
2747,15/5/2005,Algeria,Khenchela,11,0,11,All eleven members of a water supply convoy are blown up or machine-gunned by the Salafist Group for Preaching and Combat.
2748,16/5/2005,Thailand,Narathiwat,1,0,1,A civilian is shot off his motorcycle by Islamic gunmen.
2749,16/5/2005,Indonesia,Maluku,6,0,6,"Five policemen and a civilian are killed by Islamic militants in Indonesia, as they were sleeping.  The militants accused them of protecting a Christian village."
2750,16/5/2005,Iraq,Baghdad,3,0,3,Three blindfolded and bound bodies are found.  Some were shot multiple times.
2751,16/5/2005,Iraq,Aalgaya,2,2,4,Muslim gunmen shoot a policeman and his wife to death in their car.  The attack also left their two young children badly injured.
2752,17/5/2005,Iraq,Dujail,6,0,6,Six Iraqi truck drivers are pulled from their cabs and killed by radical Sunnis.
2753,17/5/2005,India,Lohardaga,4,3,7,"Seven family members, including women are asleep in their home when militant Muslims barge in and slit the throats of four of them while beating the rest."
2754,17/5/2005,India,Srinagar,2,17,19,"The Mujahideen attacks a funeral of a man they murdered, killing two additional mourners and injuring seventeen."
2755,17/5/2005,Algeria,Lakhdaria,3,5,8,"Members of an al-Qaeda linked group ambush an Algerian patrol, killing three and wounding five."
2756,18/5/2005,Chechnya,Staryye Atagi,1,0,1,A cop is gunned down by Jihadis.
2757,18/5/2005,Thailand,Narathiwat,1,0,1,Muslim separatists kill a defense volunteer.
2758,18/5/2005,Afghanistan,Helmand,5,0,5,A gruesome scene as an attack on a humanitarian project leaves five people dead.
2759,18/5/2005,Afghanistan,Kabul,1,0,1,Religious fundamentalists kill a 24-year-old woman in her home.  She had been a pop music personality.
2760,19/5/2005,Iraq,Mosul,7,3,10,"Fedayeen gunmen attack the house of a Sunni politician, killing seven people inside the home."
2761,19/5/2005,Afghanistan,Zabul,6,0,6,Taliban gunmen ambush and kill six humanitarian aid workers transporting the bodies from those killed in an attack the day before.
2762,19/5/2005,Iraq,Samarrah,2,0,2,"In a brutal attack, Sunni gunmen kill a policeman and his elderly father as they are riding in a car."
2763,19/5/2005,Iraq,Baghdad,1,8,9,Suicide bomber kills an Iraqi soldier at a checkpoint.  Eight others are injured.
2764,20/5/2005,India,Mogla,4,0,4,"The Mujahideen ambush a security patrol from behind bushes, killing four Indian soldiers."
2765,20/5/2005,Iraq,Baghdad,2,3,5,Two civilians are killed by a suicide bomber.  Three others are injured.
2766,20/5/2005,Dagestan,Makhachkala,2,2,4,Gema’at Sharia assassinate a government official with a powerful bomb that also kills his driver and injures two children playing nearby.
2767,22/5/2005,Thailand,Pattani,2,0,2,Two municipal workers are murdered by Islamists.
2768,22/5/2005,Iraq,Baghdad,2,3,5,"Sunni radicals spray a car with automatic weapons fire, killing a top official and his driver."
2769,23/5/2005,India,Kashmir,3,3,6,"In a series of overnight attacks, the Mujahideen hang a woman and shoot two other innocents to death."
2770,23/5/2005,Iraq,Tal Afar,35,25,60,Two suicidal religious extremists murder more than thirty people outside the house of a community leader with twin bombings.
2771,23/5/2005,Iraq,Mahmoudiya,7,22,29,A suicidal Sunni tries to drive his explosives-packed car into a mosque.  Seven are killed and more than thirty hurt.  Five killed are family members.
2772,23/5/2005,Iraq,Baghdad,10,82,92,"Muslim extremists detonate a car bomb outside a Shiite restaurant, killing seven and injuring more then eighty.  Many have serious injuries."
2773,24/5/2005,Iraq,Baghdad,6,8,14,Car bombing outside a girl's school kills six and injures eight.
2774,25/5/2005,Pakistan,Makin,6,0,6,"A woman, her two sons and three daughters, are killed by a bomb planted in their home."
2775,25/5/2005,Thailand,Pattani,1,2,3,"Muslim terrorists fire on a group of firefighters and police officers, killing one person."
2776,25/5/2005,Chechnya,Nizhny Gerzel,1,0,1,A cop is gunned down by Jihadis.
2777,26/5/2005,Philippines,Zamboanga,3,13,16,Three civilians are killed when suspected Muslim terrorists throw two hand grenades into a village.
2778,26/5/2005,Iraq,Baghdad,5,0,5,"Jihadis attack and kill a university professor, along with three of his bodyguards.  They also knife a Shiite to death elsewhere."
2779,26/5/2005,Iraq,Baghdad,3,6,9,Suicidal extremist kills three Iraqis and injures six with bombs hidden in a taxi.
2780,27/5/2005,Nigeria,Sokoto,1,14,15,"Nigerian Sunnis attack a Shia political office, killing one and injuring fourteen."
2781,27/5/2005,Philippines,Sulu,2,3,5,"Abu Sayyaf militants trigger a landmine against a vehicle on a water run, killing two soldiers and inuring three others."
2782,27/5/2005,Pakistan,Islamabad,19,41,60,A suicide bomber blows himself up amid a crowd of mostly Shia worshippers at a Pakistani shrine.  At least nineteen are killed and dozens injured.
2783,27/5/2005,Iraq,Tikrit,2,24,26,"Two civilians are killed and at least two dozen others injured, some badly, in a terrorist bombing."
2784,27/5/2005,Thailand,Yala,2,0,2,Thai Muslims kill two men in separate attacks.
2785,27/5/2005,Thailand,Pattani,1,0,1,Muslims gun down a man in front of his wife and children.
2786,27/5/2005,Algeria,Ain Defla,1,0,1,Salafist Group for Preaching and Combat kill a security patrol member with a bomb.
2787,28/5/2005,Algeria,Batna,1,0,1,"Islamic fundamentalists murder a shepherd, then burn his body."
2788,28/5/2005,Iraq,Sinjar,5,45,50,Two religious extremists kill five other people and injure at least forty more in coordinated suicide bombings.
2789,28/5/2005,Indonesia,Sulawesi,24,54,78,A priest and an infant are among the nearly two dozen Christians killed when Islamic militants detonate two bombs in the center of a village.  At least sixty others are injured.
2790,28/5/2005,Iraq,Baghdad,1,0,1,Islamists stab a 44-year-old Japanese hostage to death on videotape.
2791,29/5/2005,Afghanistan,Kandahar,1,0,1,"The Taliban stage a bold assassination on an opposition cleric, as he is leaving his office."
2792,29/5/2005,Pakistan,Kani Wam,3,2,5,al-Qaeda suspected in ambush on Pakistani official's car that leaves three dead.
2793,29/5/2005,Iraq,al-Madyen,2,8,10,A suicide car bomber kills two Iraqis and injures eight on his way to Paradise.
2794,29/5/2005,Iraq,Tuz,2,9,11,Jihadis kill two civilians with a car bomb outside a school.  Nine others are injured.
2795,29/5/2005,Iraq,Mosul,8,0,8,"Eight civilians, including children, are blown to bits by Islamic terrorists."
2796,29/5/2005,India,Anantnag,0,44,44,Forty-four people are injured in twins blasts set by Hizb-ul-Mujahideen.  One went off near a post office.
2797,30/5/2005,Afghanistan,Arghandab,4,7,11,Four officers are killed in an assault on their station by religious extremists.
2798,30/5/2005,Thailand,Pattani,1,0,1,A Buddhist teacher is murdered by Islamic radicals.
2799,30/5/2005,Iraq,Baghdad,27,118,145,"Two Fedayeen suicide bombers kill twenty-seven Iraqis.  The first waded into a crowd before detonating.  The second ran after the survivors, killing many of them as well."
2800,31/5/2005,Pakistan,Karachi,6,0,6,"A mob of angry Shias take out their frustration at Sunnis on Kentucky Fried Chicken employees, killing six, including four who were burned alive."
2801,31/5/2005,Pakistan,Karachi,5,26,31,A suicide bombing attack at a Shia mosque kills five people and injures twenty-six.
2802,31/5/2005,Algeria,Boumerdes,2,5,7,"The Salafist Group for Preaching and Combat ambushes a security patrol, killing two and injuring five."
2803,31/5/2005,Chechnya,Grozny,1,0,1,A civilian is blown apart in his car by a Jihad landmine.
2804,31/5/2005,Thailand,Yala,1,0,1,A man is killed in his motorcycle shop by Muslim radicals.
2805,31/5/2005,Thailand,Narathiwat,1,0,1,A trader is murdered by Islamists.
2806,1/6/2005,Thailand,Narathiwat,1,0,1,A government official is murdered by Islamists.
2807,1/6/2005,Thailand,Yala,1,0,1,A man is murdered by Muslims while inspecting a school.
2808,1/6/2005,Afghanistan,Kandahar,21,42,63,"An al-Qaeda member wades into a crowd of mourners at a funeral for a murdered anti-Taliban cleric, killing about two dozen people and hurting dozens more."
2809,1/6/2005,Afghanistan,Lashkargah,2,5,7,The Taliban kill two mine-detection crewmen in a remote-controlled blast.
2810,2/6/2005,Iraq,Baghdad,9,0,9,"Muslim militants fire into a crowded market from three passing cars, murdering at least nine civilians."
2811,2/6/2005,Iraq,Mosul,5,13,18,"Jihadis detonate bombs on two motorcycles parked outside a cafe, killing five Iraqis."
2812,2/6/2005,Lebanon,Beirut,1,1,2,Car bombing in a Christian area of the city takes the life of a journalist who opposed Syrian hegemony.
2813,2/6/2005,Iraq,Baqubah,4,4,8,Four Iraqis killed in a blast by a suicidal Sunni.
2814,2/6/2005,Iraq,Kirkuk,4,11,15,A convoy of civilian contractors is targeted by a Fedayeen suicide bomber who paves his way to Paradise with at least four dead bodies.
2815,2/6/2005,Iraq,Tuz Khormato,12,40,52,"Suicidal religious extremist plows his car into a restaurant and detonates a blast that leaves at least twelve people dead, including children, and forty others maimed."
2816,2/6/2005,India,Harwan,4,1,5,The Mujahideen abduct and later behead four members of two families.
2817,2/6/2005,Iraq,Mosul,5,0,5,"Thinking that they were a Christian family, Jihad gunmen spray the inside of a car with weapons fire, killing two parents and their three young children."
2818,3/6/2005,Thailand,Pattani,1,0,1,A teacher is murdered by Islamic radicals.
2819,3/6/2005,Afghanistan,Tirin Kot,1,1,2,"The Taliban invade the home of a civic educator, beat up his elderly father, then execute him."
2820,3/6/2005,Afghanistan,Kandahar,5,5,10,"Five separate attacks by the Taliban, leave five people dead and at least five others injured."
2821,3/6/2005,Iraq,Balad,10,12,22,Ten Iraqis are slaughtered by a suicidal religious fanatic in a car bombing.  Twelve more are injured.
2822,4/6/2005,Mauritania,Limgheiti,15,19,34,al-Qaeda militants attack and kill fifteen Mauritanian soldiers in a remote area.  Nineteen others are injured.
2823,4/6/2005,Algeria,Aomar,1,0,1,Islamic fundamentalists assassinate a deputy mayor.
2824,5/6/2005,Thailand,Pattani,1,0,1,A man is murdered by Muslim radicals while leaving his tea shop.
2825,5/6/2005,Thailand,Narathiwat,2,0,2,A man and his brother are shot to death in their shop by Muslim terrorists.
2826,5/6/2005,India,Bandipore,2,0,2,The Mujahideen abduct and kill two civilians.
2827,5/6/2005,Iraq,Shorgat,1,3,4,An Iraqi soldier is killed by a suicide bomber on a motorcycle.
2828,6/6/2005,Thailand,Narathiwat,1,0,1,A 59-year-old Buddhist plantation worker is captured and beheaded by militant Muslims.
2829,7/6/2005,Afghanistan,Gilan,1,0,1,A teacher is murdered by fundamentalists.
2830,7/6/2005,India,Bahk-e-Hakar,1,0,1,A civilian is abducted from his home and beheaded by the Mujahideen.
2831,7/6/2005,Israel,Ganei Tal,3,0,3,"Islamic Jihad bomb an Israeli greenhouse, killing three, including a Chinese worker."
2832,7/6/2005,Algeria,M'sila,13,6,19,Militants fighting for an Islamic state kill thirteen soldiers in a bombing attack on their truck.
2833,7/6/2005,Afghanistan,Spin Boldak,2,0,2,Two Pakistani truck drivers are murdered by the Taliban.
2834,7/6/2005,Iraq,Hawija,18,38,56,Militant Sunnis kill eighteen Iraqi civilians in a series of four suicide bombings and other attacks.
2835,7/6/2005,Iraq,Habaniyah,7,0,7,The 'Army of Ansar al-Sunna' ambushes a civilian truck convoy and slaughters seven drivers.
2836,9/6/2005,Thailand,Yala,1,0,1,A Buddhist teenager is shot in the head by Muslim separatists.
2837,9/6/2005,Iraq,Qaim,17,0,17,The bodies of seventeen Iraqi Shiites are discovered bound and executed.  Some were beheaded.
2838,9/6/2005,Syria,Damascus,1,1,2,Two Syrian security force personnel are shot by religious extremists as they are attempting an arrest.
2839,9/6/2005,Chechnya,Tver,7,1,8,Seven Chechen police officers are killed when Mujahideen rebels fire a grenade launcher at their car.
2840,9/6/2005,Iraq,Kirkuk,2,0,2,Two Iraqis are killed in a Jihad attack on their vehicle.
2841,10/6/2005,Iraq,Basra,2,0,2,A policeman and his brother are shot to death by Jihadis while riding in their car.
2842,10/6/2005,Thailand,Narathiwat,2,0,2,"Two separate shooting attacks by Muslim militants leave two, including a Buddhist, dead."
2843,11/6/2005,Thailand,Narathiwat,1,0,1,Muslims murder a 49-year-old Buddhist construction worker on his way to work.
2844,11/6/2005,Iraq,Baghdad,10,0,10,"Ten people are slaughtered by a Sunni bomb in a Shia neighborhood, including a pregnant woman and her husband."
2845,11/6/2005,Iraq,Najaf,2,3,5,"A bomb planted in a Shia cemetery kills two people, including an 8-year-old girl, and injures three others, all from the same family."
2846,11/6/2005,Iraq,Diyara,11,2,13,"Jihad gunmen open fire on a bus carrying construction laborers, killing eleven in the brutal attack and injuring two."
2847,12/6/2005,Russia,Uzunova,0,15,15,Fifteen people are injured when a bomb believed to be planted by Chechen terrorists derails a commuter train
2848,12/6/2005,Iraq,Baghdad,3,4,7,"Three people are killed, and at least four injured in two separate suicide blasts."
2849,12/6/2005,Afghanistan,Kandahar,1,4,5,The Taliban kill a woman with a landmine.  The blast injures her two children and two other women.
2850,12/6/2005,Iran,Ahvaz,8,74,82,Four women are among eight dead in a series of bomb blasts.
2851,13/6/2005,Algeria,Khadirat El Nukta,4,6,10,"Armed fundamentalists stage a shooting attack on a group of people, killing at least four."
2852,13/6/2005,India,Pulwama,13,100,113,"At least thirteen people are slaughtered, and over one hundred injured when the Mujahideen set off a truck bomb near a school.  Many schoolchildren are among the casualties."
2853,13/6/2005,Thailand,Pattani,1,1,2,Two Buddhist twin brothers are shot by Islamic terrorists as they are riding home from school.  One dies.
2854,13/6/2005,Thailand,Narathiwat,1,3,4,"Islamic radicals plant a bomb in a garbage truck, killing one of the workers and injuring several more."
2855,14/6/2005,Iraq,Baqubah,6,4,10,"Suicide bomber kills six Iraqis, including two children and injures four others."
2856,14/6/2005,Iraq,Kirkuk,19,89,108,"A Fedayeen suicide bomber wades into a crowd of people shopping in a market and kills nineteen, including children, and injures about ninety others in an egregious and senseless attack."
2857,14/6/2005,Afghanistan,Khost,7,0,7,Taliban extremists walk into a medical clinic and gun down a doctor and seven hospital workers in cold blood.
2858,15/6/2005,Thailand,Pattani,4,0,4,Four people are murdered in three shooting attacks by Islamic radicals.
2859,15/6/2005,Afghanistan,Kandahar,1,0,1,A man is cut to pieces by Taliban bullets.
2860,15/6/2005,India,Chaklas,2,0,2,"The Mujahideen assassinate a veterinarian and also set fire to another civilian's house, killing his 8-month-old daughter in the flames."
2861,15/6/2005,Iraq,Khalis,23,28,51,A particularly heinous suicide bombing attack on Iraqi soldiers eating lunch at their base leaves twenty-three dead and about thirty injured.
2862,15/6/2005,Iraq,Baghdad,4,29,33,"A suicide bomber detonates near a market, murdering four Iraqis and injuring twenty-nine others."
2863,16/6/2005,India,Awantipora,0,15,15,"Fifteen people, including a child and two women are injured by the splinters of a grenade thrown by the Mujahideen on a road."
2864,16/6/2005,Thailand,Narathiwat,2,3,5,Three separate attacks in the same Thai province by militant Muslims leave two dead and three injured.
2865,16/6/2005,Iraq,Mosul,2,0,2,"Ansar al-Sunna terrorists shoot an Iraqi judge to death, along with his driver."
2866,17/6/2005,Egypt,Sinai,1,3,4,Islamic extremists gun down a cop.
2867,17/6/2005,Russia,Astrakhan,2,1,3,"Islamic gunmen are thought responsible for an attack on a hospital, in which two patients were shot to death in their beds."
2868,17/6/2005,Thailand,Pattani,2,0,2,A Laotian man and wife are beheaded on the chicken farm where they work.
2869,17/6/2005,Thailand,Narathiwat,1,0,1,A policeman is murdered by Islamists.
2870,17/6/2005,Thailand,Yala,1,0,1,A school guard is beaten to death by radical Muslims.
2871,17/6/2005,Iraq,Fallujah,14,8,22,Fourteen Iraqis die when a suicide bomber detonates an explosives laden car on a street corner.
2872,18/6/2005,Saudi Arabia,Makkah,1,0,1,Senior Saudi official is gunned down by Islamists outside his home.
2873,18/6/2005,Iraq,Baghdad,3,0,3,"A 10-year-old girl is killed by a bomb and two bodies are found, brutally executed."
2874,19/6/2005,Iran,Mashad,2,0,2,Two gay teenagers are hanged.
2875,19/6/2005,Israel,Gaza,1,2,3,"The Palestinian terrorist group, Abu Rish Brigade, takes credit for an ambush on a civilian labor group that leaves an Israeli guard dead."
2876,19/6/2005,Iraq,Baghdad,23,36,59,A suicidal religious extremist walks into a restaurant and blows up twenty-three innocent people.  Another thirty-six patrons are injured.
2877,19/6/2005,Iraq,Tikrit,3,9,12,Fedayeen suicide bomber kills three Iraqis.
2878,19/6/2005,Iraq,Iskandariya,3,7,10,"Sunni terrorists open fire on shoppers at a marketplace, killing three and injuring seven."
2879,19/6/2005,Afghanistan,Nad Ali,3,0,3,"The Taliban machine-gun a car with three people, including a judge."
2880,19/6/2005,India,Dachan,1,1,2,"The Mujahideen fire into a civilian's home, killing his 14-year-old daughter and injuring his wife."
2881,20/6/2005,Thailand,Pattani,3,0,3,Islamic militants invade a home and shoot three young volunteer teachers to death.
2882,20/6/2005,India,Watalar,1,0,1,Two Harkat-ul-Mujahideen terrorists assassinate a local political figure.
2883,20/6/2005,Israel,Baqa al-Sharqiya,1,1,2,Palestinian snipers kill an Israeli civilian traveling in his car.  His 13-year-old son is shot as well.
2884,20/6/2005,Iraq,Ebril,19,118,137,"Three car bombs, at least one by a suicidal ""holy warrior,"" kill eighteen people, mostly Kurds, and injure over one-hundred."
2885,21/6/2005,Afghanistan,Kandahar,1,0,1,A civilian is killed in an ambush by Taliban gunmen.
2886,21/6/2005,Afghanistan,Maiwand,1,1,2,Taliban terrorists kill the husband of an election worker.
2887,21/6/2005,Lebanon,Beirut,1,1,2,An anti-Syria political leader is assassinated by a car bomb in Lebanon.
2888,22/6/2005,Thailand,Narathiwat,0,7,7,"A bomb set off by Muslim extremists injures seven, including two monks and three elderly people."
2889,22/6/2005,Thailand,Narathiwat,1,0,1,Muslim extremists behead a 34-year-old cloth vendor.  The head is found 2km away.
2890,22/6/2005,Iraq,Baghdad,18,46,64,Eighteen Shiite civilians are slaughtered in three separate bombing attacks by radical Sunnis.  About fifty are injured.
2891,22/6/2005,India,Bijbehara,0,17,17,"About seventeen people, including two teenage boys are injured when the Mujahideen toss a grenade onto a road."
2892,22/6/2005,India,Nadihal,2,0,2,The Mujahideen abduct and kill two civilians by slashing their throats.
2893,22/6/2005,Algeria,Skikda,1,2,3,A civilian is killed when Islamists put a bomb under his vehicle.
2894,23/6/2005,Algeria,Azzefoun,1,5,6,"The Salafist Group for Preaching and Combat bombs a police convoy, killing one officer."
2895,23/6/2005,Iraq,Fallujah,4,13,17,"A senseless attack on a U.S. Marine mail convoy kills four, including three women."
2896,23/6/2005,Iraq,Baghdad,17,60,77,Four more car bombs aimed at Shia civilians kill fifteen and injure over fifty in residential neighborhoods.
2897,23/6/2005,Pakistan,Karachi,2,1,3,Two Sunni clerics are assassinated in an attack that leaves a boy injured.
2898,23/6/2005,Pakistan,South Waziristan,4,0,4,Probable al-Qaeda ambush on a delivery truck leaves four people dead.
2899,24/6/2005,Iraq,Ramadi,13,10,23,"Eight policemen are captured at a checkpoint by Jihadis, then executed.  Two separate attacks elsewhere leave five others dead."
2900,24/6/2005,Afghanistan,Chora,3,0,3,The Taliban murder an election candidate and two of his bodyguards.
2901,24/6/2005,Thailand,Yala,2,0,2,"A man and his wife stop to remove a tree branch from the road, when they are attacked by militant Muslims, who then cut off their heads."
2902,24/6/2005,India,Srinagar,9,25,34,Nine people are killed when Islamic militants detonate a powerful car bomb at a popular tourist attraction.
2903,24/6/2005,Chechnya,Shali-Makhety,1,0,1,A man is killed by a Muslim sniper.
2904,24/6/2005,Thailand,Narathiwat,1,0,1,A female school principal is murdered by Islamic gunmen.
2905,25/6/2005,Thailand,Yala,2,0,2,"Two civilians, including a rubber worker, are murdered by Muslims in separate attacks."
2906,25/6/2005,India,Behibagh,1,0,1,A female schoolteacher is killed by the Mujahideen.
2907,25/6/2005,Iraq,Mosul,5,2,7,"Suicide bomber blows himself to Allah, taking five innocents with him."
2908,25/6/2005,Iraq,Samarrah,9,16,25,"Suicide bomber slams into a residential neighborhood, killing nine civilians and injuring sixteen."
2909,25/6/2005,Iraq,Baghdad,5,7,12,"Sunni insurgents mortar bomb a crowded Shia cafe, killing five civilians and injuring seven."
2910,25/6/2005,Israel,Beit Hagai,2,3,5,"A brutal shooting attack a point-blank range on a group of Israeli teenagers, hitchhiking on a roadside, leaves a 17-year-old and a 16-year-old dead.  Three others were injured.  al-Aqsa Martyrs Brigade take credit for the murder."
2911,26/6/2005,Iraq,Mosul,36,19,55,Four bombings by suicidal Fedayeen in disguised vehicles leave three dozen people dead and dozens more injured.
2912,26/6/2005,India,Dachabpore,1,0,1,"The Mujahideen abduct a civilian from his home, take him to an orchard and kill him in brutal fashion."
2913,27/6/2005,Iraq,Baghdad,3,0,3,"Islamic fundamentalists attack a barbershop, killing two, including a 9-year-old boy, then blow up the building."
2914,27/6/2005,India,Kupwara,1,0,1,"The Mujahideen abduct a woman from her home, torture then murder her."
2915,27/6/2005,Ingushetia,Karabulak,1,0,1,Sunni extremists murder an engineer.
2916,28/6/2005,Thailand,Narathiwat,1,0,1,A chicken vendor is murdered by Islamists.
2917,28/6/2005,Iraq,Tal Afar,4,21,25,"Four people, including a child, lose their lives in a Jihad mortar attack."
2918,28/6/2005,Thailand,Pattani,2,0,2,A janitor and a poultry trader are murdered in separate attacks by Islamic militants on motorcycles.
2919,28/6/2005,Thailand,Yala,1,0,1,Islamic militants shoot a government worker to death as he is walking along the side of the road.
2920,28/6/2005,Iraq,Kirkuk,3,0,3,Sunni terrorists kill three oil company workers with a roadside bomb.
2921,28/6/2005,Iraq,Baghdad,4,24,28,"Four civilians are killed, and dozens injured when fundamentalists detonate a car bomb outside a theater."
2922,28/6/2005,Iraq,Musayyib,3,13,16,"A suicide bomber enters a hospital then detonates his explosives, killing three other people."
2923,28/6/2005,Iraq,Baghdad,5,0,5,"An 87-year-old Iraqi politician and four others, including his son, are killed by a Fedayeen suicide bomber."
2924,28/6/2005,India,Bhaderwah,4,0,4,Four security personnel are killed by Muslim militants in a shootout.
2925,29/6/2005,India,Srinagar,0,14,14,Fourteen people are injured when the Mujahideen toss a grenade into a city street.
2926,29/6/2005,Israel,Mount Dov,1,3,4,"Hezbollah attacks an Israeli position from across the Lebanese border, killing one and injuring three."
2927,29/6/2005,Thailand,Narathiwat,2,0,2,Two people are murdered in separate attacks by radical Muslims.
2928,29/6/2005,Thailand,Pattani,1,0,1,A city councilman is killed by Muslim assassins.
2929,30/6/2005,Saudi Arabia,Mecca,1,0,1,A security specialist is murdered by al-Qaeda as he is leaving work.
2930,30/6/2005,Thailand,Yala,1,0,1,A civilian is murdered by Islamists as he is leaving a market.
2931,30/6/2005,India,Kallar Kattal,1,0,1,A man is attacked in his home and beaten to death by militant Muslims.
2932,30/6/2005,Iraq,Baghdad,7,0,7,Muslim gunmen burst into an optician's shop and kill seven people in cold blood - four from the same family.
2933,30/6/2005,India,Mahakund,4,0,4,"The Mujahideen kill a 20-year-old girl on the night before her wedding, along with her mother and a neighbor.  A civilian is also abducted from his home and killed in the same district."
2934,30/6/2005,Afghanistan,Tirin Kot,9,1,10,"Nine village elders are kidnapped and killed by the Taliban, along with a 10-year-old boy."
2935,1/7/2005,India,Kashmir,3,0,3,"Three civilians are abducted from their homes and executed by the Mujahideen, including a 65-year-old man."
2936,1/7/2005,Iraq,Baghdad,1,0,1,A Shiite cleric is gunned down in cold blood by Sunnis in a drive-by attack.
2937,2/7/2005,Thailand,Pattani,1,0,1,A farmer is gunned down my Islamic radicals.
2938,2/7/2005,Thailand,Pattani,2,0,2,Two Buddhist villagers are murdered by Muslim terrorists while drinking tea.
2939,2/7/2005,Thailand,Pattani,1,1,2,"Muslims fire on a policeman and his wife, killing the man."
2940,2/7/2005,Dagestan,Makhachkala,11,23,34,Russian troops and civilians are casualties in a radio-controlled bomb attack outside a bathhouse blamed on Islamic militants.
2941,2/7/2005,Afghanistan,Paktika,6,2,8,"The Taliban attack a UN convoy with a roadside bomb, killing six Afghan security personnel."
2942,2/7/2005,Iraq,Mahmudiyah,2,0,2,A bomb hidden in a vegetable cart targets a Shia funeral procession.
2943,2/7/2005,Iraq,Hilla,6,26,32,Two Sunni suicide bombers kill at least six people and injured dozens more in a Shia neighborhood.
2944,2/7/2005,Iraq,Baghdad,16,22,38,A suicidal Muslim bomber kills sixteen other people outside a police station.  About two dozen others are injured in the blast.
2945,3/7/2005,Afghanistan,Kandahar,1,0,1,Pro-democracy cleric is killed by a Taliban sniper his home.
2946,3/7/2005,Syria,Damascus,2,0,2,"Two Syrian border patrol personnel are killed an Islamic extremist, near Lebanon."
2947,4/7/2005,Afghanistan,Registan,2,0,2,Two Afghan policemen are kidnapped and executed by the Taliban.
2948,4/7/2005,Thailand,Yala,1,0,1,A civilian is murdered by Muslim jihadists.
2949,4/7/2005,Dagestan,Makhachkala,2,2,4,Two policemen are killed by an insurgent bombing.
2950,4/7/2005,India,Dadsara,1,0,1,The Mujahideen abduct then shoot a civilian to death.
2951,4/7/2005,Iraq,Baghdad,2,1,3,"Sunni insurgents kill a painting contractor, and kidnap, torture and behead another man."
2952,4/7/2005,Iraq,Baghdad,2,4,6,"A remote-controlled bomb kills two civilians, including a woman."
2953,4/7/2005,India,Wagbal Karhama,1,0,1,A youth is abducted and hanged by the Mujahideen.
2954,4/7/2005,Iraq,Fallujah,3,9,12,"Three civilians are blown to bits, and nine others badly injured by a Fedayeen suicide bombing on a busy road."
2955,4/7/2005,Afghanistan,Bande Sardeh,1,2,3,A suicide bomber on a bicycle kills a Turkish engineer and injures two others.
2956,5/7/2005,Dagestan,Makhachkala,2,0,2,"A prominent politician is assassinated, along with his uncle, by suspected Islamists as they sit in their car at a light."
2957,5/7/2005,India,Pulwama,2,1,3,"In two separate home invasions, the Mujahideen shoot two people to death and critically injure the wife of one."
2958,5/7/2005,Thailand,Pattani,1,0,1,A 44-year-old security force member is abducted and beheaded by Islamists.
2959,5/7/2005,Iraq,Baghdad,3,0,3,Islamic extremists shoot three barbers to death for shaving beards.
2960,6/7/2005,Dagestan,Makhachkala,1,3,4,"Islamic militants open fire on a group of policemen, killing one."
2961,6/7/2005,Thailand,Narathiwat,1,0,1,A newspaper deliveryman is murdered by Muslim radicals.
2962,6/7/2005,Thailand,Pattani,1,0,1,A teacher is murdered by Islamists.
2963,6/7/2005,Algeria,Tizi Ouzou,4,0,4,Fundamentalists slit the throats of three Algerian soldiers and a civilian.
2964,6/7/2005,India,Budgam,1,0,1,The Mujahideen kidnap a student from his classroom and subsequently shoot him to death.
2965,6/7/2005,Algeria,Skikda,1,13,14,"Islamic fundamentalists bomb a convoy, killing one Algerian solider and injuring thirteen others."
2966,6/7/2005,Thailand,Narathiwat,1,0,1,Muslims on motorcycles shoot a 52-year-old in the neck and hand as he is riding to market.
2967,6/7/2005,Iraq,Jbala,13,30,43,Thirteen civilians are slaughtered in twin suicide bombings by Muslim extremists.  About thirty others are injured.
2968,7/7/2005,Iraq,Baghdad,1,0,1,"al-Qaeda Organization for Holy War pronounces ""Allah's judgment"" and kills a kidnapped Egyptian diplomat on video."
2969,7/7/2005,Afghanistan,Helmand,10,0,10,Ten Afghan police officers are captured by the Taliban and senselessly beheaded.
2970,7/7/2005,England,London,52,750,802,Islamic terrorists massacre more than fifty commuters on three separate subway trains and a double-decker bus on the street with four suicide bombs.  Over seven-hundred people are injured.
2971,7/7/2005,Iraq,Mosul,5,52,57,Five people at a market are killed when Sunni terrorists lob more than a dozen mortar rounds into the square.
2972,7/7/2005,Afghanistan,Spin Boldak,3,0,3,"Religious extremists blow up a passing vehicle, killing three civilians."
2973,8/7/2005,Thailand,Narathiwat,1,0,1,"Islamists fire on utility workers trimming trees, killing one."
2974,8/7/2005,Afghanistan,Paktika,2,0,2,A man and his wife are murdered inside their home by Sunni extremists.
2975,8/7/2005,India,Rajouri,4,0,4,Four Indian soldiers are ambushed and killed by Islamic militants.
2976,9/7/2005,Algeria,Tezi Ozo,4,0,4,"A group of thirty Islamists set-up a fake roadblock, then slaughter four Algerians that are fooled into stopping."
2977,9/7/2005,Pakistan,Karachi,1,0,1,A Shia cleric is gunned down on a street by Pakistani Sunnis.
2978,9/7/2005,Iraq,Baghdad,8,0,8,A family of eight Shia is gruesomely murdered by Sunni radicals as they sleep in their home.
2979,10/7/2005,Iraq,Kirkuk,4,15,19,"Suicidal Sunni kills four civilians on a highway, near a hospital.  Fifteen are injured in the blast."
2980,10/7/2005,Iraq,Baghdad,25,47,72,"A al-Qaeda suicide bomber blows himself to Allah, taking twenty-five innocents with him.  Nearly fifty others are injured."
2981,10/7/2005,Iraq,Syrian Border,7,0,7,Two Islamic suicide bombers kill seven customs agents.
2982,10/7/2005,Afghanistan,Darreh-ye Nur,2,0,2,The Taliban murder two civilians in an incendiary attack on their vehicle.
2983,10/7/2005,Thailand,Narathiwat,1,0,1,A man is murdered in his grocery story by Islamic radicals.
2984,11/7/2005,Thailand,Yala,2,0,2,Two village guards are killed in separate terror attacks.
2985,11/7/2005,Somalia,Mogadishu,1,0,1,al-Qaeda assassinates a Somali peace activist outside his home.
2986,12/7/2005,Israel,Netanya,5,70,75,"The terror group, Islamic Jihad, takes credit for a suicide bombing, in which a bomber kills five Jews crossing the street in front of a mall.  All of the victims were female, two were teenage girls.  About seventy others were injured."
2987,12/7/2005,Iraq,Kirkuk,3,15,18,"Sunnis detonate a car bomb in an industrial district, killing three civilians and injuring fifteen more."
2988,12/7/2005,Thailand,Pattani,4,0,4,Four civilians are murdered in separate attacks by Muslim radicals.
2989,12/7/2005,Algeria,Ahnif,2,0,2,Two community guards are killed in separate attacks by Islamic fundamentalists (Jijel).
2990,12/7/2005,Lebanon,Beyrouth,1,12,13,"Muslim terrorists target a Christian politician with a bomb, but kill a civilian instead."
2991,13/7/2005,Afghanistan,Safian,1,0,1,A civilian is shot to death by Sunni extremists.
2992,13/7/2005,Iraq,Jalawlah,2,16,18,A suicide bomber kills two others inside a Sunni mosque.
2993,13/7/2005,Iraq,Baghdad,27,25,52,"An Islamic suicide bomber deliberately plows his car into a group of children, slaughtering at least twenty-seven.  Children were amply represented among the injured."
2994,13/7/2005,Pakistan,Jhal Magsi,3,3,6,"Three children, including two brothers, are killed by a homemade bomb."
2995,13/7/2005,India,Bigambri,1,0,1,"The Mujahideen abduct a civilian, then kill him in captivity."
2996,14/7/2005,Thailand,Yala,2,21,23,"Islamic militants set off four bombs in restaurants and other business areas, killing at least two people."
2997,14/7/2005,Israel,Netiv Haasara,1,1,2,"Palestinian terrorists hit an Israeli residence with a missile, killing a woman."
2998,15/7/2005,Thailand,Narathiwat,1,0,1,A metal-shop owner is shot to death in a tea shop by Islamists.
2999,15/7/2005,Thailand,Pattani,2,0,2,"Two civilians, including a taxi driver, are murdered by Islamic terrorists."
3000,15/7/2005,Afghanistan,Kandahar,7,0,7,Seven cops are brutally slain in a surprise attack by religious extremists.
3001,15/7/2005,Thailand,Narathiwat,2,0,2,Two female teachers are gunned down by Muslims on motorcycles as they are walking home.
3002,15/7/2005,Iraq,Baghdad,27,100,127,Seven suicide bombers take at least twenty-seven innocents with them to Allah.  About one hundred others suffer injuries; many lose limbs.
3003,16/7/2005,India,Baramulla,2,0,2,"The Mujahideen shoot a man to death outside his home, and also stage a separate attack that kills a 6-year-old girl."
3004,16/7/2005,Iraq,Basra,3,2,5,Muslim terrorists kill three British soldiers with a roadside bomb.
3005,16/7/2005,Iraq,Musayyib,71,160,231,"A religious extremist with explosives wrapped around his chest, detonates himself in a crowded city street, killing over seventy other people.  Nearly two-hundred others are injured in the horrific attack."
3006,16/7/2005,Thailand,Narathiwat,2,0,2,"Muslim separatists attack a school, killing two security guards."
3007,17/7/2005,Iraq,Baghdad,22,21,43,Four Fedayeen kill twenty-two people in separate suicide bombings.
3008,18/7/2005,Afghanistan,Kamdish,1,0,1,Taliban extremists murder an electoral worker.
3009,18/7/2005,Afghanistan,Uruzgan,9,0,9,Nine villagers are slaughtered in a Taliban raid.
3010,18/7/2005,Pakistan,Chilas Farm,5,15,20,Five passengers aboard a bus are killed when the Mujahideen ambush it along a mountain road.  Fifteen others are injured.
3011,18/7/2005,Pakistan,Quetta,1,1,2,"A Shia schoolteacher is gunned down, and his wife critically injured."
3012,18/7/2005,Pakistan,Karachi,1,1,2,"A Sunni cleric is attacked in his car by Shia on motorcycles, who manage to kill his son."
3013,18/7/2005,Iraq,Baghdad,7,0,7,Islamic insurgents murder six policemen and a government worker in six separate shooting attacks.
3014,18/7/2005,India,Arwani,1,1,2,The Mujahideen shoot a man to death outside his shop.
3015,18/7/2005,Thailand,Yala,3,1,4,"In three separate attacks, Muslims behead a farmer and shoot at least two other people to death, including a school principal."
3016,19/7/2005,Ethiopia,Jigjiga,1,0,1,Islamic militants stop a bus and force the Christians on it to repeat a Muslim creed and pray to Mecca.  The one who refuses to do so is shot to death.
3017,19/7/2005,India,Chitabas,6,0,6,"The Hizbul Mujahideen enter a residence and slaughter six members of a family, in a heinous attack."
3018,19/7/2005,Chechnya,Znamenskoye,14,36,50,"Fourteen people, including civilians, are killed in a Jihad attack by Muslim separatists on a remote road."
3019,19/7/2005,Iraq,Baqubah,13,0,13,"Jihadis stage a shooting attack on a minivan carrying civilians, killing thirteen in all."
3020,20/7/2005,Pakistan,Gilgit,3,0,3,Three people are gunned down in sectarian attacks.
3021,20/7/2005,Iraq,Baghdad,10,21,31,A suicidal Sunni murders ten people near an airport and causes egregious injuries to at least a dozen others.
3022,20/7/2005,India,Srinagar,6,17,23,"Hizbul Mujahideen suicide bomber targets a missionary children's school in the Indian capital, killing at least six and injuring more than a dozen."
3023,20/7/2005,Iraq,Hilla,4,4,8,"Two Jihad car bombings kill four and injure four, including a young girl."
3024,21/7/2005,Afghanistan,Kajran,15,0,15,Fifteen innocents are attacked and killed by Taliban extremists in a three-day spree.
3025,21/7/2005,Thailand,Narathiwat,2,0,2,Two civilians are brutally murdered in separate attacks.
3026,21/7/2005,Iraq,Mahmudiyah,5,8,13,A religious extremist kills himself and five innocents in a blast at a traffic checkpoint.
3027,21/7/2005,India,Sopore,2,2,4,Two civilians are killed when the Mujahideen attack a security camp.
3028,21/7/2005,Afghanistan,Helmand,2,0,2,The Taliban ambush a vehicle carrying two people.  Both are killed in the explosion.
3029,21/7/2005,India,Anantnag,1,2,3,"Militant Muslims fire on a bus stop, killing a civilian and injuring two others."
3030,22/7/2005,Iraq,Baghdad,12,5,17,"Four Jihad attacks leave twelve Iraqis dead, including a senseless ambush on a wedding party that left the bride and her mother dead."
3031,22/7/2005,Pakistan,South Waziristan,4,0,4,"al-Qaeda suspected in shooting deaths of a tribal leader, his two sons and brother."
3032,22/7/2005,Thailand,Pattani,2,0,2,Islamic terrorists kill two people in a shooting ambush.
3033,23/7/2005,Chechnya,Shelkovskaya,1,0,1,A forest director is killed in his home by Jihad gunmen.
3034,23/7/2005,Thailand,Pattani,1,0,1,A Buddhist student is gunned down by Islamic extremists.
3035,23/7/2005,Israel,Kissufim,2,5,7,"Palestinian gunmen murder an Israeli husband and wife.  They also open fire on medical rescue workers, injuring five of them."
3036,23/7/2005,Egypt,Sharm el-Sheik,88,119,207,More than eighty tourists and workers are killed when Islamic militants detonate three powerful car bombs outside a cafe and two hotels.  One suicide bomber drove into the lobby.  Over one-hundred people suffer injuries.
3037,23/7/2005,Thailand,Narathiwat,1,0,1,Islamic militants shoot a 58-year-old village leader twice in the head as he is riding with his wife.
3038,23/7/2005,Lebanon,Beirut,0,12,12,Twelve people are injured by a car bomb placed in a Christian neighborhood.
3039,23/7/2005,Afghanistan,Kandahar,1,0,1,The Taliban assassinate a judge as he is walking to work.
3040,24/7/2005,Iraq,Baghdad,22,30,52,"A horrific scene as a Fedayeen suicide bomber kills twenty-two people, mostly civilians in a crowded area near sidewalk cafes."
3041,24/7/2005,Dagestan,Makhachkala,1,4,5,Muslim terrorists put a bomb beneath a passenger train that kills one and injures four commuters.
3042,25/7/2005,Thailand,Pattani,1,0,1,Islamists behead the son of a police officer.
3043,25/7/2005,Iraq,Baghdad,12,16,28,A Fedayeen suicide bomber drives his car in front of a hotel and slaughters a dozen people.  Sixteen others are injured.
3044,26/7/2005,Chechnya,Dargo,1,3,4,"Muslim terrorists ambush a security patrol, killing one and injuring three."
3045,26/7/2005,Iraq,Basra,3,0,3,"In two separate attacks (one in Tikrit) Jihadis kill three innocents, including a child and a truck driver."
3046,26/7/2005,Iraq,Hilla,3,0,3,Three policemen are killed when terrorists fire a rocket at point-blank range.
3047,26/7/2005,Iraq,Baghdad,16,27,43,Sunni gunmen massacre sixteen Shia civilians with an automatic weapons attack on their vehicles.  Over two dozen are inured with gunshot wounds.
3048,26/7/2005,India,Mahore,1,0,1,Hizb-ul-Mujahideen members invade a home and murder a civilian.
3049,26/7/2005,Afghanistan,Kandahar,2,0,2,The Taliban kill a police chief and one other with a rocket attack on their car.
3050,26/7/2005,Ethiopia,Jigjiga,5,30,35,"A Muslim separatist group, the ONLF, kills five people, including a child, in two grenade attacks against civilian targets."
3051,26/7/2005,Thailand,Narathiwat,2,0,2,Two civilians are killed in their motorcycle shop.
3052,26/7/2005,Thailand,Narathiwat,1,0,1,A school principal is murdered by Islamic radicals.
3053,27/7/2005,Chechnya,Grozny,1,0,1,A cop is gunned down by Jihadis.
3054,27/7/2005,Thailand,Southern Provinces,5,1,6,Five civilians are gunned down by Islamic radicals in separate attacks.
3055,27/7/2005,Iraq,Baghdad,2,0,2,al-Qaeda executes two Algerian diplomats that were abducted several days earlier.
3056,28/7/2005,India,Sokar,3,0,3,"A 5-year-old girl, her mother and grandmother are slaughtered in a home invasion by the Mujahideen."
3057,28/7/2005,Thailand,Narathiwat,1,0,1,Islamic terrorists kill a man as he is buying candy for his children.
3058,29/7/2005,Chechnya,Grozny,1,1,2,A cop is gunned down by Jihadis.
3059,29/7/2005,Afghanistan,Gizab,7,0,7,The Taliban ambush and slaughter seven people.
3060,29/7/2005,Bangladesh,Boalmari,2,0,2,"Two Christian charity workers are hacked to death inside their home by hardline Islamic militants, who chained the doors shut to prevent their escape or rescue."
3061,29/7/2005,Thailand,Pattani,1,3,4,A village leader is gunned down and three others suffer injuries in a separate attack in Narathiwat.
3062,29/7/2005,Algeria,Boumerdes,2,4,6,The Salafist Group for Preaching and Combat kill two Algerian police officers in an ambush.
3063,29/7/2005,Iraq,Rabiah,52,35,87,"A suicidal religious extremist wanders into a crowd of people and detonates explosives strapped to his body, killing over fifty people."
3064,29/7/2005,India,Kupwara,2,0,2,"The Mujahideen invade a home to kill the wife of a police officer, along with his young nephew."
3065,29/7/2005,India,Rajouri,6,0,6,"Muslims line up five Hindu villagers and then slit their throats.  Elsewhere in the same district, they murder a woman with an axe."
3066,29/7/2005,India,Doda,2,0,2,Islamists kill two policemen in an ambush.
3067,30/7/2005,India,Srinagar,2,25,27,The Mujahideen stage an attack on a hotel that claims the lives of two security personnel and injures about twenty-five others.
3068,30/7/2005,Iraq,Baghdad,6,26,32,A Fedayeen suicide bomber kills six Iraqis near a theatre.  Twenty-six others are injured.
3069,30/7/2005,Afghanistan,Charchino,3,0,3,A district governor and his two bodyguards are assassinated by the Taliban in a roadside attack.
3070,30/7/2005,Iraq,Basra,2,2,4,A bomb attack on the British Embassy convoy leaves two security guards dead and two children injured.
3071,30/7/2005,Iraq,Baghdad,3,0,3,"Police find the bodies of three airport workers, bound and tortured by the Jihadis.  Their throats were cut."
3072,31/7/2005,India,Badarkot,1,0,1,A civilian is shot to death inside his own home by militant Muslims.
3073,31/7/2005,Iraq,Haswa,7,12,19,Seven civilians are killed by a Jihad car bombing.
3074,1/8/2005,Afghanistan,Gresk,2,0,2,Religious extremists gun down a policeman and his young daughter.
3075,2/8/2005,Thailand,Narathiwat,2,4,6,Muslim assailants kill two people in separate attacks.
3076,2/8/2005,Iraq,Shu'la,7,0,7,"Shia gunmen kill a Sunni cleric and his brother, then gun down a vehicle carrying five mourners on their way to view the bodies."
3077,2/8/2005,Iraq,Baghdad,4,24,28,An Islamic suicide bomber kills four civilians and injures two dozen.
3078,2/8/2005,India,Pulwama,1,0,1,The Mujahideen kill a man who is working his paddy fields.
3079,2/8/2005,India,Nandyali,1,0,1,A woman is shot to death by the Mujahideen inside her home.
3080,2/8/2005,Afghanistan,Nuristan,8,0,8,The Taliban kill eight police in an attack on their checkpoint.
3081,3/8/2005,Israel,Sderot,1,9,10,"Palestinian terrorists fire a rocket at a group of Israeli demonstrators.  The missile hits their own group instead, killing a 3-year-old boy and injuring nine others, including five children."
3082,3/8/2005,Iraq,Basra,1,1,2,Shia gunmen abduct and execute an American journalist.  They also cause severe injury to his female interpreter.
3083,3/8/2005,Thailand,Yala,1,0,1,A civilian is murdered by armed Muslims.
3084,4/8/2005,Thailand,Narathiwat,1,0,1,Muslim terrorists murder a school bus driver.
3085,4/8/2005,Thailand,Narathiwat,2,0,2,A married couple is murdered in their orchard by Islamists.
3086,4/8/2005,Indonesia,Poso,2,0,2,Two witnesses who testified against the Islamic bombers behind a massacre of Christians at a market are themselves assassinated.
3087,4/8/2005,Iraq,Baqubah,7,0,7,A Fedayeen suicide bomber kills four Iraqis and injures an unknown number of others.
3088,4/8/2005,Iraq,Doloyah,2,0,2,Jihadis shoot two engineers to death for working at a U.S. base.
3089,4/8/2005,Pakistan,Miranshah,5,0,5,al-Qaeda militants kill five Pakistani soldiers with a landmine.
3090,4/8/2005,Afghanistan,Lashkargah,1,0,1,The Taliban kill an election worker in an attack from a motorcycle.
3091,5/8/2005,Iraq,Dora,1,5,6,"Jihadis open fire on a line of cars at a gas station, killing one civilian."
3092,5/8/2005,Iraq,Mosul,4,0,4,The bodies of four civilians surface in Mosul with signs of torture.
3093,5/8/2005,Iraq,Baqubah,3,0,3,"Muslim fanatics invade the home of an Iraqi soldier and kill his wife, 12-year-old daughter and 6-year-old son in their beds."
3094,6/8/2005,Pakistan,Koti Ashro,1,2,3,al-Qaeda suspected in the attack on a highway police checkpoint that leaves an officer dead.
3095,6/8/2005,India,Doda,1,4,5,"The Mujahideen throw a grenade at a hostel, killing a pregnant woman."
3096,6/8/2005,Afghanistan,Mizan,1,2,3,The Taliban murder a civilian and kidnap two others.
3097,6/8/2005,Thailand,Yala,1,0,1,A man is murdered by Muslim terrorists as he leaves a tea shop.
3098,7/8/2005,Thailand,Narathiwat,1,0,1,A man is shot to death by Muslims at a tea shop.
3099,7/8/2005,Iraq,Baghdad,10,4,14,"In six separate attacks, Jihadi gunmen kill ten Iraqis."
3100,7/8/2005,Iraq,Tikrit,2,10,12,"Suicide bomber blows himself to Allah, taking two Iraqis with him.  Ten others are injured."
3101,7/8/2005,India,Thatharaka,1,1,2,"The Mujahideen invade two residences, killing one civilian and severely injuring another."
3102,8/8/2005,Iraq,al-Sharqat,7,3,10,"Seven civilians, including three children are murdered when Islamic terrorists bomb a minibus."
3103,8/8/2005,Chechnya,Grozny,1,2,3,"Militant Muslims spray a car with automatic weapons fire, killing the parent of a young child, who was also severely injured in the attack."
3104,8/8/2005,Afghanistan,Ghanzi,2,0,2,"The Taliban murder a doctor, on the grounds that he was planning to run for public office.  Another villager is killed as well."
3105,8/8/2005,India,Batalik,3,0,3,Three young girls are killed by a Mujahideen bomb.
3106,8/8/2005,India,Awantipora,2,0,2,Two civilians are killed in a bomb blast outside a shop.
3107,8/8/2005,Thailand,Yala,1,0,1,A tractor mechanic is murdered by Muslim terrorists.
3108,8/8/2005,Philippines,Basilan,1,0,1,A cop is gunned down by Sunni terrorists.
3109,9/8/2005,Chechnya,Kurdyukovskaya,1,1,2,A policeman is murdered in an attack by Islamic terrorists.
3110,9/8/2005,Thailand,Narathiwat,2,0,2,"Two civilians, including a school janitor, are murdered separately by Islamic terrorists."
3111,9/8/2005,Thailand,Yala,1,0,1,A civilian is murdered by Islamists.
3112,9/8/2005,Pakistan,Lahore,1,0,1,A Catholic layman is abducted and strangled to death by Islamic fundamentalists.
3113,9/8/2005,Iraq,Baiji,4,5,9,"In a senseless attack, terrorists use a roadside bomb and small arms fire to kill four Americans trying to clear landmines."
3114,9/8/2005,India,Thanna Mandi,1,0,1,A shepherd is beaten to death by the Mujahideen.
3115,9/8/2005,Iraq,Baghdad,21,41,62,"At least six separate Jihad attacks, mostly on civilians, leave over twenty Iraqis dead and more than twice as many injured."
3116,10/8/2005,Iraq,Ghazaliya,6,14,20,"A suicidal Sunni detonates a car bomb near a group of police, killing at least six, including four civilians.  Fourteen suffer injury."
3117,10/8/2005,Iraq,Baiji,2,0,2,Two oil pipeline security guards are shot to death by Islamic terrorists.
3118,10/8/2005,Iraq,Baghdad,2,1,3,Jihadis kill a 12-year-old girl's mother and pharmacist father in an attack that also leaves her injured.
3119,10/8/2005,Afghanistan,Bakurzai,1,0,1,"The Taliban drag a poor, illiterate woman from her house and shoot her to death."
3120,10/8/2005,Philippines,Zamboanga,0,26,26,Abu Sayyaf behind two bombs that injure twenty-six near a parked van and at a restaurant.
3121,10/8/2005,Pakistan,Taza Ghondai,4,1,5,al-Qaeda targets and kills four civilians with a landmine.
3122,10/8/2005,India,Bandipore,1,0,1,The Mujahideen abduct and later kill a police officer.
3123,10/8/2005,Pakistan,Quetta,2,0,2,Muslim extremists kill two Shia civilians in separate motorcycle attacks.
3124,10/8/2005,Thailand,Yala,1,0,1,A school guard is murdered by Muslim terrorists on his way to work.
3125,10/8/2005,Thailand,Narathiwat,1,0,1,A rubber plantation owner is murdered by Islamists.
3126,11/8/2005,Afghanistan,Zabol,2,0,2,Two civilians are beheaded by Islamic extremists.
3127,11/8/2005,Pakistan,Lahore,1,0,1,"Islamic radicals kidnap, torture and kill a Catholic layman."
3128,11/8/2005,Algeria,Skikda,3,4,7,Muslim extremists kill three community guards and injure four others.
3129,11/8/2005,India,Kawani,1,0,1,An employee of an irrigation works project is abducted and killed by the Mujahideen.
3130,12/8/2005,Iraq,Najaf,4,19,23,Three children are among four civilians killed by a bomb planted by radical Muslims near a mosque.
3131,12/8/2005,India,Kulhand,2,0,2,The Hizb-ul-Mujahideen attack a village and shoot two teenage boys to death.
3132,12/8/2005,Afghanistan,Kandahar,1,6,7,"A bomb explodes at a women's market, killing a young child."
3133,13/8/2005,India,Shajroo,5,9,14,"Muslim militants attack a Hindu village in the middle of the night, killing five people in their homes, including three Hindu teenagers, and injuring at least nine others."
3134,13/8/2005,Thailand,Pattani,0,2,2,A man and his 13-year-old son are critically wounded by Muslim gunmen.
3135,13/8/2005,Thailand,Narathiwat,2,0,2,Two civilians are shot to death by Islamists.
3136,14/8/2005,Iraq,Baghdad,18,15,33,Various sectarian attacks leave eighteen dead.
3137,14/8/2005,Thailand,Narathiwat,2,2,4,"In three separate attacks, Muslim gunmen shoot two Buddhist men at point-blank range as they are drinking tea.  They also shoot a 40-year-old woman by the side of the road and hack another woman with a machete while she is working her garden."
3138,14/8/2005,Chechnya,Roshnichu,5,2,7,Four investigators are killed by Islamic terrorists on their way to probe another murder that took place earlier in the day.
3139,14/8/2005,Pakistan,Sialkot,5,0,5,Five family members lose their lives in an 'honor killing.'
3140,14/8/2005,Iraq,al-Mahawil,2,5,7,An Islamic suicide bomber kills two civilians and injures five others.
3141,15/8/2005,Chechnya,Grozny,2,11,13,"Muslims target a restaurant with a car bomb, killing a woman and a 12-year-old boy."
3142,15/8/2005,Iraq,Uwarige,30,0,30,"The mass grave of thirty people, including two women, is uncovered.  The Fedayeen tortured the victims before executing them."
3143,15/8/2005,Iraq,Dura,1,0,1,'Holy Warriors' kidnap a Christian woman and then cut off her head.
3144,17/8/2005,India,Qazigund,1,9,10,"An Indian guard is killed, and nine other people are injured by a Mujahideen car bombing in a residential area."
3145,17/8/2005,Iraq,Hawija,6,0,6,Six Iraqi recruits are pulled from a bus by Sunni radicals and shot to death execution-style.
3146,17/8/2005,Afghanistan,Kandahar,1,11,12,"One person is killed, and eleven others injured by a Taliban bus bomb."
3147,17/8/2005,Bangladesh,Dhaka,2,115,117,"The Jumatul Mujahedin take credit for hundreds of synchronized blasts that kill two, including a 40-year-old rickshaw puller.  Over one-hundred others are injured."
3148,17/8/2005,Iraq,Baghdad,43,89,132,Jihadis murder over forty people in three separate car bombings that also leave about one-hundred injured.  Most of the victims were simply waiting at a bus stop or seeking medical treatment at a hospital when they were targeted.
3149,17/8/2005,Algeria,Mozaya,3,0,3,Three civilians are killed when Islamic fundamentalists attack their village.
3150,18/8/2005,Chechnya,Grozny,1,0,1,A police officer is abducted and brutally slain by the Mujahideen.
3151,18/8/2005,Iraq,Baghdad,2,0,2,Jihadis murder a judge and his driver.
3152,18/8/2005,Thailand,Narathiwat,2,2,4,A teacher and a policeman are shot dead by Muslim militants in separate attacks.
3153,18/8/2005,India,Kashmir,4,0,4,"In four separate attacks, the Mujahideen kill four civilians, including a 75-year-old man and a 16-year-old boy."
3154,19/8/2005,Iraq,Mosul,3,0,3,"Jihadi gunmen abduct three Sunni political workers that were hanging posters urging people to vote.  They are later made to stand against a wall, where they are executed."
3155,19/8/2005,Jordan,Aqaba,1,1,2,A Jordanian soldier is killed by an al-Qaeda rocket attack at a seaport.
3156,19/8/2005,Algeria,Kechida,6,0,6,"In a gruesome attack, Islamic fundamentalists knife six hikers to death, including a woman."
3157,19/8/2005,India,Gogaldara,1,0,1,A man is gunned down in cold blood by the Mujahideen.
3158,20/8/2005,Dagestan,Makhachkala,3,1,4,Islamic Jamaat claims responsibility for a bombing that killed three policemen walking past a grove of trees.
3159,21/8/2005,Ingushetia,Nazran,1,2,3,A 48-year-old passerby is killed by Islamic militants in a remote-controlled bombing.
3160,21/8/2005,India,Salbala,1,0,1,Jaish-e-Mohammed terrorists kidnap and kill a civilian.
3161,21/8/2005,Afghanistan,Daychopan,4,3,7,The Taliban kill four members of a medical rescue team.
3162,21/8/2005,Iraq,Fallujah,4,5,9,A terrorist bomb kills four Iraqis and injures five.
3163,21/8/2005,Thailand,Pattani,8,15,23,"Islamic separatists kill eight people, mostly civilians, in five separate attacks across the southern Thai provinces using bombs and bullets."
3164,21/8/2005,Afghanistan,Panjawyi,2,0,2,Sunni extremists kill two scholars.
3165,22/8/2005,Ingushetia,Nazran,2,3,5,Muslims place a bomb near a gas pipeline.  Two civilians are killed in the explosion.
3166,22/8/2005,Thailand,Narathiwat,1,0,1,A power company employee is murdered by Islamic radicals.
3167,22/8/2005,Iraq,Baghdad,8,0,8,"In four separate attacks across the country radical Sunnis kill eight, including a married couple in their car, the owner of a food shop and his son, and two truck drivers."
3168,22/8/2005,Iraq,Tarmiyah,8,3,11,"Jihad gunmen spray a police van with bullets, killing eight and injuring three.  Casualties include civilians."
3169,22/8/2005,India,Koteranka,5,0,5,Hizb-ul-Mujahideen kill three family members inside their home.  Two other civilians are abducted and killed in separate incidents in Kashmir.
3170,22/8/2005,Iraq,Baghdad,2,6,8,Two children are killed in a bombing by Islamic terrorists.  Six others are injured.
3171,23/8/2005,Iraq,Baqubah,7,19,26,An al-Qaeda suicide bomber on foot slaughters seven people and injures about twenty others.
3172,23/8/2005,Thailand,Yala,1,0,1,A tour operator is murdered by Islamists.
3173,23/8/2005,Thailand,Narathiwat,1,3,4,Muslim gunmen kill a man in his pickup truck.
3174,24/8/2005,Thailand,Pattani,1,0,1,A man is shot to death by Muslim terrorists while drinking tea with friends.
3175,24/8/2005,Thailand,Narathiwat,2,0,2,A teacher and a school guard are shot to death by Muslim radicals.
3176,24/8/2005,Iraq,Baghdad,9,35,44,"In at least four separate attacks, nine people are killed by Jihadis and over thirty injured."
3177,24/8/2005,India,Srinagar,0,7,7,Seven people are injured when an Islamic militant throws a grenade into the street.
3178,25/8/2005,Israel,Jerusalem,1,1,2,"A Palestinian stabs two young ultra-orthodox Jews on the street, killing one of them and leaving the other badly injured."
3179,25/8/2005,Iraq,Oraida,36,0,36,The bodies of thirty-six men in civilian clothes are found dumped in a remote area.  They were handcuffed and executed.
3180,25/8/2005,Iraq,Abu Saida,6,15,21,"Six civilians, mostly elderly men, are murdered in a cafe by militant Muslim gunmen, who enter at breakfast to gun down the victims."
3181,25/8/2005,Indonesia,Ambon,0,7,7,A bomb set by Muslim radicals in a Christian sector of town injures seven people.
3182,25/8/2005,India,Thanna Mandi,2,1,3,"A man and his son are shot to death by the Mujahideen, while another family is injured in the attack."
3183,25/8/2005,Egypt,Sinai,2,2,4,"Islamic extremists attack a police patrol with an IED, killing two members."
3184,25/8/2005,Afghanistan,Lashkar Gah,2,0,2,A map-maker and a merchant are slaughtered by Taliban extremists.
3185,25/8/2005,Thailand,Narathiwat,1,0,1,A cattle farmer is murdered by Islamists.
3186,26/8/2005,Thailand,Narathiwat,1,0,1,Muslim militants murder a man on his way home.
3187,26/8/2005,Thailand,Yala,1,1,2,Muslims shoot and kill a Buddhist man and also shoot his paralyzed father as the two were watching TV.
3188,26/8/2005,Ingushetia,Nazran,1,3,4,An assassination attempt by Islamic militants injures a prime minister and kills his bodyguard.
3189,26/8/2005,India,Kashmir,4,18,22,Several separate attacks across Kashmir by Muslim terrorists leave four civilians dead and more than a dozen people injured.
3190,27/8/2005,Egypt,Halal,2,0,2,"Two Egyptians are killed in the Sinai, when Islamic radicals detonate a landmine under their car."
3191,27/8/2005,Afghanistan,Uruzgan,1,0,1,A political candidate is murdered by the Taliban.
3192,27/8/2005,Kosovo,Urosevac-Skopje,2,2,4,Two Christians are killed and two wounded when Muslim gunmen attack their car.
3193,27/8/2005,Iraq,Mosul,3,0,3,"Three members of a Sunni political party are kidnapped and later killed in front of a mosque by men calling them ""non-Muslims."""
3194,27/8/2005,Pakistan,Shawal,2,1,3,Islamic militants kill two Pakistani soldiers with a bomb.
3195,27/8/2005,Iraq,Mosul,1,0,1,A Christian is gunned down by Muslim militants.
3196,27/8/2005,Thailand,Yala,1,0,1,A defense volunteer is killed by Muslim gunmen.
3197,28/8/2005,Thailand,Yala,1,0,1,An art teacher is murdered by Islamic fundamentalists.
3198,28/8/2005,Thailand,Narathiwat,1,0,1,A former religious teacher is killed by Islamists.
3199,28/8/2005,Kosovo,Strpce,2,0,2,Two Serbian men are shot and killed in a terror attack.
3200,28/8/2005,Israel,Beersheba,0,8,8,"Eight Israelis are hospitalized by a Fatah suicide bomber, including two guards that were seriously wounded."
3201,28/8/2005,Philippines,Lamitan,2,29,31,"Thirty people are injured and two people, including a child, are killed when Abu Sayyaf militants, disguised as fishermen, bomb a ferry."
3202,29/8/2005,Iraq,Mosul,3,7,10,"Islamic insurgents ""fight for freedom"" by killing a child with a missile that also injures seven other children, who are then treated by U.S. soldiers.  Elsewhere the bodies of a beheaded civilian and a policeman are found."
3203,29/8/2005,Thailand,Yala,1,0,1,A guard protecting Buddhist monks is shot to death by Muslim radicals.
3204,29/8/2005,Thailand,Narathiwat,1,0,1,A cleric is gunned down by terrorists.
3205,30/8/2005,Thailand,Narathiwat,1,0,1,A former official is killed in front of a school full of children by Muslim gunmen.
3206,30/8/2005,Thailand,Narathiwat,1,0,1,A Buddhist construction worker is murdered by Islamists.
3207,31/8/2005,India,Wusan Pattan,1,0,1,A campaign worker is shot to death by the Mujahideen.
3208,31/8/2005,Thailand,Pattani,1,1,2,"Islamic radicals spray a police checkpoint with bullets, killing an officer and severely injuring his wife."
3209,31/8/2005,Thailand,Sungai Kolok,0,15,15,Fifteen people are injured by six bombs set by Muslim militants outside a hotel.
3210,31/8/2005,Pakistan,Mastung,1,3,4,"Muslim radical detonates a bomb on a city street, killing a passerby and injuring three others."
3211,31/8/2005,Chechnya,Novoterskoye,2,0,2,Two police officers are killed in a shootout with Islamic militants planning a major terror attack in Chechnya.
3212,31/8/2005,Iraq,Baghdad,7,36,43,"Sunni radicals stage three separate attacks on Shia pilgrims, killing seven and injuring about three dozen."
3213,31/8/2005,Afghanistan,Helmand,1,0,1,A cleric is beheaded by the Taliban for participating in an election.
3214,31/8/2005,Afghanistan,Herat,3,2,5,The Taliban gun down three security officers in cold blood and kidnap a British engineer and his interpreter.
3215,31/8/2005,Thailand,Yala,1,1,2,"A rubber plantation worker is gunned down, and his wife injured by Muslim terrorists."
3216,1/9/2005,Afghanistan,Girishk,1,0,1,A moderate cleric is gunned down by Muslim extremists.
3217,1/9/2005,Thailand,Narathiwat,1,0,1,A bus driver is shot to death by Islamists while dropping kids off at school.
3218,1/9/2005,Thailand,Narathiwat,1,0,1,Militant Muslims gun down a hospital worker.
3219,1/9/2005,Thailand,Yala,1,0,1,A religious teacher is killed by terrorists on his way to school.
3220,1/9/2005,Algeria,Ammal,1,0,1,The mayor of a small town is shot and killed by Islamic fundamentalists at a fake roadblock.
3221,2/9/2005,Thailand,Yala,1,1,2,Muslims kill a 45-year-old Buddhist man as he is traveling home with his daughter.
3222,2/9/2005,Pakistan,Laddha,1,0,1,al-Qaeda militants kill a village elder.
3223,2/9/2005,India,Soundhar,3,4,7,"Lashkar-e-Toiba terrorists attack a group of civilians, killing three and injuring four.  The casualties include two women."
3224,2/9/2005,Dagestan,Makhachkala,5,11,16,"Five people, including a 7-year-old child, are killed and eleven wounded in a Jihad bombing attack."
3225,2/9/2005,Iraq,Baiji,5,9,14,Five Iraqi soldiers are killed in a terrorist bombing while on patrol.  Nine are injured.
3226,2/9/2005,Thailand,Narathiwat,1,0,1,A rubber tapper is murdered by Islamists.
3227,3/9/2005,Afghanistan,Ghowrak,5,0,5,Five people are murdered in a shooting spree by Taliban terrorists.
3228,3/9/2005,Thailand,Narathiwat,1,0,1,A civilian is murdered by Islamic radicals while on his way to pick herbs.
3229,3/9/2005,Thailand,Narathiwat,1,0,1,Militant Muslims gun down a cattle farmer.
3230,3/9/2005,Thailand,Pattani,1,0,1,"Muslim separatists shoot a civilian in his car, then burn him alive."
3231,3/9/2005,Thailand,Yala,1,0,1,"Muslim terrorists spray a grocery store with machine-gun fire, killing a Buddhist patron."
3232,3/9/2005,Afghanistan,Zabul,1,2,3,Taliban extremists murder a police officer at a checkpoint.
3233,3/9/2005,Iraq,Baqubah,16,2,18,Jihadis murder sixteen Iraqi security force personnel in three separate attacks.
3234,3/9/2005,Iraq,Zubayr,1,4,5,"Shia gunmen fire on Sunni worshippers at a mosque, killing one."
3235,3/9/2005,Iraq,Samarrah,3,11,14,"Islamic militants fire several mortars into a residential area, killing three civilians and injuring eleven."
3236,4/9/2005,Iraq,Qaim,10,0,10,"al-Qaeda takes over a small town and executes at least ten people, including a woman accused of being a prostitute."
3237,4/9/2005,Afghanistan,Helmand,5,0,5,"The Taliban execute a British hostage and also ambush a police patrol, killing four officers."
3238,4/9/2005,Philippines,Karawan,3,0,3,"Abu Sayyaf terrorists kill three unarmed, off-duty Filipino soldiers."
3239,4/9/2005,India,Bijbehara,2,0,2,The Mujahideen shoot a retired schoolteacher to death.  Elsewhere (Poshana) another civilian is abducted and killed in captivity.
3240,4/9/2005,Thailand,Pattani,1,0,1,A man is murdered by Muslim gunmen in front of his home.
3241,5/9/2005,Thailand,Narathiwat,1,0,1,A Buddhist worker delivering wood is brutally slain by Muslim terrorists.
3242,5/9/2005,Thailand,Yala,1,0,1,Muslims intrude into a villager's home and kill him.
3243,5/9/2005,Thailand,Narathiwat,1,3,4,"Islamic radicals bomb a convoy of teachers, killing a guard."
3244,5/9/2005,India,Batpora,0,16,16,Sixteen civilians are injured when a Muslim terrorist hurls a grenade into the road.
3245,5/9/2005,India,Poshana,1,0,1,A civilian is abducted and killed by Islamic militants.
3246,5/9/2005,India,Sangiot,1,0,1,An elderly woman is abducted and beheaded by the Mujahideen.
3247,5/9/2005,India,Kahi,1,0,1,Militant Muslims shoot a young woman to death approximately two months after her husband is killed.
3248,5/9/2005,India,Achar,3,0,3,Three brothers are shot to death by the Hizb-ul-Mujahideen.
3249,5/9/2005,Iraq,Hit,11,16,27,"Eleven Iraqis, mostly civilian, are killed by a 'Holy Warrior' suicide bomber on a city street."
3250,5/9/2005,Pal. Auth.,Gaza City,4,27,31,"Four people, including a woman, are killed and twenty-seven injured when a Hamas weapons lab blows up in a residential neighborhood."
3251,5/9/2005,Iraq,Balad,2,1,3,Suicide bomber kills two Iraqis.
3252,6/9/2005,Dagestan,Inchkhe,3,0,3,Islamic militants suspected in a shooting attack on a police vehicle that leaves three Russian officers dead.
3253,6/9/2005,India,Kashmir,2,1,3,Two civilians are gunned down by the Hizb-ul-Mujahideen in separate attacks.
3254,7/9/2005,Thailand,Narathiwat,1,3,4,An elderly civilian is killed in a bombing by Muslim radicals.
3255,7/9/2005,Dagestan,Khasavyurt,1,0,1,A Russian soldier is killed in an Islamic terror bombing.
3256,7/9/2005,Afghanistan,Helmand,1,2,3,"A suicide car bombing goes badly, killing three bombers but only one passerby."
3257,7/9/2005,Afghanistan,Ghazni,4,0,4,The Taliban kill four policemen guarding a road maintenance crew.
3258,7/9/2005,Iraq,Basra,16,21,37,"Muslim terrorists car bomb a take-out restaurant, killing sixteen civilians in and around the building.  Twenty-one are injured."
3259,7/9/2005,Iraq,Basra,4,0,4,Four American civilians are killed by Muslim terrorists in a roadside bombing.
3260,8/9/2005,India,Sopore,1,13,14,One civilian is killed and thirteen others injured when Muslim militants toss a grenade into a bus stop.
3261,8/9/2005,India,Doda,2,0,2,Two civilians are abducted and killed in separate attacks by the Mujahideen.
3262,8/9/2005,Pakistan,Gilgit,2,0,2,Two civilians are killed in attacks by rival Islamic groups.
3263,8/9/2005,Thailand,Narathiwat,2,0,2,Two ordinary civilians are gunned down for no apparent reason by Muslim terrorists in separate attacks.
3264,8/9/2005,Thailand,Yala,1,1,2,A Buddhist truck driver delivering rice is murdered by radical Islamic gunmen.
3265,9/9/2005,Afghanistan,Helmand,4,0,4,Four police officer are brutally murdered in their vehicle in a Taliban bombing.
3266,9/9/2005,Thailand,Narathiwat,1,0,1,A woman is murdered by Muslims while on her way to see children at a hospital.
3267,9/9/2005,India,Gandoh,1,0,1,The Mujahideen kill a Hindu as he is grazing his cattle.
3268,9/9/2005,India,Udhampur,2,0,2,Two shepherds are abducted from their field by the Mujahideen and then killed in captivity.
3269,9/9/2005,India,Dharmari,6,8,14,"Six members of three families are massacred by Muslim militants, who level continuous fire into their village.  Two women are among the dead."
3270,9/9/2005,Afghanistan,Herat,1,0,1,Taliban extremists kill the bodyguard of an election candidate.
3271,10/9/2005,Thailand,Yala,1,0,1,Muslims slash a 62-year-old Buddhist man to death while he was on his way to work.
3272,10/9/2005,India,Awantipora,5,7,12,Vicious ambush on an Indian convoy by Lashkar-e-Toiba terrorists leaves five security force personnel dead and seven injured.
3273,10/9/2005,India,Jammu,2,0,2,The Mujahideen shoot a father and son to death.
3274,10/9/2005,Thailand,Narathiwat,1,0,1,Muslim radicals nearly behead a teenage boy with a knife.
3275,10/9/2005,Thailand,Pattani,1,0,1,Islamic terrorists kill a cattle salesman.
3276,10/9/2005,Thailand,Narathiwat,1,0,1,A Buddhist construction worker is shot to death by militant Muslims.
3277,11/9/2005,Thailand,Pattani,1,0,1,A civilian is shot off the back of a motorcycle by terrorists.
3278,12/9/2005,India,Shopian,1,0,1,A civilian is abducted and murdered by the Mujahideen.
3279,12/9/2005,Pakistan,Tappi,3,0,3,Three citizens are abducted by al-Qaeda terrorists and then have their throats slit after being tortured.
3280,12/9/2005,Thailand,Pattani,1,1,2,Two Buddhist school bus drivers are ambushed by Muslim terrorists.  At least one dies from gunshot wounds.
3281,12/9/2005,Iraq,Baghdad,2,17,19,"Jihadis car bomb a restaurant, killing two people and injuring seventeen more.  Most of the victims were women."
3282,12/9/2005,Chechnya,Grozny,1,5,6,A Mujahideen remote control bomb kills one and injures five.
3283,12/9/2005,Bangladesh,Khulna,1,0,1,Islamic extremists suspected in deadly attack on a high school teacher.
3284,13/9/2005,Iraq,Mosul,1,0,1,A 21-year-old Christian woman is assaulted by Muslim radicals for wearing jeans.  She is beaten and stabbed to death.
3285,13/9/2005,Thailand,Pattani,1,0,1,A teacher is murdered by Islamic radicals.
3286,13/9/2005,Dagestan,Buinaksk,1,1,2,Coordinated attack by Muslim terrorists leaves a Russian policeman dead.
3287,13/9/2005,Algeria,Sidi Daoud,3,0,3,Three Algerian troops are killed in an ambush by the Salafi Group for Preaching and Combat.
3288,13/9/2005,Afghanistan,Zabul,1,0,1,An election official is captured and hanged by the Taliban.
3289,13/9/2005,Afghanistan,Uruzgan,7,0,7,The Taliban shoot seven civilians to death after finding election materials in their car.
3290,13/9/2005,India,Rajouri,1,3,4,"The Mujahideen invade a woman's home, take her food, then shoot her to death and seriously injure her three children."
3291,14/9/2005,Iraq,Baghdad,134,300,434,"'Holy Warrior' suicide bombers stage twelve separate attacks against Shia civilians (mostly day laborers looking for work).  About one-hundred and thirty-five are slaughtered, with over three-hundred others injured."
3292,14/9/2005,Iraq,Taji,17,0,17,"Sunni gunmen invade Shia homes in the middle of the night, pulling seventeen men out and murdering them execution style."
3293,14/9/2005,Pakistan,Quetta,1,0,1,Sunnis murder a Shia civilian.
3294,14/9/2005,Chechnya,Argun,5,3,8,"Islamic militants open fire on a group of Russian soldiers from a house, killing five."
3295,14/9/2005,Afghanistan,Tirin Kot,3,4,7,"Taliban extremists kill three civilians traveling in a car.  Four others, including a child, are badly injured."
3296,14/9/2005,Thailand,Pattani,1,0,1,A merchant is murdered by Islamists.
3297,15/9/2005,Dagestan,Kizilyurt,1,3,4,Islamic terrorists attack a police checkpoint.
3298,15/9/2005,Iraq,Mosul,1,3,4,"A terrorist bomb explodes in a Shia mosque, killing the Imam and injuring three others."
3299,15/9/2005,Thailand,Narathiwat,1,1,2,"Muslim terrorists shoot a former school teacher to death in front of his wife, who narrowly escapes with her life."
3300,15/9/2005,Thailand,Yala,1,0,1,A 40-year-old man is killed by Muslim extremists on his way to work at a rubber plantation.
3301,15/9/2005,Iraq,Karbala,3,0,3,Three Shia pilgrims on their way to a shrine are gunned down by Sunni radicals.
3302,15/9/2005,Iraq,Baghdad,23,32,55,Three Fedayeen suicide bombers kill at least twenty Iraqis and injure more than thirty more in a commercial district.  Three bodies are found elsewhere.
3303,15/9/2005,Afghanistan,Ghazni,1,2,3,An Afghan interpreter is killed by the Taliban in a roadside attack.
3304,15/9/2005,India,Tipri,2,0,2,The Mujahideen guns down two civilians in cold blood at their village.
3305,15/9/2005,Afghanistan,Helmand,1,0,1,A candidate for election is pulled from his house and executed by religious extremists.
3306,16/9/2005,Iraq,Baghdad,12,22,34,Five Jihad attacks leave about a dozen Iraqis dead and over twenty injured.
3307,16/9/2005,Iraq,Tuz,10,21,31,A suicidal Sunni kills himself and ten others outside a Shia mosque with a car bomb.  Almost two dozen others are injured.
3308,16/9/2005,Chechnya,Grozny,2,4,6,"Muslim terrorists attack a police car on the city streets, killing an officer and a civilian."
3309,16/9/2005,Lebanon,Beirut,1,22,23,A bomb placed in a Christian neighborhood kills one man and injures twenty-two other people.
3310,16/9/2005,Thailand,Narathiwat,1,0,1,A Buddhist construction worker is murdered by Muslim radicals.
3311,16/9/2005,Algeria,Ouled Attia,2,4,6,"Fundamentalists attack a security patrol, killing two members."
3312,17/9/2005,Algeria,Bordj,1,0,1,A guard at a natural gas facility is murdered by terrorists.
3313,17/9/2005,India,Surankote,1,0,1,A civilian is abducted from his village and beheaded by the Mujahideen.
3314,17/9/2005,Iraq,Baghdad,9,0,9,Sunni radicals kidnap and torture nine men before killing them execution style.
3315,17/9/2005,Iraq,Nahrawan,30,38,68,al-Qaeda murders thirty Shiites in a street bombing in an industrial area.  About forty others are injured in the blast.
3316,17/9/2005,Iraq,Mushahada,3,1,4,A Jihad ambush on an Iraqi Parliament member leaves him and two civilians dead.
3317,18/9/2005,Afghanistan,Khost,2,0,2,Two security officers are killed by the Taliban in an ambush.
3318,18/9/2005,Pakistan,Wana,1,0,1,al-Qaeda shoots a 50-year-old schoolteacher to death.
3319,18/9/2005,Iraq,Kirkuk,4,3,7,Four Iraqi security force personnel are killed by a roadside bomb planted by Jihadis.
3320,18/9/2005,Iraq,Baghdad,1,4,5,"Sunnis open fire on a group of Shia civilians, killing at least one."
3321,19/9/2005,Kabardino-Balk.,Nalchik,1,0,1,Mujahideen kill a Russian soldier in a terror attack.
3322,19/9/2005,India,Doda,2,0,2,Two civilians are killed in their homes by the Mujahideen.
3323,19/9/2005,India,Takiya Sheikhpora,1,0,1,A villager has his throat slit by the Mujahideen.
3324,19/9/2005,Algeria,Skikda,4,0,4,Islamic fundamentalists kill two civilians and two Algerian soldiers in a remote area.
3325,19/9/2005,Iraq,Basra,1,0,1,"Islamic extremists kidnap, torture, and kill a reporter for the New York Times."
3326,19/9/2005,Iraq,Karbala,10,12,22,Two suicide bombers strike Shia pilgrims as they are walking on foot to a shrine.  Ten are killed and at least a dozen injured.
3327,20/9/2005,Iraq,Baghdad,1,0,1,A transsexual is beaten and burned to death by Islamic extremists.
3328,20/9/2005,Philippines,Milaya,1,0,1,Abu Sayyaf gunmen murder a security member.
3329,20/9/2005,Iraq,Duluiyah,4,2,6,Four American contractors are murdered by Muslim radicals after their car takes a wrong turn.
3330,20/9/2005,Thailand,Tanyong Limo,2,3,5,"Militant Muslims stage a shooting attack on a tea shop, killing two men."
3331,20/9/2005,Pakistan,Shakai,2,8,10,al-Qaeda kills a tribal leader and a soldier in separate remote-controlled bomb attacks.
3332,20/9/2005,Iraq,Mosul,4,2,6,A suicidal extremist kills an American diplomat and three civilian contractors in a car bombing.
3333,20/9/2005,India,Udhampur,3,0,3,Three civilians are shot to death after the Mujahideen invade their homes.
3334,20/9/2005,Ingushetia,Karabulak,3,1,4,"Shouting 'Allah Akbar,' masked terrorists attack a group of border policemen checking passports, killing three."
3335,20/9/2005,Chechnya,Krasny Voskhod,1,3,4,An ambush by Jihadis on a police convoy leaves one officer dead.
3336,20/9/2005,Afghanistan,Sahag,2,0,2,Two civilians are killed in a roadside terror bombing by the Taliban.
3337,20/9/2005,Afghanistan,Uruzgan,3,3,6,Three policemen are killed by the Taliban while traveling home.
3338,20/9/2005,Thailand,Tanyong Limo,2,0,2,Two Thai marines are captured by Muslim villagers when their car breaks down.  The people later stab and beat the two Buddhists to death after holding them hostage for 18 hours.
3339,21/9/2005,Afghanistan,Jozjan,7,0,7,Seven musicians are slaughtered by the Taliban as they are traveling home from a wedding.
3340,21/9/2005,Thailand,Narathiwat,1,1,2,"A man is killed, and his Buddhist wife injured, by Muslim gunmen."
3341,21/9/2005,Thailand,Yala,1,1,2,"A school janitor is killed, and a female factory worker injured, in a shooting attack by religious extremists."
3342,22/9/2005,Chechnya,Oktyabrskiy,1,0,1,A cop is gunned down by Jihadis.
3343,22/9/2005,Thailand,Yala,1,0,1,A Buddhist vegetable vendor is murdered by Islamic extremists.
3344,22/9/2005,Thailand,Yala,1,0,1,A Buddhist care-taker of elephants is murdered by Islamists.
3345,22/9/2005,Thailand,Narathiwat,1,1,2,"In the second such attack in as many days, Muslims fire on a married couple, killing the husband."
3346,22/9/2005,Pakistan,Lahore,6,27,33,"Two separate bomb blasts in commercial areas by Muslim terrorists kill six, including a woman, and injure thirty."
3347,22/9/2005,Iraq,Baghdad,9,3,12,"Jihadis kill nine people in four attacks, including the owner of a tile-making factory, who is killed in his home along with his two sons and daughter-in-law."
3348,22/9/2005,Algeria,M'sila,8,4,12,"The Salafist Group for Preaching and Combat stages a terrorist attack against an Algerian army patrol, killing at least eight."
3349,22/9/2005,India,Pathan Mohalla,1,1,2,Two family members are abducted from their home by the Mujahideen.  The father is released after his son is executed.
3350,23/9/2005,Denmark,Slagelse,1,1,2,Pakistani man guns down his 19-year-old sister and injures her husband in a public honor killing in Denmark.
3351,23/9/2005,Iraq,Karbala,1,4,5,A suicide bomber succeeds in killing a small child.  Four others are wounded.
3352,23/9/2005,Pal. Auth.,Jebaliya,17,140,157,"A Hamas truck, loaded with rockets intended for Israel, explodes early, killing seventeen Palestinians (including three children) and injuring another one-hundred and forty."
3353,23/9/2005,Iraq,Baghdad,6,12,18,Suicide bomber targets a civilian passenger bus and kills six people and injures at least a dozen.
3354,23/9/2005,Thailand,Narathiwat,2,2,4,Two policemen are killed by a mobile-phone bomb triggered by Islamists.
3355,23/9/2005,Thailand,Pattani,2,0,2,"In separate attacks, a construction worker and a public health employee are gunned down by Muslim terrorists."
3356,23/9/2005,Thailand,Yala,1,0,1,Militant Muslims shoot a migrant worker to death.
3357,23/9/2005,India,Kulgam,1,0,1,Militant Muslims kill a female police officer in her home.
3358,23/9/2005,Pakistan,Gilgit,2,2,4,"Sunni terrorists open fire on a bus, killing two Shias, including a 15-year-old girl."
3359,23/9/2005,Iraq,Baghdad,4,0,4,Four Assyrian Christians are killed in a Muslim bomb attack on a Christian minister.
3360,24/9/2005,Afghanistan,Chemtal,6,0,6,Six musicians are shot to death by religious fundamentalists opposed to music.
3361,24/9/2005,Chechnya,Grozny,6,11,17,Three Mujahideen terror attacks leave six Russian servicemen dead and eleven wounded.
3362,24/9/2005,India,Gandoh,1,0,1,The mother-in-law of a police officer is killed inside her home by Islamic militants.
3363,25/9/2005,Algeria,Skikda,2,0,2,Islamic fundamentalists set up a fake roadblock to stop a civilian car and cut the throats of two occupants.  Family members are abducted.
3364,25/9/2005,Pakistan,Lahore,2,0,2,"Two more victims of the 9/22 blast die from injuries, including a 7-year-old girl."
3365,25/9/2005,India,Kalotra,1,0,1,A government lecturer is shot to death by the Mujahideen.
3366,25/9/2005,Iraq,Hilla,5,48,53,"A bomb planted on a bicycle kills a passerby outside a music store.  Elsewhere, four bodies are found bound and murdered."
3367,25/9/2005,Iraq,Mussayib,6,19,25,A Fedayeen suicide bomber on a motorcycle kills six civilians and injures about twenty others.
3368,25/9/2005,Iraq,Baghdad,9,12,21,"A horrific scene of twisted metal, charred bodies and blood, as a 'Holy Warrior' kills himself in a bombing attack that also takes the lives of nine others."
3369,26/9/2005,Thailand,Tonmaisoong,1,1,2,A 54-year-old man is killed by Muslim terrorists while sitting in a tea shop.
3370,26/9/2005,Afghanistan,Helmand,4,0,4,Taliban landmine kills all four people in a passenger car.
3371,26/9/2005,Iraq,Baghdad,6,14,20,"A suicide bomber blows himself to Allah in an attack against a bus carrying oil ministry staff workers, taking six innocents with him and leaving fourteen others critically injured."
3372,26/9/2005,Israel,Ramallah,1,0,1,"The body of an Israeli factory worker is found after he is kidnapped, tortured and killed by Hamas."
3373,26/9/2005,Iraq,Muelha,6,0,6,"In a senseless attack, nine Sunni gunmen walk into an elementary school and drag five Shia teachers and their driver out of their classrooms, put them up against a wall and execute them."
3374,26/9/2005,Chad,Madayouna,38,0,38,Thirty-eight innocent people are murdered in a Janjaweed raid.
3375,27/9/2005,Algeria,Boukhil,3,1,4,Three civilians are killed when Islamic fundamentalists blow a vehicle apart with an IED.
3376,27/9/2005,Thailand,Pattani,1,0,1,Islamic radicals gun down a school teacher.
3377,27/9/2005,India,Mendhar,1,0,1,A Lashkar-e-Toiba terrorist uses a teenage girl as a human shield in a gun battle.  Both are killed.
3378,27/9/2005,Iraq,Baqubah,9,21,30,A suicide bomber kills himself and nine innocents in the process of applying for government jobs.  Twenty-one others are injured.
3379,27/9/2005,Iraq,Kut,22,0,22,The bodies of twenty-two victims of Islamic terror are found bound and executed outside a small town.
3380,28/9/2005,India,Nasu,2,0,2,A civilian is killed in his home by Islamic militants and another (in Thom Gali) is abducted and executed.
3381,28/9/2005,India,Malad,2,1,3,Hizb-ul-Mujahideen terrorists invade a home and take a family of four hostage during a shoot-out with police.  A mother and daughter are killed.
3382,28/9/2005,Iraq,Tal Afar,6,30,36,A female suicide bomber detonates a bomb packed with metal ball bearings in a crowd waiting outside a recruitment center.  Six are killed and many hurt.
3383,28/9/2005,Afghanistan,Kabul,9,28,37,Nine Afghans are killed outside a military training center by a suicide bomber on a motorbike.  Twenty-eight others are injured in the blast.
3384,28/9/2005,Sudan,Aro Sharow,34,10,44,Thirty-four refugees are massacred by Arab militia on horseback at a camp.  Women and children are amply represented among the dead.
3385,29/9/2005,Thailand,Narathiwat,1,1,2,"A fruit vendor is shot to death by Muslims, in an attack that also injures his 8-year-old daughter."
3386,29/9/2005,Indonesia,Landangan,1,0,1,A 43-year-old Christian is shot to death.
3387,29/9/2005,Iraq,Balad,99,124,223,"About one-hundred people are massacred in three separate suicide attacks by Sunni fanatics.  Most were at a vegetable market or near a bank.  The third was near a clothing shop.  Many more are injured, most with burns - some with missing limbs."
3388,29/9/2005,Pakistan,Karim Kut,5,0,5,"al-Qaeda terrorists stage an attack on a vehicle carrying government officials, killing five."
3389,29/9/2005,Pakistan,Angoor Adda,1,0,1,A civilian has his throat slit by al-Qaeda militants.
3390,29/9/2005,India,Alal,1,0,1,Islamic militants abduct a civilian and beat him to death.
3391,29/9/2005,India,Srinagar,0,19,19,Fifteen civilians and four security personnel are injured when a Muslim militant hurls a grenade into a crowd.
3392,29/9/2005,Chechnya,Grozny,3,1,4,"Mujahideen gunmen open up on a car, killing two police officers and a 3-year-old girl.  The girl's mother suffered injury."
3393,29/9/2005,Iraq,Baghdad,4,8,12,"In two attacks, Sunni gunmen machine-gun workers at a Shia bakery as well as a van carrying soccer-stadium employees.  Four people are murdered."
3394,30/9/2005,India,Somboora,2,0,2,The Mujahideen invade a home and kill a young girl.  Another civilian is killed elsewhere (Kulgam).
3395,30/9/2005,Thailand,Narathiwat,2,0,2,Two Chinese street vendors are killed in a drive-by shooting by Islamists on motorcycles.
3396,30/9/2005,Thailand,Yala,1,5,6,"Terrorists ambush a police patrol, killing one and injuring five."
3397,30/9/2005,Iraq,Hilla,9,47,56,Nine Shia civilians are blown to bits by a morning car bomb at a vegetable market.  Nearly fifty others are injured.
3398,30/9/2005,Sudan,Darfur,29,10,39,"Janjaweed militia attack a camp for displaced persons, killing about thirty innocents."
3399,30/9/2005,Iraq,Baghdad,1,0,1,A transgender man is murdered by Islamic extremists earlier in the month.
3400,30/9/2005,Thailand,Pattani,1,0,1,A Buddhist student is murdered by Islamists as he is riding home.
3401,1/10/2005,Chechnya,Grozny,2,0,2,Two people are abducted and brutally murdered by the Mujahideen.
3402,1/10/2005,Chechnya,Shatoi,1,2,3,"Jihad rebels blow apart a troop transport, killing one soldier and injuring two others."
3403,1/10/2005,Indonesia,Bali,19,132,151,"Islamic suicide bombers murder nineteen people, mostly tourists, at two cafes and a restaurant in three coordinated attacks.  Over one-hundred are injured."
3404,2/10/2005,Bangladesh,Atkhira,2,3,5,"Militants hurl homemade bombs at a group of civilians in a fish market, killing two and injuring three."
3405,2/10/2005,Pakistan,Mir Ali,3,8,11,al-Qaeda militants kill three Pakistani security personnel in a rocket attack.
3406,2/10/2005,India,Bhalna,1,0,1,A civilian is murdered by a Harkat-ul-Jehad-i-Islami terrorist.
3407,2/10/2005,Pakistan,Zha Gundai,1,1,2,The son of a pro-government tribal leader is gunned down by al-Qaeda militants.
3408,2/10/2005,Thailand,Songkhla,2,3,5,Two bomb squad inspectors are killed in a remote-controlled explosion courtesy of Islamic terrorists.
3409,3/10/2005,Indonesia,Pantangolemba,1,0,1,A 53-year-old Christian is shot to death.
3410,3/10/2005,Bangladesh,Laxmipu,2,40,42,Members of Jamaat-ul-Mujahideen stage a series of bombing attacks that kill at least two people and injure forty.
3411,3/10/2005,Iraq,Baghdad,3,2,5,An attempted assassination of an oil minister leaves his two bodyguards dead.  A Jihad attack from the day before killed the director of public works.
3412,3/10/2005,India,Shopian,1,0,1,Terrorists abduct a civilian and murder him in captivity.
3413,4/10/2005,Iraq,Baghdad,3,6,9,Ramadan in Iraq begins with a suicide car bombing inside the Green Zone that kills three people.
3414,4/10/2005,India,Budgam,3,0,3,The Mujahideen kill two counter-insurgents in an attack and also abduct and kill a civilian in Kulgam.
3415,4/10/2005,Afghanistan,Spin Boldak,6,16,22,Six Afghans are killed by a Taliban bomb at a border crossing.  Sixteen others are injured.
3416,5/10/2005,Iraq,Hilla,36,95,131,At least three dozen Shiites are killed and nearly one-hundred others injured by a suicide bomber at a mosque during a funeral service.
3417,5/10/2005,Afghanistan,Kandahar,1,3,4,A 'Holy Warrior for Allah' manages to kill a 10-year-old boy in a suicide bombing.
3418,5/10/2005,India,Gumeri,3,0,3,Hizb-ul-Mujahideen cadres enter a residence and kill a man along with his 21-year-old daughter and 16-year-old son.  Another son had been killed last year.
3419,5/10/2005,Thailand,Yala,1,0,1,A civilian is abducted and beheaded by Muslim terrorists.
3420,6/10/2005,Thailand,Narathiwat,5,2,7,Islamic militants shoot five Thai soldiers to death as they are eating dinner at a remote outpost.
3421,6/10/2005,Pakistan,Datta Kheil,3,0,3,"al-Qaeda militants fire a rocket into a house, killing a man and his young son and daughter."
3422,6/10/2005,Iraq,Baghdad,10,8,18,Ten Iraqis riding a bus are blown to bits by a Fedayeen suicide bomber.  Eight others are badly injured.
3423,6/10/2005,Thailand,Narathiwat,1,10,11,"Two bombs are set off by Muslim terrorists at a restaurant, killing one and injuring ten."
3424,6/10/2005,Iraq,Baghdad,2,0,2,"Suicide bomber blows himself to Allah, taking two innocent women with him."
3425,6/10/2005,India,Dooru,1,5,6,"Hizb-ul-Mujahideen terrorists detonate a bomb under a bank truck, killing the driver."
3426,6/10/2005,India,Anantnag,2,0,2,Two people are taken from their homes and murdered by the Mujahideen.
3427,6/10/2005,Algeria,Messila,2,0,2,Two civilians are killed in a car bombing.
3428,7/10/2005,Chechnya,Vinogradnoye,1,0,1,A policeman is murdered in his home by Jihadis.
3429,7/10/2005,Iraq,Kirkuk,3,11,14,Jihadi car bomb kills three civilians.
3430,7/10/2005,Thailand,Yala,1,0,1,Radicals kill the driver of a police chief.
3431,7/10/2005,India,Sapore,2,6,8,A small girl is among two killed by a Mujahideen grenade blast in a terror attack.
3432,7/10/2005,Pakistan,Mong,8,19,27,Sectarian attack on a crowd of people by gunmen at a mosque for a minority Islamic group leaves eight dead and nineteen injured.
3433,7/10/2005,India,Briswana,1,0,1,A civilian is killed inside his home by the Mujahideen.
3434,8/10/2005,Iraq,Baghdad,7,16,23,Fedayeen suicide bomber murders seven people on a city street.  Sixteen others are injured in the blast.
3435,8/10/2005,Thailand,Yala,1,0,1,A rubber tapper is gunned down by Islamic extremists.
3436,8/10/2005,Thailand,Pattani,2,0,2,A Buddhist husband and wife are murdered on their way home by Islamic gunmen.
3437,9/10/2005,Thailand,Pattani,1,1,2,A woman having dinner with her son is shot to death by Muslim radicals.
3438,9/10/2005,Dagestan,Makhachkala,2,0,2,Two policemen are slain in a brutal assault by Islamic terrorists.
3439,9/10/2005,Algeria,Algiers,2,0,2,"Members of the Salafist Group for Preaching and Combat storm a coffee house, where they slit the throats of two patrons."
3440,9/10/2005,Iraq,Baghdad,13,8,21,Suicide bombings and other Sunni attacks across the country (and an incident in which a Shiite teacher was dragged out of his classroom and shot to death) leave thirteen Iraqis dead.
3441,9/10/2005,Afghanistan,Gerdiz,1,5,6,A Taliban rocket attack leaves one person dead and five injured.
3442,9/10/2005,Pakistan,Miranshah,3,0,3,al-Qaeda militants kill three Pakistani soldiers in a landmine blast.
3443,9/10/2005,Iraq,Basra,2,3,5,A suicide bomber kills a woman and a child outside an apartment building.
3444,10/10/2005,India,Qazigund,2,2,4,"A young woman is killed inside her home by Muslim terrorists.  The same group also invades a second residence, killing a teenager."
3445,10/10/2005,Afghanistan,Helmand,18,4,22,The Taliban ambush a police convoy in a remote area and slaughter eighteen officers.
3446,10/10/2005,India,Rajnagar,10,1,11,"In two gruesome attacks, Hizb-ul-Mujahideen members swoop into two residences and slit the throats of ten Hindu family members.  Only one child is known to have survived."
3447,10/10/2005,Afghanistan,Kandahar,3,5,8,Three people are killed when a Taliban suicide bomber detonates his explosives along a city street.
3448,10/10/2005,Chechnya,Zakan-Yurt,2,0,2,A firefighter and a civilian are blown apart by a Muslim IED.
3449,11/10/2005,Thailand,Pattani,1,0,1,Muslims kill a security volunteer.
3450,11/10/2005,Iraq,Baghdad,4,0,4,Four people are killed by a suicide bomber at a gas station.
3451,11/10/2005,Iraq,Tal Afar,30,45,75,"A Fedayeen suicide bomber drives an explosives-laden car disguised as a taxi into a crowd of shoppers at a market, killing thirty and injuring forty-five."
3452,11/10/2005,Pakistan,Naurote,1,0,1,Sectarian attack leaves a civilian dead.
3453,11/10/2005,Pakistan,Gilgit,1,7,8,"Militant Muslims ambush a group of civilians, shooting one of them to death."
3454,12/10/2005,Egypt,Alexandria,0,2,2,A nun and one other person are stabbed in front of their church by a Muslim demonstrator.
3455,12/10/2005,India,Hyderabad,1,1,2,Suicide blast sponsored by Islamic terror groups kills one and injures another.
3456,12/10/2005,Iraq,Tal Afar,30,35,65,A second al-Qaeda suicide bombing in as many days leaves another thirty Iraqis dead and at least thirty-five others in various stages of physical suffering.
3457,12/10/2005,Afghanistan,Uruzgan,6,0,6,Six policemen die in a Taliban ambush.
3458,12/10/2005,Afghanistan,Kandahar,5,3,8,"Taliban extremists murder five medical workers returning from a relief trip.  The dead include two doctors, two nurses and a driver."
3459,12/10/2005,Philippines,Pamatsakin,3,2,5,"Abu Sayyaf militants attack a security patrol, killing a civilian and two soldiers."
3460,13/10/2005,Thailand,Narathiwat,1,0,1,A fruit trader is murdered by Islamists.
3461,13/10/2005,Kabardino-Balk.,Nalchik,44,64,108,A coordinated urban attack by 150 Islamic militants on a school and airport leaves at least forty-four civilians and law enforcement personnel dead.
3462,13/10/2005,Pakistan,Gilgit,12,25,37,"Twelve people, including three women, are killed in sectarian violence following a Shia demonstration."
3463,13/10/2005,India,Chowkian,2,1,3,An elderly man is killed in his home by the Mujahideen in an attack that also injures his wife.  Another civilian is gunned down in Sambora.
3464,14/10/2005,Afghanistan,Miwand,2,13,15,Two policemen are killed in an ambush by religious extremists.
3465,14/10/2005,Thailand,Pattani,1,0,1,Militant Muslims capture and behead a 68-year-old Buddhist cattle farmer.
3466,14/10/2005,Thailand,Narathiwat,1,0,1,A 43-year-old electrician is gunned down by Islamists on a motorcycle while on his way to work.
3467,14/10/2005,Afghanistan,Tani,1,16,17,Religious extremists kill a cleric and injure sixteen others with a bombing at a mosque.
3468,15/10/2005,India,Kathua,2,6,8,Islamic militants attack a group of soldiers as they are performing physical exercises on their base.
3469,15/10/2005,Iraq,Saqlawiyah,5,0,5,Five U.S. Marines are killed by a terrorist bomb while responding to a mortar attack on a polling station.
3470,15/10/2005,Thailand,Narathiwat,3,0,3,Three Thai civilians are killed in three separate attacks across the southern provinces.
3471,15/10/2005,Algeria,Tizi Ouzou,1,0,1,A civilian is murdered by an Islamic terrorist.
3472,16/10/2005,Iran,Ahvaz,6,80,86,At least six people are killed by a mysterious bomb planted at a shopping center.  More than eighty bystanders are injured.
3473,16/10/2005,Thailand,Yala,2,0,2,Two policemen guarding a railway station are gunned down by Islamists.
3474,16/10/2005,Thailand,Pattani,3,0,3,"Militant Muslims attack a Buddhist temple, slit the throat of a 76-year-old monk and brutally kill two teenage boys.  The bodies are subsequently burned."
3475,16/10/2005,Israel,Gush Etzion,3,5,8,"Three Israeli civilians, two young women and a 14-year-old boy, are gunned down in cold blood while waiting by the side of the road.  Five others are injured.  al-Aksa claims credit for the child killings."
3476,16/10/2005,Afghanistan,Lashkargah,3,0,3,The Taliban assassinate a religious cleric and later open fire on a group of security personnel in a separate attack.
3477,16/10/2005,Algeria,Algiers,2,3,5,Religious fundamentalists in eastern Algerian storm a house and slit the throats of two of the occupants.  Three other family members are kidnapped.
3478,17/10/2005,Iraq,Samarrah,2,1,3,"Two people attending a funeral are killed by a Fedayeen suicide bomber, who wanders in amidst the mourners."
3479,17/10/2005,Iraq,Baghdad,1,0,1,al-Qaeda releases a video of a man with his hands tied behind his back being shot twice in the back of the head.
3480,17/10/2005,Thailand,Narathiwat,2,0,2,Two men are gunned down by Muslim militants in separate attacks.
3481,18/10/2005,Afghanistan,Dand,1,0,1,A school janitor is shot to death by the Taliban.
3482,18/10/2005,Bangladesh,Narsingdi,1,0,1,A Hindu priest is kidnapped and murdered by Islamic extremists.
3483,18/10/2005,Thailand,Narathiwat,1,0,1,A villager is murdered by Muslim militants while standing in his yard.
3484,18/10/2005,Algeria,Jejil,6,0,6,Five security guards and a civilian are killed when Islamic fundamentalists open fire at a checkpoint.
3485,18/10/2005,India,Srinagar,4,3,7,"Lashker-e-Toiba terrorists barge into the home of a government minister in a suicide attack that leaves him, a security guard and two civilians dead."
3486,18/10/2005,Dagestan,Khasavyurt,1,3,4,Islamic militants kill a policeman and injure two others in a shootout.
3487,18/10/2005,Iraq,Baghdad,7,11,18,A Jihad attack on a police checkpoint leaves four Iraqis dead.  Three civilians are gunned down in a residential neighborhood elsewhere in the city.
3488,19/10/2005,Iraq,Baghdad,3,0,3,Three election workers are killed by Jihadis while driving home after counting ballots.
3489,19/10/2005,Pakistan,Wana,1,0,1,al-Qaeda militants abduct and kill a pro-government tribal chief.
3490,19/10/2005,Thailand,Paluru,1,0,1,Islamic militants kill a 28-year-old woman riding on the back of a motorcycle.
3491,19/10/2005,Iraq,Iskandariya,6,0,6,"Sunni gunmen barge into a factory, identify six Shia workers, then line the men up against a wall and kill them in front of their co-workers."
3492,19/10/2005,Afghanistan,Panjwayi,1,0,1,An anti-Taliban government official is gunned down while praying in a mosque.
3493,19/10/2005,Afghanistan,Panjwayi,2,0,2,The headmaster of a school is executed in front of his students.  A guard at a different school is also killed and his body is dumped in a stream.
3494,19/10/2005,India,Pampore,2,10,12,Two civilians are killed in a Mujahideen attack that also leaves ten others injured.
3495,20/10/2005,Chechnya,Elistanzhi,3,3,6,"Islamists fire at a group of civilians fishing, killing three."
3496,20/10/2005,Iraq,Baqubah,4,14,18,A Fedayeen suicide car bomber kills four civilians and causes injury to at least fourteen others.
3497,20/10/2005,India,Nalli Dillo,1,0,1,A shepherd is killed by the Mujahideen as he is grazing in the field.
3498,20/10/2005,India,Dardkoot,1,0,1,A man is abducted from his home by militant Muslims and killed in captivity.
3499,20/10/2005,Thailand,Narathiwat,2,0,2,A 60-year-old man is shot to death in front of a school in a motorcycle attack.  Muslims also kill another civilian in Yala.
3500,20/10/2005,Iraq,Baghdad,3,5,8,A small girl is among three people killed when Jihadis fire a rocket at a school.  Five other children are injured.
3501,20/10/2005,Afghanistan,Faryab,1,3,4,Religious extremists kill a humanitarian worker.
3502,21/10/2005,Afghanistan,Khost,1,3,4,The Taliban kill an Afghan journalist with a remote-controlled bomb.
3503,21/10/2005,Afghanistan,Helmand,9,0,9,Nine policemen are killed in a Taliban ambush on their patrol.
3504,21/10/2005,India,Ratnipora,1,0,1,A political activist is killed inside his residence by the Mujahideen.
3505,21/10/2005,India,Srinagar,1,14,15,"Fourteen people are injured, and one civilian killed, when an Islamic militant hurls a grenade at a crowd outside a hotel."
3506,21/10/2005,Afghanistan,Nimroz,2,5,7,The Taliban kill a police chief and at least one other person with a remote-controlled bomb outside a mosque.
3507,23/10/2005,Lebanon,Ein el-Hilweh,1,3,4,Fatah gunmen kill a government contractor.
3508,23/10/2005,Thailand,Pattani,1,0,1,"In a brutal attack, Muslims force a Buddhist man into a burning car."
3509,23/10/2005,England,Birmingham,1,1,2,Pakistanis stab a 24-year-old Christian man senselessly to death in what is either a racial or religious attack.
3510,23/10/2005,India,Wadwal,3,1,4,"Islamic terrorists open fire on a group of security personnel, killing three."
3511,23/10/2005,Iraq,Taji,3,0,3,Three Iraqis are shot to death by Sunni insurgents while driving a water truck.
3512,23/10/2005,Iraq,Kirkuk,2,13,15,Two civilians are killed by a suicide bomber.  Thirteen others are injured.
3513,23/10/2005,Iraq,Baghdad,4,11,15,A suicide bomber kills two civilians and two police officers.
3514,23/10/2005,Iraq,Tikrit,5,0,5,"Jihadis murder two young boys riding in a car, as well as two girls, ages 7 and 9, who were standing by the car when the remote-controlled device was detonated."
3515,23/10/2005,Bangladesh,Khulna,1,0,1,Jamaat-ul-Mujahideen suspected of bombing that kills a party leader.
3516,23/10/2005,Pakistan,North Waziristan,1,2,3,"A terrorist shoots at a group of three men at a bazaar, killing one."
3517,23/10/2005,India,Srinagar,2,0,2,Jaish-e-Mohammed members attack and kill two policemen at a market.
3518,24/10/2005,India,Puchhal,1,0,1,A man is killed inside his home after failing to heed the warning posters at a local mosque.
3519,24/10/2005,Pakistan,Ladha,1,11,12,al-Qaeda militants kill the driver of a military truck with a remote-controlled bomb.
3520,24/10/2005,Afghanistan,Kandahar,2,6,8,Two workers for a British agency working to clear landmines are killed in a bomb attack by religious extremists.
3521,24/10/2005,Iraq,Baghdad,14,5,19,"Three separate incidents include the discovery of eight bound and executed victims, a suicide car bomb that kills two civilians, and a shooting ambush that kills three municipal workers and a passerby."
3522,24/10/2005,Iraq,Hilla,12,1,13,Terrorists execute twelve people working at a construction site.  Five of the victims were brothers.
3523,24/10/2005,Iraq,Baghdad,20,40,60,Twenty passersby are massacred by three coordinated suicide attacks against a hotel.  The bombs were packed with ball-bearings to maximize human suffering.
3524,24/10/2005,Thailand,Pattani,1,3,4,Muslim gunmen shoot a villager to death and injure three more.
3525,24/10/2005,Canada,"Montreal, QB",1,0,1,A 'scholar of Islam' stabs his apostate brother to death over heresy.
3526,25/10/2005,Algeria,Medea,1,1,2,"Islamic fundamentalists shoot into a group of civilians, killing one."
3527,25/10/2005,Thailand,Yala,1,0,1,"Muslims stab a Buddhist man multiple times, and eventually kill him by slitting his throat."
3528,25/10/2005,Iraq,Sulaimaniyah,9,4,13,Nine civilians are killed by a Fedayeen suicide bomber on a city street.
3529,25/10/2005,Afghanistan,Jalalabad,1,2,3,"The Taliban opens fire on a police vehicle, killing an instructor and injuring two others."
3530,25/10/2005,Afghanistan,Kabul,4,3,7,A child is among four civilians killed by Taliban extremists in a rocket attack on a convoy of cars.
3531,25/10/2005,Iraq,Baghdad,1,9,10,Sunni insurgents kill a 7-year-old boy by the side of the road with a bomb that also injured nine other pedestrians.
3532,25/10/2005,India,Srinagar,0,9,9,Nine people are injured when a Jaish-e-Mohammed cadre lobs a grenade into a street.
3533,25/10/2005,Algeria,Medea,2,3,5,"In separate attacks, Islamic fundamentalists kill two people at a coffee house and a nearby market."
3534,25/10/2005,Lebanon,Helweh,1,0,1,Fatah Uprising terrorists kill a Lebanese army contractor.
3535,26/10/2005,Ingushetia,Nazran,4,1,5,"Muslim militants ambush a vehicle carrying Russians, shooting four to death in the attack."
3536,26/10/2005,Algeria,Skikda,3,0,3,Two civilians are among three killed by the Salafist Group for Preaching and Combat.
3537,26/10/2005,Algeria,Batna,1,0,1,Religious fundamentalists slit the throat of a 70-year-old shepherd.
3538,26/10/2005,Thailand,Narathiwat,9,10,19,Nine people are killed in a series of attacks by militant Islamists.
3539,26/10/2005,India,Mundana,2,0,2,Two security personnel are slain in a brutal ambush by Muslim terrorists.
3540,26/10/2005,India,Omarabad,0,30,30,About thirty people are injured when Hizb-ul-Mujahideen target a bus with an IED.
3541,26/10/2005,Pakistan,Quetta,1,0,1,A Shia teacher is gunned down on his way to school by radical Sunnis.
3542,26/10/2005,Israel,Hadera,5,30,35,A suicide bomber from Islamic Jihad murders five Israelis in front of a food stand in a public area.
3543,27/10/2005,Pakistan,Kot Langarkhel,1,11,12,"al-Qaeda-linked tribesmen target a military vehicle with a landmine, killing one."
3544,27/10/2005,India,Ganethi,2,0,2,A Mujahideen ambush on a security patrol leaves two dead.
3545,27/10/2005,Iraq,Nahrawan,15,14,29,Sectarian violence in the form of a Sunni on Shia ambush claims the lives of fifteen.
3546,27/10/2005,Iraq,Baghdad,1,9,10,A Fedayeen suicide bomber kills a civilian and injured nine others.
3547,28/10/2005,India,Shabga,6,0,6,Six members of a family are hacked to death in an honor killing.
3548,28/10/2005,Thailand,Narathiwat,1,0,1,Islamic militants disguised as fully-veiled women shoot a local religious leader to death from the back of a motorcycle.
3549,28/10/2005,Afghanistan,Paktika,3,0,3,Two men are dragged out a mosque and executed by Taliban extremists.  A tribal leader in nearby Khost is also shot to death.
3550,28/10/2005,Afghanistan,Helmand,3,0,3,"The Taliban ambush a civilian vehicle, killing two brothers and one of their sons."
3551,29/10/2005,Thailand,Yala,1,0,1,Islamic radicals kill a man herding goats.
3552,29/10/2005,Iraq,Howaider,31,42,73,"In a particularly heinous attack, an Islamist suicide bomber disguises an explosives-laden truck as a produce vendor, gathers ordinary customers around it, then detonates, killing at least thirty innocents."
3553,29/10/2005,Indonesia,Bukit Bambu,3,1,4,"Three Christian 16-year-old girls on their way to school are attacked and beheaded by six Muslim gentlemen, who leave the headless bodies in the street and carry the heads to a different location."
3554,29/10/2005,India,New Delhi,62,155,217,Three coordinated blasts that tear through a bus and two markets crowded with people celebrating a Hindu festival bear all the hallmarks of the Religion of Peace.  An Islamic group claims responsibility.
3555,30/10/2005,Iraq,Baghdad,5,9,14,Jihad attacks on an oil tanker and a construction site kill four laborers and a government driver.
3556,30/10/2005,India,Batpora Harwan,1,0,1,A civilian is abducted and executed by the Mujahideen.
3557,30/10/2005,India,Kanji,1,0,1,The Mujahideen murder a civilian defense volunteer in his village.
3558,30/10/2005,Algeria,al-Taheer,1,7,8,"Islamic fundamentalists attack a police patrol in a small town, killing one officer and injuring seven people, including civilians."
3559,30/10/2005,Algeria,Boumerdes,2,0,2,Two civilians are shot to death by Islamic fundamentalists.  One was a child.
3560,31/10/2005,Iraq,Tal Afar,14,0,14,Fourteen bound and tortured corpses are found in the former Islamist stronghold.  Two were decapitated.
3561,31/10/2005,Nigeria,Niger Province,3,13,16,Three Christians are killed by Muslims in unrest following the carrying out of a Sharia sentence of amputation against a Christian.
3562,31/10/2005,Iraq,Baghdad,4,5,9,Four employees working at an oil company are killed in a rocket attack by Jihadis.
3563,31/10/2005,Yemen,Munabbah,12,0,12,Islamists ambush and kill twelve Yemeni policemen as they are traveling through a remote town.
3564,31/10/2005,Iraq,Basra,18,59,77,Eighteen shoppers are killed when Islamic insurgents detonate a car bomb in a crowded market area.  About fifty others are injured.
3565,31/10/2005,Algeria,Baghlia,1,0,1,A civilian standing on a city street is gunned down in a suspected Islamist attack.
3566,31/10/2005,Thailand,Yala,1,0,1,A cop is gunned down by Jihadis on his way home.
3567,31/10/2005,Thailand,Pattani,1,3,4,A villager is shot and killed by terrorists in a shooting attack.
3568,1/11/2005,Thailand,Narathiwat,1,0,1,A civilian is murdered by Islamists.
3569,1/11/2005,India,Lamad-Bernai,1,1,2,Two civilians are abducted by the Mujahideen.  One is strangled.  The other is still missing.
3570,2/11/2005,Iraq,Jurf al Naddaf,5,6,11,Five Iraqis in a private minibus are killed in a Jihadi roadside bombing attack.
3571,2/11/2005,Afghanistan,Bahramshah,5,0,5,"A drug-fighting police unit is surprised by the Taliban, who take five officers prisoner, then cut off their heads."
3572,2/11/2005,India,Srinagar,10,18,28,"Jaish-e-Mohammed kill a 10-year-old boy, a woman, and at least eight others with a suicide bombing in a residential neighborhood."
3573,2/11/2005,Chechnya,Grozny,1,1,2,Jihadis use a landmine to kill a member of an engineering squad.
3574,2/11/2005,Thailand,Yala,1,0,1,A 32-year-old man is shot to death by Muslim militants as he is riding a motorcycle.
3575,2/11/2005,Israel,Kafr Mirka,1,0,1,"An Israeli soldier is shot in the head by Palestinian gunmen while making an arrest.  Soldiers noticed suspicious movement nearby, but hesitated for fear of hitting civilians."
3576,2/11/2005,Iraq,Musayyib,23,46,69,Twenty-three Shiites are killed when a minibus packed with explosives is detonated next to a mosque and a busy market.
3577,2/11/2005,Thailand,Pattani,1,0,1,A fisherman is shot to death by Islamic extremists.
3578,2/11/2005,Thailand,Narathiwat,2,3,5,Two men are killed in a Jihadi bombing.
3579,3/11/2005,Thailand,Pattani,1,0,1,Muslim extremists behead a Buddhist monk.
3580,3/11/2005,Thailand,Narathiwat,1,0,1,A teenager is shot to death by Muslim gunmen.
3581,4/11/2005,Iraq,Baghdad,9,2,11,"Two Jihad attacks kill four, including a 10-year-old girl.  Her mother and another child were seriously injured.  Five policemen are killed in a separate bombing south of Kirkuk."
3582,4/11/2005,Iraq,Bores,9,11,20,A brutal ambush on a police checkpoint by Islamic insurgents dressed as women leaves nine officers and eleven injured.
3583,4/11/2005,Thailand,Yala,1,0,1,A villager is gunned down for no apparent reason by Muslim radicals.
3584,4/11/2005,Thailand,Narathiwat,1,1,2,Muslim separatists murder a civilian.
3585,5/11/2005,Thailand,Narathiwat,2,0,2,Two Buddhist rubber tappers are slain by Muslim gunmen.
3586,5/11/2005,Iraq,Balad Ruz,13,3,16,Sunni insurgents machine-gun an infant to death along with twelve other Shia family members as they are returning from a minibus trip to a family cemetery.
3587,5/11/2005,India,Rajwar,1,0,1,A villager is gunned down by the Mujahideen.
3588,5/11/2005,Pakistan,Mir Ali,3,0,3,Three children are killed by an al-Qaeda bomb that explodes prematurely.
3589,6/11/2005,India,Kashmir,3,1,4,"Terrorists shoot three villagers to death in separate attacks (Chakras, Batapora Sopore, Kulgam)"
3590,6/11/2005,Iraq,Kut,21,0,21,"Eleven bodies are found in Kut, five of which were beheaded.  Ten others are found outside Baghdad to days later, bound and showing signs of torture."
3591,6/11/2005,Iraq,Baghdad,3,7,10,Car bomb on a city street kills three civilians and injures seven.
3592,7/11/2005,Somalia,Mogadishu,1,0,1,"Muslim terrorists spray a car with bullets, killing the driver."
3593,7/11/2005,Thailand,Yala,6,2,8,Six people are murdered in a series of coordinated attacks by Muslim terrorists.
3594,7/11/2005,France,Paris,1,0,1,A 61-year-old retiree is beaten to death by Muslim youth for trying to extinguish a fire that they started.
3595,7/11/2005,Sudan,Darfur,18,16,34,"Arab militias attack a series of villages, killing at least eighteen people."
3596,7/11/2005,Afghanistan,Uruzgan,2,0,2,The Taliban abduct and behead two villagers.
3597,7/11/2005,Iraq,Baghdad,9,10,19,A suicide car bomber kills nine Iraqis and injures ten.
3598,7/11/2005,Thailand,Yala,2,0,2,Muslim militants kill a villager and a Buddhist policeman in coordinated attacks.
3599,7/11/2005,India,Indergam,1,0,1,The Mujahideen gun down a civilian in an apple orchard.
3600,7/11/2005,India,Quil Muqam,2,0,2,Two civilians are killed in a Mujahideen bombing.
3601,7/11/2005,Iraq,Baghdad,5,0,5,A Fedayeen suicide bomber kills four U.S. soldiers on security patrol along with their civilian translator.
3602,8/11/2005,Iraq,Kirkuk,7,3,10,Six bound and executed corpses are discovered on the same day that Sunni insurgents kill a policeman with a car bomb.
3603,8/11/2005,Iraq,Mustansiriyah,1,1,2,"A car bomb explodes at a university, killing one civilian."
3604,8/11/2005,India,Larkuti,2,0,2,Lashkar-e-Toiba terrorists invade the home of a council member's brother and sister-in-law to shoot both people to death.
3605,8/11/2005,Indonesia,Poso,1,1,2,Two Christian 17-year-old girls are shot in the head in a brutal attack only a few days after three others were beheaded.
3606,8/11/2005,India,Lawaypora,1,19,20,"The Mujahideen bomb a security patrol, injuring twenty people, one of whom later succumbs to his injuries."
3607,8/11/2005,Iraq,Basra,3,0,3,"In two attacks, a journalist is shot to death by Islamic militants and a member of the Iraqi security forces is killed in a bombing along with his brother."
3608,8/11/2005,Thailand,Narathiwat,3,0,3,"Three civilians, including a food vendor and newspaper editor, are shot to death by Muslim radicals in separate attacks."
3609,9/11/2005,Thailand,Narathiwat,1,1,2,"A Buddhist businessman is murdered, and his teenage son injured, by Muslim gunmen."
3610,9/11/2005,India,Tral,1,0,1,A civilian is gunned down by the Mujahideen in his village.
3611,9/11/2005,Jordan,Amman,56,115,171,"Three coordinated and horrific suicide bombings target hotels, including Days Inn and the Grand Hyatt.  The worst damage was at the Radisson, where an al-Qaeda bomber walked into a wedding party and killed dozens, including several children."
3612,9/11/2005,Iraq,Baqubah,7,9,16,Suicidal Sunni straps explosives to his body and kills three civilians and four policemen on patrol.  Nine other people are injured.
3613,9/11/2005,Afghanistan,Shah Wali Kot,7,2,9,Seven policemen are killed in an ambush by religious extremists along a remote road.  Two others are abducted.
3614,9/11/2005,Iraq,Baghdad,6,31,37,"Two Sunni car bombs detonate outside a Shiite mosque, killing six people and injuring thirty-one.  Woman and children are among the casualties."
3615,10/11/2005,Afghanistan,Helmand,3,0,3,A former district chief and two others are killed in separate Taliban attacks.
3616,10/11/2005,Iraq,Baghdad,33,24,57,"Two suicide bombers target a packed restaurant, slaughtering over thirty people.  The vast majority of the casualties are civilian."
3617,10/11/2005,Iraq,Kirkuk,7,13,20,Seven Iraqis standing outside a recruiting center are killed in a Sunni car bombing.  Thirteen others are injured.
3618,10/11/2005,India,Nadihal-Bandipora,1,0,1,A teacher is shot to death by Islamic militants.
3619,10/11/2005,Pakistan,Brabcha,6,6,12,Six members of the same family are killed in an al-Qaeda landmine blast.  Six others sustain injury.
3620,11/11/2005,Algeria,Beni Boussaid,1,4,5,"Fundamentalists fire on a group of vacationers, killing one."
3621,11/11/2005,Afghanistan,Khost,1,5,6,The Taliban attack a police station killing one officer and injuring five others.
3622,11/11/2005,Iraq,Baghdad,2,4,6,Drive-by shooting on the Oman embassy by Jihadis leaves two workers dead and four injured.
3623,11/11/2005,India,Pulwama,1,0,1,A congressional party activist is murdered by Muslim militants.
3624,12/11/2005,Afghanistan,Helmand,3,0,3,"Three policemen are kidnapped by Taliban extremists, then shot to death in captivity."
3625,12/11/2005,Philippines,Jolo,3,12,15,Three Filipino soldiers are killed in an ambush by Abu Sayyaf militants and the shootouts that follow.
3626,12/11/2005,Iraq,Baghdad,8,12,20,"At least one car bomb goes off in a marketplace, killing eight shoppers, including an 8-year-old girl."
3627,12/11/2005,Iraq,Baghdad,4,1,5,"Four bodies are found, tortured and bound, along with one survivor."
3628,12/11/2005,India,Raipora,2,3,5,A 16-year-old is among two people killed in an encounter with the Hizb-ul-Mujahideen.
3629,12/11/2005,Philippines,Jolo,1,0,1,A 26-year-old photojournalist is shot in the head by Abu Sayyaf militants.
3630,12/11/2005,Thailand,Narathiwat,1,0,1,Militant Muslims gun down a school teacher.
3631,12/11/2005,Thailand,Narathiwat,1,0,1,A man is murdered in front of his home by Islamic gunmen.
3632,13/11/2005,Somalia,Mogadishu,4,5,9,"Islamic fundamentalists fire into the lobby of a cinema, killing four civilians."
3633,13/11/2005,Thailand,Pattani,3,0,3,"Three civilians, including a teacher, are gunned down over the weekend by Muslim extremists."
3634,14/11/2005,Iraq,Baghdad,2,3,5,Two South Africans are killed and three other foreigners wounded in a terrorist attack on their SUV.
3635,14/11/2005,Thailand,Pattani,3,1,4,Islamists walk into a grocery store and murder the husband and wife owners.  Their 10-year-old boy escapes.  Two Buddhist highway workers are shot in a separate attack.
3636,14/11/2005,Iraq,Ramadi,6,30,36,Six civilians are killed when Jihadis bomb two passenger buses.  Over thirty others are injured.
3637,14/11/2005,Bangladesh,Jhalokathi,2,0,2,"Jamatul Mujahideen extremists hurl a bomb at a car carrying two judges, killing them both."
3638,14/11/2005,India,Srinagar,4,14,18,"Islamic militants attack people in a business district, near hotels.  Four people are killed and fourteen others injured."
3639,14/11/2005,Afghanistan,Kabul,9,7,16,Two suicide bombings kill nine people and injure seven others.
3640,14/11/2005,India,Gulbug Ratnipora,1,0,1,A 22-year-old woman is killed inside her home by the Mujahideen.
3641,14/11/2005,Iraq,Baghdad,3,4,7,At least three people are killed when Islamic terrorists detonate a roadside bomb in a busy commercial district.
3642,15/11/2005,Chechnya,Grozny,2,0,2,Two policemen are kidnapped and murdered by the Religion of Peace.
3643,15/11/2005,Iraq,Baghdad,2,7,9,Two policemen are killed by a bomb.  Two small girls are among the injured.
3644,15/11/2005,Iraq,Kirkuk,7,3,10,Seven Iraqis are killed in two separate attacks by Jihadis.
3645,15/11/2005,Afghanistan,Paktika,5,2,7,Five Afghan police are killed in a landmine attack by Taliban extremists.
3646,15/11/2005,India,Tangmarg,7,90,97,"al-Arifeen claims responsibility for a grenade attack on a political rally.  Seven people are killed, including a 12-year-old, and about ninety injured."
3647,15/11/2005,Pakistan,Karachi,3,12,15,"A firebomb goes off inside a fast-food restaurant, then a car bomb detonates nearby.  Three people are killed and about a dozen injured.  (Identity unclear)."
3648,15/11/2005,Thailand,Narathiwat,1,0,1,A man working in a rice field is shot three times by two Islamists who stop him under the pretense of asking directions.
3649,16/11/2005,Thailand,Narathiwat,9,9,18,"A man, woman and seven children, including an infant are slaughtered in their home by ten Islamic militants with assault rifles."
3650,16/11/2005,Afghanistan,Kandahar,3,6,9,At least three civilians are killed by a suicide car bomber.  Another six are injured.
3651,16/11/2005,Thailand,Narathiwat,2,0,2,Two Buddhists are murdered by Muslim extremists in separate shooting attacks.
3652,16/11/2005,India,Awantipora,2,3,5,"Muslim militants attack a security convoy, killing two and injuring three."
3653,16/11/2005,India,Srinagar,6,48,54,"Lashkar-e-Taiba sets off a car bomb in the heart of a business district, killing at least four people and injuring over forty."
3654,17/11/2005,Thailand,Narathiwat,1,0,1,A villager is murdered in front of a tea shop by militant Muslims.
3655,17/11/2005,Ingushetia,Malgobek,2,1,3,Islamic gunmen suspected in attack on a group of policemen.
3656,17/11/2005,India,Lancha,2,0,2,Two cousins are killed inside their home by the Hizb-ul-Mujahideen.
3657,17/11/2005,Iraq,Baghdad,1,0,1,Jihad gunmen kill a doctor inside his clinic.
3658,18/11/2005,Iraq,Baghdad,8,40,48,Two synchronized suicide car bombs near a hotel kill at least eight people and injure about forty.
3659,18/11/2005,Iraq,Khanaqin,74,85,159,Seventy-four worshippers at two Shia mosques are slaughtered by two Sunni suicide bombers.  At least eighty others are injured amidst the carnage.
3660,18/11/2005,Afghanistan,Kabul,1,3,4,A Portuguese peacekeeper is killed in a Taliban landmine attack on his vehicle.
3661,18/11/2005,Indonesia,Palu,1,1,2,Machete-wielders attack and nearly decapitate a 23-year-old cosmetics salesgirl. Her 20-year-old companion's left arm is nearly hacked off as well.
3662,18/11/2005,Indonesia,Poso,1,1,2,One woman dies after a machete attack by militant Muslims.
3663,18/11/2005,Sweden,Hogsby,1,0,1,"A 20-year-old man is beaten with an iron bar, doused with oil and stabbed 23 times by the family of his lover in an honor killing."
3664,19/11/2005,Chechnya,Chechen-Aul,1,0,1,A civilian is kidnapped and murdered by the Mujahideen.
3665,19/11/2005,Afghanistan,Helmand,3,0,3,The Taliban blow-up a vehicle carrying three Afghans..
3666,19/11/2005,Indonesia,Palu,0,2,2,Christian couple shot by radical Muslims while on their way to church.
3667,19/11/2005,Iraq,Baghdad,13,21,34,A car bombing at a popular market leaves thirteen shoppers dead and at least fifteen others injured.
3668,19/11/2005,Iraq,Haditha,15,0,15,A bombing and shooting ambush by Jihad fighters leaves fifteen civilians dead and an unknown number wounded.
3669,19/11/2005,Iraq,Abu Saida,36,50,86,A suicide car bomber blows himself to Allah after plowing in a Shia funeral procession.  Thirty-six innocents are killed and at least fifty others injured.
3670,20/11/2005,Iraq,Basra,1,4,5,Terrorists kill a British soldier in a roadside bombing attack.
3671,20/11/2005,Thailand,Narathiwat,0,3,3,"Islamic gunmen attempt to kill three people, including a pregnant milk vendor in drive-bys."
3672,20/11/2005,Thailand,Sungai Kolok,0,12,12,"Twelve people, including a 2-year-old boy, are injured by two bombs at a market.  One was hidden in a fruit basket."
3673,21/11/2005,Thailand,Yala,3,2,5,"Armed Muslim extremists rampage though a Buddhist village, killing at least three residents."
3674,21/11/2005,Iraq,Kanaan,5,14,19,Roadside terrorist blast kills five civilians and injures fourteen others.
3675,21/11/2005,Iraq,Baghdad,4,0,4,Four Christian women are killed when gunmen storm their home in the middle of the night.
3676,21/11/2005,India,Srinagar,0,10,10,"Ten people, including eight civilians, are injured in a Mujahideen grenade attack on a city street."
3677,21/11/2005,India,Sopore,1,1,2,"A Muslim extremist shoots a man to death in a residential area, then lobs a grenade at another house, injuring a woman."
3678,21/11/2005,Israel,Metulla,0,12,12,Eleven Israeli soldiers and one civilian are injured by a Hezbollah attack in northern Israel.
3679,22/11/2005,Thailand,Yala,1,0,1,A village chief is shot eight times by Muslim militants as he returns home.
3680,22/11/2005,Thailand,Narathiwat,1,1,2,"A man is killed in his home by Muslim militants, who also shoot his wife to keep her from getting help."
3681,22/11/2005,Iraq,Kirkuk,18,28,46,"Jihadis kill eighteen innocents in a suicide bombing, including four policemen who were lured to the scene after the gunmen injured one of their own as bait."
3682,22/11/2005,Iran,Gonbad-e-Kavus,1,0,1,A Muslim convert to Christianity is stabbed to death by radical Islamists after being abducted from his home.
3683,23/11/2005,Thailand,Narathiwat,1,0,1,A 4-year-old child is shot to death by Muslim extremists.
3684,23/11/2005,Afghanistan,Charchino,3,0,3,Three unarmed policemen are gunned down with Kalashnikovs while walking home after work.
3685,23/11/2005,India,Doda,1,0,1,"A civilian who was injured in a terrorist ambush a few days earlier, succumbs to his injuries."
3686,23/11/2005,Afghanistan,Nimroz,1,0,1,The Taliban behead an Indian engineer that was captured the week before.
3687,23/11/2005,India,Ashminder Pulwama,1,0,1,The Mujahideen abduct a man from his home and strangle him.
3688,23/11/2005,Iraq,Baqubah,1,1,2,A civilian is killed in a roadside terrorist bombing.
3689,23/11/2005,Iraq,Baghdad,5,0,5,"A pro-election sheik, his three sons, and a son-in-law are killed by radicals, who invade the home in the middle of the night to shoot the victims."
3690,23/11/2005,India,Srinagar,3,4,7,Three policemen are killed in a Fedayeen grenade and small arms attack on a former cinema used as a security post in a downtown area.
3691,23/11/2005,Philippines,Sulu,1,2,3,A Philippine solider is killed by Abu Sayyaf.
3692,24/11/2005,India,Surankote,2,2,4,"Muslim militants throw a grenade into a family's house, killing a 3-year-old girl and her sister."
3693,24/11/2005,Iraq,Baghdad,4,0,4,An attempted ambush assassination by Jihadis leaves four innocents dead.
3694,24/11/2005,Afghanistan,Khogyani,2,2,4,A bomb hidden in a car kills two people and injures two others.
3695,24/11/2005,Iraq,Baghdad,4,0,4,Four policemen are killed by radical Sunnis while on patrol.
3696,24/11/2005,Iraq,Mahmoudiya,30,35,65,"Women and children are amply represented among more than thirty people blown to bits by a ""Holy Warrior"" suicide bomber near a hospital."
3697,24/11/2005,Thailand,Narathiwat,1,4,5,"Islamic militants spray a tea shop with automatic weapons, killing a patron and injuring four others."
3698,24/11/2005,Thailand,Pattani,1,0,1,A 42-year-old man is gunned down by Islamists on his way to work.
3699,24/11/2005,Iraq,Hilla,11,17,28,"Terrorists target patrons at a soft drink stand with a car bomb, killing eleven and injuring seventeen."
3700,25/11/2005,Afghanistan,Mazar-e-Sharif,1,3,4,A Swedish peacekeeper dies in a bomb attack.
3701,25/11/2005,India,Handwara,1,0,1,A civilian is gunned down by the Mujahideen.
3702,25/11/2005,Iraq,Hawija,4,0,4,"In a brutal attack, Jihadis ambush and kill two off-duty Iraqi soldiers and their wives."
3703,26/11/2005,Iraq,Baghdad,1,3,4,An election worker is killed while hanging campaign posters.
3704,26/11/2005,Afghanistan,Helmand,1,0,1,A civilian is gunned down by the Taliban.
3705,26/11/2005,Iraq,Baghdad,4,0,4,Four civilians are killed by Islamic terrorists in a car bomb attack.
3706,26/11/2005,Afghanistan,Sharana,1,0,1,A government official is killed by a sustained Taliban rocket attack on public buildings.
3707,26/11/2005,Iraq,Samarrah,6,12,18,"A Fedayeen suicide bomber drives his explosives-laden pickup truck into a crowded gas station, incinerating six innocents."
3708,26/11/2005,Thailand,Narathiwat,1,0,1,Muslim terrorists shoot a man to death in his rice paddy.
3709,27/11/2005,Thailand,Narathiwat,1,0,1,A husband is gunned down in front of his wife in an attack by Islamic extremists.
3710,27/11/2005,Iraq,Baqubah,2,1,3,"Roadside bomb kills a civilian.  In Hawija, Islamists kidnap and behead a former Army cook."
3711,27/11/2005,Iraq,Baghdad,2,4,6,Islamic gunmen shoot two members of a pro-government news channel to death.  Four others are injured.
3712,27/11/2005,Iraq,Rustomia,7,0,7,Seven bodies are discovered over a 24-hour period.
3713,28/11/2005,Chechnya,Pamyatoi,1,0,1,Government official is assassinated by Jihadis in an ambush on his vehicle.
3714,28/11/2005,Yemen,Sadah,8,0,8,Radical Shiites kill eight policemen in a series of attacks.
3715,28/11/2005,Iraq,Baghdad,3,3,6,Three British citizens are murdered when a bus carrying Shia pilgrims is attacked by Sunnis.
3716,28/11/2005,Iraq,Abu Ghraib,4,0,4,"Four men, including a legislator are shot to death in a brutal Jihadi assassination."
3717,28/11/2005,India,Bandipore,2,0,2,Jamiat-ul-Mujahideen terrorists stop a car carrying a local official then execute him and his cousin.
3718,29/11/2005,Chechnya,Avtury,2,0,2,Jihadis enter a house and murder a man and his son.
3719,29/11/2005,Thailand,Narathiwat,1,1,2,A man is shot off the back of his motorcycle by Muslim radicals.
3720,29/11/2005,Iraq,Mosul,2,1,3,Two Christians are gunned down by Muslim militants as they are hanging campaign posters.
3721,29/11/2005,Bangladesh,Gazipur,5,50,55,Jamaatul Mujahideen suicide bomber at a law library kills at least five others and injures over fifty.
3722,29/11/2005,Bangladesh,Chittagong,2,16,18,A suicide bombing at a courthouse checkpoint kills at least two people.
3723,30/11/2005,Thailand,Narathiwat,1,0,1,A 33-year-old Buddhist is gunned down by Islamic militants.
3724,30/11/2005,Thailand,Yala,1,0,1,Muslims kill a 40-year-old Buddhist man as he is on his way to tend cattle.
3725,30/11/2005,Iraq,Baqubah,9,2,11,"Jihad gunmen open up on a minibus with assault weapons, killing nine farm workers as they are boarding."
3726,1/12/2005,India,Challi Dangri,2,0,2,Two boys are killed by a landmine planted by Islamic militants.
3727,1/12/2005,Iraq,Zaghneya,1,0,1,A Shiite leader is killed in a sectarian drive-by attack.
3728,1/12/2005,Iraq,Rutba,5,0,5,"The bodies of four men, bound and executed, are found.  In Basra, radicals kill an Iraqi translator."
3729,1/12/2005,Pakistan,Miranshah,2,0,2,Two innocent victims of a bomb-making cell are a teenage student and a 5-year-old boy.
3730,1/12/2005,Bangladesh,Gazipur,2,30,32,"An Islamist straps a bomb to his leg then detonates it in a DA's office, killing two other people."
3731,1/12/2005,Thailand,Yala,1,1,2,"Two Buddhist villagers are shot at by Muslim militants, one of whom succumbs to injury."
3732,2/12/2005,Thailand,Narathiwat,1,0,1,A village headsman is gunned down by Islamic radicals.
3733,2/12/2005,Iraq,Fallujah,10,11,21,Ten U.S. Marines guarding a hospital are senselessly killed by Islamic bombers
3734,2/12/2005,India,Chuntimulla,1,0,1,The Mujahideen enter the house of a widow and shoot her to death.
3735,2/12/2005,India,Pattan,1,0,1,Islamic militants shoot a teacher to death by the side of the road.
3736,2/12/2005,India,Karam Katha,1,0,1,A man is kidnapped and murdered by the Mujahideen.
3737,2/12/2005,Pakistan,Balochistan,1,0,1,"A Sunni group, Lashkar-e-Jhangvi, takes credit for killing a Shia cleric in front of his home."
3738,2/12/2005,Afghanistan,Shah Wali Kot,3,3,6,A district chief is killed in a Taliban roadside bombing along with two other Afghans.
3739,2/12/2005,Afghanistan,Helmand,1,5,6,A Taliban ambush on a police vehicle leaves one officer dead.
3740,3/12/2005,Iraq,Adhaim,19,2,21,Iraqi soldiers are ambushed by terrorists while in transport.  Nineteen are killed.
3741,4/12/2005,Egypt,Cairo,1,0,1,Christian pastor killed following threats.
3742,4/12/2005,Iraq,Baghdad,3,26,29,"Two civilians are killed by a bomb planted under a car on a city street.  Elsewhere in the city, a Shiite cleric is gunned down."
3743,4/12/2005,Pakistan,Shakai,1,0,1,al-Qaeda backed militants kill a Pakistani soldier.
3744,4/12/2005,Afghanistan,Kandahar,1,2,3,A civilian is killed by a suicide bomber.  Two others are injured.
3745,5/12/2005,India,Nambalhar,1,1,2,A civilian is killed in a Mujahideen attack.
3746,5/12/2005,Pakistan,Karachi,1,0,1,A Sunni cleric is killed in a sectarian attack while buying food at a store.
3747,5/12/2005,Iraq,Rutba,11,0,11,"The bodies of eleven civilians are found, bound and executed."
3748,5/12/2005,Afghanistan,Marja,3,2,5,Two civilians are among three dead in a drive-by Taliban shooting.
3749,5/12/2005,Israel,Netanya,5,47,52,"Five Israelis are murdered at the entrance to a shopping mall by a bomber from the militant group, 'Islamic Jihad'."
3750,5/12/2005,Thailand,Pattani,1,0,1,Religious extremists kill a school janitor walking home from work.
3751,6/12/2005,Thailand,Pattani,1,0,1,A man is murdered in front of his family by Islamic terrorists.
3752,6/12/2005,Thailand,Narathiwat,1,0,1,A cleric is gunned down by Islamists on a motorcycle.
3753,6/12/2005,Iraq,Baghdad,43,73,116,Two al-Qaeda suicide bombers walk into separate classrooms at a police academy and slaughter more than forty students.  Over seventy others are injured.
3754,6/12/2005,Iraq,Fallujah,9,0,9,"Nine bodies of civilians are found, bound and executed."
3755,6/12/2005,Iraq,Shorkat,3,0,3,Jihadis gun down three employees of an Iraqi oil company as they are driving home.
3756,6/12/2005,Pakistan,Wana,2,0,2,Two Pakistani soldiers are kidnapped and beheaded by Islamic fundamentalists.
3757,6/12/2005,Pakistan,Miranshah,7,0,7,"The Taliban kill seven tribesmen in their homes, later mutilating and hanging the bodies from utility poles."
3758,6/12/2005,Iraq,Baghdad,3,20,23,Three people at a cafe are murdered by a Fedayeen suicide bomber.  Twenty other patrons are injured.
3759,7/12/2005,Iraq,Kirkuk,3,5,8,Three hospital guards are gunned down on the job by terrorists.
3760,7/12/2005,Ingushetia,Nazran,0,9,9,Nine Russians manning a checkpoint are injured when Jihad gunmen open fire.
3761,8/12/2005,Iraq,Baghdad,1,0,1,The Islamic Army of Iraq claims to have executed an unarmed American civilian abducted earlier.
3762,8/12/2005,Pakistan,Jandola,12,40,52,Twelve people are killed when a planted bomb rips through a hotel restaurant.  Forty others are injured.
3763,8/12/2005,Iraq,Baghdad,32,44,76,"A 'Holy Warrior' blows apart more than thirty passengers on a packed bus, including women and children, as they are prepared to travel home for the weekend."
3764,8/12/2005,Bangladesh,Netrakona,6,100,106,A Jamaatul Mujahideen Bangladesh suicide bomber kills six people working in a Communist Party office.
3765,8/12/2005,India,Gandoh,1,0,1,A security guard at a civilian residence is shot and killed at point blank range by a Muslim terrorist.
3766,8/12/2005,Afghanistan,Helmand,1,2,3,"Taliban extremists attack a police patrol, killing one officer."
3767,8/12/2005,Bangladesh,Gangni,1,10,11,Bombing at a traffic crossing kills one person and leaves ten others injured.
3768,8/12/2005,Israel,Kalandiya,1,0,1,A 20-year-old Israeli soldier is fatally stabbed in the neck by an al-Aqsa terrorist at a point of entry.
3769,8/12/2005,Afghanistan,Khost,4,1,5,Two civilians are among four people reported killed by the Taliban.
3770,9/12/2005,Thailand,Narathiwat,2,0,2,A Buddhist husband and wife are brutally murdered by radical Muslims.
3771,9/12/2005,Afghanistan,Zabul,1,2,3,"The Taliban attack a remote checkpoint, killing a policeman and injuring two others."
3772,9/12/2005,Iraq,Baghdad,3,0,3,Two men are killed by Islamic insurgents.  The body of a kidnapped intelligence officer is found in Balad.
3773,10/12/2005,Iraq,Tikrit,1,0,1,An Egyptian man working to build a medical clinic is kidnapped and murdered by Islamic insurgents.
3774,10/12/2005,Pakistan,North Waziristan,2,0,2,"The Taliban kill two more people, decapitating them and hanging their bodies upside down from pylons."
3775,10/12/2005,Iraq,Mosul,2,1,3,Terrorists kill two civilians with a roadside bomb.
3776,10/12/2005,Iraq,Mosul,1,1,2,Two campaign workers are shot while hanging posters.
3777,10/12/2005,Afghanistan,Nazarjusth,7,6,13,Seven policemen are killed when religious extremists stage an assault on their compound.
3778,11/12/2005,Iraq,Baiji,2,1,3,"Sunni gunmen attack a car carrying off-duty Iraqi soldiers, killing two."
3779,11/12/2005,India,Chandilora,1,0,1,A shop owner is killed in his place of business by Muslim terrorists.
3780,12/12/2005,Iraq,Baghdad,10,31,41,Three Jihad attacks kill six people and the bodies of four abductees are discovered.
3781,12/12/2005,Lebanon,Mkalles,4,30,34,Christian reporter is assassinated by a car bombing that kills three other people.  Thirty innocents are injured in the blast.
3782,13/12/2005,Pakistan,Balochistan,1,0,1,A hotel owner is killed in a sectarian attack.
3783,13/12/2005,India,Kashreyan,1,0,1,The Mujahideen gun down a civilian near his home.
3784,13/12/2005,Pakistan,Dera Bugti,3,6,9,"Three members of a family, including a child, are killed when al-Qaeda-backed militants attack their home with a dozen rockets."
3785,13/12/2005,Philippines,Patikul,2,11,13,Two Filipino soldiers are killed in a gunfight with Abu Sayyaf militants.
3786,13/12/2005,Iraq,Ramadi,1,0,1,An election candidate is gunned down by Jihadis while waiting for gas at a station.
3787,14/12/2005,Afghanistan,Andar,2,0,2,Two civilians are kidnapped and killed by religious extremists.
3788,14/12/2005,India,Tanta,1,0,1,A student who refused to join the Mujahideen is kidnapped and shot to death.
3789,14/12/2005,Afghanistan,Kandahar,1,0,1,A pro-government cleric is assassinated by the Taliban as he is riding to work.
3790,15/12/2005,Afghanistan,Nad Ali,1,0,1,The Taliban drag a teacher out of his classroom and kill him for teaching girls.  He had ignored previous warnings.
3791,15/12/2005,Iraq,Mosul,1,7,8,A polling station guard is killed when militants toss a grenade from a motorcycle.
3792,16/12/2005,Thailand,Pattani,1,0,1,A man is murdered by Islamists as he is walking home from evening exercises.
3793,16/12/2005,Thailand,Yala,1,0,1,Islamists murder a civilian.
3794,16/12/2005,India,Mohalla Jamia,2,0,2,The Mujahideen kills two villagers near their home.
3795,16/12/2005,India,Baramulla,2,0,2,"Two civilians die in separate incidents.  One is kidnapped and murdered, the other is killed with a grenade."
3796,16/12/2005,Iraq,Parwana,5,2,7,Four children playing soccer are among five killed by Islamic insurgents mortaring a schoolyard.  Two other children are injured.
3797,16/12/2005,India,Kulgam,1,0,1,A woman is shot to death by Islamic militants.
3798,16/12/2005,India,Jamia Mohalla,1,1,2,"The Mujahideen open fire on a group of civilians, killing one and injuring another."
3799,16/12/2005,Israel,Hebron,1,1,2,"al-Aqsa fires on a passenger car carrying Israeli civilians, killing a 35-year-old man."
3800,16/12/2005,Afghanistan,Kabul,2,2,4,Two passersby are killed by a Fedayeen suicide car bomber.  Two others are injured.
3801,17/12/2005,Iraq,Balad Ruz,3,1,4,A barbershop attack by fundamentalists leaves three dead and one injured.
3802,17/12/2005,Afghanistan,Akhundkariz,3,0,3,Three policemen are killed when religious extremists storm a checkpoint.
3803,17/12/2005,Afghanistan,Lashkargah,2,0,2,The Taliban murder an 18-year-old student and a school guard with automatic weapons.
3804,18/12/2005,Iraq,Baghdad,6,13,19,"Three attacks, including a Fedayeen bombing, leave four innocents dead and thirteen injured.  The bodies of two people are recovered elsewhere."
3805,18/12/2005,Iraq,Baghdad,3,2,5,A terrorist's roadside bomb kills two police officers and injures two.
3806,19/12/2005,Sudan,Abu Surooj,20,16,36,"Arab militias kill at least twenty villagers, including an elderly man, three women and two children."
3807,19/12/2005,Iraq,Baghdad,3,3,6,Three bodyguards of a politician are killed in a Jihad ambush on their car.
3808,19/12/2005,Iraq,Baghdad,2,11,13,A suicidal religious extremist kills two people outside a children's hospital with a bomb.
3809,19/12/2005,Pakistan,Miranshah,1,0,1,"The Taliban abduct and behead a man, then hang his body from a pole while throwing the head into a cemetery."
3810,20/12/2005,Afghanistan,Kabul,3,0,3,Three Afghan soldiers are killed in an ambush by religious extremists.
3811,21/12/2005,Thailand,Narathiwat,1,0,1,Muslims behead a Buddhist civilian.
3812,21/12/2005,Thailand,Narathiwat,1,0,1,A farmer is shot to death by Islamic terrorists.
3813,21/12/2005,Thailand,Yala,1,0,1,Muslim radicals shoot a 55-year-old Buddhist to death as he is working in his orchard.
3814,21/12/2005,Thailand,Yala,1,0,1,A 42-year-old man is gunned down by Islamists while walking home from work.
3815,21/12/2005,Pakistan,Wana,1,0,1,A man is abducted and beheaded by the local Taliban.
3816,21/12/2005,Pakistan,Wana,3,1,4,Religious fundamentalists kill three men at a barbershop.
3817,22/12/2005,Iraq,Iskandariya,4,1,5,"Sunni gunmen rake a passenger bus with machine-guns, killing at least four civilians."
3818,22/12/2005,Iraq,Baghdad,4,6,10,Jihadis murder four policemen at a checkpoint with a barrage of automatic weapons fire.  Six others are injured.
3819,22/12/2005,India,Sopore,2,3,5,Al-Mansooran claims responsibility for a grenade attack that kills one person.  Elsewhere (Guloora Handwara) a civilian is shot to death.
3820,22/12/2005,Pakistan,Miranshah,2,0,2,Two more bullet-ridden victims of Islamic seminary students calling themselves the Taliban are found in a stream.
3821,22/12/2005,Iraq,Baghdad,2,3,5,Two foreign civilians are killed in an IED terror attack.
3822,23/12/2005,Iraq,Adhaim,8,17,25,Eight Iraqi policemen are massacred when Jihadis open up on their checkpoint with rockets and automatic weapons.
3823,23/12/2005,Thailand,Narathiwat,0,7,7,"Islamists car-bomb a tea shop, injuring at least seven people."
3824,23/12/2005,Iraq,Balad Ruz,10,4,14,"A suicidal Sunni on a bicycle rides it up to a Shia mosque and detonates, killing ten innocents."
3825,23/12/2005,Chechnya,Grozny,9,4,13,The lives of nine people are cut short by Mujahideen terrorists in three attacks over 24 hours.
3826,24/12/2005,Bangladesh,Rajshahi,1,0,1,Radicals murder a university professor out for a morning walk.
3827,24/12/2005,Thailand,Narathiwat,1,0,1,A Buddhist civilian is shot to death by Muslim radicals.
3828,24/12/2005,Algeria,Boumerdes,3,13,16,"The Salafist Group for Preaching and Combat blows up a coast guard boat, killing three innocents."
3829,24/12/2005,Iraq,Baghdad,14,0,14,"Seven civilians are gunned down by Jihadis in three separate attacks, while the bodies of seven others are found bound and executed."
3830,24/12/2005,Thailand,Narathiwat,1,0,1,A 46-year-old school guard is cut down in a hail of automatic weapons fire from Muslim extremists.
3831,24/12/2005,Pakistan,Tank,1,0,1,Islamists kill the nephew of a pro-government leader at a market.
3832,25/12/2005,Iraq,Kirkuk,2,7,9,Two civilians are killed by a terrorist car bombing.
3833,25/12/2005,Thailand,Bannag Sata,1,1,2,A man is killed and a woman seriously injured by Islamic gunmen while riding a motorcycle.
3834,25/12/2005,Thailand,Raman,2,0,2,Two members of the Buddhist minority are shot to death by Muslim militants on a road.
3835,26/12/2005,India,Hiynan,1,0,1,The body of a civilian that had been abducted by Islamists is recovered.
3836,26/12/2005,Iraq,Baghdad,11,38,49,Five separate bombings kill eight civilians as three bodies are found bound and executed.
3837,26/12/2005,Iraq,Dhabab,5,0,5,Five Iraqi soldiers are killed in a coordinated terror attack.
3838,26/12/2005,Iraq,Buhriz,5,4,9,al-Qaeda slaughters five policemen at a checkpoint with rockets and mortars from point-blank range.
3839,26/12/2005,Dagestan,Makhachkala,2,0,2,Two people are gunned down by Jihadis in their car.
3840,26/12/2005,Sudan,Kulbus,20,13,33,"Suspected Arab militias attack a village, killing twenty people."
3841,26/12/2005,Thailand,Narathiwat,1,0,1,An innocent villager is murdered by Islamists.
3842,27/12/2005,Thailand,Narathiwat,1,0,1,A Buddhist villager is shot off the back of his motorcycle by Muslim gunmen.
3843,27/12/2005,Saudi Arabia,Buraydah,5,0,5,Five Saudi policemen are killed in two drive-by shooting attacks by an Islamic fundamentalists.
3844,27/12/2005,Iraq,Jbala,4,0,4,Four residents are killed in their homes by terrorists.
3845,27/12/2005,Iraq,Asriya,4,0,4,"Islamic insurgents attack a poultry farm, killing four Iraqi workers."
3846,28/12/2005,Iraq,Hilla,4,0,4,Two girls and their parents are stabbed to death by Allah's holy warriors.
3847,28/12/2005,Afghanistan,Kunar,2,2,4,"Two people, including a civilian, are killed when the Taliban ambush a military convoy."
3848,28/12/2005,India,Bangalore,1,4,5,Lashkar-e-Taiba suspected in a campus attack on a university professor and four others.
3849,28/12/2005,Thailand,Narathiwat,1,0,1,A village headsman is gunned down by Islamists.
3850,28/12/2005,Thailand,Yala,1,0,1,A civilian is shot and killed by Muslim gunmen.
3851,29/12/2005,Thailand,Narathiwat,1,0,1,A civilian shot and killed by Muslim terrorists in his home while eating dinner.
3852,29/12/2005,Iraq,Baghdad,4,5,9,Four Iraqi policemen are killed by a Fedayeen suicide bomber.
3853,29/12/2005,Israel,Tulkarm,5,10,15,"A suicide bomber exits a taxi and detonates an explosives belt, killing an Israeli and four other Palestinians, including the taxi driver.  Islamic Jihad takes credit."
3854,29/12/2005,Iraq,Latifiya,11,0,11,"Eleven members of a Shiite family are massacred by six Sunnis, who invade their home and slit the throats of all, including children."
3855,29/12/2005,Pakistan,Mir Ali,1,0,1,"al-Qaeda militants open fire on a restaurant, killing a Pakistani soldier."
3856,29/12/2005,Pakistan,Miranshah,1,0,1,"A local tribal leader is abducted by militant Muslims, who then slash his throat."
3857,30/12/2005,Afghanistan,Maywand,1,1,2,"The Taliban ambush a vehicle on a remote road, killing a passenger."
3858,30/12/2005,Iraq,Baghdad,6,23,29,Terrorists use mortars to kill six civilians near a coffee shop.
3859,30/12/2005,Afghanistan,Hazar Joft,4,7,11,Religious extremists use a bomb to kill four policemen and injure seven.
3860,30/12/2005,Pakistan,Khuzdar,2,0,2,Two security force members are gunned down in their car.
3861,30/12/2005,Pakistan,Gago Mandi,3,0,3,A father slits the throats of his three daughters after learning that at least one was 'dishonored' by adultery.
3862,30/12/2005,India,Poonch,1,1,2,The Mujahideen kill a police officer in a shooting ambush on a city street.
3863,30/12/2005,Iraq,Baghdad,9,0,9,"Islamic extremists kill nine people in a drive-by shooting, because the victims were drinking alcohol in public."
3864,30/12/2005,Thailand,Yala,1,1,2,Muslim extremists shoot a retired teacher to death as he is jogging along a road with his brother.
3865,31/12/2005,Chechnya,Grozny,5,2,7,Two civilians and a child are among five killed when Islamic militants attack a security patrol.
3866,31/12/2005,Pakistan,Rawalpindi,2,0,2,Islamic fundamentalists kill a 23-year-old Christian and his Muslim girlfriend because their relationship was against Sharia.
3867,31/12/2005,India,Pulwama,1,1,2,"The Mujahideen invade a home and open fire on the residents, killing the father and injuring another family member."
3868,31/12/2005,Indonesia,Sulawesi,8,56,64,Eight Christians are killed when Islamists bomb a market selling pork at a time when it is packed with shoppers.  The bomb was packed with nails.
3869,31/12/2005,Iraq,Khalis,5,2,7,Five civilians die in a bombing attack on their vehicle.
3870,1/1/2006,Thailand,Narathiwat,2,3,5,Two people are killed in a bomb blast staged by Islamic militants. Three others are injured.
3871,2/1/2006,India,Khog,1,0,1,An 18-year-old Hindu is kidnapped by militant Muslims and tortured to death.
3872,2/1/2006,Chechnya,Kurchaloi,2,0,2,Two Russian guards are killed by Jihadi snipers.
3873,2/1/2006,Thailand,Yala,1,3,4,"Islamic militants attack four Thai soldiers, capturing and beheading one of them."
3874,2/1/2006,Iraq,Iskandariya,3,0,3,Three more civilians are killed by Muslim radicals in a drive-by shooting.
3875,2/1/2006,Iraq,Kirkuk,2,2,4,"Two children, ages 7 and 10, are killed by Jihadi gunmen in an attack that also injures their parents."
3876,2/1/2006,Iraq,Baqubah,7,13,20,"A Fedayeen suicide bomber rams his car into a bus carrying police recruits, killing seven and injuring thirteen."
3877,3/1/2006,Thailand,Narathiwat,1,0,1,A militant Muslim assassinates a village headsman outside his home with an automatic rifle.
3878,3/1/2006,India,Bumloora,1,0,1,A civilian is abducted from his job site and hanged by the Mujahideen.
3879,3/1/2006,Afghanistan,Helmand,1,0,1,Two Taliban members shoot a humanitarian aid worker in the back of the head as he is kneeling in prayer.
3880,4/1/2006,Thailand,Sungai Padi,1,0,1,A 51-year-old man is gunned down by Islamic radicals as he is eating breakfast in a tea shop.
3881,4/1/2006,Afghanistan,Qalat,1,0,1,The Taliban kill the headmaster of a school by cutting off his head in front of his wife and eight children.
3882,4/1/2006,Iraq,Kirkuk,2,2,4,Two civilians are killed by a roadside terror bombing.
3883,4/1/2006,Iraq,Baghdad,3,13,16,Three civilians are killed and thirteen others injured by a terrorist car bombing on a city street.
3884,4/1/2006,Iraq,Muqdadiyah,36,40,76,Nearly forty people are blown to bits by a Fedayeen suicide bomber at a Shiite funeral for a child.  At least forty more suffer various injury and lost limbs.
3885,4/1/2006,Iraq,Baghdad,8,12,20,At least eight civilians are killed and twelve injured when radical Sunnis detonate a bomb near a market.
3886,4/1/2006,Iraq,Baghdad,4,0,4,An oil company employee and his son are shot to death in a Jihad attack.  Two other bodies found executed in Mahawil.
3887,4/1/2006,Russia,Gimry,1,8,9,One Russian is killed by Chechen Mujahideen who infiltrated the border.
3888,5/1/2006,Iraq,Baghdad,15,14,29,"Four bombs, two of them suicide attacks in Baghdad, leave four people dead in the capital and Najaf.  Four policemen are also killed by Jihad gunmen in Baqubah and seven U.S. soldiers are killed in two terror attacks."
3889,5/1/2006,Afghanistan,Tarin Kot,10,50,60,Two children are among ten people murdered by an Islamic suicide bomber in a crowded area of the capital.  Fifty others are injured.
3890,5/1/2006,Iraq,Ramadi,82,70,152,Eighty people waiting in line to apply for jobs at a recruiting station are blown to bits by a religious fanatic.  Another seventy are injured.
3891,5/1/2006,Iraq,Karbala,53,148,201,"A Sunni suicide bomber targets a Shia shrine, killing more than sixty innocent souls and injuring seventy more.  Women and children are amply represented among the victims."
3892,5/1/2006,Yemen,Al Salem,2,0,2,Two Yemeni troops are killed in an ambush by radical Islamists.
3893,6/1/2006,Yemen,Saada,4,2,6,"Four civilians are killed, and two injured, in a mortar attack by armed fundamentalists."
3894,7/1/2006,Iraq,Baghdad,1,1,2,"An American journalist is taken hostage, and her Iraqi translator murdered."
3895,7/1/2006,Algeria,Tissemsilt,4,0,4,Four civilian employees of a state water company are killed by the Salafist Group for Preaching and Combat.
3896,7/1/2006,Afghanistan,Jalalabad,1,1,2,A terrorist bombing by the Taliban leaves one civilian dead and another person injured.
3897,7/1/2006,Thailand,Yala,2,3,5,"Two policemen are murdered by Islamic fundamentalists.  Separately, a bomb at a tea shop injures three people."
3898,7/1/2006,Iraq,Fallujah,1,9,10,"A doctor is gunned down by Jihadis.  Elsewhere, a suicide bomber injures nine people."
3899,7/1/2006,Pakistan,Miranshah,8,6,14,Eight soldiers are massacred by religious militants at a border checkpoint.
3900,7/1/2006,Thailand,Yala,2,4,6,A grocery store is shot up by Muslim radicals.  Two people in their 20's are killed and four others injured.
3901,7/1/2006,Thailand,Pattani,1,3,4,"Islamic militants kill a pig farmer and also fire on a family of foreigners, injuring three, including a baby."
3902,7/1/2006,Pakistan,Wana,1,1,2,A 6-year-old boy is killed by a bomb that also injures an 8-year-old.
3903,7/1/2006,Pakistan,Kai Kot,5,0,5,A family is massacred by the Taliban.  The dead include a young girl.
3904,8/1/2006,Iraq,Baghdad,2,5,7,A Fedayeen suicide bomber kills two Iraqis and injures five others outside a mosque.
3905,9/1/2006,Thailand,Pattani,1,0,1,"The burnt body of a 74-year-old Buddhist is found after he is murdered by Islamic radicals, who beat the elderly man severely before slashing his throat."
3906,9/1/2006,Iraq,Baghdad,29,21,50,Two Fedayeen suicide bomber maximize their killing power and send themselves and dozens of others to Allah at a government building.
3907,9/1/2006,Thailand,Yala,1,0,1,Muslim radicals shoot a 60-year-old Buddhist three times in the neck after vowing to 'keep killing innocents'.
3908,9/1/2006,Iraq,Kirkuk,1,0,1,Ansar al-Sunna terrorists gun down a judge.
3909,9/1/2006,India,Awantipora,1,0,1,The Mujahideen abduct a man from his home and shoot him to death.
3910,10/1/2006,Pakistan,Sarbandki,7,2,9,al-Qaeda backed militants kill seven Pakistani soldiers in a rocket attack.
3911,11/1/2006,India,Udhampur,1,2,3,A teenage girl is killed when militants hurl a grenade into her home on Eid day.  Two other relatives are injured.
3912,11/1/2006,Philippines,Maguindanao,1,1,2,The Moro Islamic Front is suspected in the assassination of a local sultan.
3913,13/1/2006,Iraq,Baqubah,3,5,8,"Two policemen are killed by a car bomb.  Another dead officer is found in Iskandariya, blindfolded and with hands tied behind his back."
3914,14/1/2006,Pakistan,Sarbandki,1,3,4,A rocket attack leaves one man dead and three children injured.
3915,14/1/2006,Iraq,Baghdad,3,4,7,"Sunni gunmen assassinate a Shiite cleric.  Elsewhere, a bomb kills two policemen."
3916,14/1/2006,Afghanistan,Kandahar,1,0,1,The Taliban assassinate a political figure outside his home.
3917,14/1/2006,Afghanistan,Khost,0,22,22,"Religious fundamentalists bomb a sporting event and a music shop, injuring twenty-two."
3918,14/1/2006,Pakistan,Sarband,1,2,3,"al-Qaeda backed militants fire a rocket into a home, killing a man and injuring his two children."
3919,15/1/2006,Pakistan,Jangzai,2,0,2,Two men are killed in a landmine blast.
3920,15/1/2006,Iraq,Ulwiya,6,8,14,Five separate Jihad attacks and kidnappings leave at least six dead around the country.
3921,15/1/2006,Afghanistan,Kandahar,3,14,17,"At least three people are killed, including two civilians, when a suicide bomber rams a Canadian convoy."
3922,15/1/2006,Thailand,Narathiwat,2,0,2,Islamists butcher two 20-year-old men in a gruesome attack.
3923,15/1/2006,India,Kashmir Valley,1,0,1,A contractor is abducted and killed by the Mujahideen.
3924,16/1/2006,Afghanistan,Kandahar,5,10,15,"Five people are killed and ten others injured by a ""Holy Warrior"" suicide bomber."
3925,16/1/2006,Afghanistan,Spin Boldak,22,20,42,"A Fedayeen bomber plows an explosives-laden motorbike into a crowd of people in a downtown area, killing at least twenty-two."
3926,16/1/2006,India,Kulgam,2,1,3,Islamic radicals gun down two political activists in separate attacks.
3927,16/1/2006,Iraq,Ramadi,1,0,1,A physics professor is gunned down in a brutal attack.
3928,16/1/2006,Iraq,Miqdadia,6,18,24,"A Jihad car bombing kills six, including a child, and injures eighteen."
3929,16/1/2006,Chechnya,Grozny,1,3,4,A policeman is killed by Jihadis.
3930,17/1/2006,Chechnya,Grozny,5,0,5,Four Russians and one Chechen are blown apart in a landmine attack by Muslim rebels.
3931,17/1/2006,Iraq,Kirkuk,2,1,3,Radical Sunni gunmen kill two Kurdish election officials in separate attacks.
3932,18/1/2006,Iraq,Baghdad,3,0,3,Sunni radicals infiltrate an office building and murder three men.
3933,18/1/2006,Iraq,Baghdad,12,2,14,"Jihadis ambush a private convoy, blasting and shooting twelve guards and bystanders to death and kidnapping two African engineers."
3934,18/1/2006,Iraq,al-Sa'diya,5,9,14,Four people are killed in a terror bombing attack on a police vehicle.
3935,18/1/2006,India,Pampore,1,0,1,The body of a civilian is recovered ten days after being abducted by the Mujahideen.
3936,18/1/2006,Iraq,Basra,2,1,3,Two American civilians are killed in a roadside terrorist bombing.
3937,19/1/2006,Egypt,Udaysaat,2,14,16,"Muslims go on a rampage against Christians, angered by the construction of a church.  Two, including a 13-year-old boy, are killed."
3938,19/1/2006,Iraq,Dujail,12,0,12,Twelve civilians are machine-gunned to death by radical Sunnis after their cars were stopped at a fake roadblock.
3939,19/1/2006,Israel,Tel Aviv,0,20,20,A Palestinian suicide bomber injures two dozen Israelis in an attack on a fast-food stall at a bus station.
3940,19/1/2006,Iraq,Baghdad,23,26,49,"Two religious extremists hit a coffee shop in a downtown area with suicide bombs, dismembering themselves and twenty-three innocents while causing egregious injury to two dozen others."
3941,19/1/2006,India,Khrew Pampore,1,0,1,A civilian is shot to death by the Mujahideen at his village.
3942,20/1/2006,Iraq,Baghdad,1,0,1,A homosexual is shot to death by Islamic extremists.
3943,20/1/2006,Ingushetia,Ordzhonikidzevskaya,1,2,3,"Suspected Islamists invade the home of a civilian, killing him and injuring his wife and son."
3944,20/1/2006,Thailand,Narathiwat,1,0,1,A 63-year-old farmer is killed when a bomb planted at the base of a cell tower explodes.
3945,20/1/2006,Iraq,Baghdad,6,3,9,Four civilians are killed in a roadside bomb and two other people are gunned down by Muslim radicals in separate Karbala attacks.
3946,20/1/2006,Iraq,Dujail,9,0,9,The bodies of seven civilians are found bound and executed where two others were found days earlier.
3947,20/1/2006,Ingushetia,Nazran,2,2,4,Two civilians are killed by Islamic terrorists in a small village.
3948,20/1/2006,Indonesia,Waghete,4,1,5,Indonesian soldiers kill four unarmed Papua teenagers (ages 13 to 15) in an unprovoked attack as they are walking to school.  A fifth boy is severely beaten.
3949,21/1/2006,Pakistan,Angoor Adda,4,2,6,Four civilians die when militants hit a food store with a rocket.
3950,21/1/2006,Iraq,Baghdad,3,0,3,Three butchers standing on a corner are mowed down in a drive-by shooting by radical Muslims.
3951,21/1/2006,Iraq,Tikrit,6,9,15,"Six people, including a child, are killed in four separate Jihad attacks across the country."
3952,21/1/2006,India,Budshah Chowk,0,7,7,Seven people are injured in a Mujahideen grenade attack.
3953,21/1/2006,Afghanistan,Ghazni,1,1,2,A policeman is killed in a Taliban ambush.
3954,22/1/2006,Iraq,Baqubah,12,16,28,"A suicide car bombing, two brutal kidnappings (including a man and his son) and a roadside terror attack leave twelve people dead across the country."
3955,22/1/2006,Iraq,Balad Ruz,5,1,6,Four children (ages 6 to 11) and a man are killed when Islamic insurgents deliberately fire a rocket into a home.
3956,22/1/2006,Iraq,Mashahidah,23,0,23,"The bodies of twenty-three police recruits are found bound and executed, days after they were forced off a bus at gunpoint by Sunni terrorists."
3957,23/1/2006,Iraq,Baghdad,3,20,23,"A Fedayeen suicide car bomber kills two civilians.  Another civilian is killed, and over a dozen wounded in two other car bombings."
3958,24/1/2006,Iraq,Dujail,11,3,14,The bodies of eight police recruits are found.  Two separate Jihad attacks claim three more lives elsewhere.
3959,24/1/2006,Iran,Ahvaz,8,46,54,At least eight people are killed by two bombs in an Iranian city.  Some forty-six are injured in the sectarian attack.
3960,25/1/2006,Bangladesh,Meherpur,2,9,11,Jama'atul Mujahideen terrorists kill a Hindu woman and her daughter at a memorial service for her dead father by throwing two bombs at them.  Nine others were injured.
3961,25/1/2006,Afghanistan,Gomal,2,2,4,"Taliban militants attack a remote police post with rockets, killing two and injuring two."
3962,25/1/2006,Tajikistan,Ghayroghum,1,0,1,Uzbeki Islamic Movement terrorists kill a prison warden to free a comrade.
3963,26/1/2006,Iraq,Baghdad,12,7,19,"Jihadis kill at least ten people in five separate attacks, along with two bodies found bound and blindfolded a day earlier."
3964,26/1/2006,Iraq,Balad,3,1,4,"Terrorists attempt an assassination, killing three bodyguards instead."
3965,27/1/2006,Afghanistan,Helmand,2,2,4,Religious extremists kill two policemen with a roadside bomb.
3966,27/1/2006,India,Tral,1,0,1,A policeman is killed in a Mujahideen mine attack.
3967,28/1/2006,Iraq,Fallujah,7,9,16,Five separate Jihad attacks leave seven people dead and nine others injured.
3968,28/1/2006,Iraq,Karbala,6,0,6,"Six bodies are found bound, blindfolded and executed in a garbage dump."
3969,28/1/2006,India,Poonch,2,2,4,"Two army personnel are killed by Lashkar-e-Toiba and Jaish-e-Mohammed terrorists, who infiltrated the border."
3970,29/1/2006,Philippines,Pulunoling,2,0,2,Muslims shoot a Christian couple to death as they are riding a motorcycle on their way home.
3971,29/1/2006,Iraq,Iskandariya,11,5,16,"Radical Sunnis plant a bomb outside a shop in a Shia town, blowing at least ten people into disparate parts."
3972,29/1/2006,Thailand,Pattani,1,0,1,Muslim terrorists shoot a 41-year-old government official to death in his home.
3973,29/1/2006,Thailand,Pattani,1,0,1,A 38-year-old schoolteacher is killed by Muslim radicals while walking home from work.
3974,29/1/2006,Thailand,Narathiwat,2,0,2,"Islamic militants open fire on a railway station, killing two guards."
3975,29/1/2006,India,Kanjikullah,1,0,1,A policeman is abducted and murdered by the Mujahideen.
3976,29/1/2006,Iraq,Ojah,4,6,10,"A Fedayeen suicide bomber blows himself to Allah, taking several innocents along with him."
3977,29/1/2006,Iraq,Kirkuk,3,11,14,"Muslims target Christian churches with six car bombs, killing at least three people and injuring eleven."
3978,30/1/2006,Pakistan,Miranshah,2,11,13,Two Pakistani soldiers are killed by an al-Qaeda landmine.
3979,31/1/2006,Iraq,Baghdad,1,0,1,A baker is killed by Islamic radicals in his shop.
3980,31/1/2006,Iraq,Muqdadiyah,4,0,4,Jihadis kill the wife and two sons of a religious cleric in their home.
3981,31/1/2006,Iraq,Baghdad,14,0,14,"The bodies of fourteen young people are found blindfolded, bound and executed at two separate sites."
3982,1/2/2006,Iraq,Baghdad,8,50,58,A Fedayeen bomber kills eight men waiting for work next to a crowded intersection.  At least fifty others are in various states of physical agony from the blast.
3983,1/2/2006,Philippines,Jolo,2,0,2,A man and his son are gunned down on their way home by Islamists.
3984,1/2/2006,Iraq,Baghdad,8,0,8,Sunni insurgents kill at least eight people in four separate terror attacks around the country.
3985,1/2/2006,Thailand,Pattani,1,0,1,Muslims stab a 63-year-old Buddhist man to death as he is working his rubber plantation.
3986,2/2/2006,Russia,Vladikavkaz,2,16,18,Muslim separatists are suspected to be behind three bombings at gambling establishments that kill a young man and woman.
3987,2/2/2006,Thailand,Narathiwat,2,1,3,Islamists kill a village chief's driver and deputy with a shrapnel bomb hidden under their vehicle.
3988,2/2/2006,Iraq,Baghdad,19,11,30,"The bodies of fourteen men, blindfolded and tortured, are discovered.  Sectarian violence also claims five other lives in five additional attacks around the country."
3989,2/2/2006,Afghanistan,Khost,5,3,8,The Taliban send a Fedayeen suicide bomber to kill three Afghan soldiers and two civilians at a checkpoint.
3990,2/2/2006,Thailand,Pattani,1,0,1,A 42-year-old wood trader is gunned down by Muslim terrorists.
3991,2/2/2006,Thailand,Janae,1,5,6,A Buddhist policeman is killed when Islamic radicals attempt to kill a group of teachers under escort in a motorcade with a bomb hidden in a fire extinguisher.
3992,2/2/2006,Iraq,Baghdad,16,90,106,Sixteen people are killed in two Islamic terror bombings.  One shrapnel bomb detonated at a gas station and the other at a market.
3993,3/2/2006,Bangladesh,Rajshahi,1,0,1,A university professor is murdered after receiving death threats from Islamic fundamentalists.
3994,3/2/2006,Philippines,Patikul,6,5,11,Islamists massacre a family of Christians after confirming their religious identity.  The victims included an infant and other young children.
3995,3/2/2006,Afghanistan,Helmand,3,13,16,Three policemen are killed and thirteen injured in a series of Taliban ambushes.
3996,3/2/2006,Thailand,Songkhla,1,4,5,A Buddhist teacher is gunned down by Muslim militants and four others are wounded in a separate attack on teachers.
3997,3/2/2006,Iraq,Hawija,1,0,1,"In a heinous attack, Sunni extremists kill an Iraqi translator."
3998,4/2/2006,India,Sarhuti,1,0,1,Hizb-ul-Mujahideen  behead a young man.
3999,4/2/2006,Thailand,Yala,1,32,33,"Thirty-three people are injured by a mobile-phone bombing at a cafe, including a teenager who succumbs to injuries two days later."
4000,4/2/2006,Pakistan,Zarmilan,3,1,4,"al-Qaeda militants detonate a bomb under a truck, killing three Pakistanis."
4001,4/2/2006,Pakistan,Bahawalpur,2,27,29,Two people are killed in a train crash resulting from an act of sabotage by suspected Islamists.
4002,4/2/2006,Afghanistan,Helmand,5,0,5,"Two overnight attacks by religious extremists leave at least five people dead, including a district chief."
4003,4/2/2006,Afghanistan,Nish,6,5,11,Six policemen are killed when Islamic fundamentalists set off a landmine under their vehicle.
4004,4/2/2006,Afghanistan,Kandahar,2,3,5,A woman and her child are killed in a Taliban remote-control bomb attack on a city street.
4005,4/2/2006,Iraq,Nasiriyah,3,0,3,"A Sunni radical fires into a crowd of Shiites marching in a procession, killing three."
4006,5/2/2006,Pakistan,Quetta,12,13,25,A dozen people are blown to bits when Taliban terrorists bomb a passenger bus.
4007,5/2/2006,Israel,Petach Tikva,1,4,5,A Palestinian stabs an Israeli woman to death as she is riding a bus.  Four others were stabbed as well.
4008,5/2/2006,Iraq,Baghdad,6,12,18,"Six people are killed in four separate attacks by Jihadis, including two men who were tortured to death."
4009,5/2/2006,Iraq,Salman Pak,2,7,9,"Two people are killed, and seven wounded by a car bomb along a city street."
4010,5/2/2006,Turkey,Trabzon,1,0,1,A Catholic priest is murdered by an assailant who shouts 'Allah Akbar!' after he fires the gun.
4011,5/2/2006,India,Baramulla,1,0,1,A civilian is murdered by the Mujahideen.
4012,6/2/2006,Thailand,Narathiwat,1,0,1,Muslims kill a 71-year-old Buddhist as he is on his way home with his 16-year-old granddaughter.
4013,6/2/2006,Thailand,Banangstar,3,0,3,Three villagers are shot to death by Muslim militants in a heinous attack on a market.
4014,6/2/2006,Iraq,Dujail,4,0,4,"The body of an Iraqi contractor is found, and three other people are killed in two separate Jihad attacks."
4015,6/2/2006,India,Gursai,1,0,1,Muslim terrorists abduct a civilian from his home and murder him in captivity.
4016,6/2/2006,India,Amirabad Tral,1,0,1,Muslim terrorists gun down a policeman.
4017,7/2/2006,Afghanistan,Bala Buluk,4,3,7,"Two engineers working on road construction are killed by religious extremists in a bomb attack, along with two Afghans."
4018,7/2/2006,Afghanistan,Kandahar,13,11,24,"A Fedayeen suicide bomber drives an explosives-laden motorbike into a crowd near a police post, killing at least thirteen."
4019,7/2/2006,Iraq,Yusufiyah,7,4,11,Seven people are killed in at least three separate attacks around the country by Jihad terrorists.
4020,7/2/2006,Iraq,Baghdad,8,23,31,Seven civilians are among eight people blown to bits by two terrorist bombings along a crowded roadside.
4021,7/2/2006,Thailand,Narathiwat,1,0,1,A Buddhist is shot in the head at close range by Muslims while on his way home.
4022,8/2/2006,Pakistan,Dabkot,1,0,1,"Local Islamists abduct and behead a man, leaving the body with a note attached."
4023,8/2/2006,Iraq,Ramadi,5,3,8,Three civilians are among five people killed when a Fedayeen suicide bomber rams a checkpoint with a car.
4024,9/2/2006,Pakistan,Hangu,31,50,81,Some 31 Shiites are blown to bits while celebrating a religious holiday by a suicidal Sunni extremist.  The dead include women and children.
4025,9/2/2006,Iraq,Baghdad,4,2,6,"Jihadi gunmen kill four people in three separate attacks, including two who were murdered in captivity."
4026,9/2/2006,Afghanistan,Herat,5,27,32,At least five people die in religious violence after Sunnis accuse Shias of destroying a sacred flag.
4027,9/2/2006,India,Kither,2,0,2,A woman is among two people killed in an ambush by Muslim terrorists.
4028,10/2/2006,Philippines,Sulu,1,0,1,Abu Sayyaf terrorists kill a police chief in front of his family.
4029,10/2/2006,Afghanistan,Kunar,8,6,14,"Eight Afghan soldiers are killed by two Taliban landmines, the second designed to kill those trying to help the first."
4030,10/2/2006,Iraq,Baqubah,4,2,6,"Four people are killed in three separate Jihad attacks, including a woman inside her home."
4031,10/2/2006,Iraq,Baghdad,9,38,47,A grisly scene as nine people are killed at a Shiite mosque by a car bomb detonated by radical Sunnis.  Nearly forty others were injured.
4032,10/2/2006,Pakistan,Sydan Banda,4,2,6,A woman is among four people killed when radicals open fire on a train in a sectarian attack.
4033,10/2/2006,India,Gursai,1,0,1,A civilian is abducted and hanged to death by the Mujahideen.
4034,10/2/2006,Pakistan,Sangsilla,3,4,7,"Three members of a family, including two women, are blown apart in a roadside bomb blast."
4035,10/2/2006,Philippines,Jolo,2,0,2,Militant Muslims shoot a policeman in the head in front of a bakery.  The same group beheaded another man in a separate attack in the same area.
4036,10/2/2006,Iraq,Baghdad,1,2,3,A brutal shooting attack in which a Fedayeen holds a gun to a woman's head before killing her.
4037,11/2/2006,Iraq,Baqubah,2,0,2,Radical Sunnis sneak up and shoot two policemen in the head as they are sitting in their car.
4038,11/2/2006,Ingushetia,Troitskaya,1,4,5,"Islamic militants ambush a troop carrier with automatic weapons, killing one Russian soldier."
4039,11/2/2006,India,Shedgam,1,0,1,Muslim radicals kill a civilian outside his home.
4040,11/2/2006,Pakistan,Hangu,3,2,5,"Three more people, including a 9-year-old boy, are killed in sectarian violence."
4041,12/2/2006,Iraq,Kirkuk,7,17,24,A doctor and a sports director are among seven people gunned down by Jihadis in four separate attacks around the country.
4042,12/2/2006,Iraq,Mahawil,6,0,6,"The bodies of six people, who were bound and tortured, are found at three separate sites."
4043,12/2/2006,Iraq,Baghdad,4,4,8,A Fedayeen suicide bomber kills four people at a checkpoint.
4044,12/2/2006,Iraq,Baghdad,2,3,5,A child is among two killed by a roadside terror bombing.
4045,12/2/2006,Afghanistan,Helmand,8,0,8,Two Afghan soldiers are killed in a Taliban ambush.  Another six are captured and executed in captivity.
4046,13/2/2006,France,Saint Genevieve des Bois,1,0,1,A young Jewish man is kidnapped by a Muslim gang and tortured for three weeks before expiring of his wounds.
4047,13/2/2006,Iraq,Baqubah,4,0,4,"Sunnis slaughter a family of four Shias sitting in their car, in an automatic weapons attack."
4048,13/2/2006,Iraq,Baghdad,7,47,54,"A Fedayeen suicide bomber standing outside a bank blows himself to Allah, taking at least seven innocent bystanders with him.  Children are among the victims."
4049,13/2/2006,Afghanistan,Grishk,7,0,7,Seven policemen are gunned down at a road construction guard post by the Afghan Taliban.
4050,13/2/2006,Pakistan,Manawan,1,0,1,A doctor is gunned down outside his clinic.
4051,14/2/2006,Pakistan,Peshawar,1,0,1,An 8-year-old boy is shot in the face by an Islamic activist protesting cartoons.
4052,14/2/2006,Iraq,Balad,11,1,12,"A horrible Valentine's day massacre as Sunnis round up a family of Shiites and then machine-gun them to death, including a 5-year-old boy.  Only one other child escaped death."
4053,14/2/2006,India,Sopore,1,5,6,Six civilians are injured when a Muslim militant tosses a grenade into the street.  One succumbs to injuries two days later.
4054,14/2/2006,Iraq,Tikrit,3,0,3,"Gunmen kill an Iraqi contractor and, in a separate attack in Baghdad, a man and his son."
4055,15/2/2006,Pakistan,Hub,4,0,4,Three Chinese engineers and their Pakistani driver are shot to death in their car by Muslim terrorists.
4056,15/2/2006,Iraq,Baghdad,6,12,18,"Two deadly bombing attacks, including one at a university leave six Iraqis dead, as five more bodies are found dumped elsewhere."
4057,15/2/2006,Iraq,Baghdad,4,0,4,"Four children, ages 10 to 14, are blown up by Islamic fundamentalists targeting a liquor store as they are walking to school.  Two brothers and their sister were among the four."
4058,15/2/2006,UAE,Fujairah,1,0,1,"A Hindu sailor is beaten to death by Iranian crewmates, angered over Muhammad cartoons."
4059,15/2/2006,Afghanistan,Nimroz,1,4,5,An attack by religious fundamentalists kills one policeman and leaves four others injured.
4060,15/2/2006,India,Bugam Kulgam,1,1,2,"The Mujahideen force their way into a home, then shoot a man to death and injure his brother."
4061,16/2/2006,Thailand,Narathiwat,1,0,1,Muslim militants murder a policeman assigned to guard teachers from terror attacks.
4062,16/2/2006,Iraq,Baghdad,9,19,28,"Two car bombs, one near a crowded market, kill seven civilians and injure over a dozen more.  Elsewhere, four bodies are found bound and blindfolded."
4063,16/2/2006,Afghanistan,Farah,2,0,2,Two Afghani intelligence agents are kidnapped and beheaded by religious extremists.
4064,17/2/2006,Iraq,Baghdad,12,4,16,"Jihadis kill a dozen people in four separate attacks, which included an 18-month-old girl and the kidnapping of a bank manager and his son after slaughtering five bodyguards."
4065,17/2/2006,Thailand,Yala,1,0,1,A security guard at an irrigation plant is murdered by Islamic militants.
4066,17/2/2006,Thailand,Narathiwat,1,13,14,"Islamists shoot a Buddhist villager, then detonate a bomb that injures thirteen people investigating the scene."
4067,17/2/2006,India,Panglar,1,1,2,The Mujahideen gun down a policeman in a brutal attack that also injures a young girl.
4068,18/2/2006,Nigeria,Maiduguri,21,112,133,Angry Muslim mobs burn churches and beat Christians to death.  At least sixteen people are killed in the violence.
4069,18/2/2006,Iraq,Baqubah,2,5,7,Two Jihad bombings kill two people and injure five.
4070,18/2/2006,Iraq,Baghdad,7,4,11,Five people are killed in three separate roadside terror attacks as two more kidnap victims are discovered.
4071,18/2/2006,Philippines,Jolo,2,22,24,"Abu Sayyaf bombs a karaoke bar, killing a janitor and injuring about two dozen others.  Another civilian later dies of injuries."
4072,18/2/2006,Afghanistan,Helmand,3,0,3,A late night attack by the Taliban on a police post leaves three officers dead.
4073,19/2/2006,Iraq,Baghdad,2,4,6,Car bombing on a city street followed by a suicide bomber kills two people.
4074,19/2/2006,Iraq,Kirkuk,3,0,3,Three policemen are killed by radical Sunnis in a roadside bombing.
4075,19/2/2006,Nigeria,Borno,7,24,31,Muslim mobs target Nigerian Christians in a protest against Danish cartoons.  More churches are burned and seven more are killed.
4076,19/2/2006,India,Srinagar,1,0,1,A civilian is gunned down in broad daylight by the Mujahideen.
4077,19/2/2006,Thailand,Yala,2,0,2,"Two people, at least one of whom was Buddhist, are shot to death by Muslim radicals in separate attacks."
4078,19/2/2006,Thailand,Narathiwat,1,0,1,Islamists murder a civilian.
4079,20/2/2006,Iraq,Baghdad,10,53,63,Muslim radicals kill ten people in five deadly attacks around the country.
4080,20/2/2006,Iraq,Kadhimiya,12,9,21,A Fedayeen suicide bomber massacres a dozen innocent Shias on a passenger bus.  Survivors suffered horrible burns.
4081,20/2/2006,Iraq,Mosul,5,21,26,"A Jihadi eats his breakfast at a packed diner, then places a bomb under the counter before walking out.  Five people killed.  Two dozen injured."
4082,20/2/2006,Pakistan,Eisokhel,1,0,1,Uzbeki Islamists kill a local tribesman in a terror attack.
4083,20/2/2006,India,Pattan,1,0,1,Militant Muslims shoot a civilian to death on a highway.
4084,20/2/2006,Nigeria,Maiduguri,30,95,125,An additional thirty bodies are counted from the Muslim rioting against Christians over the weekend.
4085,21/2/2006,Ingushetia,Troitskaya,1,0,1,Suspected Islamists kill a Russian woman with a grenade.
4086,21/2/2006,Nigeria,Bauchi,25,100,125,"Muslims mobs take out their rage on Christians in yet a third Nigerian state, killing at least twenty-five and injuring over one-hundred in a two-day spree."
4087,21/2/2006,Pakistan,Angoor Adda,2,0,2,Islamists shoot two brothers execution-style.
4088,21/2/2006,Iraq,Baghdad,22,28,50,"Jihadis set off a car bomb at a crowded market, killing at least twenty-two innocents and injuring dozens more."
4089,21/2/2006,Iraq,Iskandariya,5,8,13,A roadside bomb destroys a pick-up truck carrying workers to a job site.  Two similar attacks elsewhere take four more lives.
4090,21/2/2006,Thailand,Yala,1,0,1,Thai Islamists gun down a border patrolman as he is riding a motorcycle.
4091,22/2/2006,Uzbekistan,Tashkent,1,0,1,A local Jewish leader and father of four is beaten to death.
4092,22/2/2006,Iraq,Baghdad,6,12,18,Three Sunni clerics are assassinated as Shias go on a mosque-burning  rampage.  Three guards are also killed.
4093,22/2/2006,Iraq,Baqubah,6,0,6,Two brothers are among six people gunned down in two separate attacks by radical Sunnis.
4094,22/2/2006,Iraq,al-Mashrugiya,3,4,7,Two children and a woman are killed when terrorists set off a bomb near a primary school.
4095,22/2/2006,Afghanistan,Kunduz,1,12,13,"Religious extremists set off a bicycle bomb, killing one civilian and injuring twelve."
4096,22/2/2006,Pakistan,Wana,1,3,4,al-Qaeda supported militants kill a village chief and injure three of his family members.
4097,22/2/2006,India,Sopore,1,0,1,The Mujahideen murder a woman outside her village.
4098,23/2/2006,Pakistan,Vehari,2,0,2,A man shoots his two sisters to death on suspicion that they were having love affairs.
4099,23/2/2006,Iraq,Baghdad,54,0,54,Reprisal from the destruction of a Shiite mosque leaves at least fifty Sunnis dead in random attacks around the capital.
4100,23/2/2006,Iraq,Baqubah,21,31,52,A suicide bomber slaughters sixteen people at a market and injures two dozen others.  Five people are killed in a second bombing
4101,23/2/2006,Iraq,Basra,25,16,41,Radical Shias raid a prison and haul away thirteen Sunni prisoners.  At least eleven are executed.  Separate attacks leaves more casualties.
4102,23/2/2006,Iraq,Nahrawan,47,0,47,"In a horrific crime, 47 demonstrators for peace, ages 20 to 50, are forced from their cars at gunpoint and then machine-gunned to death by Sunni Jihadis."
4103,23/2/2006,Iraq,Samarrah,3,1,4,"A reporter for the al-Arabiya network is kidnapped, stripped naked, tortured and then brutally murdered by men shouting 'Allah Akbar'."
4104,23/2/2006,India,Srinagar,1,0,1,Islamic terrorists murder a university student.
4105,24/2/2006,Saudi Arabia,Abqaiq,2,10,12,Two oil refinery guards are killed defending the plant against suicide bombers.
4106,24/2/2006,Iraq,Latifiya,3,2,5,Sunni gunmen raid a house in the middle of the night and kill two women and a man.  Two young children are injured in the attack.
4107,24/2/2006,Afghanistan,Girishk,4,0,4,Taliban fundamentalists ambush and kill four Afghan soldiers.
4108,24/2/2006,Nigeria,Potiskum,4,12,16,"At least four Christians are clubbed to death by a Muslim mob, and five churches burned."
4109,24/2/2006,Nigeria,Kontagora,9,27,36,Machete-wielding Muslims hack nine Christians apart and set fire to four churches.
4110,25/2/2006,India,Sarhuti,1,0,1,"Only weeks after the Hizb-ul-Mujahideen beheaded her fiancé, the same group breaks into a young woman's house and shoots her to death."
4111,25/2/2006,Iraq,Baqubah,13,0,13,"In a horrible attack, thirteen members of a Shia family (representing three generations) are slaughtered by Sunni gunmen as they are fleeing the violence."
4112,25/2/2006,Iraq,Karbala,8,31,39,Eight people are blown apart by a Sunni car bomb at a crowded market.  At least thirty others are injured.
4113,25/2/2006,Iraq,Baghdad,26,0,26,Twenty-six bodies are found in six locations in the city.  Some showed signs of torture.
4114,25/2/2006,Iraq,Baghdad,3,8,11,"Radicals attack a funeral procession for a journalist, killing at least three people."
4115,25/2/2006,Thailand,Pattani,1,0,1,A Thai soldier is killed after being ambushed by Islamic radicals.
4116,25/2/2006,Ingushetia,Ordzhonikidzevskaya,1,1,2,A woman is killed when a militant throws a hand grenade trough the window of her house.
4117,26/2/2006,Iraq,Baghdad,21,55,76,"Muslim radicals shoot mortars into residential neighborhoods, killing fifteen Sunnis and three Shias.  Three other bodies are found elsewhere."
4118,26/2/2006,Iraq,Baqubah,2,5,7,"Jihadis open fire on a group of teenagers playing soccer, killing two boys and injuring five."
4119,26/2/2006,Iraq,Hilla,5,3,8,"A Muslim terrorist detonates a bomb in a passenger bus at a station, killing at least five people."
4120,26/2/2006,Thailand,Pattani,1,0,1,A local doctor is killed by Islamists while walking home from work.
4121,26/2/2006,Iraq,Mosul,1,0,1,Angry Muslims pull a pediatrician from his office and execute him.
4122,26/2/2006,Afghanistan,Kabul,6,38,44,Taliban-led prison uprising leaves six inmates dead and about forty injured.
4123,26/2/2006,Pakistan,Tank,2,2,4,Two policemen are killed by al-Qaeda militants.
4124,27/2/2006,India,Sopore,1,0,1,The Mujahideen gun down a civilian on the street.
4125,27/2/2006,Thailand,Narathiwat,2,0,2,Two villagers are gunned down by Islamic terrorists in separate attacks.
4126,27/2/2006,Iraq,Baghdad,11,17,28,Four people are killed in a mortar attack and three more die in a roadside bombing near Kirkuk.  Four bound bodies are found elsewhere.
4127,27/2/2006,Iraq,Baqubah,2,5,7,Gunmen kill the owner of a glaze shop and an employee.
4128,27/2/2006,Saudi Arabia,Riyadh,2,3,5,Two Filipino oil workers are killed when al-Qaeda militants open fire on Saudi security forces.
4129,28/2/2006,India,Bijbehara,1,0,1,Islamic terrorists kill an animal worker.
4130,28/2/2006,Thailand,Narathiwat,0,8,8,A bomb hidden in a food market injures eight.
4131,28/2/2006,Iraq,Baghdad,18,42,60,Four separate Jihad bombings leave at least eighteen dead and over forty injured.
4132,28/2/2006,Iraq,Baghdad,23,51,74,"A Fedayeen suicide bomber joins a line of people waiting for kerosene, then detonates his explosives, killing two dozen innocents and injuring many more."
4133,28/2/2006,Iraq,Tarfaya,9,0,9,"Sunnis roundup and execute nine Shias, leaving their bodies at a dump site."
4134,28/2/2006,Iraq,Hurriyah,23,55,78,"Religious extremists bomb a Shiite mosque, slaughtering twenty-three innocents and leaving dozens more in various states of agony."
4135,1/3/2006,Iraq,Baghdad,2,5,7,Radicals kill two family members attending a Shiite funeral.
4136,1/3/2006,Iraq,Mahmudiya,3,2,5,Terrorists use mortar rounds to kill three members of the same family.
4137,1/3/2006,Iraq,Kirkuk,4,8,12,"Jihadis ambush a police patrol, killing four officers."
4138,1/3/2006,Thailand,Narathiwat,1,0,1,Islamic militants murder a rubber wood trader.
4139,1/3/2006,Thailand,Yala,1,0,1,A postman is shot to death by Islamists.
4140,1/3/2006,India,Baramulla,2,0,2,Two policemen are murdered by Islamic militants while on street patrol.
4141,1/3/2006,Israel,Samaria,1,1,2,Two Muslims gun down a Jew outside a gas station.  The victim was a father of two.
4142,1/3/2006,Iraq,Baghdad,27,68,95,Radical Muslims set off two car bombs in civilian areas.  At least twenty-five people are burned to death or torn apart by shrapnel.
4143,1/3/2006,India,Titwan,1,0,1,The Mujahideen abduct a teenage boy and then behead him in captivity.
4144,1/3/2006,Pakistan,Sergardan Chowk,1,0,1,The local Taliban kill a civilian and leave his body in the open.
4145,1/3/2006,India,Baramulla,2,0,2,Two security personnel are gunned down by the Mujahideen.
4146,2/3/2006,India,Tarzoo,1,0,1,A civilian is murdered by the Mujahideen.
4147,2/3/2006,Iraq,Basra,3,0,3,"A Sunni cleric is assassinated, and a man and woman are found dead from a separate Shiite attack."
4148,2/3/2006,Iraq,Mosul,4,0,4,"In a senseless act of violence, gunmen spray a car with machine-gun fire after it left a police academy."
4149,2/3/2006,Iraq,Tikrit,6,3,9,"Jihadis attack a police checkpoint, killing six officers."
4150,2/3/2006,Iraq,Baghdad,8,14,22,"Islamic militants bomb a market, slaughtering eight innocents including a child."
4151,2/3/2006,Iraq,Baghdad,10,8,18,Five people are killed when Muslim radicals bomb a passenger bus.  Five additional bodies are found elsewhere.
4152,2/3/2006,Pakistan,Karachi,4,51,55,"A suicide bomber kills four people, including two Americans, outside a hotel."
4153,3/3/2006,India,Lucknow,2,12,14,Muslim rioters kill two Hindus and injure a dozen more.
4154,3/3/2006,Philippines,Basilan,1,4,5,Abu Sayyaf suspected in the shooting assassination of a city mayor.
4155,3/3/2006,Iraq,Nahrawan,25,0,25,"Sunnis attack Shiite laborers at two brick factories, executing twenty-five people with a shot to the forehead.  Among the dead was at least one woman and three children, including a 6-year-old girl."
4156,3/3/2006,USA,"Chapel Hill, NC",0,9,9,"Calling it the will of Allah, an Iranian immigrant plows his SUV into a crowd of students as 'retribution' for foreign policy overseas."
4157,4/3/2006,Pakistan,Mir Ali,2,7,9,"al-Qaeda backed militants attack a security patrol, killing two Pakistani troops."
4158,4/3/2006,Afghanistan,Bala Buluk,1,0,1,Six Taliban terrorists drag a UN engineer from his car and shoot him to death.
4159,4/3/2006,Afghanistan,Nakhonak,1,2,3,One person is killed by a Taliban landmine.
4160,4/3/2006,Afghanistan,Lashkargah,5,0,5,Religious extremists kill four Afghan security agents and an electrician with a remote-controlled bomb.
4161,4/3/2006,Iraq,Salman Pak,2,3,5,Two civilians die from injuries received in a car bombing on a city street.
4162,4/3/2006,Pakistan,Quetta,2,3,5,"A Muslim militant throws a grenade at children playing in the street, killing two young girls."
4163,4/3/2006,Iraq,Gisr Diyala,7,20,27,Seven people are killed when Jihadis lob a mortar round into a crowded market.
4164,4/3/2006,Afghanistan,Helmand,1,0,1,Taliban terrorists assassinate a government official with machine-gun fire into his car from motorcycles.
4165,4/3/2006,Thailand,Sungai Padi,1,1,2,A 21-year-old man is gunned down in an Islamist attack against him and his teenage sister.
4166,4/3/2006,Iraq,Kirkuk,2,0,2,Two Shias are killed inside their mosque by Sunni gunmen.
4167,4/3/2006,Iraq,Baqubah,1,8,9,Fundamentalists kill a young girl with a bombing of a store that sold musical paraphernalia.
4168,5/3/2006,India,Kishtwar,1,0,1,A civilian is shot to death by the Mujahideen outside his home.
4169,5/3/2006,Iraq,Baghdad,3,7,10,"Shia gunmen storm a Sunni mosque, killing three people."
4170,5/3/2006,India,Srinagar,2,3,5,Two policemen die when a Jaish-e-Mohammad radical lobs a grenade at their picket.
4171,5/3/2006,India,Baramulla,1,0,1,A man is gunned down by the Mujahideen at a bus stop.
4172,5/3/2006,India,Pulwama,0,26,26,Twenty-four civilians and two police are injured when a Jaish-e-Mohammad militant tosses a grenade into the road.
4173,5/3/2006,Iraq,Baiji,2,0,2,Religious fundamentalists murder two barbers who were on their way to work.
4174,6/3/2006,Pakistan,Barwan,1,0,1,Islamic militants kidnap and behead a school teacher.
4175,6/3/2006,Iraq,Baghdad,5,16,21,Three Jihad car bombs kill five and injure sixteen.
4176,6/3/2006,Iraq,Baqubah,9,23,32,Two girls under the age of 4 are among the six deaths when Sunni radicals detonate a car bomb at a busy market.  Three other people are killed is separate shooting attacks.
4177,6/3/2006,Thailand,Pattani,2,0,2,Two civilians are gunned down by Islamic separatists.
4178,6/3/2006,Thailand,Pattani,3,2,5,"Radical Muslims storm a Buddhist village and shoot an elderly couple and their neighbor to death, then set fire to their homes."
4179,6/3/2006,Pakistan,Miranshah,1,2,3,"Militants fire a rocket into a house, killing a young woman and injuring two children."
4180,7/3/2006,India,Varanasi,23,62,85,Muslim terrorists (Lashkar-e-Toiba) use a trio of bombs against Hindu civilians at a religious prayer offering.  At least twenty-three innocents are massacred and several dozen injured.
4181,7/3/2006,Iraq,Baqubah,4,5,9,Sunni gunmen kill three Shias at a political office.  A separate car bombing kills one civilian.
4182,7/3/2006,Iraq,Baiji,3,4,7,Three security force members are killed outside an oil refinery in an ambush by Sunni insurgents.
4183,7/3/2006,Thailand,Yala,1,0,1,Islamists behead a 41-year-old plantation worker.
4184,7/3/2006,Pakistan,Mirali,1,1,2,"Fundamentalists attack a vehicle, killing one of the occupants."
4185,7/3/2006,Chechnya,Kurchaloi,2,2,4,A woman and her 12-year-old son are killed by the Mujahideen in a bomb explosion.
4186,7/3/2006,India,Handwara,1,0,1,"A woman who suffered injuries when Muslims attacked her on 11/21 finally succumbs.  Elsewhere, the Mujahideen kidnaps a 17-year-old and chops off his fingers."
4187,8/3/2006,Pakistan,Tabba Takka,1,0,1,al-Qaeda militants shoot a civilian to death and pin a warning note to his body.
4188,8/3/2006,Iraq,Fallujah,4,2,6,Islamic terrorists kill four civilians with a remote-controlled bomb.
4189,8/3/2006,Iraq,Baghdad,4,5,9,Two young boys selling gas are among four people killed in two bombings by Jihadis.
4190,8/3/2006,Iraq,Baghdad,23,0,23,The bodies of eighteen men are found bound and strangled on a minibus.  Five other bodies are found elsewhere.
4191,8/3/2006,India,Awantipora,1,0,1,An SPO is kidnapped by Islamic militants and killed in captivity.
4192,8/3/2006,India,Chajru,1,0,1,A villager is brutally gunned down by the Mujahideen.
4193,9/3/2006,Algeria,El Oued,1,0,1,Armed fundamentalists kill a freed prisoner by spraying his home with automatic weapons fire.
4194,9/3/2006,Pakistan,Quetta,2,0,2,A policemen and his daughter are killed when sectarian radicals toss a bomb into their home.
4195,9/3/2006,Iraq,Baghdad,8,15,23,Terrorists set off a bomb in front of a hospital and another in a street to kill eight civilians and injure fifteen.
4196,9/3/2006,Thailand,Yala,1,0,1,Islamists gun down a Buddhist outside his home.
4197,9/3/2006,Thailand,Pattani,1,0,1,A Buddhist man is found murdered with a note on his body from Islamists acknowledging that they are killing the innocent.
4198,9/3/2006,Pakistan,Miran Ali,2,1,3,"al-Qaeda backed militants attack a Pakistani checkpoint, killing two soldiers."
4199,9/3/2006,Pakistan,Ouspas,1,0,1,The son of a pro-government leader is murdered by the local Taliban.
4200,9/3/2006,Iraq,Mosul,2,2,4,Religious fundamentalists kill the host of an educational and cultural TV show while on his way to interview poets.
4201,10/3/2006,England,Birmingham,1,0,1,A 6-year-old is burned to death when two Muslims burn down her family's house in an attempted honor killing.
4202,10/3/2006,Nigeria,Kaduna,1,1,2,"Angry Muslims shoot into the house of an Anglican bishop, killing one person and injuring another."
4203,10/3/2006,Dagestan,Makhachkala,1,1,2,"Radicals plant a bomb under the car of a government official, killing him and badly injuring his driver."
4204,10/3/2006,Turkey,Van,2,19,21,An apparent Fedayeen suicide bombing leaves two other people dead.
4205,10/3/2006,Iraq,Fallujah,11,0,11,Eleven people are killed by a suicide truck bomber at an intersection.
4206,10/3/2006,Iraq,Baghdad,6,0,6,Six bodies are found bound and executed.
4207,10/3/2006,Iraq,Samarra,3,5,8,Two car bombings leave three civilians dead.
4208,10/3/2006,Iraq,Kirkuk,1,14,15,"A civilian is killed by gunmen, and another ten injured.  Jihadis also kidnap four women."
4209,10/3/2006,Pakistan,Quetta,28,5,33,Twenty-eight people traveling to a wedding party are blown to bits by a landmine suspected to have been planted by the Taliban.
4210,10/3/2006,Pakistan,Jandola,1,0,1,"Islamic fundamentalists murder a man, then circulate pamphlets as a warning to others."
4211,10/3/2006,Sudan,Graida,27,23,50,"The Islamic government targets six villages, killing at least twenty-seven people and injuring dozens more including women and children."
4212,11/3/2006,India,Thathri,0,1,1,Muslim terrorists force their way into a home and deliberately cripple a young girl by shooting her in both legs.
4213,11/3/2006,India,Ladi Pahalgam,1,1,2,The Mujahideen abducts two civilians from their home and shoots one to death in captivity.
4214,11/3/2006,India,Reasi,1,1,2,Mujahideen terrorists force their way into a civilian's house and shoot him to death.
4215,11/3/2006,Iraq,Baghdad,1,1,2,A television station director is killed by Islamic terrorists outside his home.
4216,11/3/2006,Iraq,Baghdad,1,0,1,"A 'Christian Peacemaker' pacifist is kidnapped by Islamic radicals, held for three months, tortured and then shot to death."
4217,11/3/2006,Afghanistan,Helmand,2,0,2,The decapitated bodies of two men abducted two days earlier by religious extremists are found in the desert.
4218,11/3/2006,Afghanistan,Helmand,1,0,1,A police officer is killed by a Taliban landmine.
4219,12/3/2006,Afghanistan,Kabul,2,5,7,A Fedayeen suicide bomber attempts a political assassination.  Two people are killed in the blast.
4220,12/3/2006,Afghanistan,Kunar,4,0,4,Four Americans are killed by a remote-controlled blast while providing security to a group of Afghan civilians.
4221,12/3/2006,Afghanistan,Kabul,2,5,7,Suicide bombers kill a young girl on her way to school and a man on a motorbike.
4222,12/3/2006,Iraq,Baghdad,10,4,14,A paint shop is the target of a terror blast as eight bodies are found bound and executed elsewhere in the city.
4223,12/3/2006,Iraq,Baghdad,52,204,256,al-Qaeda suicide bombers tear apart forty-four poor Shias living in a slum in two separate market attacks.  About two-hundred others are injured.  Eight are hanged or beaten to death in revenge
4224,12/3/2006,Thailand,Pattani,1,2,3,"Islamic militants kill a 44-year-old Buddhist as he is riding his motorcycle.  They also bomb a Buddhist temple, injuring a young girl and her mother."
4225,12/3/2006,Iraq,Baghdad,8,14,22,Jihadis kill six civilians with a remote-controlled bomb and shoot two policemen to death in a separate attack.
4226,12/3/2006,Pakistan,Madakhel,1,0,1,"A civilian is abducted, tortured and killed by Muslim radicals."
4227,12/3/2006,Pakistan,Anghar,1,0,1,Islamists kill a man and pin a note to his body.
4228,12/3/2006,India,Kader,1,0,1,A boy is abducted and beheaded by the Mujahideen.
4229,13/3/2006,Iraq,Tikrit,5,18,23,At least five people are killed when Islamic radicals set off a bomb along a city street.
4230,13/3/2006,Iraq,Baghdad,3,7,10,"Three civilians, including a child, are killed by two terrorist bombings."
4231,13/3/2006,Bangladesh,Comilla,3,0,3,An Islamic militant sets off a suicide blast to avoid arrest.  A mother and two children are blown apart as well.
4232,13/3/2006,India,Ganderbal,1,0,1,"After keeping him in captivity for two days under harsh conditions, the Hizb-ul-Mujahideen hang an abducted civilian."
4233,13/3/2006,Iraq,Baghdad,1,0,1,Radicals gun down a journalist outside his home.
4234,13/3/2006,Afghanistan,Kandahar,4,0,4,The Taliban execute four Albanian cleaning-company contractors that were abducted a day earlier.
4235,13/3/2006,Afghanistan,Miansheen,5,6,11,"Religious extremists attack a police post, killing five officers."
4236,14/3/2006,Iraq,Baghdad,87,0,87,Eighty-seven victims of sectarian violence are found in at least four separate locations around the city in a 24-hour period.
4237,14/3/2006,Indonesia,Ambon,1,0,1,"In a suspected Muslim attack, a 33-year-old Catholic nun is stabbed to death by an intruder."
4238,15/3/2006,Thailand,Muang,2,0,2,A man and his son are attacked by Muslim radicals while riding home on a motorbike.  Both are killed.
4239,15/3/2006,Thailand,Pattani,1,1,2,"Islamists attack a husband and wife on a road, killing the man and leaving the woman severely injured."
4240,15/3/2006,Iraq,Baghdad,22,0,22,"Twenty-two bodies, victims of sectarian violence, are reported found."
4241,15/3/2006,Iraq,Baghdad,3,2,5,Jihadis murder two Shia pilgrims walking by the road and kill two other innocents in separate bomb attacks.
4242,15/3/2006,Iraq,Baqubah,2,11,13,Two people are killed when religious fundamentalists bomb a photography studio.
4243,15/3/2006,Iraq,Baqubah,2,6,8,A woman and two children are among the causalities as a suicide bomber on a bicycle pedals his way to paradise.
4244,15/3/2006,India,Bhajja,2,0,2,An older husband and wife are shot to death by Hizb-ul-Mujahideen terrorists after forcing their way into the couple's home.
4245,16/3/2006,Iraq,Baijii,2,4,6,Radical Sunnis invade a home and kill a translator and his son inside.
4246,16/3/2006,Iraq,Baqubah,3,0,3,Islamic terrorists kill three schoolgirls with a roadside bomb.
4247,16/3/2006,Iraq,Ramadi,3,6,9,"Sunni radicals attack a checkpoint at an intersection, killing three civilians."
4248,16/3/2006,Iraq,Mosul,5,2,7,Jihad gunmen murder four college students.  Another civilian is killed in a bombing.
4249,16/3/2006,Thailand,Yala,1,1,2,An ice cream vendor is murdered and his 8-year-old son injured by militant Islamists.
4250,16/3/2006,Thailand,Pattani,6,2,8,"In a shocking attack, a group of Muslims walk into a government office and gun down six officials meeting in a conference room."
4251,17/3/2006,Afghanistan,Zabul,1,2,3,"The Taliban attack a construction site, killing a guard and taking two people hostage."
4252,17/3/2006,Iran,Sistan-Baluchistan,21,7,28,"Sunni rebels (Jundollah, 'God's Soldiers') in Iran pose as police officers to stop cars carrying Shias, then machine-gun the occupants, killing twenty-one."
4253,17/3/2006,Iraq,Baghdad,8,4,12,"A Fedayeen suicide bomber blows up a minibus, and seven bodies are found over the last two days, some showing signs of torture."
4254,17/3/2006,Afghanistan,Maiwand,9,0,9,The Taliban kill nine policemen with a bomb as they are transporting the bodies of four Albanians kidnapped and murdered earlier.
4255,17/3/2006,Iraq,Adil,3,2,5,"Sunni gunmen shoot Shia pilgrims from a passing car, killing three."
4256,18/3/2006,Iraq,Baghdad,2,8,10,Sunni extremists kill two more Shia pilgrims with a roadside bomb.
4257,18/3/2006,India,Sumbal,1,0,1,Muslim gunmen murder a young civilian.
4258,18/3/2006,Afghanistan,Ghazni,5,0,5,"Religious extremists assassinate a former governor, two relatives and two employees in a residential neighborhood."
4259,18/3/2006,India,Rawalpora,0,10,10,A woman and nine others are injured in a powerful Hizb-ul-Mujahideen car blast.
4260,18/3/2006,Thailand,Yala,1,0,1,A 39-year-old man is murdered by Islamic separatists.
4261,18/3/2006,Thailand,Yala,1,0,1,Islamists gun down a 53-year-old man who was riding out to his rubber plantation.
4262,18/3/2006,Iraq,Baghdad,22,0,22,The bodies of twenty-two men showing signs of torture are found by police.
4263,19/3/2006,Iraq,Baghdad,14,10,24,Twelve bodies are found in the capital and Jihadis also gun down two civilians in Ramadi.
4264,19/3/2006,Afghanistan,Kandahar,2,4,6,Two policemen are killed by the Taliban.  The fundamentalists take four other people hostage in the attack.
4265,19/3/2006,Iraq,Hawija,2,0,2,Religious extremists abduct and behead two soldiers.
4266,19/3/2006,Iraq,Mosul,4,1,5,Jihadi gunmen murder four people.
4267,19/3/2006,Pakistan,Dera Ismail Khan,7,4,11,"al-Qaeda militants detonate a bomb on a road, killing seven people and injuring four."
4268,19/3/2006,India,Sopore,2,5,7,Al Mansooran terrorists kill two security guards by tossing a grenade into their complex.
4269,19/3/2006,Pakistan,Pir Ghaib,2,1,3,"After ascertaining that the victims were Punjabis, Muslim radicals shoot three men at a picnic area, killing two."
4270,19/3/2006,Pakistan,Zafar Colony,7,7,14,Islamic militants are suspected in a bombing attack on a security convoy that leaves seven dead.
4271,20/3/2006,Iraq,Fallujah,1,1,2,Militants invade a home and kill a man while injuring his wife.
4272,20/3/2006,Iraq,Baghdad,9,3,12,"Four separate attacks by Muslim radicals leave nine dead, including a woman and a university lecturer"
4273,20/3/2006,Iraq,Baghdad,3,4,7,Passengers on a minibus are the targets of Islamic terrorists who kill at least three with a bomb.
4274,20/3/2006,Iraq,Baghdad,3,23,26,"Muslims kill three people in a coffee shop by skillfully hiding a bomb in a bag.  Twenty-three people are injured, many seriously."
4275,20/3/2006,India,Rajouri,1,0,1,A civilian is murdered by the Mujahideen.
4276,20/3/2006,Afghanistan,Musa Qala,4,0,4,"Religious extremists stage a vicious attack on a police vehicle in a remote area, killing all four occupants."
4277,21/3/2006,Iraq,Miqdadiya,17,4,21,"Islamic insurgents attack a police station with rockets and arms fire, killing seventeen people, including two civilians."
4278,21/3/2006,Somalia,Salagle,1,0,1,A humanitarian worker is killed by an Islamic militia as he is delivering food supplies.
4279,22/3/2006,Ethiopia,Arisi Negellie,1,0,1,Muslims gun down a father of seven in front of a Lutheran church.  The victim was a convert from Islam.
4280,22/3/2006,Pakistan,South Waziristan,1,3,4,Islamists kill a pro-government cleric and abduct three other people.
4281,22/3/2006,Iraq,Baghdad,21,24,45,"In a cold-blooded attack, Sunni radicals gun down sixteen Shia pilgrims in two separate attacks.  Five other bodies are also discovered."
4282,22/3/2006,Iraq,Baghdad,8,22,30,A Shia pilgrim is killed when Sunni radicals attack a bus full of passenger.  Seven bodies are found in two locations elsewhere.
4283,22/3/2006,Iraq,Madaen,4,6,10,"Jihadis attack a police station with RPGs and mortars, killing four officers."
4284,23/3/2006,Afghanistan,Andar,1,0,1,The Taliban assassinate a policeman in front of his home.
4285,23/3/2006,Iraq,Fallujah,14,0,14,"Eight victims of religious militants are found, along with six others in the capital."
4286,23/3/2006,Afghanistan,Maidan Wardak,1,1,2,At least one civilian is killed when Jihadis fire a rocket into the center of a town.
4287,23/3/2006,Iraq,Baqubah,4,0,4,Four policemen are killed by terrorists using a remote-controlled roadside bomb.
4288,23/3/2006,Iraq,Baghdad,7,22,29,A suicide bomber at a market murders at least seven innocents.
4289,23/3/2006,Iraq,Baghdad,23,35,58,Twenty-three people are blown apart by a Fedayeen suicide bomber on a city street.
4290,23/3/2006,Dagestan,Makhachkala,1,9,10,"Gunmen open fire on a car carrying a senior government official, killing him and injuring nine others."
4291,23/3/2006,Pakistan,Kohlu,1,9,10,"A man is killed and nine people, including two children, are injured when extremists bomb a telephone booth."
4292,24/3/2006,Iraq,Mahmoudiya,4,1,5,"Muslim radicals shoot four members of a family to death in their home, including a child.  The mother is critically injured."
4293,24/3/2006,Pakistan,Datta Kheil,1,2,3,One person is killed when al-Qaeda backed militants fire a rocket at a security post.
4294,24/3/2006,Iraq,Baghdad,5,1,6,Fundamentalists bomb a bake shop killing five people including four bakery employees.
4295,24/3/2006,Iraq,Baghdad,15,1,16,Three policemen are killed in an ambush by radical Sunnis and eighteen bodies are found at three locations in the city.
4296,24/3/2006,Iraq,Khalis,5,17,22,"Five worshippers are killed, and seventeen wounded, when radical Shias bomb a Sunni mosque."
4297,24/3/2006,Algeria,Boumerdes,1,0,1,Islamic fundamentalists shoot a town's mayor to death outside his home.
4298,25/3/2006,Algeria,Blida,4,0,4,Four farmers are machine-gunned to death in their fields by Islamic fundamentalists.
4299,25/3/2006,Thailand,Narathiwat,1,4,5,"Islamic gunmen attack voters as they are leaving the polls, killing at least one person."
4300,25/3/2006,Iraq,Mahmudiya,4,13,17,Sunni insurgents kill four residents in their homes with mortars.
4301,25/3/2006,Iraq,Baghdad,15,4,19,"Four civilians are among five killed in a bombing, and ten victims of sectarian violence are found elsewhere, some showing signs of torture."
4302,25/3/2006,India,Sangiot,1,0,1,A boy is abducted and murdered by the Mujahideen.
4303,26/3/2006,Pakistan,South Waziristan,1,0,1,The local Taliban capture and execute a man under Sharia law.
4304,26/3/2006,India,Pampore,1,7,8,"Lashker-e-Toiba militants attack an Indian army convoy on a highway, killing at least one."
4305,26/3/2006,Iraq,Baghdad,14,3,17,A woman is blown apart in front of her house by radical Sunnis.  Thirteen bodies are also discovered at three separate locations elsewhere.
4306,26/3/2006,Iraq,Basra,1,2,3,Terrorists kill a 14-year-old boy in front of his school.
4307,26/3/2006,Iraq,Mullah Eid,30,0,30,"Thirty victims of Jihadis are discovered by a road, some were beheaded."
4308,26/3/2006,Somalia,Mogadishu,144,354,498,"Islamic militias of rival clerics set off four days of violence, leaving more than one-hundred dead."
4309,27/3/2006,India,Sanjote,1,0,1,"A youth is kidnapped and tortured by the Mujahideen, who finish him off by slitting his throat."
4310,27/3/2006,Thailand,Yala,1,0,1,Muslim radicals kill a medical doctor as he is shopping at an electronics store.
4311,27/3/2006,Iraq,Baghdad,8,35,43,"Islamic radicals fire two rockets into a commercial district, killing eight people and injuring dozens."
4312,27/3/2006,Pakistan,Shakai,0,6,6,Six children on their way to school are injured when Islamists bomb their bus.
4313,27/3/2006,Philippines,Jolo,9,20,29,"Suspected Abu Sayyaf terrorists bomb a department store, killing nine and injuring over twenty."
4314,27/3/2006,Iraq,Baghdad,21,0,21,"Twenty-one bodies are discovered, some with nooses around their necks, as sectarian violence continues."
4315,27/3/2006,Iraq,Mosul,40,30,70,"A Saudi suicide bomber attacks Iraqis at a recruiting center, killing at least forty and injuring dozens."
4316,27/3/2006,Thailand,Narathiwat,1,0,1,Radical Muslims shoot a man to death in front of his 4-year-old daughter.
4317,27/3/2006,Thailand,Yala,1,0,1,A government worker is murdered by Muslim gunmen.
4318,27/3/2006,Thailand,Pattani,1,0,1,A 32-year-old man is murdered by Muslim gunmen on his way home.
4319,27/3/2006,Thailand,Pattani,1,0,1,A 75-year-old man is gunned down by Islamists.
4320,27/3/2006,Thailand,Narathiwat,1,1,2,A 19-year-old Chinese trader is shot twice in the head by Muslim radicals as he is going door-to-door with his father.
4321,27/3/2006,Afghanistan,Helmand,3,2,5,Religious extremists kill a woman and two other villagers with a roadside bomb.
4322,27/3/2006,India,Rohama,1,0,1,A civilian is shot dead by the Mujahideen.
4323,28/3/2006,Pakistan,Fort Salop,26,25,51,At least twenty-six people are killed when a radical Muslim cleric incites his followers to attack resettled Afghan families.
4324,28/3/2006,Israel,Negev,2,0,2,A shepherd and his 16-year-old son are killed by an Islamic Jihad rocket.
4325,28/3/2006,Iraq,Baghdad,14,0,14,The bodies of fourteen people are found bound and executed.
4326,28/3/2006,Afghanistan,Farah,4,0,4,Four employees of a mining company are killed by two Fedayeen suicide bombers in a car.
4327,28/3/2006,Afghanistan,Kandahar,2,0,2,Two policemen are murdered by the Taliban.
4328,28/3/2006,Afghanistan,Helmand,6,0,6,The Taliban kill six Afghan soldiers with a roadside bomb.
4329,28/3/2006,Pakistan,Peshawar,1,16,17,"A policeman is killed, and sixteen civilians injured, by a motorcycle bomb detonated at a crowded market."
4330,29/3/2006,Thailand,Narathiwat,1,0,1,A 28-year-old man is shot to death by Muslim radicals outside his home.
4331,29/3/2006,Iraq,Baghdad,8,6,14,Muslim terrorists line up fourteen employees of a trading company and shoot them one-by-one.  Three women are among the dead.
4332,29/3/2006,Iraq,Baghdad,17,0,17,The bodies of seventeen young men are found bound and executed with signs of torture.
4333,29/3/2006,Pakistan,Mir Ali,2,9,11,Local Taliban kill a woman and a young girl with a rocket.
4334,30/3/2006,Afghanistan,Helmand,2,0,2,"Taliban terrorists open fire on a car carrying a police director and his brother, killing both."
4335,30/3/2006,Afghanistan,Kandahar,1,6,7,"A woman, two children and four men are injured by a Fedayeen suicide bomber.  A 4-year-old boy dies a day later."
4336,30/3/2006,India,Gandipora,1,0,1,The Mujahideen abduct and murder a local folk singer.
4337,30/3/2006,Israel,Kedumim,4,0,4,"A young Muslim dresses as a Jewish hitchhiker, then murders the elderly Jewish couple who stop to offer assistance, along with a teenager and one other."
4338,30/3/2006,Iraq,Baiji,8,1,9,"Islamic terrorists ambush a minivan carrying oil workers, killing at least eight."
4339,30/3/2006,Afghanistan,Laghman,4,0,4,Four men are killed in a rocket attack on their vehicle by religious extremists.
4340,31/3/2006,Thailand,Pattani,1,0,1,Islamists murder a 24-year-old civilian in a drive-by shooting.
4341,31/3/2006,Thailand,Pattani,1,0,1,A 52-year-old policeman is killed by Islamic radicals as he is waiting for his wife outside a school.
4342,31/3/2006,India,Soura,1,5,6,"The Hizbul Mujahideen terrorist group uses an IED against a military vehicle, killing one and injuring five."
4343,31/3/2006,Afghanistan,Tahhar,1,0,1,A lawmaker is killed in his home by the Taliban.
4344,31/3/2006,Iraq,Baqubah,5,0,5,Sunni gunmen shoot five civilians to death as they are riding in a car.
4345,31/3/2006,Iraq,Baghdad,5,0,5,"Five victims of sectarian violence are found bound, tortured and executed."
4346,31/3/2006,Iraq,Balad Ruz,6,1,7,Radical Sunnis kill six Shia pilgrims as they are riding in a minibus.
4347,1/4/2006,Iraq,Youssifiyah,2,0,2,"Muslims shoot down a U.S. helicopter, then drag the pilots' bodies through the street shouting ""Allah Akbar."""
4348,1/4/2006,Iraq,Tikrit,1,0,1,"Fundamentalists bomb a music shop, killing at least one person."
4349,1/4/2006,Afghanistan,Girishk,4,0,4,"A religious extremist poses as a hitchhiker, then kills the four policemen who stop to help."
4350,1/4/2006,Pakistan,Dattakhel,1,3,4,"Local Taliban militants fire a rocket into a military camp, killing one Pakistani soldier."
4351,1/4/2006,India,Gharat,1,0,1,The Mujahideen abduct and kill a civilian.
4352,1/4/2006,Iraq,Baghdad,15,1,16,"Islamic terrorists kill fifteen innocents in five attacks, including three ice cream vendors and a butcher and his son."
4353,2/4/2006,Iraq,Balad Ruz,2,3,5,"Islamists kill two members of a family, including a 12-year-old girl, in a shooting ambush."
4354,2/4/2006,Thailand,Pattani,1,0,1,Muslim extremists stalk and kill a 45-year-old man on the way to pick up his wife.
4355,2/4/2006,Pakistan,Sararogha,1,0,1,Islamists murder a pro-government cleric.
4356,2/4/2006,India,Lama Dhar,1,0,1,A teenager is killed in a grenade attack by the Mujahideen.
4357,2/4/2006,India,Chadoora,1,0,1,The Mujahideen abduct and murder a university grad student.
4358,2/4/2006,India,Sopore,1,0,1,Islamic militants assassinate a city councilman.
4359,2/4/2006,Philippines,Lamitan,1,1,2,Suspected Abu Sayyaf terrorists gun down a policeman and seriously injure his son.
4360,2/4/2006,Afghanistan,Nimroz,1,0,1,The Taliban stop a vehicle and force a Turkish engineer out.  They then shoot him to death and burn his body.
4361,2/4/2006,Afghanistan,Kandahar,5,3,8,"Religious extremists ambush a police checkpoint, killing five officers."
4362,3/4/2006,Iraq,Basra,6,0,6,A young child is among six victims of a drive-by shooting by Muslim terrorists at a market.
4363,3/4/2006,Iraq,Baghdad,4,0,4,"Sunni gunmen invade a Shia family's home, line up two sisters, a brother and an uncle, then machine-gun them to death."
4364,3/4/2006,Pakistan,Dattakhel,5,1,6,"Pro-Talibanis plant a landmine and detonate it under a civilian vehicle, killing at least five, including a mother and her son."
4365,3/4/2006,Iraq,Baghdad,11,6,17,Terrorists use a car bomb to kill two civilians.  Nine bodies are also found bound and tortured over the next 24 hours.
4366,3/4/2006,Thailand,Yala,1,0,1,Islamists murder a 52-year old man.
4367,3/4/2006,Pakistan,Jandola,4,0,4,"A man, his wife and two children are slaughtered by Islamic fundamentalists in a bomb blast."
4368,4/4/2006,Iraq,Baghdad,10,28,38,Ten people are blown apart by a Sunni car bomb in a Shiite neighborhood.  Nearly thirty others are injured.
4369,4/4/2006,Iraq,Baghdad,2,3,5,Two children are killed when Islamic terrorists bomb their home.  Their mother and brother are injured.
4370,4/4/2006,India,Tral,1,0,1,A policeman is abducted and killed by Islamic radicals.
4371,4/4/2006,India,Baramulla,1,2,3,Militant Muslims kill a party activist and injure two women with automatic weapons.
4372,5/4/2006,Algeria,Djebel Sbaa,2,0,2,Two security personnel are murdered by Islamic fundamentalists in separate attacks.
4373,5/4/2006,Pakistan,Miranshah,3,3,6,Three Pakistanis are killed in an Islamist rocket attack on their post.
4374,5/4/2006,Iraq,Baghdad,9,18,27,Two car bombs by Muslim terrorists kill three civilians and injure eighteen as six bodies are found elsewhere.
4375,5/4/2006,Iraq,Diwaniya,1,1,2,Terrorists kill a Polish translator and injure his nephew.
4376,5/4/2006,Afghanistan,Nimroz,1,0,1,Religious extremists kill a government official.
4377,5/4/2006,Afghanistan,Ghanzi,1,0,1,The Taliban gun down a man as he is driving to work.
4378,6/4/2006,Iraq,Najaf,13,39,52,"'Iraqi Freedom Fighters' bomb a Shia cemetery near a mosque, killing at least thirteen and injuring dozens more.  The victims were mostly women and children."
4379,6/4/2006,Afghanistan,Bagram,1,3,4,A rocket fired by Taliban extremists kills a civilian.
4380,6/4/2006,Iraq,Baghdad,6,0,6,Six bodies are found bound and executed by police.
4381,6/4/2006,India,Harhama,1,0,1,A 70-year-old man is shot to death by Muslim terrorists.
4382,7/4/2006,India,Kashiyar,1,0,1,The Mujahideen abduct and behead a civilian.
4383,7/4/2006,India,Baradari,1,4,5,A Mujahideen bombing on a bus kills at least one civilian.
4384,7/4/2006,India,Parne,2,0,2,An elderly couple are murdered inside their home by Islamic radicals in a heinous attack.
4385,7/4/2006,Iraq,Baghdad,85,164,249,At least eighty Shia worshippers are slaughtered when Sunni terrorists stage a triple suicide attack against a mosque.
4386,7/4/2006,Philippines,Asturias,1,9,10,Abu Sayyaf terrorists are suspected in a drive-by that leaves a woman dead and children injured.
4387,7/4/2006,Iraq,Kirkuk,1,0,1,Sunni terrorists murder a Shia tailor in his shop.
4388,7/4/2006,Algeria,Ouardhia,13,8,21,Thirteen Algerians are massacred by Islamic fundamentalists in an ambush on their vehicles.
4389,8/4/2006,Afghanistan,Herat,2,7,9,A suicide car bomber murders two Afghans and leaves seven injured.
4390,8/4/2006,Iraq,Kirkuk,4,0,4,"Four Iraqi soldiers are kidnapped, tortured and executed by Islamic militants."
4391,8/4/2006,Iraq,Musayib,6,16,22,Suspected al-Qaeda car bombing kills six innocents near a Shia mosque.
4392,8/4/2006,Iraq,Baghdad,2,0,2,"Islamic terrorists place a bomb in the doorway of a home, killing two family members."
4393,9/4/2006,Chechnya,Sernovodsk,3,0,3,A policemen and two family members are massacred in a Jihad ambush on their vehicle.
4394,9/4/2006,India,Challad,3,0,3,"Three members of a family, including two brothers and a woman, are murdered by the Hizb-ul-Mujahideen."
4395,10/4/2006,Somalia,Baidoa,6,3,9,"Armed Muslims open fire on a food convoy, killing six humanitarian aid workers."
4396,10/4/2006,Iraq,Baqubah,1,0,1,An Iranian woman is found shot through the head in a Sunni area.
4397,10/4/2006,Iraq,Baghdad,3,0,3,Islamic radicals murder three members of the same family.
4398,10/4/2006,Afghanistan,Badghis,5,0,5,Five Afghan humanitarian workers working for a Christian aid agency are slaughtered by Muslim extremists at their clinic.
4399,10/4/2006,Pakistan,Dherdoni,2,0,2,Islamic terrorists murder a water tanker driver and his assistant.
4400,10/4/2006,India,Bijbehara,1,0,1,A forest worker is abducted and murdered by the Mujahideen.
4401,11/4/2006,Iraq,Kirkuk,1,0,1,"A man is kidnapped, tortured and beheaded by Jihad extremists."
4402,11/4/2006,Pakistan,Karachi,55,77,132,Fifty-five people attending a religious gathering in a city park are blown apart by two suicide bombers.  Some seventy others are injured.
4403,11/4/2006,Iraq,Jurf al-Sahkar,4,0,4,Four Iraqi soldiers are abducted and beheaded by 'Holy Warriors'.
4404,11/4/2006,Iraq,Baghdad,3,4,7,"Islamic terrorists bomb a passenger bus, killing three civilians."
4405,11/4/2006,Afghanistan,Asadabad,7,34,41,"The Taliban fire two rockets into a school, killing seven children between the ages of 7 and 10."
4406,11/4/2006,India,Kangan,1,0,1,A civilian is abducted and murdered by the Mujahideen.
4407,12/4/2006,Iraq,Khalis,4,27,31,Two car bombs targeting vegetable markets leave four dead in Khalis and Tal Afar.
4408,12/4/2006,Iraq,Baghdad,15,9,24,"Six separate Jihad attacks leave fifteen dead around the country, including truck drivers and oil workers."
4409,12/4/2006,Iraq,Kirkuk,1,1,2,"Terrorists attack a gas company executive and his wife, killing the woman."
4410,12/4/2006,India,Tral,1,1,2,A Mujahideen ambush against a vehicle leaves one dead.
4411,12/4/2006,Kabardino-Balk.,Nalchik,1,0,1,"Terrorists fire a grenade into an anti-Terrorism headquarters, killing a guard."
4412,12/4/2006,Iraq,Howaydir,23,50,73,"Radical Sunnis detonate a car bomb outside a Shiite mosque, blowing nearly two dozen people into bits.  Another fifty are injured."
4413,12/4/2006,Pal. Auth.,Jericho,1,0,1,An Arab man is tortured and killed by the al-Aqsa Brigade for selling property to a Jew.
4414,13/4/2006,Chad,Djawara,118,0,118,"Janjaweed Arab terrorists rampage through four African villages over a 2-day period, hacking, stabbing and shooting more than a hundred people to death."
4415,13/4/2006,Sudan,Akobo,15,11,26,"Four attacks by government-armed militias leave fifteen dead, including four children."
4416,13/4/2006,Iraq,Fallujah,7,0,7,Terrorists kill five people in Fallujah and two truck drivers are gunned down near the capital.
4417,13/4/2006,Iraq,Baghdad,13,8,21,Thirteen people are killed when Muslim terrorists car bomb a crowded market.
4418,14/4/2006,Iraq,Basra,7,3,10,"Ten employees of a construction company are handcuffed, blindfolded, then lined up against a wall and shot by Muslim extremists.  Seven die."
4419,14/4/2006,India,Srinagar,5,31,36,A series of deadly grenade attacks on civilians leave three women and two men dead.
4420,14/4/2006,Afghanistan,Khost,3,2,5,Three Afghan policemen are killed in a Taliban roadside bombing attack.
4421,14/4/2006,Egypt,Alexandria,1,3,4,"Knife-wielding Islamists attack Christians gathered outside a church, stabbing four of them.  A 78-year-old man dies."
4422,14/4/2006,Iraq,Baqubah,4,5,9,Four people are killed by two mosque bombings.
4423,14/4/2006,Iraq,Basra,2,4,6,A suicide bomber kills two Iraqi civilians.
4424,14/4/2006,Thailand,Narathiwat,1,4,5,Militant Muslims hide in the bushes to surprise a civilian party with automatic weapons.
4425,15/4/2006,Pakistan,Ghulam Khan,1,1,2,"Islamists plant a bomb at a bazaar, killing at least one shopper."
4426,15/4/2006,Pakistan,North Waziristan,1,0,1,al-Qaeda kidnap and behead a civilian - attaching a note to the body warning more of the same.
4427,15/4/2006,Chechnya,Dargo,2,5,7,Jihadis use a landmine and small arms fire to ambush a security patrol.
4428,15/4/2006,Yemen,Sanaa,1,5,6,A guard is killed when radical Shiites attack a rival mosque.
4429,15/4/2006,Iraq,Baghdad,7,26,33,"Seven people are murdered in two bomb attacks by Islamic militants, including one in a restaurant."
4430,16/4/2006,Ethiopia,Jijiga,3,23,26,"Islamists bomb a two bars and a church, killing three people and injuring two dozen."
4431,16/4/2006,Thailand,Narathiwat,1,0,1,A 32-year-old civilian is gunned down by Muslim terrorists while riding a motorcycle.
4432,16/4/2006,Philippines,North Cotabato,1,0,1,The Moro Islamic Front guns down a man in front of his wife inside a game hall.
4433,16/4/2006,Iraq,Baghdad,4,6,10,Four ordinary Iraqis are blown apart by a terrorist car bombing near a mosque.
4434,17/4/2006,Ethiopia,Gedo,3,30,33,Three people are killed when a Muslim radical hurls a grenade into a market.
4435,17/4/2006,India,Tral,1,4,5,"Muslim militants attempt a political assassination, killing one and injuring four."
4436,17/4/2006,Iraq,Baghdad,4,4,8,"Four terror attacks leave four innocents dead, including a mosque guard and a shepherd"
4437,17/4/2006,Israel,Tel Aviv,9,66,75,"With the blessing of Hamas, Islamic Jihad sends a teenage suicide bomber into a restaurant and massacres at least nine innocents.  More than sixty others are injured."
4438,17/4/2006,Pakistan,Madakhel,1,0,1,Islamic fundamentalists kidnap and behead a civilian.
4439,17/4/2006,Pakistan,Datakhel,1,0,1,al-Qaeda kills a local tribesman for supplying food to Americans.
4440,17/4/2006,Thailand,Narathiwat,1,0,1,A 50-year-old man is gunned down by Muslim fanatics.
4441,18/4/2006,Thailand,Yala,1,0,1,Islamists kill a 24-year-old man on his way to work by shooting him multiple times in the chest.
4442,18/4/2006,Iraq,Baghdad,7,20,27,Seven people are blown apart in a cafe when Islamic radicals place a bomb under a chair.  At least twenty others are injured.
4443,18/4/2006,Iraq,Baghdad,4,22,26,Four civilians are killed when Muslim terrorists detonate a roadside bomb.
4444,18/4/2006,Iraq,Baghdad,19,0,19,"Fourteen victims of execution are found in the same neighborhood, and five elsewhere, over the last two days."
4445,18/4/2006,Pakistan,Mirali,1,0,1,Islamists kidnap and behead a civilian.
4446,18/4/2006,Pakistan,Faisalabad,2,0,2,A Shia cleric and his driver are shot to death by radical Sunnis.
4447,18/4/2006,India,Sildhar,2,0,2,The Hizb-ul-Mujahideen abduct two civilians from their homes and murder them in captivity.
4448,18/4/2006,Iraq,Yusufiya,4,0,4,"Islamic radicals kidnap, torture and kill four young men."
4449,19/4/2006,Iraq,Rashad,5,3,8,Sunni gunmen take out five civilians and injure three.
4450,19/4/2006,Thailand,Narathiwat,3,17,20,"Three people, including a female election volunteer are murdered in separate attacks by Thai Islamists attempting to disrupt elections."
4451,19/4/2006,Iraq,Baqubah,3,1,4,Three university professors are gunned down by religious extremists.
4452,19/4/2006,India,Handwara,2,0,2,Two soldiers on leave are killed inside their home by the Mujahideen.
4453,19/4/2006,Iraq,Baiji,5,4,9,Jihadis use a roadside car bomb to kill five civilians.
4454,20/4/2006,Iraq,Kirkuk,9,1,10,"Nine people, including four security guards, are killed by Muslim terrorists in four separate attacks around the country."
4455,20/4/2006,Iraq,Tal Afar,3,4,7,"Three people, including a doctor in his clinic, are murdered by Islamists in two attacks."
4456,20/4/2006,Pakistan,Sarobi,7,22,29,"al-Qaeda militants ambush a military convoy, killing seven Pakistani soldiers and injuring twenty-two."
4457,20/4/2006,India,Bhaderwah,1,3,4,A Mujahideen grenade attack on a police station leaves one dead and three injured.
4458,21/4/2006,Iraq,Baghdad,3,0,3,A baker and two bakery workers are murdered in two separate attacks by Islamic fundamentalists.
4459,21/4/2006,Iraq,Baghdad,8,0,8,"The bodies of eight men, bound and executed, with signs of torture are found in two locations in the country."
4460,21/4/2006,Afghanistan,Maiwand,6,0,6,Six policemen are killed at their post by Taliban extremists.
4461,21/4/2006,India,Cherwan,1,0,1,The Mujahideen murders a civilian outside his village.
4462,21/4/2006,India,Kishtwar,1,0,1,A civilian is gunned down by the Mujahideen.
4463,21/4/2006,India,Gool,2,0,2,Two transportation employees are shot to death on the job by Muslim radicals.
4464,21/4/2006,Iraq,Baiji,6,0,6,"In a heinous act, Islamic terrorists kidnap six off-duty policemen from and murder them."
4465,22/4/2006,Afghanistan,Laghman,6,4,10,Six Afghans are killed in a Taliban bomb attack.
4466,22/4/2006,Afghanistan,Gumbad,4,0,4,"Four Canadian troops are killed by religious extremists, who detonated a bomb under their vehicle."
4467,22/4/2006,Iraq,Hawija,2,0,2,Two civilians are gunned down by Sunni extremists.
4468,22/4/2006,Iraq,Muqdadiya,13,15,28,"Two people are killed in a market bombing, as eleven bodies are found in the capital."
4469,23/4/2006,Thailand,Yala,1,0,1,A 27-year-old shopkeeper loses his life to Allah's holy warriors while tending his business.
4470,23/4/2006,Thailand,Narathiwat,1,1,2,Islamic militants gun down a civilian and seriously injure his wife in a drive-by attack.
4471,23/4/2006,Yemen,Sana'a,7,13,20,"A Muslim throws a grenade into a market, killing seven."
4472,23/4/2006,Afghanistan,Kandahar,1,2,3,"Taliban militants attack a road construction crew, killing a guard."
4473,23/4/2006,Iraq,Baghdad,15,0,15,Jihadis use a rocket to take out seven civilians riding in a car.  Eight bound bodies are found elsewhere.
4474,23/4/2006,Iraq,Mahmudiya,2,7,9,A child is among two fatalities from an Islamist mortar attack.  Seven other children are injured.
4475,23/4/2006,India,Pulwama,1,0,1,A civilian is abducted and murdered by the Mujahideen.
4476,23/4/2006,Pakistan,Dungan,1,2,3,"Militant Islamists ambush a group of villagers, killing one."
4477,23/4/2006,Pakistan,Razmak,1,0,1,Islamists murder a security officer's younger brother.
4478,23/4/2006,Algeria,Skikda,10,8,18,Islamic fundamentalists slaughter ten people at a roadblock in a remote area.
4479,24/4/2006,India,Srinagar,1,25,26,"One civilian was killed, and two dozen others wounded, when Muslim militants stage three grenade attacks on polling stations."
4480,24/4/2006,Iraq,Mosul,28,0,28,The bodies of twenty-eight young men are found bound and tortured in Mosul and in the capital.
4481,24/4/2006,Iraq,Baghdad,10,80,90,A string of Jihadi car bombings kill ten innocents and injure eighty.
4482,24/4/2006,Egypt,Dahab,19,62,81,Three bombings at an Egyptian resort area leave at least nineteen victims dead and another sixty injured.
4483,24/4/2006,Pakistan,Karwan Manza,1,0,1,The body of a government employee is found beheaded several days after being abducted by local Islamists.
4484,25/4/2006,Iraq,Baghdad,2,5,7,"Radical Sunnis plant a bomb on a minibus, killing at least two."
4485,25/4/2006,Iraq,Baqubah,4,0,4,"Holy warriors gun down four civilians, including an 8-year-old girl."
4486,25/4/2006,Pakistan,Dattakhel,4,9,13,"al-Qaeda militants attack a security patrol, killing four people, including a journalist."
4487,25/4/2006,Afghanistan,Kabul,2,3,5,"Religious extremists fire rockets into a city street, killing two civilians."
4488,25/4/2006,Thailand,Narathiwat,1,0,1,A 45-year-old civilian is killed by Muslim terrorists while walking home.
4489,25/4/2006,Thailand,Pattani,1,0,1,Islamists gun down a Buddhist pig farmer.
4490,25/4/2006,India,Shopian,1,0,1,A bookseller succumbs to injuries suffered from an Islamic terror attack.
4491,25/4/2006,India,Arnora,2,0,2,Two bodyguards are killed by Muslim terrorists attempting to wipe out the family of a legislator.
4492,25/4/2006,India,Tral,0,24,24,Twelve schoolchildren are among twenty-four people injured when an Islamic radical hurls a grenade into a crowded market.
4493,25/4/2006,Pakistan,Quetta,4,2,6,"An Afghan bomb maker connects the wrong wires, killing four members of his own family and injuring his 2nd wife and 13-year-old son."
4494,25/4/2006,Pakistan,Shavai Kainari,1,0,1,Islamic militants kidnap and behead a taxi driver.
4495,26/4/2006,Jordan,Irbid,1,0,1,A man kills his sister to restore 'honor' after seeing her picture on a friend's mobile phone.
4496,26/4/2006,Iraq,Baghdad,24,22,46,Five bombs kill twelve civilians in various parts of the country.  Jihadis also shoot a truck driver to death and murder eleven kidnapped men.
4497,27/4/2006,Iraq,Baghdad,15,0,15,The sister of the country's vice president is gunned down along with her bodyguard by Muslim terrorists as thirteen headless bodies are discovered elsewhere.
4498,27/4/2006,Iraq,Nassiriya,4,1,5,Three Italian soldiers and one Romanian are killed when terrorists bomb their convoy.
4499,27/4/2006,India,Pahalgam,0,20,20,"Twenty people, including eight tourists, are injured when a Muslim radical tosses a grenade into a crowded bus stop."
4500,27/4/2006,India,Awantipore,1,0,1,The Mujahideen gun down a policeman.
4501,28/4/2006,Iraq,Diyala,9,18,27,"Terrorists launch a series of assaults against police stations and checkpoints, killing at least nine."
4502,28/4/2006,India,Kulgam,1,0,1,The Mujahideen kill a Communist Party activist inside his home.
4503,29/4/2006,Iraq,Jurf al-Sakhar,2,0,2,"Islamic radicals abduct a policeman and his brother, then dump their bodies by their house two hours later."
4504,29/4/2006,Iraq,Qaim,3,7,10,Three civilians are killed by a Fedayeen suicide car bomber.
4505,29/4/2006,Iraq,Basra,2,3,5,Two British contractors are killed by a Muslim terrorist bombing.
4506,29/4/2006,Afghanistan,Baghran,3,1,4,"Religious extremists fire a rocket at a police patrol, killing three and injuring another."
4507,29/4/2006,Iraq,Baghdad,9,14,23,Nine Iraqis are killed in various terror attacks around the country.
4508,30/4/2006,Iraq,Baghdad,1,0,1,"News surfaces of the murder of a 14-year-old boy, Ahmed Khalil, dragged from his home and executed for being gay."
4509,30/4/2006,Philippines,Surallah,1,7,8,"A 13-year-old girl is killed by Moro Islamic Front terrorists, who attack a cargo truck carrying her family."
4510,30/4/2006,Iraq,Ramadi,2,0,2,Two children are killed in an RPG attack by Muslim insurgents.
4511,30/4/2006,Afghanistan,Kandahar,1,0,1,An Indian engineer is kidnapped and brutally decapitated by the Taliban.
4512,30/4/2006,Iraq,Baghdad,9,6,15,"Sunni radicals plant a bomb inside a minibus, killing two civilians.  Seven bodies are discovered elsewhere."
4513,30/4/2006,India,Udhampur,13,0,13,Thirteen Hindus are kidnapped by Muslim extremists and brutally executed.  Families are among the dead.
4514,30/4/2006,Iraq,Baghdad,3,2,5,Islamic terrorists kill three civilian contractors from Fiji.
4515,30/4/2006,Afghanistan,Lashkargah,1,2,3,"Religious extremists open fire on a civilian car, killing one occupant."
4516,1/5/2006,India,Handwara,1,3,4,The Mujahideen kill a construction worker and injure three others with an IED on their job site.
4517,1/5/2006,India,Doda,22,9,31,"Islamic militants rouse Hindu villagers in the middle of the night and have them line up outside their homes, where they are massacred.  Twenty-two are killed.  Only nine survive with injury.  The victims include women and children."
4518,1/5/2006,Pakistan,Mir Ali,1,0,1,Islamists kidnap and kill an 80-year-old man.
4519,1/5/2006,India,Kulangam,1,0,1,A civilian is killed when the Mujahideen detonate a roadside bomb.
4520,2/5/2006,Thailand,Yala,1,0,1,Islamists gun down a civilian as he is walking home.
4521,2/5/2006,Afghanistan,Kabul,1,2,3,A Fedayeen suicide bomber kills at least one civilian on a city street.
4522,2/5/2006,Iraq,Baghdad,2,5,7,"Terrorists plant a bomb on a passenger bus, killing at least two civilians."
4523,2/5/2006,Iraq,Yusufiya,20,0,20,"The bodies of twenty men, bound and tortured, are found in three locations, including the capital."
4524,2/5/2006,Pakistan,Jatree,6,3,9,"Six members of a family, including two children, were gunned down in an honor killing over a love affair."
4525,2/5/2006,India,Doda,1,0,1,A civilian is abducted from a forested area and executed by the Mujahideen.
4526,2/5/2006,Afghanistan,Farah,1,0,1,A judge is assassinated by religious extremists.
4527,2/5/2006,Pakistan,Chichawatni,1,0,1,A man slits his sister's throat in an honor killing.
4528,3/5/2006,Pakistan,Khanpur,1,0,1,A Muslim man hacks his wife to death with an axe over suspicion that she may have been stepping out on him.
4529,3/5/2006,Pakistan,Bajaur,3,0,3,al-Qaeda backed militants storm a police station and murder three officers.
4530,3/5/2006,Iraq,Baghdad,4,0,4,Islamic terrorists pull four college students off a bus and shoot them in the head.
4531,3/5/2006,Iraq,Baghdad,16,15,31,"Fourteen bodies, victims of sectarian violence are discovered, some with signs of torture, as a bomb kills two civilians at a market."
4532,3/5/2006,Iraq,Fallujah,16,25,41,"Fedayeen suicide bomber blows himself to Allah, taking at least sixteen young police recruits with him."
4533,3/5/2006,Iraq,Tikrit,1,0,1,A tailor is murdered by Islamic radicals.
4534,3/5/2006,Thailand,Yala,1,0,1,A civilian is killed in his home by Islamists.
4535,3/5/2006,Thailand,Yala,1,0,1,A villager is killed by Muslim radicals in a roadside shooting attack.
4536,3/5/2006,Thailand,Pattani,2,0,2,Islamic militants gun down two neighbors in separate attacks.
4537,4/5/2006,Israel,Beit Shemesh,1,0,1,An 8-year-old is raped and murdered by a Palestinian.
4538,4/5/2006,India,Chadoora,2,9,11,Two civilians are killed when Islamic militants hurl a grenade into a market.
4539,4/5/2006,Iraq,Baghdad,10,52,62,"A Fedayeen suicide bomber attacks a crowd of civilians waiting outside a courthouse, slaughtering at least ten."
4540,5/5/2006,Iran,al-Dura,1,0,1,A 14-year-old boy is gunned down on his doorstop by Iranian police who suspected him of being a homosexual.
4541,5/5/2006,Iraq,Baghdad,6,0,6,Islamic fundamentalists kill six people for buying alcohol.
4542,5/5/2006,Afghanistan,Necha,3,0,3,Three civilians traveling in a car are killed by a bomb set by religious extremists.
4543,5/5/2006,Pakistan,Leghari,1,1,2,"al-Qaeda militants fire a rocket at a checkpoint, killing a Pakistani soldier."
4544,5/5/2006,India,Bijnour,1,0,1,A civilian is kidnapped from his home by the Mujahideen and killed in captivity.
4545,6/5/2006,Somalia,Coast,1,2,3,Muslim pirates kill an Indian crewmember of a commercial ship.
4546,6/5/2006,Afghanistan,Kabul,2,4,6,Taliban extremists kill two Italian peacekeepers in a bomb attack.
4547,6/5/2006,Iraq,Tikrit,3,1,4,"A Fedayeen suicide bomber detonates himself inside a military base, killing three Iraqis."
4548,6/5/2006,Iraq,Kirkuk,1,2,3,"Sunni radicals open fire on a group of civilians, killing at least one."
4549,6/5/2006,Iraq,Baghdad,8,3,11,"Two children, ages 5 and 6, are killed when Muslim insurgents lob a mortar shell at their family.  Six other bodies are found tortured and executed elsewhere."
4550,6/5/2006,India,Kupwara,1,0,1,A civilian is killed inside his home by the Mujahideen.
4551,7/5/2006,India,Pulwama,2,0,2,"Two Mujahideen, who are considering quitting, are gunned down by their peers."
4552,7/5/2006,Afghanistan,Zabul,2,0,2,"Taliban terrorists ambush a police patrol, killing two officers."
4553,7/5/2006,Thailand,Pattani,1,0,1,Muslim terrorists kill a 38-year-old man as he is riding a motorcycle with his wife.
4554,7/5/2006,Iraq,Baghdad,42,0,42,The bodies of forty-two victims of Muslim sectarian violence are discovered in several locations.
4555,7/5/2006,Iraq,Baghdad,10,15,25,Ten people in a residential neighborhood are blown to bits by a suicidal religious fanatic.
4556,7/5/2006,Iraq,Karbala,21,52,73,A suicide car bomber kills twenty-one innocents on a city street near a bus station.
4557,8/5/2006,Thailand,Narathiwat,1,0,1,A part-time teacher is shot seven times by Muslim assassins on motorcycles.
4558,8/5/2006,Iraq,Balad Ruz,2,3,5,Two civilians are killed by a Jihadi bombing.
4559,8/5/2006,Iraq,Khalisa,2,0,2,Two Iraqi journalists are kidnapped by religious fanatics and murdered.
4560,8/5/2006,Iraq,Baghdad,16,35,51,Three terrorist bombings leave at least fifteen civilians dead.  Another six bodies are found elsewhere.
4561,8/5/2006,Pakistan,Inayat Kili,1,0,1,Pro-Taliban terrorists kill a policeman with a landmine.
4562,8/5/2006,Thailand,Pattani,2,5,7,"Muslim radicals open fire on Buddhist sanitation workers, killing two."
4563,8/5/2006,Somalia,Mogadishu,11,40,51,An Islamic militia sparks a gun battle that leaves eleven dead over a two day period.
4564,9/5/2006,India,Kilimanoor,1,0,1,A father of three is brutally stabbed to death by Muslim militants.
4565,9/5/2006,Iraq,Tal Afar,37,134,171,Fedayeen suicide bombers leave a horrific scene of death and suffering after targeting a crowded Shiite market.  Nearly forty people lose their lives.
4566,9/5/2006,Iraq,Ramadi,4,0,4,"Four policemen are brutally murdered by Jihadis, who ambush their car."
4567,9/5/2006,Iraq,Baghdad,2,5,7,"Islamic terrorists target an electrical plant, killing two civilians."
4568,9/5/2006,Iraq,Suwayra,26,0,26,The headless body of a 10-year-old boy is among twenty-six victims of sectarian violence that are found in three locations.
4569,9/5/2006,Thailand,Yala,1,0,1,Radical Muslims kill a man attending a memorial service for one of their previous victims.
4570,9/5/2006,Thailand,Songkhla,1,0,1,A 65-year-old female schoolteacher is shot four times in the back by radical Muslims.
4571,9/5/2006,Thailand,Pattani,1,0,1,The owner of a motorcycle repair shop is murdered by Muslims posing as customers.
4572,9/5/2006,Thailand,Narathiwat,1,0,1,Islamic radicals use shotguns to take down a 44-year-old man walking by the side of the road.
4573,10/5/2006,India,Doda,1,2,3,A Mujahideen attack on a house leaves one civilian dead.
4574,10/5/2006,Somalia,Siisii,47,103,150,"Islamic militias clash, leaving about fifty dead."
4575,10/5/2006,Iraq,Baqubah,11,6,17,Sunni gunmen kill eleven workers at an electrical plant in brutal fashion.
4576,10/5/2006,India,Gandoh,1,0,1,A guard is killed in a Mujahideen attack on a civilian's home.
4577,10/5/2006,Thailand,Pattani,3,13,16,"Three Buddhists, including two women, are killed when Muslim radicals hide a bomb on a motorcycle along a city street."
4578,11/5/2006,Thailand,Narathiwat,1,1,2,A man is brutally slain while riding a motorcycle with his 2-year-old daughter on his lap.
4579,11/5/2006,Pakistan,Khar,1,0,1,al-Qaeda backed militants behead a man and pin a note to his body.
4580,11/5/2006,Kosovo,Kosovska Mitrovica,0,2,2,Two Christian youth are seriously injured when Muslims open up on them with automatic weapons.
4581,11/5/2006,Iraq,Baqubah,1,2,3,"A female school teacher is murdered by Islamists, and her 14-year-old nephew and 12-year-old daughter are badly injured."
4582,11/5/2006,Iraq,Baghdad,4,1,5,Jihadis kill four street sweepers with a planted bomb.
4583,11/5/2006,Somalia,Siisii,27,0,27,"Islamic militias claim another twenty-seven lives, mostly civilians.  The dead include a pregnant woman and at least three children."
4584,11/5/2006,India,Dhandli,1,0,1,A woman is murdered inside her home by a group of militant Muslims.
4585,11/5/2006,India,Bi-Tara,1,1,2,The Mujahideen murder a civilian and injure another in a shooting attack.
4586,11/5/2006,India,Srinagar,2,0,2,Al Mansoorian terrorists gun down two police officers in cold blood.
4587,12/5/2006,Somalia,Yaqshid,12,0,12,At least a dozen more civilians are killed in a gun battle sparked by Islamic militias.
4588,12/5/2006,Iraq,Basra,2,0,2,Radical Shiites murder a Sunni cleric and his son as they are leaving a mosque.
4589,12/5/2006,Kyrgyzstan,Batken,6,3,9,"In a rolling gun battle that begins in Tajikistan, a group of Islamic extremists kill several border guards and civilian drivers."
4590,12/5/2006,Iraq,Balad Ruz,2,2,4,"A funeral is attacked by Islamic radicals, who kill two more civilians."
4591,12/5/2006,Kenya,Nairobi,1,2,3,A Christian radio station airing the testimony of Muslim apostates is targeted in a bombing attack.  One guard is shot to death by the radicals.
4592,12/5/2006,Afghanistan,Herat,2,1,3,"The Taliban targets a UN vehicle with a rocket, killing two employees."
4593,13/5/2006,Iraq,Mosul,2,4,6,Two policemen are ambushed and killed by Sunni radicals.
4594,13/5/2006,India,Doda,2,41,43,Militant Muslims attack Hindus civilians at a rally with grenades.  At least two are killed.
4595,13/5/2006,Iraq,Baghdad,3,0,3,Sunni extremists kill the 22-year-old son of a judge and two bodyguards.
4596,13/5/2006,Iran,Kerman,12,0,12,Sunnis execute eleven Iranians after stopping their cars.  They also string an injured 12-year-old boy up on pole before fleeing.
4597,13/5/2006,Somalia,Mogadishu,11,0,11,Another eleven civilians die in violence sparked by Islamic militias.
4598,14/5/2006,Iraq,Karbala,9,0,9,Four brothers working on a humanitarian project are kidnapped by Islamic radicals and beheaded.  Five other bodies are found elsewhere.
4599,14/5/2006,Iraq,Baghdad,26,66,92,"Two suicide car bombings at an airport, and several other bombings elsewhere leave at least twenty-six Iraqis dead, including children and other civilians."
4600,14/5/2006,Afghanistan,Helmand,1,7,8,"An intelligence officer is gunned down by the Taliban as a bomb injures seven other people, including two girls."
4601,14/5/2006,Algeria,Jijel,21,0,21,The bodies of eighteen children and three women are found massacred in a cave used by armed Islamic fundamentalists.
4602,14/5/2006,India,Kunan Poshpora,1,0,1,The Mujahideen ambush and kill a civilian.
4603,14/5/2006,Pakistan,Jandola,1,0,1,A government official is assassinated in his home by pro-Taliban militants.
4604,14/5/2006,Iraq,Baghdad,2,0,2,Two Shia bakery workers are murdered by Sunni fundamentalists.
4605,15/5/2006,Iraq,Mosul,6,0,6,Six member of a single family are brutally slaughtered by Islamic militants.
4606,15/5/2006,Iraq,Wajihiya,1,7,8,Jihadis kill a 7-year-old girl with a mortar round.  Seven members of her family are injured in the explosion.
4607,15/5/2006,Iraq,Balad Ruz,4,0,4,Sunni gunmen shoot four primary school teachers to death as they are making their way in to work.
4608,15/5/2006,Iraq,Baghdad,5,0,5,"In a brutal attack, Islamic terrorists kidnap five members of the same family and shoot them to death."
4609,15/5/2006,Pakistan,Amma Khel,1,0,1,Pro-Taliban gunmen murder a civil employee on his way to restore power to a remote village.
4610,15/5/2006,India,Chatibandi Bandipore,2,0,2,The Mujahideen behead two civilians.
4611,15/5/2006,India,Batpora,2,0,2,"Two civilians are kidnapped by Muslim radicals, then killed by having their throats slit.  One was a shopkeeper."
4612,16/5/2006,Iraq,Baghdad,3,0,3,"Three people are kidnapped, tortured and executed by Islamic radicals."
4613,16/5/2006,Somalia,Mogadishu,2,0,2,Islamic militias kill two of a rival's bodyguards.
4614,16/5/2006,Pakistan,Miranshah,2,0,2,Two guards are gunned down by Islamic terrorists while on duty at a bazaar.
4615,16/5/2006,Afghanistan,Zangali,2,0,2,Two government employees are kidnapped and beheaded by radical Islamists.
4616,16/5/2006,Iraq,Karbala,1,0,1,An Egyptian working at a bakery is gunned down by Muslim extremists.
4617,16/5/2006,Iraq,Baghdad,4,0,4,Radical Sunnis murder four Iraqis on their way home from working at a U.S. base.
4618,16/5/2006,Iraq,Baghdad,23,37,60,"Sunni gunmen attack Shiites at a bus stop with automatic weapons and a bomb, killing at least twenty innocents and leaving dozens more in agony."
4619,16/5/2006,India,Handwara,1,0,1,A civilian is lynched from a tree by the Mujahideen.
4620,16/5/2006,Thailand,Narathiwat,1,1,2,A policeman is killed in a bomb attack by Islamic militants.
4621,17/5/2006,Somalia,Mogadishu,5,0,5,"Islamic militia attacks a compound, killing five people."
4622,17/5/2006,Ingushetia,Nazran,7,0,7,Seven innocent people are killed when terrorists bomb a car carrying a deputy minister.
4623,17/5/2006,Iraq,Baghdad,4,0,4,The lives of four civilians are destroyed by a terrorist bombing.
4624,17/5/2006,Iraq,Baqubah,4,11,15,"Jihadis shoot a baker to death, then murder others who arrive on the scene to help."
4625,17/5/2006,Turkey,Ankara,1,4,5,"Shouting 'Allah Akbar,' a gunmen murders a judge and injures four others in a courtroom shooting sparked by a limited ban of hijabs."
4626,17/5/2006,India,Doda,0,18,18,Eighteen people are injured when a Muslim hurls a grenade at a crowd.
4627,17/5/2006,Afghanistan,Mosa Qala,13,6,19,"The Taliban attack a small town, killing at least thirteen defenders."
4628,17/5/2006,Chechnya,Kurchaloi,5,6,11,Five Russian servicemen are slaughtered in a Mujahideen ambush on their vehicle.
4629,17/5/2006,Pakistan,Miser,1,4,5,"Pro-Taliban militants attack a security patrol, killing one."
4630,18/5/2006,India,Srinagar,1,23,24,"A Muslim woman tosses a grenade out a car window, killing a civilian.  A second blast in Pulwama injures twenty-three."
4631,18/5/2006,Thailand,Pattani,1,0,1,Islamic militants murder a house painter.
4632,18/5/2006,Iraq,Kirkuk,3,0,3,Jihadis kill two people in a drive-by shooting.  They also kidnap a woman and remove her head.
4633,18/5/2006,Iraq,Karbala,1,0,1,A math teacher is gunned down by a radical Shiite.
4634,18/5/2006,Iraq,Baghdad,8,9,17,"Eight innocents are blown to bits, and another nine suffer injury when Jihadis detonate a bomb along a city street."
4635,18/5/2006,Iraq,Baghdad,8,0,8,Radical Islamic gunmen stop a minibus carrying auto mechanics and their driver.  All eight are machine-gunned to death.
4636,18/5/2006,Afghanistan,Herat,1,0,1,An American civilian is killed by a suicidal religious extremist.
4637,18/5/2006,Afghanistan,Ghazni,1,0,1,A suicide bomber kills a civilian along a city street.
4638,19/5/2006,Sudan,Baja Baju,6,0,6,Six civilians are killed by the Janjaweed Arab militia.
4639,19/5/2006,Sudan,Natiqa,29,5,34,"The Janjaweed raid an African village, killing nearly thirty people."
4640,19/5/2006,Pakistan,Khaddi,1,0,1,A tribal leader is dragged from his car by militant Islamists and shot to death.
4641,19/5/2006,Somalia,Mogadishu,6,0,6,"Islamic militias break a truce, killing at least a half-dozen more."
4642,20/5/2006,Iraq,Qaim,5,10,15,A Fedayeen suicide car bomber murders at least five others on his way to paradise.
4643,20/5/2006,Iraq,Mussayab,19,0,19,Nineteen victims of sectarian violence are discovered.
4644,20/5/2006,Iraq,Al-Udhaim,2,3,5,A man and his wife are killed in their home by Islamic radicals.  Three of their children are injured in the invasion.
4645,20/5/2006,Iraq,Baghdad,19,58,77,al-Qaeda thought to be behind a brutal bombing that kills nineteen Shiite laborers gathering for work along a city street.
4646,20/5/2006,Pakistan,Hurmuz,2,1,3,Two Pakistani soldiers were killed when a Muslim radical tossed a grenade at their post in a Fedayeen attack.
4647,20/5/2006,Pal. Auth.,Gaza,1,6,7,Hamas suspected in elevator blast that kills a bodyguard.
4648,21/5/2006,England,Leeds,1,0,1,"A 19-year-old woman is beaten to death by her family, who claim that she had an 'evil spirit.'"
4649,21/5/2006,Pakistan,Karachi,1,0,1,A 14-year-old girl dies after her family shoots her in an honor killing for rejecting an arranged marriage.
4650,21/5/2006,Thailand,Pattani,1,0,1,A 22-year-old laborer is murdered by Islamic radicals on his job site.
4651,21/5/2006,Thailand,Narathiwat,1,1,2,A 69-year-old man is killed and his wife seriously injured in the brutal assault by Islamic militants.
4652,21/5/2006,Thailand,Yala,1,0,1,Muslims gun down a plantation worker.
4653,21/5/2006,Iraq,Baghdad,3,23,26,"Islamists hide two bombs at a fish market, killing at least three people."
4654,21/5/2006,Iraq,Baghdad,13,17,30,"An al-Qaeda suicide bomber detonates himself at a restaurant, slaughtering over a dozen patrons."
4655,21/5/2006,Afghanistan,Kabul,2,8,10,A Fedayeen car bomber kills himself and two innocent civilians.
4656,21/5/2006,India,Srinagar,6,22,28,Two Islamic groups vie for responsibility for a bloody attack on a youth rally that leaves six innocents dead.
4657,22/5/2006,Thailand,Pattani,1,0,1,"A Buddhist is shot off his motorcycle by Islamists, who then burn his body."
4658,22/5/2006,Iraq,Jurf al-Sakhar,4,0,4,Four policemen are blown to bits by radical Islamics.
4659,22/5/2006,Iraq,Baghdad,9,15,24,Separate Jihad bombings at a market and clinic end the lives of at least nine innocents.
4660,22/5/2006,Iraq,Jbela,3,6,9,Three civilians are killed by a terrorist bombing.
4661,22/5/2006,Pal. Auth.,Gaza,1,1,2,Hamas suspected in the assassination of a Fatah militant.
4662,22/5/2006,Iraq,Muqdadiya,2,0,2,An Islamic radical walks into a shop and murders two occupants.
4663,23/5/2006,Iraq,Baqubah,3,0,3,Three elderly men sitting outside their home are gunned down by Islamic extremists.
4664,23/5/2006,Pal. Auth.,Ramle,1,0,1,A 24-year old woman is stabbed 29 times in broad daylight by her brother for 'unIslamic' behavior.
4665,23/5/2006,Iraq,Baghdad,3,12,15,"Radical Muslims bomb a bakery, killing three people inside."
4666,23/5/2006,Iraq,Baghdad,11,9,20,Eleven people are killed when Sunnis detonate a bomb in the courtyard of a Shia mosque.
4667,23/5/2006,Thailand,Narathiwat,1,1,2,Muslim gunmen murder a civilian and seriously injure another.
4668,23/5/2006,Philippines,Jolo,4,0,4,Muslim terrorists kill four government soldiers in three separate attacks over the weekend.
4669,23/5/2006,India,Srinagar,2,20,22,Two people are killed when a Fedayeen detonates an explosives-laden vehicle along a city street.
4670,23/5/2006,India,Thanala,1,0,1,A civilian is beheaded by Islamic extremists.
4671,23/5/2006,Chechnya,Eshilkhatoy,4,3,7,A Mujahideen attack on a security patrol leaves four dead and three injured.
4672,23/5/2006,Thailand,Yala,2,0,2,Two policemen are shot to death in the head and chest by Muslim militants.
4673,23/5/2006,India,Srinagar,2,38,40,Jaish-e-Mohammad terrorists rampage against unarmed civilians in the capital city.
4674,23/5/2006,Iraq,Aswad,3,7,10,"Sunnis spray bullets into a crowd of Shia laborers, killing at least three."
4675,23/5/2006,Iraq,Ain al- Tamur,4,0,4,The bodies of four victims of sectarian violence are found blindfolded and shot.
4676,23/5/2006,Iraq,Baghdad,5,5,10,"Terrorists detonate a car bomb, killing five innocents."
4677,23/5/2006,Afghanistan,Helmand,3,6,9,"The Taliban ambush a vehicle carrying police, killing at least three."
4678,23/5/2006,Afghanistan,Wardak,4,0,4,Three health workers and their driver are killed when the Taliban bomb their car.
4679,24/5/2006,Pal. Auth.,Gaza,1,2,3,Hamas assassination claims one life.
4680,24/5/2006,Philippines,Jolo,1,0,1,Abu Sayyaf kill a 22-year-old coffee shop worker.
4681,24/5/2006,Iraq,Latifiya,7,0,7,Seven people are brutally slain by Islamic terrorists.
4682,24/5/2006,Afghanistan,Wazi Khwa,3,1,4,Three truck drivers are murdered by the Taliban.  The victims included a 15-year-old boy.
4683,25/5/2006,Afghanistan,Kabul,2,2,4,A Taliban rocket attack on a residential area kills two civilians.
4684,25/5/2006,India,Chewa,1,0,1,A civilian is murdered by the Mujahideen.
4685,25/5/2006,India,Srinagar,4,7,11,An 8-year-old boy is among four killed when militant Muslims hurl a grenade at a tourist bus.
4686,25/5/2006,Philippines,Jolo,1,0,1,A 32-year-old cigarette vendor is gunned down by Abu Sayyaf near a Catholic church.
4687,25/5/2006,Iraq,Tikrit,9,0,9,"A Sufi mosque is bombed, killing two, and sectarian violence claims seven more lives elsewhere."
4688,25/5/2006,Somalia,Mogadishu,48,50,98,Nearly fifty more people are killed in violence sparked by Islamic militias.
4689,25/5/2006,Iraq,Muqdadiya,5,0,5,"Sunni Holy Warriors abduct five men from a wedding, including the groom and his father, then behead them in captivity."
4690,26/5/2006,Iraq,Baghdad,3,0,3,Religious fundamentalists shoot three tennis players to death for wearing shorts.
4691,26/5/2006,Iraq,Baghdad,9,51,60,"Islamic terrorists detonate two bombs at outdoor markets, killing at least nine and injuring over fifty."
4692,26/5/2006,Pakistan,Miranshah,1,0,1,A local man is executed by radical fundamentalists.
4693,26/5/2006,India,Kishtwar,2,0,2,Harkat-ul-Jehad-e-Islami shoot two farmers to death in their field.
4694,27/5/2006,Thailand,Pattani,1,3,4,"A 3-year-old baby is shot to death by Islamists, who also injure the mother, father and a brother in the attack."
4695,27/5/2006,Iraq,Baghdad,4,15,19,"Terrorists lob a mortar into a marketplace, killing at least four shoppers."
4696,27/5/2006,Iraq,Baiji,2,1,3,Jihadis murder two oil truck drivers.
4697,27/5/2006,Iraq,Baqubah,7,5,12,"Islamic gunmen kill two brothers at an ironsmith shop, then three brothers at a nearby tire shop.  Two other people are killed elsewhere."
4698,27/5/2006,India,Bandipura,2,1,3,A woman is among two people shot to death by Islamic terrorists.
4699,28/5/2006,Thailand,Narathiwat,2,1,3,"Two men riding in a pickup up truck are killed, and a woman seriously injured in an Islamic shooting attack."
4700,28/5/2006,Pakistan,Mir Ali,1,0,1,Pro-Talibanis assassinate a tribal leader at a bazaar.
4701,28/5/2006,Pakistan,Datta Khel,2,3,5,Two people are killed and three injured when a car bomb goes off at a checkpoint.
4702,28/5/2006,India,Srinagar,3,0,3,Three civilians are murdered by Islamic terrorists in separate attacks - one as he lay injured in a hospital bed.
4703,28/5/2006,Iraq,Baghdad,2,17,19,Two civilians are killed in a double bombing by Islamic radicals.
4704,28/5/2006,Iraq,Baqubah,3,0,3,Three severed heads are thrown out of a car as it passes through the area where Islamic terrorists kidnapped three civilians.
4705,28/5/2006,Pakistan,Sindh,2,7,9,"Muslim gunmen open fire on a group of Hindus returning from a religious ceremony, killing two and injuring seven."
4706,29/5/2006,Pakistan,Jacobabad,5,0,5,A man kills his wife and four other relatives in an honor killing.
4707,29/5/2006,Iraq,Baghdad,29,46,75,"Three separate Jihad bombings targeting a university, mosque, and a residential area leave at least twenty-seven innocents dead and nearly fifty injured."
4708,29/5/2006,Iraq,Khalis,14,17,31,"Fourteen laborers traveling to work are blown to bits, and another sixteen left in agony by a bomb planted on a passenger bus."
4709,29/5/2006,Pakistan,Chakmalai,1,0,1,A tribal leader is assassinated by pro-Taliban elements.
4710,29/5/2006,Iraq,Baghdad,4,7,11,"Four people are killed, including two members of a news crew, when radical Muslims bomb a U.S. convoy."
4711,29/5/2006,Philippines,Jolo,1,0,1,Abu Sayyaf gunmen murder a police officer.
4712,29/5/2006,Iraq,Samarra,2,0,2,Two brothers are gunned down by Muslim radicals as the are walking by the side of the road.
4713,29/5/2006,Pakistan,Akori,3,0,3,Local Taliban suspected in a landmine attack that leaves three small girls dead.
4714,30/5/2006,Iraq,Baghdad,9,10,19,Nine people in a bakery are cut down by a terrorist bombing.
4715,30/5/2006,Iraq,Hilla,12,36,48,A Fedayeen suicide car bomber massacres at least a dozen people near a car dealership.
4716,30/5/2006,Iraq,Husaniya,25,65,90,"Jihadis bomb a market, slaughtering at least twenty-five innocents."
4717,30/5/2006,Thailand,Yala,1,0,1,Muslims shoot a 50-year-old man to death.
4718,30/5/2006,India,Srinagar,1,9,10,"A Jaish-e-Mohammad militant tosses a grenade into a crowd of people, killing one."
4719,30/5/2006,Pakistan,Ferozewala,4,20,24,"Four people, including a woman and child, are killed when terrorists spray their vehicle with automatic weapons fire."
4720,30/5/2006,Afghanistan,Qalat,1,4,5,A rocket attack by Taliban fundamentalists leaves at least one Afghan dead.
4721,30/5/2006,Pal. Auth.,Raffidiyeh,1,0,1,A mother of four is shot to death in a hospital courtyard by relatives and al-Aqsa Martyrs Brigade.
4722,30/5/2006,Pal. Auth.,Balata,1,0,1,A man is executed on a city street on suspicion of helping Jews.
4723,30/5/2006,Afghanistan,Shiberghan,4,0,4,Three Afghan women working for a humanitarian aid agency are gunned down in cold blood along with their driver by religious fundamentalists.
4724,30/5/2006,Afghanistan,Badakhshan,2,2,4,Two Afghan employees of a U.S. firm are murdered by Taliban terrorists in a landmine attack.
4725,31/5/2006,India,Thal,1,0,1,Islamic terrorists slit the throat of a villager.
4726,31/5/2006,India,Dalgate,1,36,37,Thirty-six tourists are injured in two Mujahideen attacks on their buses.  One succumbs to injuries on June 2.
4727,31/5/2006,Iraq,Muqdadiya,2,0,2,The mayor and his cousin are killed when Islamic radical put a bomb under his car.
4728,31/5/2006,Iraq,Baghdad,1,0,1,A TV sports anchorman is killed by religious fundamentalists as he stepped out of his house.
4729,31/5/2006,Iraq,Baghdad,46,0,46,Forty-six victims of sectarian violence are found with signs of torture in various locales around the capital.
4730,1/6/2006,Iraq,Baghdad,6,21,27,"Islamic terrorist kill six people, including two laborers in a roadside bombing."
4731,1/6/2006,Iraq,Samarra,1,4,5,A woman is blown apart by Islamic terrorists.
4732,1/6/2006,Kosovo,Zitkovac,1,0,1,A 22-year-old man is shot to death in an automatic weapons ambush by suspected Albanians.
4733,1/6/2006,India,Budhal,1,0,1,A civilian is abducted and murdered by the Mujahideen.
4734,2/6/2006,Iraq,Khaldiya,3,0,3,Three victims of sectarian violence are found tortured and executed.
4735,2/6/2006,Afghanistan,Azmarai,3,0,3,A Fedayeen suicide bomber kills three civilians returning from a picnic.
4736,2/6/2006,Thailand,Yala,1,0,1,A local official is gunned down by Islamists.
4737,2/6/2006,Syria,Damascus,1,0,1,Armed Islamists attempt to storm a radio station.  A security guard is killed.
4738,2/6/2006,Iraq,Baghdad,7,61,68,"Three terrorist bombings, two at the same market, kill at least seven innocents."
4739,2/6/2006,Pakistan,Miran Shah,4,7,11,"Two Fedayeen suicide bombers blow themselves to Allah, taking four Pakistani soldiers with them."
4740,2/6/2006,Pakistan,Noor Gul,2,1,3,Two people are killed when militants fire a rocket at a house.
4741,2/6/2006,India,Bhata,1,0,1,A civilian is abducted and murdered by the Mujahideen.
4742,3/6/2006,Iraq,Basra,28,62,90,"'Insurgents' bomb a packed market, blowing twenty-eight innocent souls to Allah and injuring dozens more."
4743,3/6/2006,Iraq,Baghdad,23,4,27,Twenty-two bodies are found showing signs of torture and Islamists also kill a Russian diplomat.
4744,3/6/2006,Iraq,Baquba,8,0,8,Eight severed Sunni heads are found.
4745,3/6/2006,Iraq,Baquba,9,2,11,Islamic radicals storm an auto parts shop killing three workers.  Six police are killed in a separate attack on a checkpoint.
4746,4/6/2006,Pal. Auth.,Khan Younis,1,2,3,Militants kill a pregnant woman.
4747,4/6/2006,Pakistan,Shena Khowar,2,3,5,al-Qaeda back militants use an IED to kill two Pakistani soldiers in a roadside blast.
4748,4/6/2006,Ingushetia,Nazran,1,2,3,Muslim militants kill a soldier in a terror attack.
4749,4/6/2006,Iraq,Baghdad,19,2,21,Radical Islamic gunmen kill four employees at a local company and fifteen others in various parts of the capital.
4750,4/6/2006,Iraq,Diyala,21,1,22,"Sunnis drag twenty-one people, mostly Shia high school students, from a bus and execute them in cold blood."
4751,4/6/2006,Afghanistan,Paktika,1,0,1,A health official is shot dead by the Taliban as he is leaving his home.
4752,4/6/2006,Afghanistan,Kandahar,4,13,17,A suicidal religious extremist blows up four civilians with an explosives-laden vehicle.
4753,4/6/2006,India,Rajouri,1,0,1,Islamic radicals kill a man inside his home.
4754,4/6/2006,Pal. Auth.,Gaza,3,0,3,Three civilian bystanders are shot to death by Hamas gunmen.
4755,5/6/2006,Iraq,Suwayra,4,0,4,Four men are stabbed to death by Muslim militants.
4756,6/6/2006,Afghanistan,Oal a-I Oadzi,3,8,11,Three children are among the casualties when religious extremists blow up a mosque and school.
4757,6/6/2006,Afghanistan,Khogyani,2,2,4,A Taliban roadside attack leaves two soldiers dead.
4758,6/6/2006,Iraq,Baghdad,5,7,12,"At least two women are among five civilians killed by Muslim terrorists in three attacks, which include a husband and wife gunned down on a city street."
4759,6/6/2006,Iraq,Baqubah,9,0,9,"Nine more severed heads are found, courtesy of the Religion of Peace.."
4760,7/6/2006,Iraq,Baghdad,11,5,16,Separate attacks and the discovery of five bodies add up to eleven dead in sectarian violence.
4761,7/6/2006,Iraq,Baqubah,2,0,2,Two ship-owners are gunned down by Islamic radicals.
4762,7/6/2006,Iraq,Mosul,6,0,6,"Six people, including three university students are shot to death by Muslim terrorists."
4763,7/6/2006,India,Patnazi,1,0,1,Islamic terrorists murder an 18-year-old girl in her home.
4764,8/6/2006,Afghanistan,Kandahar,2,0,2,"The Taliban kill two policemen, then mutilated their bodies."
4765,8/6/2006,Philippines,Patikul,1,2,3,"Islamists attack Christians at a carnival, killing one and injuring two more."
4766,8/6/2006,Afghanistan,Ghazni,3,1,4,Three Afghans are murdered by a Taliban roadside bomb.
4767,8/6/2006,Iraq,Baghdad,19,50,69,Nineteen people are killed and more than fifty injured by two terror bombings near a market.
4768,8/6/2006,Thailand,Narathiwat,5,3,8,Five policemen are blown to bits by militant Muslims in a landmine attack.
4769,8/6/2006,Afghanistan,Bala Buluk,1,0,1,Two Talibanis kill a government official on a city street.
4770,8/6/2006,Afghanistan,Balkh,2,1,3,Two humanitarian workers are murdered in a shooting attack by religious fundamentalists.
4771,8/6/2006,Turkey,Istanbul,1,0,1,Islamists suspected in the assassination of a lawyer.
4772,8/6/2006,Iraq,Kazimiyah,6,15,21,Six day laborers are blown apart by a Muslim car bomb.
4773,8/6/2006,Iraq,Baghdad,15,23,38,"Jihadis target an outdoor market with separate car bombs, killing at least fifteen innocents."
4774,9/6/2006,Ingushetia,Karabulak,1,0,1,A woman is gunned down by Muslim radicals.
4775,9/6/2006,Ingushetia,Ordzhonikidzevskaya,6,0,6,Three young children are among six killed in a targeted Jihad ambush on a vehicle.
4776,9/6/2006,Pakistan,Wana,1,4,5,An 18-year-old farm worker is killed in a landmine attack.
4777,10/6/2006,Iraq,Khan Bani Saad,2,0,2,Shiites kidnap two Sunni brothers from their workplace and then chop off their heads.
4778,10/6/2006,Iraq,Baghdad,9,41,50,"Islamic radicals set off bombs near two crowded shopping areas, killing at least nine and injuring over forty others."
4779,11/6/2006,Algeria,Skikda,1,3,4,Fundamentalists capture a civilian and cut his throat on video.
4780,11/6/2006,Israel,Jerusalem,1,4,5,"Palestinian gunmen fire on a car carrying Israelis, killing a 35-year-old father."
4781,11/6/2006,Thailand,Narathiwat,1,0,1,A young man is murdered by Islamic extremists outside a mosque.
4782,11/6/2006,Iraq,Fallujah,2,0,2,A man and a woman are brutally gunned down by Muslim terrorists.
4783,11/6/2006,Iraq,Tikrit,1,0,1,An Iraqi soldier is captured and beheaded by the Mujahideen.
4784,11/6/2006,Chechnya,Niki-Khita,1,1,2,A Jihad ambush kills one Russian and injures another.
4785,11/6/2006,Afghanistan,Kandahar,4,0,4,Four road workers are murdered by the Taliban.
4786,11/6/2006,Iraq,Baghdad,6,42,48,"Muslim terrorists detonate a car bomb in a commercial district, killing at least six innocents."
4787,12/6/2006,Iraq,Baghdad,6,12,18,"Sunni radicals bomb a minibus carrying oil workers, killing six."
4788,12/6/2006,India,Jammu,1,22,23,Hindu pilgrims at a bus stop are the targets of a grenade attack by Islamic militants.
4789,12/6/2006,Afghanistan,Ghazni,1,1,2,"Religious extremists attack a private truck convoy, killing one of the drivers."
4790,12/6/2006,Afghanistan,Paktia,2,5,7,Two passengers in a car are killed and five injured when the Taliban place a bomb under a bridge.
4791,12/6/2006,India,Sopore,3,0,3,Three people are killed in two separate Islamic grenade attacks.
4792,12/6/2006,India,Budora,1,0,1,"A newly recruited soldier, home on leave, is abducted, tortured and beheaded by the Mujahideen."
4793,12/6/2006,India,Kulgam,8,5,13,Hizbul Mujahideen massacre eight migrant laborers.
4794,12/6/2006,Iraq,Suwayra,9,0,9,A 10-year-old boy is among nine people killed by radical Shiites and dumped into a river.
4795,12/6/2006,Iraq,Balad,2,26,28,"A market is once again the target of Islamic militants, who blast at least two shoppers to Allah."
4796,12/6/2006,Iraq,Baghdad,5,19,24,A suicidal Sunni blows up five Shiites at a market.
4797,12/6/2006,Iraq,Tal Afar,4,43,47,"A Fedayeen suicide bomber plows into a gas station, sending at least four civilians to Allah."
4798,13/6/2006,Algeria,Skikda,1,3,4,A bomb attack by Islamic fundamentalists kills an Algerian soldier.
4799,13/6/2006,India,Anantnag,1,0,1,"The Mujahideen abduct a civilian, murder him and then toss his body in a stream."
4800,13/6/2006,Iraq,Baghdad,7,0,7,Islamists shoot a university professor to death as six bodies showing signs of torture are found elsewhere.
4801,13/6/2006,Iraq,Kirkuk,22,43,65,"A series of Jihad car bombings leave at least twenty people dead, mostly civilians."
4802,14/6/2006,Iraq,Baghdad,2,7,9,"Jihadis detonate a car bomb near a market, killing two civilians."
4803,14/6/2006,Pakistan,Thabi,1,0,1,A man is kidnapped and beheaded by local Taliban.
4804,14/6/2006,India,Sopore,1,0,1,A man is murdered by Islamic terrorists.
4805,14/6/2006,India,Bandipore,2,0,2,Two civilians are gunned down by the Mujahideen.
4806,15/6/2006,Iraq,Baqubah,10,2,12,Muslim gunmen slaughter ten laborers as they are headed to work.  All are shot to death.
4807,15/6/2006,Thailand,Pattani,1,6,7,A man is killed by Muslim bombers targeting a city hall.
4808,15/6/2006,Thailand,Pattani,1,10,11,"Islamists bomb a tea shop, killing a Buddhist patron.  Just one of 41 bombs set that morning."
4809,15/6/2006,Afghanistan,Kandahar,10,16,26,"Religious extremists bomb a minibus carrying laborers, killing at least ten people."
4810,15/6/2006,Pakistan,Karachi,5,6,11,"Militants ambush a car carrying policemen on a city street, killing five people."
4811,15/6/2006,Iraq,Tikrit,4,15,19,Radicals storm a mosque and shoot a cleric and three others to death.
4812,15/6/2006,Pakistan,Mir Ali,1,0,1,A journalist who was abducted six months earlier is executed by Islamists while in handcuffs.
4813,15/6/2006,India,Srundoo,1,0,1,The Mujahideen gun down a civilian.
4814,15/6/2006,India,Dunga,1,13,14,"Two brothers are brutally tortured by Islamists, who cut off their tongues, noses and ears.  Their 60-year-old father is also shot to death."
4815,15/6/2006,Pakistan,Hasilpur,1,1,2,An elderly man is killed by a Muslim mob as he tries to protect another man from torture over suspicion of blasphemy.
4816,15/6/2006,Algeria,Gouraya,10,0,10,"Two people are beheaded by Islamic fundamentalists, who also kill seven other persons in separate attacks."
4817,16/6/2006,USA,"Baltimore, MD",1,0,1,A 62-year-old Jewish movie-goer is shot to death by a Muslim gunman in an unprovoked terror attack.
4818,16/6/2006,Iraq,Baghdad,3,16,19,"Muslim terrorists fire mortar rounds into a residential neighborhood, killing at least three Iraqis."
4819,16/6/2006,Iraq,Yusifiyah,3,0,3,"Islamic terrorists attack a checkpoint and kidnap two U.S. soldiers, who are later tortured to death."
4820,16/6/2006,Iraq,Fallujah,5,0,5,Jihad gunmen massacre five truck drivers trying to make a living.
4821,16/6/2006,Pakistan,Orakzai,4,0,4,Two girls under the age of 5 are slaughtered along with two women working for an NGO by Muslim gunmen who broke into their home in the middle of the night.
4822,16/6/2006,Iraq,Baghdad,11,25,36,"A Sunni suicide bomber hits a Shiite mosque, blasting eleven worshippers to Allah and leaving dozens more in agony."
4823,16/6/2006,Pakistan,Muzzafargarh,1,0,1,A man accused of blasphemy is knifed to death by two religious men outside a courtroom.
4824,16/6/2006,India,Kashmir,2,0,2,Two civilians are murdered by militant Muslims in separate attacks.
4825,16/6/2006,India,Bandipore,2,3,5,"The Mujahideen stages a grenade attack along a city street, killing two civilians."
4826,17/6/2006,Iraq,Baghdad,8,37,45,"Jihadis target two markets with explosives, killing at least eight shoppers and leaving another 25 in various stages of injury."
4827,17/6/2006,Iraq,Baghdad,3,14,17,"Muslim extremists bomb a minibus, killing at least four passengers."
4828,17/6/2006,Iraq,Baghdad,23,52,75,Two suicidal Sunnis slaughter dozens in separate attacks at traffic checkpoints.
4829,17/6/2006,Thailand,Yala,1,2,3,"Islamists bomb a karaoke bar, killing one patron."
4830,18/6/2006,Iraq,Baqubah,13,0,13,"Radical Muslims gun down three people in cold blood, as ten other bodies are found elsewhere."
4831,18/6/2006,Iraq,Mosul,1,19,20,Jihadis murder a high-school girl and injure nineteen others with a car bomb.
4832,18/6/2006,Thailand,Pattani,1,2,3,An 88-year-old woman is murdered when Islamists open up on a crowd with automatic weapons.
4833,18/6/2006,Afghanistan,Helmand,32,14,46,Some thirty members of the same family are massacred by the Taliban.
4834,18/6/2006,Thailand,Narathiwat,1,0,1,A 48-year-old man out for a Sunday drive is shot to death by Islamists.
4835,19/6/2006,Iraq,Baghdad,7,13,20,Seven civilians are murdered by Islamic terrorists in two car bombings.
4836,19/6/2006,Pakistan,Wana,1,0,1,Militant Muslims assassinate a tribal chief.
4837,19/6/2006,India,Tangmarg,1,0,1,A civilian is abducted and murdered by the Mujahideen.
4838,19/6/2006,Afghanistan,Kandahar,4,0,4,Four members of a construction company are killed when religious extremists attack their vehicle.
4839,20/6/2006,Algeria,Blida,5,0,5,Five farmers are murdered by Islamic fundamentalists in a gruesome knife attack.
4840,20/6/2006,India,Aaora Missipora,1,0,1,A political activist is shot to death by the Mujahideen.
4841,20/6/2006,Iraq,Baghdad,2,18,20,Islamic terrorists kill two civilians in a bomb attack on a commercial area.
4842,20/6/2006,Iraq,Suwayra,7,0,7,The bodies of seven victims of Islamic radicals are found handcuffed and tortured.
4843,20/6/2006,Iraq,Basra,2,3,5,Elderly patients at an old age home are targeted by a Sunni suicide bomber.  Two are killed.
4844,21/6/2006,Iraq,Baghdad,4,6,10,"Jihadis murder two people with a car bomb at a crowded market.  Elsewhere, a Sunni imam and a high school teacher are gunned down."
4845,21/6/2006,Dagestan,Khasavyurt,2,0,2,Two policemen sitting in a car are slaughtered in a brutal shooting attack at a traffic stop.
4846,21/6/2006,Algeria,Bouira,6,3,9,"Islamic fundamentalists ambush a security patrol, killing six individuals."
4847,21/6/2006,Afghanistan,Kandahar,1,7,8,A Fedayeen suicide bomber kills a civilian and injures seven others.
4848,21/6/2006,Pakistan,Bannu,3,1,4,Three Pakistan policemen on patrol are murdered by al-Qaeda backed terrorists.
4849,22/6/2006,Iraq,Hawija,1,0,1,A carpenter is murdered by Islamic terrorists.
4850,22/6/2006,India,Sopore,2,20,22,"Muslim militants hurl a grenade at the house of a religious rival, killing a woman and a child, and injuring twenty others."
4851,22/6/2006,India,Rajpura,1,0,1,A civilian is killed in his home by the Mujahideen.
4852,23/6/2006,Philippines,Shariff Aguak,6,9,15,Six shoppers are blown to bits when Filipino Muslims set off a bomb at a crowded market.
4853,23/6/2006,Afghanistan,Zabul,4,0,4,The Taliban kidnap four civilians and then cut off their heads.
4854,23/6/2006,Iraq,Hibhib,10,15,25,"Shia terrorists bomb a Sunni mosque, killing at least ten."
4855,23/6/2006,India,Lal Chowk,1,0,1,Islamists murder a police officer on a city street in the capital.
4856,23/6/2006,Somalia,Mogadishu,1,0,1,A Swedish journalist attending an Islamic rally is shot fatally in the chest.
4857,23/6/2006,Iraq,Baghdad,5,0,5,"The bodies of five factory workers, kidnapped the day before, are found in a river."
4858,23/6/2006,Iraq,Basra,5,15,20,At least five people are killed when Islamic militants bomb a gas station.
4859,24/6/2006,India,Palhalan,1,1,2,A 12-year-old boy is killed in a Mujahideen ambush.
4860,24/6/2006,India,Srinigar,1,9,10,An Islamic militant tosses a grenade into a crowded street crossing.
4861,24/6/2006,Iraq,Baqubah,14,5,19,Three civilians at a car dealership are among fourteen who loose their lives to Islam in four terror attacks.
4862,24/6/2006,Iraq,Suwayra,1,0,1,A young woman is tortured and beheaded by angry Muslims.
4863,24/6/2006,Afghanistan,Khost,1,0,1,Religious extremists kill a policeman as he is driving to work.
4864,25/6/2006,Israel,Kerem Shalom,2,3,5,Hamas takes credit for an attack on Israel that leaves two IDF soldiers dead and a third kidnapped.
4865,25/6/2006,USA,"Denver, CO",1,5,6,"Saying that it was 'Allah's choice', a Muslim shoots four of his co-workers and a police officer."
4866,25/6/2006,Iraq,Hawija,3,0,3,Three Shiites are killed in a drive-by shooting.
4867,25/6/2006,Pakistan,Karachi,2,0,2,Muslims gun down two civilians in a suspected sectarian attack.
4868,25/6/2006,India,Tral,1,0,1,The Mujahideen kidnap a policeman and then torture and execute him.
4869,25/6/2006,Iraq,Baghdad,3,0,3,Islamists read from the Qur'an as they execute three Russian hostages in cold blood.  The last two are forced to stand over the blood and decapitated body of the first.
4870,25/6/2006,Iraq,Baghdad,5,22,27,"Two Jihad bombings, one in a shopping center and the other on a minibus, leave at least five Iraqi civilians dead."
4871,25/6/2006,Israel,Ramallah,1,0,1,An 18-year-old Israeli hitchhiker is picked up by Palestinian terrorists and murdered.
4872,26/6/2006,India,Bandipore,3,0,3,Islamic radicals gun down three civilians.
4873,26/6/2006,Iraq,Hilla,6,56,62,Six shoppers at a market are murdered in a Jihad bombing.
4874,26/6/2006,Iraq,Baqubah,18,25,43,"Islamic terrorists bomb a crowded market, slaughtering at least eighteen innocents."
4875,26/6/2006,Pakistan,North Waziristan,6,5,11,"A Fedayeen suicide bomber plows into a checkpoint, taking the lives of six Pakistanis."
4876,26/6/2006,Pakistan,Karachi,1,0,1,A Muslim man slits his pregnant wife's throat in an honor killing.
4877,26/6/2006,India,Baramulla,2,0,2,Two civilians are murdered by the Mujahideen in separate attacks.
4878,26/6/2006,Pakistan,Guldar,5,0,5,Local Talibanis attack a civilian and kill him along with four family members.
4879,27/6/2006,Iraq,Baghdad,3,3,6,Three policemen are killed in a roadside terror bombing.
4880,27/6/2006,Iraq,Kirkuk,3,21,24,"Jihadis blow up a gas station, killing three patrons."
4881,27/6/2006,Thailand,Narathiwat,2,0,2,Two villagers are murdered by Islamic radicals.
4882,27/6/2006,Thailand,Yala,5,1,6,Islamists target a convoy of teachers with a bomb.  Five security guards are killed in the explosion.
4883,27/6/2006,India,Rajpora,2,0,2,"Two people are kidnapped by Islamic militants, and then executed with their bodies thrown into a stream."
4884,27/6/2006,Thailand,Yala,1,0,1,A man is killed in his home by Islamists.
4885,27/6/2006,Somalia,Lafole,6,0,6,Islamic militias break a truce and attack two checkpoints.
4886,27/6/2006,Afghanistan,Kunduz,2,8,10,"Fedayeen bombers target German peacekeepers, but kill two civilians."
4887,27/6/2006,Iraq,Baghdad,3,10,13,A nail-packed bomb at a market kills three.
4888,28/6/2006,Thailand,Narathiwat,1,5,6,"Islamic gunmen storm into a karaoke bar, killing one and injuring five others."
4889,28/6/2006,Nigeria,Izom,1,0,1,A 20-year-old woman is stoned to death by a Muslim mob after she criticized Islam.
4890,28/6/2006,Philippines,Maguindanao,1,2,3,A government official is gunned down and two 9-year-old girls are wounded by suspected Muslims .
4891,28/6/2006,Iraq,Baqubah,3,12,15,Jihadis use a car bomb in a crowd of laborers looking for work.  Children are among the casualties.
4892,29/6/2006,Iraq,Kirkuk,2,0,2,A 15-year-old girl is among two people kidnapped and murdered by radical Muslims.
4893,29/6/2006,Iraq,Baghdad,8,4,12,"In separate attacks, Jihadis kill eight civilians including a baker, and electrical worker, a garbage collector and a university professor."
4894,29/6/2006,Iraq,Kirkuk,4,27,31,A suicide bomber kills four Iraqis at a funeral.
4895,29/6/2006,Iraq,Hilla,14,0,14,"Fourteen bodies are found in Hilla, Kut and Karbala.  The victims included women and children who were killed in brutal fashion."
4896,29/6/2006,India,Kashmir,2,0,2,Two civilians are shot to death by radical Muslims in separate attacks (Kangan and Bandipore).
4897,29/6/2006,Algeria,Albalouta,2,11,13,"Islamic fundamentalists attack a communal guard post with rockets, killing two people, whose bodies they later burned."
4898,30/6/2006,Pakistan,Gadi Wind,1,0,1,"A group of Muslim bulldoze a Christian family's house, killing an infant."
4899,30/6/2006,Iraq,Baghdad,7,0,7,Six bodies are found dumped in a house and Jihadi terrorists elsewhere gun down an Imam.
4900,30/6/2006,Pakistan,Ipi,1,0,1,"Shouting ""Allah Akbar,"" executioners shoot a man to death in a public square."
4901,30/6/2006,Pakistan,Spinkai Raghzai,1,3,4,Local Taliban shoot a rival religious leader to death.
4902,1/7/2006,Iraq,Baghdad,62,114,176,Sixty-two Shiite shoppers are blown to bits in a horrific marketplace bombing by Sunni terrorists that leaves over a hundred others in various stages of suffering.
4903,1/7/2006,Iraq,Mosul,2,6,8,Two people are killed by a suicide bomber.
4904,1/7/2006,Iraq,Haditha,5,12,17,"Jihadis mortar a residential neighborhood, killing five residents."
4905,1/7/2006,Thailand,Yala,1,0,1,Muslim terrorists shoot a civilian off of his motorcycle.
4906,1/7/2006,Afghanistan,Sangin,3,4,7,Two Brits and an Afghan interpreter are killed in an attack on their compound by the Taliban.
4907,1/7/2006,Thailand,Narathiwat,1,0,1,Radical Muslims shoot a 22-year-old man to death as he is sleeping in the back of his pick-up truck.
4908,2/7/2006,India,Mumbai,1,0,1,An 18-year-old girl is strangled by her family for loving a Hindu boy.  Her father then chops up the body.
4909,2/7/2006,Pakistan,Ningolai,2,0,2,A 15-year-old boy is among two people murdered by Muslim terrorists.
4910,2/7/2006,Iraq,Baghdad,3,29,32,Three separate bombings kill three people and injure over two dozen others.
4911,2/7/2006,Iraq,Baqubah,2,3,5,Two members of a family are killed when Islamic terrorists set off a bomb outside their home.
4912,2/7/2006,Pakistan,Lower Dir,6,7,13,Six members of a security patrol are killed by a Taliban landmine at an Afghan refugee camp.
4913,3/7/2006,India,Poonch,1,0,1,"Hizb-ul-Mujahideen kidnap a police officer then cut out his eyes, ears and penis before slitting his throat."
4914,3/7/2006,Iraq,Hawija,1,0,1,Islamic terrorists kidnap and behead a civilian.
4915,3/7/2006,Afghanistan,Kandahar,1,6,7,Fedayeen suicide bomber kills one other person.
4916,3/7/2006,Afghanistan,Kunar,5,1,6,Five laborers are shot to death by Taliban extremists.
4917,3/7/2006,Afghanistan,Herat,1,6,7,A female university student is murdered by religious extremists.
4918,3/7/2006,Iraq,Mosul,5,28,33,"Jihadis bomb a crowded market, killing five innocents."
4919,3/7/2006,Iraq,Diwaniya,3,0,3,Religious fundamentalists kill two alcohol traders.  A third person is beheaded elsewhere.
4920,4/7/2006,Turkey,Gaziantep,1,0,1,A pregnant 16-year-old girl is brutally slain in her bed by her brother in an 'honor killing.'
4921,4/7/2006,Chechnya,Avtury,6,14,20,"The Mujahideen fire rockets at a truck convoy, killing at least six Russians."
4922,4/7/2006,Iraq,Karbala,6,0,6,Six civilians are killed execution style by Muslim terrorists.
4923,4/7/2006,Philippines,Patikul,2,0,2,Abu Sayyaf terrorists ambush and kill two government soldiers.
4924,4/7/2006,India,Sarharda,1,0,1,"Lashkar-e-Toiba kidnap a man, take him to a field and then slit his throat."
4925,4/7/2006,Somalia,Mogadishu,2,0,2,"Hard-line Islamists open fire on a group of teenagers watching a World Cup match, killing two, including a girl."
4926,5/7/2006,Afghanistan,Kabul,1,47,48,Three Taliban bombs against commuter buses leave at least one person dead.
4927,5/7/2006,Iraq,Baghdad,2,10,12,"Jihadis bomb a restaurant, killing two people."
4928,5/7/2006,Thailand,Yala,1,0,1,A man is shot to death by Islamic gunmen while riding a motorcycle.
4929,5/7/2006,Nigeria,Kumutu,3,30,33,"Nigerian 'Taliban' attacks Christian villagers, killing at least three."
4930,6/7/2006,Iraq,Kufa,13,41,54,"Sunni 'freedom fighters' blast two buses full of Shiite pilgrims with a car bomb, killing at least thirteen."
4931,7/7/2006,Iraq,Baghdad,5,9,14,"Shia terrorists bomb two Sunni mosques, killing five people."
4932,7/7/2006,Iraq,Tal Banat,6,46,52,Six Shia worshippers at a mosque are blown apart by Sunni radicals in a bombing.
4933,7/7/2006,Iraq,Baghdad,3,30,33,"Sunnis mortar a Shia mosque, killing at least three innocents."
4934,7/7/2006,Iraq,Khadimiyah,4,38,42,Islamic terrorists massacre four children in a mortar attack on a field where they are playing.
4935,8/7/2006,Iraq,Baghdad,13,14,27,"Five horrible attacks on civilians by Muslim terrorists leave thirteen dead, including six people who were merely collecting rags."
4936,8/7/2006,Chechnya,Shelkovskaya,4,2,6,Four civilians are murdered by the Mujahideen in an ambush on their vehicle.
4937,8/7/2006,India,Kulgam,5,32,37,Five people are killed when Islamic militants lob grenades at a female political figure.
4938,8/7/2006,Ingushetia,Sunzhensky,2,1,3,"Militants ambush a car with automatic weapons, killing two occupants."
4939,9/7/2006,Iraq,Baghdad,19,59,78,"Radical Sunnis bomb a Shiite mosque, killing nineteen innocents."
4940,9/7/2006,Iraq,Baghdad,41,0,41,Radical Shiites set up a phony roadblock and shoot 41 Sunni civilians to death in retaliation for a mosque bombing.
4941,9/7/2006,Somalia,Mogadishu,19,20,39,At least nineteen people are killed when Islamic militias attack a compound.
4942,9/7/2006,Thailand,Narathiwat,1,0,1,Muslim radicals gun down a young man at a rubber plantation.
4943,9/7/2006,Kyrgyzstan,Jalal-Abad,1,3,4,Islamic militants gun down a policeman.
4944,10/7/2006,Pakistan,Babara,2,0,2,Local Islamists kill a tribal leader and a community guard in a pre-dawn attack.
4945,10/7/2006,Algeria,Tipaza,6,4,10,Algerian fundamentalists kill six people in an attack on a community.
4946,10/7/2006,Iraq,Suwayra,5,0,5,Five civilians are kidnapped and executed by the Mujahideen.
4947,10/7/2006,Iraq,Kirkuk,3,8,11,A Fedayeen suicide bomber murders three others.
4948,10/7/2006,Iraq,Baghdad,6,28,34,Jihadis kill six with a car bomb located outside a restaurant.
4949,10/7/2006,Pakistan,Malir,1,0,1,A prominent Sunni is gunned down in a sectarian attack.
4950,11/7/2006,Iraq,Baghdad,23,15,38,"In three horrible attacks, Islamic radicals kill twenty-three innocent people, including ten Shias on their way to a funeral."
4951,11/7/2006,Iraq,Baqubah,19,0,19,Nineteen people are gunned down by Muslim terrorists.
4952,11/7/2006,India,Srinagar,9,43,52,"The Mujahideen hurl grenades at tourists, killing nine, including four women."
4953,11/7/2006,Somalia,Mogadishu,140,150,290,Islamic militias stage a Jihad attack a compound.  At least one-hundred and forty are killed in the following two days.
4954,11/7/2006,India,Mumbai,209,714,923,Lashkar-e-Toiba and local Students Islamic Movement of India set off coordinated bombs that kill nearly two hundred train commuters during the busy rush hour.
4955,11/7/2006,Iraq,Baghdad,15,13,28,A double suicide bombing by determined Muslims ends the lives of fifteen innocent people.
4956,12/7/2006,Thailand,Narathiwat,1,0,1,A school principal is killed by Islamic terrorists.
4957,12/7/2006,Afghanistan,Spin Boldak,2,8,10,"The Taliban place a bomb in a fruit cart, killing two innocents."
4958,12/7/2006,Iraq,Muqdadiya,20,0,20,Twenty bus drivers are kidnapped and brutally executed by Sunni radicals.
4959,12/7/2006,Iraq,Baghdad,7,20,27,A Fedayeen suicide bomber walks into a restaurant and sends seven patrons to Allah.
4960,12/7/2006,Afghanistan,Zabul,3,0,3,Three Afghan border guards are killed by Islamic extremists.
4961,12/7/2006,Israel,Lebanese Border,7,2,9,"Hezbollah stages a cross-border raid into Israel, killing seven Israelis and capturing two."
4962,12/7/2006,Afghanistan,Khost,1,5,6,A child is killed by a suicide bomber.
4963,12/7/2006,Iraq,Tikrit,2,0,2,Two carpenters are murdered by Muslim militants.
4964,12/7/2006,Somalia,Jowhar,1,0,1,Islamists shoot a man to death for complaining about new religious taxes.
4965,13/7/2006,Iraq,Kirkuk,3,5,8,Jihadis use a car bomb to kill three people.
4966,13/7/2006,Thailand,Narathiwat,1,6,7,"Islamists set off a bomb in a market, killing one person."
4967,13/7/2006,Israel,Nahariya,1,29,30,A woman is killed in her home by Hezbollah rockets.
4968,13/7/2006,India,Magnar,4,2,6,"Two children are among four people killed by Lashkar-e-Toiba radicals, who gun down villagers in a heinous attack."
4969,13/7/2006,Iraq,Mosul,5,5,10,A suicide car bomber sends five others to Allah.
4970,13/7/2006,Israel,Safed,1,21,22,A 70-year-old Israeli woman is killed by a Hezbollah rocket.
4971,14/7/2006,Israel,Meron,2,3,5,Hezbollah rockets kill an elderly woman and her 5-year-old grandson.  The boy's mother and father are seriously injured.
4972,14/7/2006,Thailand,Yala,1,0,1,A 52-year-old man is gunned down by Islamic radicals.
4973,14/7/2006,Iraq,Baghdad,7,5,12,"Muslim radicals bomb a rival mosque, killing seven."
4974,14/7/2006,Pakistan,Karachi,3,1,4,"A suicide bomber kills a Shiite cleric, his nephew and a guard."
4975,14/7/2006,Philippines,Zamboanga,2,1,3,An Abu Sayyaf member carrying a Qur'an guns down two policemen.
4976,15/7/2006,India,Ganderbal,2,3,5,The Mujahideen kill a civilian with a grenade.  An injured man succumbs to injuries a day later.
4977,15/7/2006,Iraq,Baghdad,5,4,9,"A suicide bomber kills two policemen.  Elsewhere, Jihadis gun down three brothers."
4978,15/7/2006,Iraq,Kirkuk,1,2,3,"A bomb placed inside a computer explodes at an Internet cafe, killing one."
4979,15/7/2006,India,Hilltak,2,0,2,Two adults are killed inside their home by the Mujahideen.
4980,16/7/2006,Iraq,Muqdadiyah,3,0,3,"Three people, including a boy and woman are gunned down by Shia radicals."
4981,16/7/2006,Iraq,Mosul,6,0,6,Three woman are among six people executed by Muslim radicals and dumped.
4982,16/7/2006,Iraq,Baghdad,6,40,46,Separate terror attacks leave ten civilians dead about forty injured.
4983,16/7/2006,Iraq,Kirkuk,2,0,2,Two barbers are murdered by Islamic fundamentalists.
4984,16/7/2006,Israel,Haifa,8,17,25,"Hezbollah fires Iranian missiles at an Israeli city, killing eight residents."
4985,16/7/2006,Thailand,Pattani,1,0,1,Thai Jihadis murder a 71-year-old man standing in front of his house.
4986,16/7/2006,Thailand,Pattani,1,0,1,A 40-year-old retired policeman is killed by Islamic militants as he entered his home.
4987,16/7/2006,Thailand,Pattani,1,0,1,A man is stabbed to death by Muslim militants and dumped into a river.
4988,16/7/2006,Thailand,Pattani,1,0,1,Islamists on a motorcycle pump four rounds into a civilian.
4989,16/7/2006,Iraq,Baghdad,26,22,48,A suicidal Sunni bomber slaughters twenty-six Shiite patrons in a cafe.
4990,16/7/2006,India,Darhal,2,0,2,Two civilians are abducted and murdered by the Mujahideen.
4991,17/7/2006,Afghanistan,Gardez,5,22,27,"A suicide bomber kills five people, including four civilians."
4992,17/7/2006,India,Poonch,1,0,1,"Fedayeen attack a police station, killing a constable."
4993,17/7/2006,Israel,Nablus,1,6,7,"Palestinians throw a bomb at a group of Israeli soldiers in the West Bank, killing one."
4994,17/7/2006,Iraq,Mahmoudiya,41,90,131,Sunni gunmen attack unarmed civilians in a market.  Dozens of innocents are massacred.
4995,17/7/2006,Chechnya,Grozny,2,0,2,A cleric and his brother are assassinated by gunmen at point-blank range.
4996,17/7/2006,Chechnya,Grozny,2,1,3,Jihadis spray two policemen with machine-gun fire in broad daylight.
4997,17/7/2006,Iraq,Mahmoudiya,12,0,12,The bodies of a dozen victims of sectarian violence are found around the city.
4998,17/7/2006,Pakistan,Torghundai,1,0,1,Islamists attack a police post and kill one officer.
4999,18/7/2006,India,Kulgam,1,0,1,"A boy is kidnapped from a cricket match by Islamic terrorists, tied up and killed in front of a crowd."
5000,18/7/2006,Iraq,Mosul,4,2,6,"A suicide bomber punches his ticket to Allah, taking four other souls with him."
5001,18/7/2006,Iraq,Mahmudiya,14,0,14,"Police find fourteen more victims of sectarian violence, blindfolded and shot at close range."
5002,18/7/2006,Israel,Nahariya,1,60,61,An Israeli civilian is killed by a Hezbollah missile as the terror group fires multiple rockets into civilian areas.
5003,18/7/2006,Iraq,Haditha,3,0,3,Three translators are brutally murdered by Islamic terrorists.
5004,18/7/2006,Iraq,Tikrit,2,0,2,"Radical Muslims cut off a girl's head, then place it on a bomb, which kills another civilian when it detonates."
5005,18/7/2006,Iraq,Kufa,59,132,191,A suicidal Sunni drives an explosives-packed minivan into a crowd of Shia laborers looking for work.  Over fifty lay dead in the ensuing horror.
5006,18/7/2006,Philippines,Maimbung,1,2,3,At least one policeman is killed in an attack by Muslim terrorists.
5007,18/7/2006,India,Mahore,1,0,1,A 6-year-old child dies from gunshot wounds after Muslim radicals fire into a family home.
5008,18/7/2006,Algeria,Ain Defla,4,0,4,Four municipal guards are shot to death in an ambush by Islamic fundamentalists.
5009,19/7/2006,Israel,Nazareth,2,9,11,"Two brothers, ages 9 and 3, are blown apart by Hezbollah rockets in their front yard."
5010,19/7/2006,Iraq,Rasheed,3,11,14,"Muslim gunmen storm a market, shooting three people to death and injuring eleven."
5011,19/7/2006,Iraq,Mahmudiya,24,0,24,"Eighteen people are kidnapped, tortured and shot to death.  Another six in Suwayra."
5012,19/7/2006,Iraq,Baghdad,12,29,41,A marketplace shooting and two bombings by Sunni radicals leaves at least a dozen innocents dead.
5013,19/7/2006,Iraq,Kirkuk,4,16,20,Four people at a cafe are killed by a bomb.
5014,19/7/2006,India,Palhalan Pattan,1,0,1,A civilian is murdered by the Mujahideen.
5015,20/7/2006,Iraq,Basra,4,5,9,The throats of a mother and her three children are slit by Muslim terrorists in their home.
5016,20/7/2006,Thailand,Pattani,3,1,4,"Militant Muslims spray a police booth with automatic weapons, killing three officers."
5017,20/7/2006,Thailand,Yala,1,0,1,A 60-year-old fruit grower is gunned down by Islamic militants.
5018,20/7/2006,India,Vehil Nowgam,1,0,1,A youth is executed in public view by the Mujahideen.
5019,20/7/2006,Iraq,Beiji,12,0,12,A dozen people examining a corpse in a car are killed when Jihadis detonate the vehicle remotely.
5020,20/7/2006,Iraq,Baiju,3,0,3,Islamic gunmen murder three oil refinery engineers.
5021,20/7/2006,Iraq,Baghdad,8,31,39,Three separate terror bombings leave at least eight people dead.
5022,20/7/2006,Iraq,Kirkuk,4,20,24,Four people are killed in a Jihad bombing.
5023,20/7/2006,Iraq,Muqdadiya,7,0,7,Seven people are killed in two separate Muslim terror attacks.
5024,20/7/2006,Iraq,Fallujah,9,13,22,A Fedayeen suicide bomber ends the lives of six other people.  Three others are kidnapped an tortured to death.
5025,21/7/2006,Iraq,Baghdad,38,0,38,Police find 38 corpses of those killed in sectarian violence.
5026,22/7/2006,Afghanistan,Kandahar,6,20,26,"A religious extremist approaches a crowd of civilians and then detonates himself, killing at least six innocents."
5027,22/7/2006,Afghanistan,Kandahar,2,8,10,Two Canadian troops are killed when a Fedayeen suicide bomber rams his car into their vehicle.
5028,22/7/2006,Iraq,Baqubah,7,0,7,A suicidal Sunni bomber sends seven innocents to Allah.
5029,22/7/2006,Iraq,Baghdad,7,1,8,"Jihadis open fire on workers in a house, killing seven."
5030,23/7/2006,Iraq,Kirkuk,22,159,181,At least twenty-two souls are lost to a suicide bomber bent on achieving Islamic paradise.
5031,23/7/2006,Iraq,Baghdad,42,94,136,Thirty-three of Baghdad's poorest people are blown apart by a Sunni car bomb place just outside an open-air market.  A second bombing nets another nine.
5032,23/7/2006,Israel,Haifa,2,14,16,Two Israelis are killed by Hezbollah rockets.
5033,23/7/2006,Afghanistan,Charsada,2,0,2,Two 'World Vision' humanitarian workers are murdered as they are returning from a charity mission.
5034,23/7/2006,India,Chatroo,1,1,2,Islamic militants murder a civilian and abduct another.
5035,23/7/2006,Afghanistan,Khost,1,3,4,A suicide bomber kills one other person.
5036,23/7/2006,Afghanistan,Yaqubi,3,2,5,Three little girls are murdered by the Taliban in a grenade attack on their home.
5037,23/7/2006,Thailand,Pattani,1,3,4,Islamic radicals murder a 60-year-old janitor as he is buying vegetables for his wife.
5038,23/7/2006,India,Mawar Handwara,2,1,3,Two civilians are killed in a bombing by Islamic militants.
5039,23/7/2006,India,Larkipora,1,0,1,A political activist is shot to death by the Mujahideen.
5040,24/7/2006,Iraq,Mosul,10,4,14,Five Iraqis are killed by a Fedayeen suicide bomber and two separate shootings leave five others dead.
5041,24/7/2006,Thailand,Narathiwat,1,0,1,A Buddhist teacher is gunned down by Muslim militants in the classroom in front of his 10-year-old students.
5042,25/7/2006,Iraq,Baqubah,5,0,5,"Five farmers are kidnapped, tortured and executed by Religion of Peace radicals."
5043,25/7/2006,Iraq,Baghdad,25,0,25,The bodies of twenty-five abductees are found in four separate locations across the country.
5044,25/7/2006,Israel,Kfar Mrar,1,48,49,A 15-year-old girl is killed by a Hezbollah rocket.
5045,25/7/2006,Afghanistan,Kabul,2,4,6,The Taliban kill two civilians with a roadside bomb.  Four others are injured.
5046,25/7/2006,Thailand,Narathiwat,1,0,1,The employee of a wood-processing plant is killed by Islamic gunmen.
5047,25/7/2006,Thailand,Pattani,1,0,1,Militant Muslims shoot a man off of his motorcycle as he is riding to work.
5048,25/7/2006,Iraq,Karbala,3,0,3,Three members of a wedding party are gunned down in a drive-by shooting.
5049,26/7/2006,Afghanistan,Kandahar,4,0,4,Four security guards are killed by the Taliban while in route to help another victim.
5050,26/7/2006,Afghanistan,Zabul,1,8,9,"Religious extremists fire on a truck carrying road workers, killing one of them."
5051,26/7/2006,India,Sajan,1,0,1,Muslim terrorists slit a young girl's throat.
5052,26/7/2006,India,Renipora,3,0,3,Three Indian troops are killed in a Mujahideen ambush.
5053,27/7/2006,India,Doda,1,6,7,A 14-year-old girl is killed when a militant Muslim tosses a grenade at her family.
5054,27/7/2006,Iraq,Baghdad,32,101,133,A car bombing and mortar attacks by Jihadis on a shopping district rack up more than thirty dead bodies.
5055,27/7/2006,Iraq,Baghdad,19,0,19,The bodies of nineteen abductees showing signs of torture are found in various parts of the capital.
5056,27/7/2006,Israel,Abus,1,0,1,"al-Fatah terrorists kidnap a 60-year-old Israeli man and then murder him, leaving his body in the truck of a burning car."
5057,28/7/2006,Jordan,Amman,1,0,1,A woman is hacked to death by relatives after delivering a baby out-of-wedlock.
5058,28/7/2006,Ingushetia,Nazran,2,0,2,Two Russians are killed when Muslim sniper target their car.
5059,28/7/2006,Afghanistan,Tagab,1,11,12,"Religious extremists attack a police post, killing at least one officer."
5060,28/7/2006,Iraq,Baghdad,4,6,10,A bomb planted between a mosque and a youth center kills four people.
5061,28/7/2006,USA,"Seattle, WA",1,5,6,"An 'angry' Muslim-American uses a young girl as hostage to enter a local Jewish center, where he shoots six women, one of whom dies."
5062,28/7/2006,Somalia,Mogadishu,1,0,1,Suspected Islamic terrorist assassinates a government minister.
5063,29/7/2006,Iraq,Kirkuk,3,15,18,Jihadis kill three people with a car bomb.
5064,29/7/2006,Iraq,Suwayra,2,0,2,Two Iraqi soldiers are kidnapped and beheaded.
5065,30/7/2006,Thailand,Narathiwat,1,0,1,A man is abducted and shot in the head by Islamic radicals.
5066,30/7/2006,Thailand,Yala,1,1,2,"A Muslim terrorist poses as a fruit seller in order to gain the confidence of two other fruit sellers, who he then guns down."
5067,30/7/2006,Iraq,Baghdad,15,0,15,Fifteen victims of Religion of Peace sectarian violence are found in various parts of the city bearing signs of torture.
5068,30/7/2006,Iraq,Iskandariya,4,11,15,"Jihadis bomb a group of civilians traveling along a road, killing four."
5069,30/7/2006,Iraq,al-Rasheed,23,0,23,"In a horrible massacre, a dozen armed Sunnis force three minibuses of Shia pilgrims off the road, forcibly disembark the passengers, then machine-gun them to death."
5070,31/7/2006,Afghanistan,Farmay Adha,8,16,24,"The Taliban bomb a memorial service at a mosque, killing eight."
5071,31/7/2006,India,Kangan,1,0,1,A man is abducted and murdered by the Mujahideen.
5072,1/8/2006,India,Srinagar,4,2,6,"Four Indian soldiers are shot to death by Islamic militants in two separate attacks.  One was outside a hospital, and the other a shopping area."
5073,1/8/2006,Afghanistan,Helmand,3,1,4,A Taliban ambush on a NATO patrol leaves three British soldiers dead.
5074,1/8/2006,Iraq,Baghdad,56,91,147,At least fifty-six people are killed in five Jihad attacks by sectarian militants.  Most are burned or blasted to death in bombings.
5075,2/8/2006,Israel,Nahariya,1,0,1,An Israeli man is killed by a Hezbollah rocket while riding his bike.
5076,2/8/2006,Iraq,Baghdad,3,9,12,Three day laborers looking for work are blown to bits by Islamic bombers.
5077,2/8/2006,Iraq,Diwaniya,1,0,1,Radical Muslims murder an employee of a human rights group outside his home.
5078,2/8/2006,Iraq,Suwayra,11,0,11,"Eleven bound and tortured bodies, victims of sectarian violence, are pulled from a river."
5079,2/8/2006,Thailand,Songkhla,3,1,4,Thai Islamists kill three policeman with a bomb planted along a railroad track.
5080,2/8/2006,Thailand,Pattani,1,0,1,Islamists kill a guard at a construction site with a bomb.
5081,2/8/2006,Iraq,Baghdad,14,37,51,"Islamic terrorists target a bank with bombs, killing more than a dozen innocents."
5082,2/8/2006,Iraq,Beiji,24,0,24,Two-dozen people aboard a bus are slaughtered by a remote-controlled bomb operated by radical Sunnis.
5083,2/8/2006,Iraq,Baghdad,12,14,26,Children as young as 11 are blown apart when Sunnis deliberately target a soccer match with a bomb hidden in a gym bag.
5084,3/8/2006,Israel,Ma'a lot,3,0,3,Three Arab Israelis are killed by a Hezbollah rocket attack.
5085,3/8/2006,Israel,Acre,5,92,97,"Five Israeli civilians, including a father and daughter, are killed during a 90-minute rocket barrage on their town from Hezbollah."
5086,3/8/2006,Iraq,Bahgdad,10,32,42,"Allah's butchers detonate a bomb in a rubbish pile, killing at least ten bystanders."
5087,3/8/2006,Iraq,Wajihiya,4,0,4,"Muslim radicals invade a home, killing three women and a man."
5088,3/8/2006,Iraq,Mussayab,3,22,25,"Jihad gunmen attack a wedding party, killing three members."
5089,3/8/2006,Afghanistan,Kandahar,21,13,34,A Shaheed martyr murders twenty-one innocents at a market by detonating explosives strapped to his body.
5090,3/8/2006,Thailand,Narathiwat,1,1,2,Islamic militants shoot a mechanic to death and seriously injure a 5-year-old girl.
5091,3/8/2006,Tajikistan,Dushanbe,1,0,1,An Islamist kills himself and a police officer with a grenade.
5092,4/8/2006,Iraq,Dujail,4,8,12,Muslim terrorists barge into a home and kill four family members.
5093,4/8/2006,Iraq,Kut,7,0,7,Seven people are kidnapped and beheaded by Islamic radicals.
5094,4/8/2006,Afghanistan,Kandahar,2,2,4,Two children are killed when religious extremists lob an explosive into a house.
5095,4/8/2006,Israel,Karmiel,2,82,84,Two people are killed and dozens injured by more 'Party of Allah' rockets.
5096,4/8/2006,Israel,Mughar,1,2,3,The mother of two young children is killed in her living room by a Hezbollah rocket.
5097,4/8/2006,Iraq,Ubaydi,3,9,12,Three civilians are killed when Jihadis lob mortars into their neighborhood.
5098,4/8/2006,Iraq,Hadhar,10,12,22,"A Fedayeen suicide bomber plows his car into a crowd of spectators at a soccer game, killing at least ten."
5099,5/8/2006,Iraq,Baghdad,9,0,9,Radicals kidnap and torture to death nine members of a rival Muslim sect.
5100,5/8/2006,India,Poonch,1,0,1,"The Mujahideen capture a village head, beat him up and then shoot him in the head."
5101,5/8/2006,Israel,al-Aramshe,3,4,7,A 60-year-old Arab-Israeli woman and her two daughters are killed when a Hezbollah rocket lands in their home.
5102,6/8/2006,Iraq,Tikrit,15,22,37,Fifteen mourners at a funeral are slaughtered by a suicide bomber.
5103,6/8/2006,Israel,Haifa,3,189,192,A crowded residential area is the target of Hezbollah rockets.  An Israeli woman is among three dead.
5104,6/8/2006,Israel,Kfar Giladi,12,14,26,"Hezbollah successfully hits a gathering of people in a community, killing twelve Israelis."
5105,6/8/2006,Iraq,Baghdad,16,0,16,Police discover sixteen victims of sectarian violence in two location in the country.  Women were among the dead.
5106,6/8/2006,India,Sopore,1,17,18,A woman is killed when Islamic terrorists lob a grenade into the street.
5107,6/8/2006,Thailand,Tala,1,0,1,A rubber plantation worker is machine-gunned to death by Islamic radicals.
5108,6/8/2006,Thailand,Pattani,1,0,1,A 52-year-old Buddhist civilian is gunned down by Muslims.
5109,7/8/2006,Afghanistan,Daigh,2,0,2,A 70-year-old woman and her 13-year-old grandson are pulled from their home and hanged by the Taliban.
5110,7/8/2006,Russia,Karachaevsk,1,0,1,A local Imam is gunned down by Islamists for performing healing.
5111,7/8/2006,Iraq,Fallujah,6,2,8,Six civilians are killed when Sunni terrorists set off a bomb by the side of a road.
5112,7/8/2006,Iraq,Khalis,4,7,11,"Terrorists blow up a minibus, killing four civilians.."
5113,7/8/2006,Iraq,Baqubah,6,15,21,A senseless attack on a checkpoint by Sunni terrorists leaves at least six Iraqi soldiers dead.
5114,7/8/2006,Pakistan,Garhiyoum,1,0,1,A tribal leader is abducted and beheaded by Muslim extremists.
5115,7/8/2006,India,Donipawa,1,0,1,A civilian is abducted and murdered by the Mujahideen.
5116,8/8/2006,Dagestan,Makhachkala,3,0,3,"Islamic separatists bomb a government official's convoy, killing three people."
5117,8/8/2006,Iraq,Baghdad,10,69,79,"Muslim terrorists set off two bombs at a bustling market, killing at least ten people."
5118,8/8/2006,Iraq,Baghdad,15,0,15,Fifteen bodies are found by police from sectarian violence.
5119,8/8/2006,Iraq,Muqdadiya,3,0,3,"Three people are shot to death by Jihad militants, including a teacher."
5120,8/8/2006,Iraq,Baqubah,5,20,25,At least five people were killed when Muslim radicals blow up an apartment building in the middle of the night.
5121,8/8/2006,Thailand,Yala,1,0,1,A rubber tapper is murdered by Islamic terrorists.
5122,9/8/2006,Thailand,Yala,1,0,1,An elderly gas station owner is shot to death in a Muslim terror attack.
5123,9/8/2006,Pakistan,Angoor Adda,1,0,1,An elderly man is shot to death by Islamic militants.
5124,9/8/2006,Iraq,Baghdad,18,2,20,"Terrorists open fire on a street vendor grilling fish, killing five civilians.  Thirteen other bodies are found elsewhere."
5125,9/8/2006,Ingushetia,Nazran,1,13,14,"Radicals bomb a prosecutor's house, killing his brother."
5126,10/8/2006,Iraq,Najaf,35,122,157,At least 35 innocent people at a market are blown to bits by an Islamic fanatic wrapped in explosives.
5127,10/8/2006,India,Pattan,1,2,3,The Mujahideen gun down a civilian and injure his wife and neighbor.
5128,10/8/2006,Philippines,North Cotabato,1,5,6,A bombing attack by Islamic militants leaves one dead and five injured.
5129,10/8/2006,Israel,Karmiel,1,0,1,A baby girl is killed by Hezbollah rockets fired on her family's home.
5130,10/8/2006,Israel,Dir el-Asad,2,11,13,A young mother and her 4-year-old son are blown apart in their home by a Katyusha rocket.
5131,10/8/2006,Israel,Jerusalem,1,0,1,An Italian tourist is stabbed to death by a Palestinian youth.
5132,11/8/2006,Philippines,Pikit,2,0,2,Two policemen are ambushed and executed by the Moro Islamic Liberation Front.
5133,11/8/2006,India,Arra,3,0,3,A Hindu mother and her two young children are brutally slain in their home by Muslim fanatics.
5134,11/8/2006,Iraq,Baghdad,6,0,6,"Religious radicals kidnap, torture and murder six members of a rival sect."
5135,11/8/2006,Afghanistan,Spin Boldak,1,0,1,A suicide bomber kills a Canadian soldier in a transport convoy.
5136,11/8/2006,Afghanistan,Ghazni,2,1,3,Two civilians are killed by a roadside bombing.
5137,11/8/2006,Afghanistan,Ghazni,1,0,1,Religious extremists kill a man outside his home.
5138,12/8/2006,Thailand,Yala,1,0,1,A circus owner is killed by two Muslim terrorists posing as customers.
5139,12/8/2006,India,Drogian,2,0,2,Two elderly people are shot to death in their homes by Islamic terrorists.
5140,12/8/2006,Iraq,Mosul,12,4,16,Jihadis murder a dozen Iraqi civilians in a series of bombing and shooting attacks.
5141,12/8/2006,Italy,Brescia,1,0,1,A 20-year-old girl is killed by her family for having a relationship with a non-Muslim.
5142,12/8/2006,Iraq,Baghdad,3,9,12,Three civilians are killed when Jihadis place a shrapnel bomb in a residential neighborhood.
5143,12/8/2006,Thailand,Pattani,1,0,1,A policeman is gunned down by Muslim militants while on patrol.
5144,12/8/2006,Thailand,Narathiwat,1,0,1,Islamists shoot a policeman in the back as he is leaving his house.
5145,13/8/2006,Israel,Shlomi,1,21,22,"Hezbollah fires rockets into an Israeli neighborhood, killing a 70-year-old man in his home."
5146,13/8/2006,Philippines,Jolo,3,0,3,Abu Sayyaf kidnappers stab a businesswoman to death and behead her son after taking them captive.  A policeman trying to rescue them is killed as well.
5147,13/8/2006,Pal. Auth.,Jenin,1,0,1,Islamic Jihad executes a man in front of a crowd of people.
5148,13/8/2006,Thailand,Narathiwat,4,12,16,"Islamic radicals kill a ship-owner to draw police, then detonate a bomb, killing three additional civilians and injuring twelve."
5149,13/8/2006,Thailand,Narathiwat,1,2,3,A man is killed by Muslim gunmen in a drive-by shooting while he is having tea.  Two elderly patrons are wounded.
5150,13/8/2006,India,Shopian,1,1,2,Harkat-ul-Mujahideen kill a 20-year-old woman and leave her sister-in-law critically injured.
5151,13/8/2006,Afghanistan,Bermel,5,6,11,Five Afghan soldiers are killed when the Taliban stage a terror attack on their post.
5152,13/8/2006,Pakistan,Baltistan,1,1,2,A bomb hidden in a toy kills a 14-year-old girl.
5153,13/8/2006,Iraq,Baghdad,62,148,210,"Sunni bombers massacre Shiites in a series of neighborhood bombings, racking up over sixty dead and one-hundred and fifty injured."
5154,14/8/2006,India,Sopore,1,0,1,A grenade attack on a bus stop fatally injures a civilian.
5155,14/8/2006,Iraq,Mosul,6,1,7,"Muslim gunmen kill six civilians in three separate attacks, including three blacksmiths."
5156,14/8/2006,Thailand,Yala,1,0,1,Islamic fundamentalists murder a pork seller.
5157,14/8/2006,Thailand,Pattani,1,0,1,A rubber plantation worker is murdered by Islamic terrorists.
5158,14/8/2006,Thailand,Yala,1,0,1,A 56-year-old man is shot seven times in the head by Islamic separatists.
5159,15/8/2006,Iraq,Muqdadiya,3,0,3,Islamic radicals gun down three bakers.
5160,15/8/2006,Iraq,Mosul,9,36,45,A Fedayeen suicide bomber slaughters nine other people outside a political office.
5161,15/8/2006,Philippines,Basilan,1,0,1,Abu Sayyaf is suspected in the assassination of a high school principal.
5162,16/8/2006,Afghanistan,Ghazni,1,1,2,The Taliban murder a police officer.
5163,16/8/2006,Iraq,Baghdad,8,28,36,"Religious radicals set off a bomb at a flea market, killing eight shoppers."
5164,16/8/2006,Iraq,Muqdadiya,7,20,27,A female suicide bomber kills seven innocents at a bus station.
5165,16/8/2006,Iraq,Baghdad,13,43,56,Jihadis massacre thirteen innocents with a twin bomb attack in a commercial district.
5166,16/8/2006,Ingushetia,Nazran,1,1,2,A Russian is killed when Islamic separatists attack his vehicle with automatic weapons.
5167,17/8/2006,Iraq,Daquq,2,1,3,A bomb blast ends the lives of two civilians.
5168,17/8/2006,Iraq,Suwayra,6,0,6,"Six victims of sectarian violence are fished out of a river, blindfolded and showing signs of torture.."
5169,17/8/2006,Iraq,Baqubah,9,0,9,Three brothers are among nine people assassinated by Islamic radicals.
5170,17/8/2006,Iraq,Baghdad,3,28,31,Sunnis use a car bomb to kill three Shia civilians.
5171,17/8/2006,Thailand,Pattani,2,0,2,Two men are shot off their motorbikes by Muslim terrorists in separate attacks.
5172,17/8/2006,India,Budgam,1,0,1,"In a gruesome attack, militant Muslims kidnap a craftsman and then cut off his head."
5173,17/8/2006,India,Wutligam,1,0,1,A civilian is shot to death by the Mujahideen.
5174,17/8/2006,India,Srinagar,3,2,5,Three policemen are killed in separate attacks.
5175,18/8/2006,Thailand,Narathiwat,1,0,1,A 58-year-old man is murdered in front of his house by militant Muslims.
5176,18/8/2006,Iraq,Baghdad,7,0,7,Seven Shiite pilgrims are gunned down by Sunni terrorists while en route to a religious ceremony.
5177,19/8/2006,Algeria,Telagh,2,1,3,"Fundamentalists slit the throats of two victims, then place a bomb under the bodies to kill civil workers."
5178,19/8/2006,Israel,Bekaot,1,0,1,An Israeli is killed by a Fatah gunman in the West Bank.
5179,19/8/2006,Thailand,Yala,1,0,1,Islamic terrorists shoot a man to death on a city street.
5180,19/8/2006,Thailand,Narathiwat,1,0,1,Radical Islamists shoot a plantation worker as he is riding a motorcycle to his job.
5181,19/8/2006,Iraq,Baqubah,12,0,12,"A dozen farmers, university professors and students are gunned down by sectarian radicals."
5182,19/8/2006,Afghanistan,Paktika,1,0,1,A man is murdered by the Taliban.
5183,19/8/2006,Egypt,Cairo,1,0,1,A Christian cobbler is stabbed to death by an angry Muslim.
5184,20/8/2006,Iraq,Baqubah,6,0,6,"Six Iraqis, including two brothers, are gunned down by Islamic militants."
5185,20/8/2006,Iraq,Jurf al-Sakhar,2,0,2,Two civilians are brutally killed by Islamic terrorists.
5186,20/8/2006,Afghanistan,Panjwai,5,11,16,"The Taliban attack a police post, killing at least five Afghans."
5187,20/8/2006,Thailand,Pattani,1,1,2,"Muslim gunmen fire into a truck loaded with laborers, killing one."
5188,20/8/2006,Iraq,Baghdad,20,302,322,Sunni snipers take down sixteen Shia pilgrims taking part in a religious festival.
5189,20/8/2006,Ingushetia,Alkhasty,2,0,2,Islamic militants are suspected in two nighttime attacks on police officers in their homes.  One was set on fire in front of his family.
5190,20/8/2006,Afghanistan,Helmand,3,0,3,Three policemen are killed by a Taliban remote-controlled bomb.
5191,21/8/2006,India,Baramulla,1,0,1,The Mujahideen gun down a man near his house.
5192,21/8/2006,Thailand,Narathiwat,1,0,1,A man is murdered by Muslim terrorists in his living room.
5193,21/8/2006,Thailand,Yala,3,0,3,Three Buddhist civilians are gunned down in an orchard by Islamic radicals.
5194,22/8/2006,Afghanistan,Kandahar,2,3,5,A young girl and a Canadian soldier are murdered by a Fedayeen suicide bomber.
5195,22/8/2006,Iraq,Baqubah,7,0,7,"Islamic militants bomb a market, killing seven people."
5196,22/8/2006,Iraq,Baghdad,7,1,8,Seven civilians in a house are mowed down by Muslim gunmen.
5197,22/8/2006,Afghanistan,Gayan,5,0,5,"Religious extremists ambush a police vehicle, killing all five officers inside."
5198,23/8/2006,Thailand,Narathiwat,1,0,1,A schoolteacher is gunned down by Muslim militants as he is on his way to teach.
5199,23/8/2006,Pakistan,Sindh,5,11,16,"Five members of a family, including a 3-year-old girl, are murdered in their home in an honor killing."
5200,23/8/2006,Iraq,Mosul,1,11,12,A suicidal Sunni kills a woman with explosives.
5201,23/8/2006,Iraq,Baqubah,14,0,14,Fourteen victims of sectarian violence are found here and in Latifiya.
5202,23/8/2006,Thailand,Narathiwat,1,0,1,Militant Muslims murder a community guard.
5203,24/8/2006,Iraq,Baghdad,2,9,11,A suicide car bomber kill two civilians.
5204,24/8/2006,Iraq,Balad,3,0,3,Jihadis kill three policemen.
5205,24/8/2006,Iraq,Mosul,7,0,7,"Seven civilians, including five members of the same family, are murdered by sectarian rivals."
5206,25/8/2006,Iraq,Mosul,1,0,1,A university professor is murdered by suspected fundamentalists.
5207,25/8/2006,Thailand,Yala,1,0,1,A 25-year-old man is murdered by terrorists as he sat in his truck.
5208,25/8/2006,Iraq,Balad Ruz,3,3,6,Three teenage boys playing soccer are blown apart in a Jihadi bombing.
5209,25/8/2006,Iraq,Baqubah,9,0,9,Nine people are killed by Jihadis in various attacks.
5210,25/8/2006,Afghanistan,Ghazni,2,2,4,The Taliban kill two local officials in an attack on a community.
5211,25/8/2006,India,Doda,1,0,1,A woman is shot to death by the Mujahideen.
5212,26/8/2006,Ingushetia,Ossetian Border,3,1,4,"Terrorists attack a vehicle, killing three Russians inside."
5213,26/8/2006,Thailand,Yala,1,0,1,"Muslim militants ambush two pick-up trucks carrying soldiers, killing at least one."
5214,26/8/2006,Iraq,Tikrit,3,2,5,Sunni extremists storm a bakery and murder three Shia workers.
5215,26/8/2006,Kosovo,Kosovska Mitrovica,0,9,9,Nine people are injured when a Muslim hurls a bomb into a bar.
5216,26/8/2006,Thailand,Yala,2,5,7,Two Thai soldiers are killed by a remote-controlled roadside bomb.
5217,26/8/2006,Iraq,Basra,4,0,4,"Four civilians are killed in two separate attacks, including a woman."
5218,26/8/2006,Iraq,Baqubah,4,11,15,"Sunnis attack a Shia family, killing two women and two children."
5219,26/8/2006,Iraq,Iskandaria,3,17,20,Three people are blown apart in a Jihad car bombing.
5220,27/8/2006,Iraq,Abara,3,0,3,Two brothers and their cousin are brutally slain by Religion of Peace rivals.
5221,27/8/2006,Iraq,Khalis,9,15,24,"Jihadis bomb a food market, killing at least nine patrons."
5222,27/8/2006,Iraq,Baghdad,12,45,57,"Two bombs, one hidden on a minibus and the other outside a newspaper office, leave a dozen Iraqis dead and forty others in agony."
5223,27/8/2006,Iraq,Basra,7,0,7,Seven people are killed by a bomb hidden on a motorcycle.
5224,27/8/2006,Iraq,Khalis,16,25,41,"Terrorists storm a house and a cafe, killing sixteen people, including those rushing in to help the victims."
5225,28/8/2006,Pakistan,North Waziristan,1,0,1,"Islamists kidnap a man, pump him full of bullets, then attach a note to his body."
5226,28/8/2006,Afghanistan,Kabul,1,0,1,A second Turkish engineer is murdered in a garage by the Taliban.
5227,28/8/2006,Iraq,Baghdad,20,62,82,A Fedayeen suicide bomber ends the lives of sixteen others near the entrance to a government building.  Four others are shot to death.
5228,28/8/2006,Afghanistan,Herat,1,0,1,A Turkish engineer is murdered by religious extremists while traveling on a highway.
5229,28/8/2006,Afghanistan,Leskergah,19,41,60,Nineteen innocents at a marketplace are blown to bits by a Taliban suicide bomber.  The casualties included fifteen children.
5230,28/8/2006,Thailand,Yala,1,0,1,A man is murdered by Islamic terrorists at a petrol station.
5231,28/8/2006,Thailand,Narathiwat,1,0,1,"Muslim militants attack a man delivering donuts, killing him and then cutting off his ears."
5232,28/8/2006,Pakistan,Naushki,1,0,1,A mob enters the home of a barber and shoots him to death.
5233,29/8/2006,Iraq,Baiji,1,1,2,Religious fundamentalists gun down a bakery worker.
5234,29/8/2006,Iraq,Baghdad,20,14,34,Twenty civilians are kidnapped and killed in at least two separate attacks.
5235,29/8/2006,Iraq,Baqubah,21,5,26,Twenty-one victims of sectarian violence are found in and around the city.
5236,29/8/2006,Afghanistan,Kandahar,2,1,3,A suicide bomber kills two civilians.
5237,29/8/2006,Ingushetia,Nazran,1,0,1,A police officer is gunned down by Muslim militants.
5238,29/8/2006,India,Budgam,1,0,1,Terrorists slit the throat of a 17-year-old boy.
5239,30/8/2006,India,Devar Lolab,1,1,2,Islamic terrorists kill a policeman and injure a civilian.
5240,30/8/2006,Pakistan,North Waziristan,2,0,2,Two men are beheaded in separate attacks by the local Taliban.
5241,30/8/2006,Pakistan,Wana,1,0,1,A 14-year-old boy is abducted and murdered by the Mujahideen.
5242,30/8/2006,Iraq,Diwaniya,13,0,13,Thirteen Iraqi soldiers are captured and brutally executed by Islamic militants.
5243,30/8/2006,Iraq,Numaniya,3,0,3,Three Shia brothers are shot to death by radical Sunnis.
5244,30/8/2006,Iraq,Buhriz,5,2,7,A child and three women are among five members of a family murdered in the car by militant Muslims.
5245,30/8/2006,Iraq,Hilla,14,38,52,Fourteen people outside a recruiting center are blown to bits by Islamic terrorists.
5246,30/8/2006,Iraq,Baghdad,24,35,59,"Sunnis bomb a crowded market, slaughtering two dozen and leaving many more in physical agony."
5247,30/8/2006,Iraq,Kirkuk,4,10,14,A suicidal Sunni on a bus kills four other humans.
5248,31/8/2006,India,Dawoocha,1,0,1,The Mujahideen murder a woman in her home.
5249,31/8/2006,India,Dangiwacha,1,0,1,Islamic terrorists invade a home and kill the daughter of a policeman.
5250,31/8/2006,Iraq,Baghdad,63,282,345,"Sunni radicals send rockets into a Shia neighborhood, slaughtering over sixty people, including twenty-four women and nineteen young children."
5251,31/8/2006,Thailand,Yala,1,27,28,"Islamists set off two dozen bombs in garbage cans, killing at least one person."
5252,31/8/2006,Iraq,Baghdad,4,11,15,"Jihadis target a police patrol, killing four officers."
5253,31/8/2006,Iraq,Jbela,1,8,9,A wedding party is the target of a terrorist bombing.
5254,31/8/2006,India,Saroti,2,0,2,Islamic terrorists brutally murder two police officers.
5255,31/8/2006,Pakistan,Karachi,1,0,1,A Muslim guns down a cleric over allegations that he is insulting Islamic teachings and the prophet.
5256,31/8/2006,Sudan,Buram,38,23,61,Arab militias wipe out several villages killing dozens.  The true figures may run into the hundreds.
5257,31/8/2006,Iraq,Baqubah,2,0,2,Two brothers working in a cotton shop are brutally slain by Sunni radicals.
5258,1/9/2006,Pakistan,Neelum Valley,2,3,5,Two Christian children of missionaries are brutally murdered.  The girl had her breast cut off and was raped.
5259,1/9/2006,India,Darwashbagh,1,0,1,Islamic militants abduct and murder a civilian.
5260,1/9/2006,India,Pulwama,1,2,3,A man is murdered by the Mujahideen in an attack that also injures two family members.
5261,1/9/2006,Iraq,Mahmudiya,1,3,4,A child is killed inside a home that Jihadis try to level with a rocket.
5262,2/9/2006,Algeria,Ouled Hamza,2,0,2,Two community guards are murdered by Islamic fundamentalists.
5263,2/9/2006,Algeria,Adekar,4,5,9,Islamic fundamentalists ambush a security patrol and kill four members.
5264,2/9/2006,Afghanistan,Helmand,3,1,4,The Taliban murder three police at a checkpoint.
5265,2/9/2006,Iraq,Baghdad,9,36,45,A series of bombings and sectarian shootings leave at least nine civilians dead.
5266,2/9/2006,Iraq,Karbala,17,0,17,"Fourteen South Asian pilgrims are massacred by Sunni terrorists, along with three other locals."
5267,2/9/2006,India,Gani Hamam,1,0,1,A vegetable vendor is murdered by the Mujahideen.
5268,2/9/2006,Afghanistan,Nimroz,4,10,14,The Taliban kill four Afghan police officers and abduct ten others.
5269,3/9/2006,Iraq,Baqubah,5,0,5,A father and four young children are blown up by Islamic radicals as they are traveling in their car.
5270,3/9/2006,Iraq,Baghdad,6,15,21,"Jihadis mortar a residential neighborhood, killing six people, including two children."
5271,3/9/2006,Iraq,Khalis,4,19,23,"Muslim terrorists bomb a market, killing at least four patrons."
5272,3/9/2006,Turkey,Istanbul,1,0,1,An Imam is stabbed to death by a religious fanatic.
5273,4/9/2006,Afghanistan,Kabul,6,7,13,Six civilians are killed by a Fedayeen suicide bomber.  The casualties included children.
5274,4/9/2006,Iraq,Basra,2,2,4,"Islamic terrorists attack a British patrol, killing two members."
5275,4/9/2006,Jordan,Amman,1,5,6,"A terrorist yells, 'Allah Akbar' while gunning down a British tourist and injuring five others."
5276,4/9/2006,India,Tangmarg,2,0,2,An off-duty soldier and his kid brother are brutally murdered by Islamic extremists.
5277,4/9/2006,Iraq,Baghdad,33,0,33,Thirty-three victims are found tortured and executed by sectarian rivals.
5278,4/9/2006,Afghanistan,Parwan,3,1,4,"Religious extremists attack a police vehicle, killing three occupants."
5279,4/9/2006,India,Kashmir,7,11,18,Seven Indian troops are killed in three separate attacks by Islamic militants.
5280,4/9/2006,Philippines,Jolo,5,20,25,Abu Sayyaf militants kill five troops trying to apprehend two Bali bombers.
5281,5/9/2006,Thailand,Yala,1,2,3,An older woman is killed in her home by Islamists.
5282,5/9/2006,Thailand,Narathiwat,1,0,1,Muslims gun down a man sitting in a tea shop.
5283,5/9/2006,Thailand,Narathiwat,1,0,1,"Muslim militants set fire to a house, killing a 61-year-old man."
5284,5/9/2006,Iraq,Baghdad,18,6,24,Eighteen innocents are murdered in at least four separate terror attacks around the country.
5285,5/9/2006,Iraq,Baghdad,4,3,7,Four Shia pilgrims are gunned down in two attacks by Sunni extremists (the other in Latifiya).
5286,5/9/2006,Pakistan,Phuldayun,1,0,1,"A Muslim man guns down his wife, a young mother, in an 'honor' killing."
5287,5/9/2006,Sudan,Khartoum,1,0,1,A newspaper editor is kidnapped and beheaded by Islamic hard-liners after publishing an article questioning Muhammad's parentage.
5288,5/9/2006,Lebanon,Rmeileh,4,4,8,Four members of a detail investigating a Christian's death are themselves killed in a bombing by Muslim radicals.
5289,5/9/2006,India,Sopore,1,0,1,The Hizb-ul-Mujahideen murder a student returning home from classes.
5290,6/9/2006,Afghanistan,Yaqubi,2,1,3,A suicide bomber kills a teacher and one other person.
5291,6/9/2006,Iraq,Baghdad,27,38,65,A horrible car bombing kills eight Iraqis and injures dozens more.  The bodies of nineteen victims of sectarian violence are found elsewhere.
5292,6/9/2006,Pakistan,Kaga,1,0,1,A 12-year-old girl is killed in her home by al-Qaeda backed militants.
5293,6/9/2006,Indonesia,Tangkuran,1,0,1,A Christian is killed in a bombing attack by militant Muslims.
5294,7/9/2006,Pal. Auth.,Nablus,1,0,1,A 28-year-old man is gunned down by Palestinian terrorists.
5295,7/9/2006,Somalia,Mogadishu,1,0,1,A young college student is murdered after converting from Islam to Christianity.
5296,7/9/2006,Afghanistan,Kabul,3,11,14,Three British soldiers die in a single day from attacks by religious extremists.
5297,7/9/2006,Iraq,Baghdad,36,64,100,Islamic terrorists mow down nearly forty people in various attacks around the country.
5298,7/9/2006,Iraq,Suwayra,3,0,3,A woman is among three people tortured and beheaded by Islamic radicals.
5299,7/9/2006,India,Srinagar,1,0,1,A high school student succumbs to injuries suffered from a terror attack the week before.
5300,7/9/2006,India,Budbug,1,0,1,The Mujahideen invade a home and kill a resident.
5301,8/9/2006,Pakistan,Barkhan,5,21,26,Five people are killed in the bombing of a bus station.
5302,8/9/2006,Afghanistan,Kabul,18,30,48,The lives of eighteen people are snuffed out by a Fedayeen suicide bomber in a downtown blast.
5303,8/9/2006,Iraq,Baghdad,3,6,9,A woman and child are among three people killed by an incendiary bomb planted by Islamic terrorists.
5304,8/9/2006,India,Doda,1,0,1,A man is kidnapped by the Mujahideen.  He dies two days later from injuries suffered.
5305,8/9/2006,India,Malegaon,31,297,328,Pakistani-backed militants are thought to be responsible for multiple bomb blasts that leave thirty-one dead and three-hundred injured.
5306,8/9/2006,Iraq,Baghdad,7,0,7,"Seven victims of sectarian violence are found bound, tortured and executed."
5307,9/9/2006,Indonesia,Poso,1,0,1,A young Christian woman is killed when Islamic radicals throw a bomb at her house.
5308,9/9/2006,Pakistan,Garjakh,2,0,2,A man murders his nephew and nephew's girlfriend for an 'illicit relationship.'
5309,9/9/2006,Pakistan,Miramshah,1,0,1,The local Taliban pump a 70-year-old man full of bullets and leave him with a note attached to his body.
5310,9/9/2006,India,Sonwar,1,1,2,"A taxi driver is killed, and a young girl severely injured in a Mujahideen attack."
5311,9/9/2006,India,Bandipore,1,1,2,Islamic terrorists open fire on a fruit vendor.
5312,9/9/2006,India,Doda,1,1,2,The Mujahideen gun down a man and seriously injure his wife.
5313,9/9/2006,Iraq,Baiji,3,3,6,Three civilians are killed in separate bombings.
5314,9/9/2006,Iraq,Mosul,1,1,2,A 10-year-old boy is killed and his mother injured inside their home by Muslim terrorists.
5315,9/9/2006,Iraq,Baghdad,21,51,72,Jihadis murder twenty-one innocents in a series of bombing and shooting attacks across the city.
5316,9/9/2006,India,Doda,2,0,2,"The Mujahideen raid a police station, killing two officers and stealing weapons."
5317,9/9/2006,India,Ahlan,1,0,1,A civilian is killed by Islamic militants.
5318,10/9/2006,Iraq,Mosul,1,0,1,A barber is murdered by religious fundamentalists.
5319,10/9/2006,Iraq,Baghdad,6,29,35,Two car bombs set by Islamic militants kill at least six people.
5320,10/9/2006,Iraq,Tuz Khurmato,4,1,5,Jihadi gunmen murder four oil workers.
5321,10/9/2006,Afghanistan,Gardez,3,3,6,A suicide bomber kills a regional official and two others.
5322,10/9/2006,Pakistan,Wana,1,0,1,A tribal leader is gunned down by Islamists as he is walking home.
5323,11/9/2006,Afghanistan,Khost,6,36,42,A 12-year-old boy is among six people murdered by a suicide bomber at a funeral for a previous victim of a suicide bombing.
5324,11/9/2006,Iraq,Baghdad,4,3,7,Four civilians are killed in a Jihadi shrapnel bombing.
5325,11/9/2006,Iraq,Baghdad,16,7,23,Sixteen people are blown to bits by a suicidal Sunni on a bus.
5326,11/9/2006,India,Kulgam,1,0,1,A security official succumbs to injuries from a terrorist ambush.
5327,11/9/2006,Thailand,Yala,1,4,5,A Buddhist woman is gunned down by militant Muslims in her grocery store.
5328,12/9/2006,Iraq,Bani Saad,7,3,10,Seven Shia worshippers are murdered in their own mosque by Sunni bombers.
5329,12/9/2006,Iraq,Baghdad,6,15,21,Six civilians are shredded by a Jihadi car bomb in a commercial district.
5330,12/9/2006,Syria,Damascus,1,14,15,Terrorists shouting 'Allah Akbar' detonate a car bomb and attempt to storm the U.S. embassy.  A Syrian guard is killed.
5331,12/9/2006,Turkey,Amed,10,13,23,"An ultra-nationalist group with Islamist ties bombs a bus stop, killing ten Kurds, including seven children."
5332,12/9/2006,India,Thandi Dhok,2,0,2,A husband and wife are murdered in their home by the Mujahideen.
5333,13/9/2006,Afghanistan,Farah,1,0,1,A UN humanitarian worker is murdered by Muslim militants on a road.
5334,13/9/2006,Iraq,Baghdad,14,57,71,Jihadis kill fourteen people on a city street with a car bomb packed with shrapnel.
5335,13/9/2006,Iraq,Baghdad,69,0,69,"Sixty-nine victims of sectarian violence are found bound, tortured and murdered over a 24-hour period."
5336,14/9/2006,Iraq,Baghdad,10,39,49,"Islamic terrorists set off two bombs, one at a photography shop and the other in a city street, killing ten innocents."
5337,14/9/2006,Iraq,Baghdad,32,0,32,The tortured bodies of thirty-two victims of sectarian hatred are found.
5338,14/9/2006,India,Hathiwara,1,0,1,A photographer is kidnapped and beheaded by the Religion of Peace.
5339,14/9/2006,Afghanistan,Bakwa,2,2,4,"Religious extremists attack a police station, killing two officers."
5340,14/9/2006,Iraq,Baghdad,2,25,27,"A religious extremist targets a U.S. patrol in a suicide attack, killing two soldiers."
5341,14/9/2006,Sudan,Otash,4,9,13,"Arab militia attacks a group of refugees, killing at least four."
5342,15/9/2006,Iraq,Baghdad,1,0,1,A Christian is killed when radical Muslims attack a Catholic church.
5343,15/9/2006,Thailand,Narathiwat,1,0,1,A man is killed in his home by militant Muslims.
5344,15/9/2006,Iraq,Baghdad,22,0,22,The bodies of two-dozen more victims of sectarian hatred are found across the city.
5345,15/9/2006,Iraq,Mussayab,1,0,1,"Islamic radicals kidnap a man, cut off his legs and head, then dump his body in the river."
5346,15/9/2006,Yemen,Haradmut,1,0,1,One of two suicide attacks on oil facilities in Yemen nets the death of a guard.
5347,15/9/2006,India,Watergam,1,7,8,"al-Mansoorian terrorists attack an Indian security patrol, killing one member."
5348,15/9/2006,India,Surankote,1,5,6,A young boy is killed when Hizb-ul-Mujahideen terrorists lob a grenade into his family's home.
5349,15/9/2006,Thailand,Narathiwat,2,1,3,Two civilians are brutally shot to death by Islamic militants while traveling on a road.
5350,16/9/2006,Thailand,Hat Yai,5,79,84,At least five patrons of a shopping district are killed when Muslim militants set off six separate bombs.
5351,16/9/2006,Iraq,Baghdad,47,0,47,Forty-seven more tortured and executed victims of sectarian hatred within the Religion of Peace are found.
5352,16/9/2006,Iraq,Samarra,4,0,4,An al-Qaeda ambush leaves four tribesman dead.
5353,16/9/2006,Iraq,Baghdad,3,22,25,"Two bombs, including one strapped to a corpse, kill three people."
5354,16/9/2006,Iraq,Ramadi,4,8,12,Jihadis send four civilians to Allah with a roadside incendiary bomb.
5355,16/9/2006,Iraq,Baghdad,1,0,1,Muslims stab a Christian to death in a marketplace in retaliation for the pope's remarks.
5356,16/9/2006,Afghanistan,Kabul,3,1,4,Three humanitarian workers are blown apart by the Taliban.
5357,17/9/2006,Afghanistan,Helmand,2,0,2,Two policemen are murdered by Taliban extremists in a roadside attack.
5358,17/9/2006,Iraq,Baqubah,2,3,5,"Jihadis attack an electrical plant, killing two guards."
5359,17/9/2006,Iraq,Baghdad,24,0,24,Twenty-four more tortured and executed victims of sectarian hatred within the Religion of Peace are found.
5360,17/9/2006,Iraq,Kirkuk,21,63,84,Two suicide bomb attacks by 'Holy Warriors' take the lives of at least twenty-one innocents.
5361,17/9/2006,Afghanistan,Kandahar,1,11,12,A suicide bomber kills an innocent civilian in a blast along a city street.
5362,17/9/2006,Somalia,Mogadishu,2,0,2,"A 70-year-old nun working at a children's' hospital is shot to death by radical Muslims, along with a guard."
5363,18/9/2006,Afghanistan,Kabul,4,11,15,At least four people are killed in a suicide car bombing.
5364,18/9/2006,Afghanistan,Herat,12,17,29,A dozen innocents are blown apart by a Fedayeen suicide bomber on a motorbike.
5365,18/9/2006,Afghanistan,Kafir Band,4,39,43,"Four Canadian soldiers, and an unknown number of civilians are killed when a suicide bomber on a bicycle targets a patrol handing out candy to children."
5366,18/9/2006,Iraq,Ramadi,13,10,23,"A suicide bomber blows himself to Allah, taking more than a dozen unwilling souls with him."
5367,18/9/2006,Iraq,Tal Afar,21,27,48,"Muslim radicals bomb a marketplace, massacring twenty-one innocent shoppers."
5368,18/9/2006,Iraq,Baquba,4,5,9,Sunnis gun down four members of a Shia family.
5369,18/9/2006,Iraq,Baghdad,27,13,40,Twenty-seven people are murdered by Jihadis in various attacks around the country.
5370,18/9/2006,Iraq,Mosul,4,0,4,Islamic radicals kidnap and torture four women to death.
5371,18/9/2006,Somalia,Baidoa,5,18,23,At least five people are killed in a car bomb attack on the Somali president.
5372,18/9/2006,Pakistan,Laddha,1,0,1,A tribesman is lynched by the local Taliban.
5373,19/9/2006,Afghanistan,Helmand,1,0,1,The Taliban execute a Turkish engineer taken prisoner three weeks earlier.
5374,19/9/2006,Iraq,Baghdad,12,44,56,"Muslim radicals bomb a gas station, killing two civilians.  They also mortar a residential neighborhood killing an additional ten."
5375,19/9/2006,Pakistan,Bajaur,0,5,5,Five women are injured when Taliban terrorists bomb their car as punishment for working at a humanitarian agency.
5376,19/9/2006,Kosovo,Klina,0,4,4,Four elderly Serbs are injured when Muslims throw a bomb through their apartment window.
5377,19/9/2006,Iraq,Baqubah,11,0,11,Islamic gunmen kill at least eleven people across the city in a spasm of religious violence.
5378,19/9/2006,Iraq,Mahmudiya,13,7,20,Thirteen people are murdered by Islamic radicals in at least two separate attacks.
5379,19/9/2006,Iraq,Sherqat,18,11,29,Jihadis exterminate eighteen Iraqis with a car bomb followed by a suicide blast.
5380,19/9/2006,Canada,"Ottawa, ON",2,0,2,A Muslim man guns down his sister and her fiancé because they were living together before marriage.
5381,20/9/2006,Iraq,Mosul,1,0,1,"A young female teacher is kidnapped by Islamic militants, who gouge out her eyes and mutilate her."
5382,20/9/2006,Iraq,Samarra,1,26,27,"A Fedayeen suicide bomber runs his car into a house, killing a young boy and injuring twenty-six others."
5383,20/9/2006,Afghanistan,Wardak,1,2,3,"Religious extremists attack three policemen, killing one and severing the leg of another."
5384,20/9/2006,Iraq,Baghdad,43,15,58,Forty-two people are killed in a suicide bombing and various acts of sectarian violence around the city.
5385,20/9/2006,India,Gul Zada,3,2,5,"Local Islamists riddle a car full of bullets at a traffic stop, killing three occupants."
5386,20/9/2006,India,Doda,1,0,1,A 36-year-old woman is killed in her home by the Mujahideen.
5387,21/9/2006,Iraq,Baghdad,28,22,50,Six Jihad attacks leave two-dozen Iraqis dead and several more with burns and bullet wounds.
5388,21/9/2006,Chechnya,Grozny,5,0,5,Five Russians are brutally slaughtered by Muslim gunmen at point-blank range as they are sitting in a vehicle.
5389,21/9/2006,Pakistan,Haripur,8,3,11,A schoolchild is among eight killed when gunmen open up on a family van.
5390,21/9/2006,India,Tangmarg,1,4,5,A 13-year-old boy is killed when Muslim terrorists throw a grenade into the street.
5391,21/9/2006,Iraq,Karbala,3,0,3,Three civilians are shot to death by Islamic terrorists.
5392,21/9/2006,Iraq,Baghdad,38,0,38,Thirty-eight victims of sectarian hatred within the Religion of Peace are found tortured and executed around the city.
5393,21/9/2006,India,Damhal Hanjipora,1,0,1,A 20-year-old man is kidnapped from his home and murdered by the Mujahideen.
5394,21/9/2006,Iraq,Mosul,2,0,2,Two sisters are brutally murdered by the Mujahideen.
5395,22/9/2006,Lebanon,Ein Al Hulwa,1,0,1,"al-Ansar terrorists open fire, killing a Palestinian man."
5396,22/9/2006,Iraq,Baghdad,13,0,13,Three women are among thirteen people tortured and executed by Muslim terrorists.  At least one was beheaded.
5397,22/9/2006,Pakistan,North Waziristan,1,0,1,A man is kidnapped and executed by the local Taliban.
5398,22/9/2006,Afghanistan,Kandahar,19,3,22,Nineteen innocent laborers are massacred by religious extremists who bomb their bus then shoot the survivors.
5399,22/9/2006,Pakistan,Sargodha,1,0,1,An 85-year-old Shia cleric is gunned down by radical Sunnis.
5400,22/9/2006,Afghanistan,Jalalabad,1,0,1,The Taliban kill a Pakistani truck driver during an attack on oil tankers.
5401,23/9/2006,Pakistan,Dera Ghazi Khan,2,14,16,A 14-year-old boy is one of two people killed when radicals explode a bomb at a cattle market.
5402,23/9/2006,India,Kangan,1,0,1,Islamic terrorists murder a civilian.
5403,23/9/2006,Bangladesh,Dhaka,1,0,1,A university professor is gunned down in his home.
5404,23/9/2006,Iraq,Baghdad,17,0,17,"Radical Shias rampage through Sunni neighborhoods, leaving a trail of over a dozen bodies."
5405,23/9/2006,Iraq,Baghdad,37,40,77,'Soldiers of the Prophet's Companions' stage a massive car bomb in a Shia neighborhood that kills over three-dozen innocents - mostly women and children.
5406,24/9/2006,India,Sopore,1,2,3,"Muslim militants toss a grenade at a security patrol, killing one of the members."
5407,24/9/2006,Iraq,Tal Afar,2,3,5,"A suicide bomber rams a police checkpoint, killing two and wound three, including bystanders."
5408,24/9/2006,Iraq,Fallujah,12,0,12,Jihadis kidnap and torture to death ten people.  A father and son are killed in their home.
5409,24/9/2006,Iraq,Baghdad,6,18,24,Two Jihadi bombings kill six and injure at least eighteen.
5410,24/9/2006,Iraq,Kirkuk,4,0,4,Four young men are murdered by militant Muslims
5411,24/9/2006,India,Surenda,1,0,1,An 18-year-old woman is murdered by the Hizb-ul-Mujahideen after she refuses to marry a member.
5412,24/9/2006,Iraq,Baghdad,2,17,19,"Radical Muslims place bombs outside a Christian cathedral, intending to kill worshippers.  Two people, including a child, are killed."
5413,25/9/2006,Thailand,Narathiwat,1,0,1,"A 45-year-old civilian is lured out of his home by Muslim radicals, then cut down with an assault-weapon."
5414,25/9/2006,Thailand,Yala,2,1,3,"A heavily-armed band of Muslim militants assault a small town, killing two civilians, including a woman."
5415,25/9/2006,India,Srinagar,1,6,7,A policewoman is killed when Muslim militants throw a grenade at her.  A 9-year-old girl is among the injured.
5416,25/9/2006,India,Sanglan,1,0,1,A 23-year-old civilian is kidnapped and murdered by the Mujahideen.
5417,25/9/2006,India,Marmat,1,0,1,A village leader is kidnapped by Muslim radicals and killed in captivity.
5418,25/9/2006,India,Gundana,1,0,1,Islamic radicals kill a medical assistant inside his home.
5419,25/9/2006,India,Jwari,2,0,2,A woman is among two people brutally slain by the Mujahideen in their village.
5420,25/9/2006,Somalia,Kismayo,1,2,3,A 13-year-old boy is gunned down by Islamists for taking part in a protest against their seizure of his city.
5421,25/9/2006,Afghanistan,Kandahar,1,0,1,A woman's rights campaigner is shot to death by the Taliban.
5422,25/9/2006,Iraq,Jurf al-Sakhar,5,10,15,"Muslim radicals target a police station with mortar fire, killing five officers."
5423,25/9/2006,Iraq,Baiji,10,0,10,The body of one of nine severed heads found two days earlier surfaces.  An intact body is found elsewhere.
5424,25/9/2006,Russia,Kislovodsk,1,0,1,The Jamaat terrorist group claims responsibility for the Ramadan shooting of an imam.
5425,26/9/2006,Iraq,Mahmudiya,12,0,12,"Twelve victims of sectarian violence within the Religion of Peace are found bound, tortured and executed."
5426,26/9/2006,Iraq,Baghdad,40,34,74,A series of bomb blasts and other Jihad attacks leave at least forty dead and dozens more in agony.
5427,26/9/2006,Afghanistan,Lashkar Gah,18,17,35,"A Fedayeen suicide bomber blows himself to Allah, taking eighteen innocent souls with him, including Muslim pilgrims."
5428,26/9/2006,Afghanistan,Kabul,2,9,11,Religious extremists kill an Afghan child and an Italian solider in a remote-controlled bomb attack.
5429,26/9/2006,Iraq,Baghdad,44,0,44,Thirty-five victims of sectarian violence are found within the city and nine more in a river downstream.
5430,26/9/2006,Iraq,Baghdad,10,11,21,A shooting attack on a mosque by Islamic terrorists leaves ten people dead.
5431,26/9/2006,India,Kashmir,2,15,17,Two police personnel are killed in separate Mujahideen attacks.
5432,27/9/2006,Iraq,Baghdad,16,25,41,A Fedayeen suicide bomber kills at least two other people.  Fourteen other bodies are found elsewhere.
5433,27/9/2006,Iraq,Baghdad,8,42,50,Two separate Jihad attacks leave at least eight dead and over forty injured.
5434,27/9/2006,Thailand,Pattani,1,0,1,A Buddhist is murdered by Muslim extremists as he is riding a bus.
5435,27/9/2006,Thailand,Yala,3,0,3,Muslim teens shoot three Buddhists to death as they are shopping at a grocery.
5436,27/9/2006,Iraq,Baghdad,7,11,18,A woman gunned down on her way to work is among those killed in three attacks by radical Sunnis.
5437,27/9/2006,Thailand,Yala,1,1,2,Islamists shoot a civilian in an ambush that also injures his 6-year-old son.
5438,27/9/2006,Thailand,Narathiwat,1,2,3,"Muslim terrorists open fire on a grocery, killing one civilian."
5439,27/9/2006,India,Srinagar,2,0,2,Two cops are gunned down by the Mujahideen in separate attacks.
5440,27/9/2006,India,Maisuma,1,14,15,"A Muslim terrorist lobs a grenade into a city street, killing a police officer."
5441,28/9/2006,India,Kulgam,1,0,1,A civilian succumbs to injuries suffered from an earlier terror attack.
5442,28/9/2006,India,Diwar,1,0,1,A woman is killed inside her home by the Mujahideen two years after her husband was murdered in similar fashion.
5443,28/9/2006,Pakistan,Khadi,1,0,1,An Afghan refugee is murdered by the Taliban.
5444,28/9/2006,Thailand,Pattani,1,0,1,A man is shot in the head by Islamists after dropping his kids off at school.
5445,28/9/2006,Thailand,Sai Buri,1,0,1,A 35-year-old man is gunned down by Muslim militants in his pick-up truck.
5446,29/9/2006,Algeria,Ouled Boudekhane,2,0,2,Islamists murder two men outside a mosque.
5447,29/9/2006,Iraq,Kirkuk,3,0,3,Two brothers are among three people murdered in their car by Islamic radicals.
5448,29/9/2006,India,Dessa,1,0,1,A civilian is abducted and killed in captivity by the Mujahideen.
5449,30/9/2006,Pakistan,Bahawlnagar,1,0,1,A Christian is killed by authorities who arrest and imprison him for 'blaspheming' Islam.
5450,30/9/2006,Iraq,Tal Afar,2,30,32,A suicide bomber murders two people.
5451,30/9/2006,Iraq,Baqubah,8,0,8,A father and two sons are among eight brutally murdered by Islamic terrorists.
5452,30/9/2006,Afghanistan,Kabul,12,40,52,At least a dozen people are blown to bits by a Fedayeen suicide bomber.
5453,1/10/2006,Ethiopia,Jimma,10,12,22,"Ten people are killed, more than a dozen injured, and at least two churches burned down as Muslims attempt to ban a Christian ceremony."
5454,1/10/2006,Iraq,Baghdad,50,0,50,Fifty victims of sectarian hatred within the Religion of Peace are found by police over a 24-hour period.
5455,1/10/2006,Afghanistan,Gereshk,2,2,4,The Taliban kill two policemen from the back of a motorcycle.
5456,1/10/2006,Afghanistan,Musa Qala,5,0,5,Five civilians are killed in a Taliban landmine attack on their vehicle.
5457,1/10/2006,Thailand,Yala,1,1,2,Muslim militants gun down a police officer and injure his 4-year-old daughter.
5458,1/10/2006,Pakistan,Sibi,1,0,1,A 12-year-old boy is killed in a landmine blast.
5459,1/10/2006,India,Gool,1,0,1,"The body of a 60-year-old man, abducted and murdered by the Mujahideen, is found."
5460,1/10/2006,Indonesia,Poso,0,1,1,A Christian man is pulled off a bus and stabbed by a Muslim mob.
5461,1/10/2006,Iraq,Suwayra,9,0,9,A schoolgirl is among nine people kidnapped and shot in the head and chest in two locations (Mahmudiya).
5462,1/10/2006,Iraq,Fallujah,4,6,10,Four civilians are killed when Muslim terrorists detonate a bomb at a vegetable market.
5463,2/10/2006,Pal. Auth.,Rafah,2,15,17,A sectarian clash leaves two people dead.
5464,2/10/2006,Thailand,Pattani,2,0,2,Two people are murdered by Islamic radicals in separate attacks.
5465,2/10/2006,Iraq,Ishaqi,3,0,3,Three men are gunned down by suspected Islamic fundamentalists.
5466,2/10/2006,Iraq,Baghdad,5,10,15,Two Jihad bombings net five dead bodies.
5467,2/10/2006,Iraq,Suwayra,11,0,11,Seven people are kidnapped and beheaded by Muslim extremists.  Four others are killed in a separate attack.
5468,2/10/2006,Afghanistan,Kabul,3,3,6,"A religious extremist blows himself up, killing three people."
5469,2/10/2006,Pakistan,Latrey,2,7,9,Two people are killed in sectarian violence involving a religious shrine.
5470,2/10/2006,Thailand,Songkhla,1,0,1,A village headsman is ambushed and killed while driving his truck.
5471,2/10/2006,Thailand,Narathiwat,1,0,1,A woman is shot to death by Islamic radicals while on a shopping trip.
5472,3/10/2006,Iraq,Baqubah,16,0,16,"Seven members of the same family, including a father and three sons, are among sixteen murdered by Islamic terrorists."
5473,3/10/2006,Iraq,Sadiyah,2,19,21,"A Fedayeen suicide bomber targets a fish market, sending two people to Allah."
5474,3/10/2006,Afghanistan,Kandahar,2,5,7,Two Canadians on a road construction project are murdered by Taliban extremists.
5475,3/10/2006,Iraq,Rashad,2,0,2,"Two civilians are abducted and horribly tortured by Islamic terrorists, then killed."
5476,3/10/2006,Iraq,Kut,2,0,2,Islamists behead one woman and burn another to death.
5477,3/10/2006,Iraq,Gatoun,4,0,4,Four members of a family are murdered by sectarian rivals.
5478,3/10/2006,Pakistan,Ali Khan Brohi,1,0,1,A woman is tortured to death by her husband and in-laws for opposing his plans to take a second wife.
5479,4/10/2006,Iraq,Mosul,2,0,2,Two Turkish truck drivers are brutally murdered by Sunni extremists.
5480,4/10/2006,Philippines,Cotabato,1,0,1,A local official is gunned down by Muslim radicals while sitting in his car.
5481,4/10/2006,Iraq,Baghdad,16,87,103,"Jihadis bomb a Christian district, killing sixteen innocents and injuring many dozens more."
5482,4/10/2006,India,Lal Chowk,1,6,7,"Muslim militants storm a building housing Hindu relics, killing at least one security guard."
5483,4/10/2006,Dagestan,Maka-Kazmalyar,1,3,4,Muslim terrorists kill a policeman and wound three others on a highway.
5484,4/10/2006,Sudan,Kalama,2,1,3,"Arab militias attack a DP camp, killing two civilians."
5485,4/10/2006,India,Srinagar,8,30,38,Eight people are killed when Al Mansoorian militants stage a Fedayeen attack on a government building.
5486,5/10/2006,Iraq,Ukashat,5,0,5,Five people are kidnapped and tortured to death by Muslim terrorists.
5487,5/10/2006,Iraq,Baghdad,32,28,60,A car bombing adds two additional bodies to thirty more racked up the Religion of Peace in sectarian violence.
5488,5/10/2006,Iraq,Zaafaraniya,5,6,11,"Islamic radicals open fire on a cafe, killing five innocents."
5489,5/10/2006,Pakistan,Kalaya,8,3,11,Eight more people are killed as Sunnis and Shias clash over ownership of a shrine.
5490,5/10/2006,Iraq,Al-Samawa,4,0,4,"'Holy Warriors' burst into a house and slaughter three woman and a 3-year-old girl, who has her throat slit."
5491,5/10/2006,Algeria,Bouira,8,0,8,Eight members of a security patrol are killed by Islamic fundamentalists.
5492,6/10/2006,Iraq,Baghdad,7,0,7,Seven people are kidnapped and brutally murdered by sectarian death squads.
5493,6/10/2006,Afghanistan,Khost,1,3,4,A suicide bomber kills a policeman.
5494,6/10/2006,Iraq,Mosul,1,0,1,Radical Sunnis gun down a mother walking with her 5-year-old son.
5495,6/10/2006,India,Srinagar,1,6,7,A civilian is killed when a militant Muslim throws a grenade into a bus stop.
5496,6/10/2006,Pakistan,Kalay,5,0,5,Five Sunni family members are killed in a retaliatory mortar strike by Shias for the earlier event.
5497,6/10/2006,Pakistan,Kalay,14,8,22,"Sunnis mortar a Shia gathering, killing fourteen people."
5498,7/10/2006,Iraq,Iskandariya,2,4,6,Two members of a family are killed in their sleep by a Jihad mortar attack on their home.
5499,7/10/2006,Iraq,Sinjar,2,2,4,Two religious minorities are gunned down by Islamists.
5500,7/10/2006,Iraq,Baghdad,7,0,7,Two innocent workers at a bakery are among seven people killed by religious extremists.
5501,7/10/2006,Iraq,Tal Afar,14,13,27,A suicide truck bomber at a checkpoint blows fourteen other people to Allah.
5502,7/10/2006,Afghanistan,Baghlan,2,0,2,"Two German journalists, one of whom was a woman, are murdered in the countryside."
5503,7/10/2006,Pakistan,Tank,1,0,1,A Shia tribal leader is murdered by terrorists.
5504,7/10/2006,India,Vesu Achhabal,1,0,1,A civilian is kidnapped and killed by the Mujahideen.
5505,7/10/2006,India,Ramban,1,2,3,"A Muslim tosses a grenade at a police patrol on a city street, killing one officer."
5506,7/10/2006,India,Shalapora,1,0,1,"An off-duty soldier is kidnapped by the Mujahideen, who behead him and scatter the body parts."
5507,7/10/2006,Thailand,Songkhla,2,0,2,A Buddhist man and his son are shot to death by Islamists.
5508,7/10/2006,Iraq,Baaj,3,0,3,Three innocent workers are gunned down by Sunni terrorists.
5509,7/10/2006,Iraq,Samarra,2,0,2,The 8-year-old son of a policeman is gunned down along with his father by terrorists.
5510,7/10/2006,Iraq,Baghdad,51,0,51,Fifty-one people are killed in sectarian violence within the Religion of Peace across the city.
5511,7/10/2006,Thailand,Pattani,1,0,1,Muslims murder a policeman as he travels to work.
5512,8/10/2006,Iraq,Baghdad,1,0,1,A 14-year-old boy is crucified by Islamic radicals in a heinous attack.
5513,8/10/2006,India,Sopore,1,0,1,A dental surgeon is abducted and tortured for two hours before Islamic militants slit his throat.
5514,8/10/2006,Thailand,Pattani,1,0,1,A rubber tapper is shot to death by Islamists.
5515,8/10/2006,Thailand,Narathiwat,1,0,1,A 65-year-old Buddhist is murdered by Muslims while walking home.
5516,8/10/2006,Thailand,Yala,1,0,1,Radical Muslims shoot a man four times in front of his house.
5517,8/10/2006,Iraq,Baqubah,10,0,10,Four civilians are murdered by Islamic radicals.  Six bodies are found elsewhere.
5518,8/10/2006,Iraq,Haditha,5,0,5,Five civilians are gunned down by Jihadi gunmen.
5519,9/10/2006,Afghanistan,Khogyani,3,2,5,Three men are murdered by Islamic extremists as they are traveling to investigate a school burning.
5520,9/10/2006,Iraq,Baghdad,13,46,59,Islamic terrorists kill thirteen civilians rushing home for Ramadan in a heinous bomb attack.
5521,9/10/2006,Iraq,Baghdad,53,0,53,Police report finding fifty-three victims of sectarian violence within the Religion of Peace over the last 24 hours.
5522,9/10/2006,Iraq,Tal Afar,1,11,12,A suicide bomber kills one other person.
5523,9/10/2006,India,Bandipora,1,0,1,A man is kidnapped and brutally murdered by the Mujahideen.
5524,9/10/2006,Thailand,Narathiwat,2,1,3,A married couple are murdered by Muslim extremists.
5525,10/10/2006,Philippines,Tacurong City,2,8,10,"Islamists set off a bomb in a crowded market at noon, killing two shoppers."
5526,10/10/2006,Philippines,Makilala,6,29,35,A bomb blast at a festival by Islamic militants leaves six dead and twenty-nine wounded.
5527,10/10/2006,Iraq,Fallujah,4,0,4,Radical Sunnis kidnap and torture four civilians to death.
5528,10/10/2006,Iraq,Baghdad,60,22,82,Sixty victims of sectarian hatred within the Religion of Peace are found over a 24 hour period.  Twenty-two others are injured.
5529,10/10/2006,Afghanistan,Kabul,0,11,11,Eleven people are injured when religious extremists place a bicycle bomb next to a bus stop.
5530,10/10/2006,Iraq,Mosul,7,0,7,"Seven bodies are found here, and four others in Tal Afar, showing signs of torture at the hands of religious militants."
5531,10/10/2006,Iraq,Baqubah,12,0,12,A dozen people are gunned down by Muslim terrorists.
5532,10/10/2006,Iraq,Baghdad,10,4,14,"Islamic fundamentalists bomb a bakery, killing ten innocents."
5533,10/10/2006,Afghanistan,Khushmand,3,0,3,The Taliban execute three civilians.
5534,11/10/2006,Iraq,Baghdad,4,2,6,Islamic gunmen murder four members of a family in their home.
5535,11/10/2006,Iraq,Baghdad,1,0,1,A Christian priest is abducted and decapitated by Muslim extremists.  The head is not found with the body.
5536,11/10/2006,Iraq,Baghdad,7,13,20,Two civilians are killed when Islamic terrorists trigger a car bomb along a city street.  Five laborers are killed in a separate bombing.
5537,11/10/2006,Iraq,Kut,6,0,6,A peasant woman is among six people killed by Jihadis in separate attacks.
5538,11/10/2006,Philippines,Patikul,2,8,10,Abu Sayyaf terrorists kill two government soldiers.
5539,11/10/2006,Pakistan,Mir Ali,1,0,1,An Afghan refugee is murdered by Islamic fundamentalists.
5540,11/10/2006,Pakistan,Saobi,1,0,1,A doctor is killed by religious extremists.
5541,11/10/2006,Thailand,Pattani,1,0,1,A man is gunned down in a drive-by shooting by Islamists.
5542,12/10/2006,Thailand,Narathiwat,1,0,1,Muslim radicals kill a 26-year-old Buddhist in his home.
5543,12/10/2006,Thailand,Yala,1,0,1,A Buddhist factory worker is shot to death by Muslims.
5544,12/10/2006,Afghanistan,Kabul,1,19,20,Two suicide attacks and an ambush at Uruzgan by the Taliban leave at least one person dead.
5545,12/10/2006,Iraq,Baqubah,12,0,12,Twelve people are gunned down by Jihadis.
5546,12/10/2006,Iraq,Baghdad,19,25,44,"Eleven employees of a television station are brutally slaughtered, some in their sleep.  Two other bombings kill another eight."
5547,12/10/2006,India,Srinagar,3,8,11,Three policemen are killed in a brutal assault by Islamic terrorists in the heart of the city.
5548,13/10/2006,Afghanistan,Kandahar,9,5,14,Eight civilians are among nine killed by a Fedayeen suicide bomber.
5549,13/10/2006,Thailand,Narathiwat,1,0,1,A middle-aged Buddhist man is shot and killed by Muslim militants as he is walking home.
5550,13/10/2006,Iraq,Suwayra,8,2,10,Six women and two children are slaughtered by Muslim gunmen in a field.
5551,13/10/2006,Thailand,Pattani,1,0,1,A man is kidnapped and beheaded in front of his 13-year-old daughter by Islamic radicals.
5552,13/10/2006,Iraq,Duluiya,17,0,17,Seventeen Shiite laborers are decapitated in an orchard by their Sunni brothers.
5553,13/10/2006,Algeria,Kabylie,1,0,1,The Salafist Group for Preaching and Combat guns down a man in a cafe.
5554,13/10/2006,Iraq,Hilla,8,10,18,Eight people lose their lives to a Muslim bomber.
5555,13/10/2006,Thailand,Narathiwat,1,0,1,Two Muslims walk into a noodle shop and murder a patron.
5556,14/10/2006,Ethiopia,Beshasha,6,15,21,"A mob of 300 Muslims attack a group of unarmed Christians worshipping at a church, murdering at least six of them - including two priests."
5557,14/10/2006,Iraq,Saifiya,10,0,10,Ten Shia family members are slaughtered in their home by Sunni radicals.
5558,14/10/2006,Thailand,Narathiwat,1,0,1,"A rubber tapper is murdered by Islamic radicals, who chop his face beyond recognition."
5559,14/10/2006,Afghanistan,Kandahar,2,2,4,Two Canadians are killed in a Taliban rocket attack on a road construction project.
5560,14/10/2006,Iraq,Balad,15,0,15,Fifteen Sunnis are killed in revenge for an earlier massacre.
5561,14/10/2006,Iraq,Baghdad,25,0,25,Twenty-five victims of sectarian violence within the Religion of Peace are found tortured and executed.
5562,15/10/2006,Afghanistan,Kandahar,1,2,3,A local official is assassinated by religious extremists.
5563,15/10/2006,Iraq,Baghdad,4,6,10,Four civilians are killed in a Jihad car bombing.
5564,15/10/2006,Iraq,Fallujah,4,0,4,Four people are kidnapped and tortured to death by Islamic terrorists.
5565,15/10/2006,Iraq,Balad,31,0,31,Thirty-one Sunnis are killed in retaliation for an earlier massacre against Shias.
5566,15/10/2006,Iraq,Kirkuk,10,64,74,"Three suicide bombings, including one by a man at a girl's high school, leave at least ten innocents dead."
5567,15/10/2006,Iraq,Mosul,5,0,5,"Five members of a family, including three women, are killed in their home by Muslim militants."
5568,15/10/2006,Iraq,Latifiya,8,0,8,Three women and two children are among eight Shias of a family killed when radical Sunnis invade their home.
5569,15/10/2006,Algeria,Ain Defla,8,0,8,Islamists from the Salafist Group for Preaching and Combat shoot eight security guards to death.
5570,15/10/2006,Thailand,Chanae,1,1,2,A 30-year-old man is shot and killed by Islamists as he is riding a motorcycle.
5571,15/10/2006,Thailand,Joh I Rong,1,1,2,A 21-year-old man is killed by Islamic militants.
5572,15/10/2006,Afghanistan,Khost,3,1,4,"Hundreds of Taliban extremists attack a police post, killing at least three officers."
5573,15/10/2006,Afghanistan,Herat,2,1,3,Two people are killed when the Taliban explode a bomb along a city street.
5574,15/10/2006,India,Srinagar,2,0,2,"Jaish-e-Mohammed terrorists attack two policemen, killing one.  The second officer succumbs to injury a week later."
5575,16/10/2006,Thailand,Narathiwat,2,0,2,A husband and wife are murdered by Muslim gunmen as they are traveling home from work.
5576,16/10/2006,Thailand,Pattani,1,0,1,A 55-year-old man is machine-gunned to death by Islamic radicals.
5577,16/10/2006,Thailand,Raman,2,0,2,A village leader and colleague are shot to death by Muslim terrorists as they are returning from a shopping trip.
5578,16/10/2006,Indonesia,Sulawesi,1,0,1,A Christian priest is murdered by Muslim gunmen in front of his wife.
5579,16/10/2006,Iraq,Balad,28,0,28,Twenty-eight more Sunnis are killed by Shias over a 48-hour period in revenge for an earlier massacre.
5580,16/10/2006,Iraq,Baghdad,20,17,37,Twenty people at a Shiite funeral are killed by two car bombs.  The second was set to kill those rushing to help.
5581,16/10/2006,Thailand,Yala,2,0,2,Two men are murdered in separate attacks.
5582,16/10/2006,Thailand,Yala,2,0,2,A husband and wife rubber-tapping team are brutally gunned down by Islamic militants.
5583,16/10/2006,Afghanistan,Kandahar,4,2,6,A Fedayeen suicide bomber kills four civilians.
5584,16/10/2006,Iraq,Khalis,12,4,16,Four people standing at a bus stop are gunned down by Islamic terrorists.  Eight others are killed in two separate attacks.
5585,16/10/2006,Iraq,Baghdad,46,0,46,Forty-six victims of sectarian violence within the Religion of Peace are found tortured and executed over a 24-hour period.
5586,16/10/2006,Iraq,Suwayra,8,48,56,Eight civilians standing near a bank are cut down by a Jihad car bomb.
5587,17/10/2006,India,Batmaloo,1,0,1,A man is gunned down by Islamic militants.
5588,17/10/2006,India,Lal Chowk,2,0,2,Two policemen are killed in a Mujahideen attack on a market.
5589,17/10/2006,Iraq,Balad Ruz,5,1,6,Sunnis storm a house and murder a mother and her four sons.
5590,17/10/2006,Iraq,Basra,5,0,5,Islamic radicals murder four university students and a female doctor.
5591,17/10/2006,Thailand,Yala,1,1,2,Militant Muslims gun down a guard at a bank.
5592,17/10/2006,Iraq,Haditha,4,0,4,"Four people are kidnapped, tortured and killed by Muslim terrorists."
5593,17/10/2006,Iraq,Baghdad,19,0,19,Nineteen additional victims of sectarian hatred within the Religion of Peace are found.
5594,17/10/2006,Philippines,Basilan,1,1,2,Abu Sayyaf militants ambush two off-duty soldiers on their way to a market.
5595,17/10/2006,Afghanistan,Spin Boldak,1,0,1,Taliban extremists destroy an oil tanker and kill the Pakistani driver.
5596,17/10/2006,Eritrea,Adi-Quala,2,0,2,Two Christians are arrested and tortured to death for hosting a church meeting.
5597,18/10/2006,Thailand,Yala,1,4,5,"Muslim militants open fire on a checkpoint, killing a Thai soldier."
5598,18/10/2006,Thailand,Narathiwat,1,0,1,A civilian is shot in the head by Muslim extremists.
5599,19/10/2006,Iraq,Baghdad,12,32,44,Various attacks by the Religion of Peace claim the lives of a dozen people.
5600,19/10/2006,Iraq,Mahmudiya,7,3,10,Jihadis murder seven people in two attacks.
5601,19/10/2006,Iraq,Mosul,21,26,47,A suicide bomber kills eleven innocents at a fueling station.  Ten other people are killed elsewhere.
5602,19/10/2006,Afghanistan,Lashkar Gah,3,9,12,Two children and a British soldier are blown apart by a Fedayeen suicide bomber.
5603,19/10/2006,India,Budhal,1,0,1,"Terrorists plant a bomb in a field, killing a 12-year-old boy."
5604,19/10/2006,Afghanistan,Kunar,8,0,8,Eight Afghan employees at a NATO base are stopped in traffic and shot execution-style on their way home.
5605,19/10/2006,Iraq,Baghdad,4,8,12,Four Palestinians are killed when their Muslim 'brothers' fire rockets into their neighborhood.
5606,19/10/2006,Afghanistan,Khost,1,7,8,A suicide bomber kills one other person.
5607,19/10/2006,Iraq,Khalis,4,4,8,"In a heinous attack, gunmen murder four laborers."
5608,19/10/2006,Iraq,Kirkuk,11,74,85,Separate Fedayeen suicide bombers send eleven innocents to Allah.
5609,19/10/2006,Iraq,Khalis,10,20,30,Sectarian rivals kill ten innocents with a Ramadan bombing of a busy market.
5610,19/10/2006,Pakistan,Shakai,2,3,5,"Islamic militants ambush five Pakistani soldiers, killing two."
5611,20/10/2006,Thailand,Narathiwat,2,0,2,Two men are gunned down in separate drive-by attacks by Muslim terrorists.
5612,20/10/2006,Thailand,Narathiwat,1,0,1,A young woman is murdered by Islamic militants.
5613,20/10/2006,Thailand,Narathiwat,1,0,1,Muslim radicals kill a 37-year-old man in his home.
5614,20/10/2006,Thailand,Songkhla,4,13,17,"Islamists detonate a bomb at a village teashop, killing four civilians.  Two civilians lost both their legs."
5615,20/10/2006,Algeria,Timezrit,1,0,1,A man is stabbed to death by Islamic fundamentalists at a phony roadblock.
5616,20/10/2006,India,Lolab,1,0,1,A 7-year-old child is murdered by militant Muslims in a grenade attack.
5617,20/10/2006,Iraq,Balad,9,0,9,Nine people are killed in Sunni-Shia violence.
5618,20/10/2006,Pakistan,Jandola,1,0,1,A civilian is murdered by Islamic militants.
5619,20/10/2006,Pakistan,Peshawar,7,41,48,"Terrorists bomb a crowded shopping area, killing at least a half-dozen innocents."
5620,20/10/2006,Thailand,Pattani,1,0,1,Muslims shoot a 46-year-old man off of his motorcycle.
5621,20/10/2006,Philippines,Kabacan,1,2,3,Two Moro Islamic Liberation Front terrorists gun down a man in his bed.
5622,21/10/2006,Iraq,Baqubah,1,0,1,A 14-year-old Christian boy is abducted and beheaded by Muslim extremists.
5623,21/10/2006,Philippines,Barangay Banawag,1,0,1,Islamic militants are suspected in the murder of a farmer.
5624,21/10/2006,Iraq,Mahmoudiyah,19,52,71,Jihadis massacre nineteen people at a crowded market with mortars and a bomb.
5625,21/10/2006,Afghanistan,Ismailkhel,1,0,1,An Afghan official is killed in a remote-controlled Taliban bomb.
5626,21/10/2006,Thailand,Narathiwat,1,0,1,A Buddhist man is slaughtered by Muslim extremists.
5627,21/10/2006,Iraq,Baghdad,7,15,22,"A religious extremist blows himself up in a minivan, killing at least seven others."
5628,21/10/2006,India,Kishtwar,1,1,2,A young boy is killed by the Mujahideen in a mine attack.
5629,21/10/2006,Thailand,Pattani,1,1,2,A couple riding a motorcycle are shot by Muslim radicals.  The man dies on the scene.
5630,22/10/2006,Pakistan,Bahawalpur,1,0,1,Radical Sunnis gun down a Shia cleric.
5631,22/10/2006,Thailand,Pattani,1,0,1,A man is murdered by Muslim militants while walking home.
5632,22/10/2006,Iraq,Baghdad,50,0,50,Fifty victims of sectarian hatred within the Religion of Peace are found over a 24-hour period.
5633,22/10/2006,Iraq,Baqubah,13,25,38,Thirteen police recruits are murdered by a Jihadi bombing and shooting attack on their bus.
5634,22/10/2006,Thailand,Narathiwat,1,12,13,"A column of Buddhist monks, on their way to receive alms for the poor, is bombed by Muslim militants."
5635,22/10/2006,Iraq,Madaen,9,3,12,Nine people are killed in a Religion of Peace sectarian clash.
5636,22/10/2006,Iraq,Baghdad,5,6,11,"Muslim terrorists bomb a street market, killing five innocents."
5637,22/10/2006,Iraq,Yarmuk,2,0,2,Two street cleaners are murdered by Islamic terrorists.
5638,22/10/2006,Iraq,Amil,1,0,1,Religious fundamentalists murder a barber.
5639,22/10/2006,India,Muzaffarnagar,1,12,13,"A young Hindu is killed, and more than a dozen others injured, when Muslims object to a Diwali celebration."
5640,23/10/2006,Philippines,Zamboanga,2,0,2,Islamic militants suspected in a shooting attack that leaves a cop and a civilian dead.
5641,23/10/2006,Mali,Arouan,9,3,12,Islamic fundamentalists kill nine former Tuareg rebels.
5642,23/10/2006,Thailand,Pattani,1,0,1,Muslim radicals kill a civilian who is walking home.
5643,23/10/2006,Iraq,Haqlaniyah,1,1,2,Terrorists kill a child and injure a woman.
5644,23/10/2006,Iraq,Baghdad,21,35,56,Five separate Jihad attacks leave nearly two dozen people dead and another three dozen injured.
5645,23/10/2006,India,Tarzoo,1,1,2,A civilian is killed when the Mujahideen bomb a bus stop.
5646,24/10/2006,India,Baramulla,1,0,1,A policeman is murdered by the Religion of Peace.
5647,24/10/2006,India,Changoo Dooru,1,0,1,Terrorists assassinate a government official.
5648,24/10/2006,Iraq,Baghdad,1,7,8,"Jihadis bomb an ice cream shop, killing an innocent person."
5649,24/10/2006,Thailand,Yala,1,0,1,"Muslims shoot a laborer four times, killing him."
5650,25/10/2006,Iraq,Husayba,2,2,4,Two people are killed when Muslim militants bomb a marketplace.
5651,25/10/2006,Iraq,Mahmudiya,4,0,4,"Terrorists kidnap, bound and execute four people."
5652,25/10/2006,India,Kupwara,2,0,2,Two brothers succumb to injuries after being shot by militant Muslims.
5653,25/10/2006,India,Anantnag,1,0,1,A man is dragged out of his house and executed by the Mujahideen.
5654,26/10/2006,Philippines,Zamboanga,1,0,1,Muslims gun down a Chinese trader.
5655,26/10/2006,Thailand,Narathiwat,1,5,6,"A cleric is gunned down by terrorists, and four others are injured in a separate attack."
5656,26/10/2006,Iraq,Baqubah,34,35,69,Two separate attacks by Jihadis leave thirty-four Iraqi policemen dead.
5657,26/10/2006,Iraq,Mosul,8,0,8,At least eight people are found shot to death by Islamic terrorists over a two day period.
5658,26/10/2006,India,Tral,1,0,1,A civilian is abducted and executed by the Mujahideen.
5659,27/10/2006,Thailand,Yala,3,0,3,"A 4-year-old girl is gunned down by radical Muslims, along with her parents."
5660,27/10/2006,Afghanistan,Uruzgan,14,3,17,"Children and the elderly make up the bulk of civilians casualties, as religious extremists blow up a passenger bus."
5661,27/10/2006,Thailand,Pattani,1,0,1,Militant Muslims murder a military guard patrolling a market.
5662,27/10/2006,Iraq,Baghdad,11,0,11,Eleven victims of sectarian hatred within the Religion of Peace are found murdered.
5663,27/10/2006,Iraq,Muradiya,4,5,9,Four people are machine-gunned to death when terrorists open up on a minibus.
5664,28/10/2006,Iraq,Iskandariya,5,20,25,"Jihadis detonate a car bomb in a residential area, killing five people."
5665,28/10/2006,India,Sopore,1,32,33,"Militant Muslims toss a grenade into a market, killing one person."
5666,28/10/2006,Iraq,Baghdad,2,43,45,Two people are killed in separate bombing attacks.
5667,28/10/2006,Iraq,Suwayra,5,0,5,"Five people are kidnapped, executed and dumped in a river by sectarian rivals."
5668,28/10/2006,Thailand,Narathiwat,1,0,1,A 74-year-old Buddhist man is murdered by Islamists.
5669,28/10/2006,Thailand,Pattani,1,0,1,An off-duty officer is killed by militant Muslims.
5670,28/10/2006,Thailand,Pattani,1,0,1,A rubber plantation owner is murdered by Islamists.
5671,28/10/2006,Iraq,Kut,4,0,4,Islamic gunmen kill four members of a family in their home.
5672,28/10/2006,India,Guwahati,1,12,13,Pakistani-backed militants kill a 14-year-old boy at a Hindu festival.
5673,28/10/2006,Pakistan,Quetta,1,12,13,"Taliban-backed militants detonate a bicycle bomb on a city street, killing a young boy."
5674,28/10/2006,India,Jamslan,1,1,2,A woman is blown apart by a terrorist grenade.
5675,29/10/2006,Sudan,Khabesh,22,0,22,Twenty-two African villagers are massacred by Arab militias.
5676,29/10/2006,Iraq,Baghdad,2,0,2,"Fundamentalists gun down a sports broadcaster, along with her driver."
5677,29/10/2006,Iraq,Basra,19,0,19,"In a brutal ambush of a bus carrying cleaning workers and police recruits, Sunnis slaughter nineteen innocents."
5678,29/10/2006,Iraq,Fallujah,5,0,5,"Terrorists kidnap, torture and kill five people."
5679,29/10/2006,Iraq,Baghdad,31,0,31,Thirty-one victims of sectarian hatred within the Religion of Peace are found murdered over a 24-hour period.
5680,29/10/2006,Philippines,Zamboanga,1,0,1,A policeman is killed by Abu Sayyaf terrorists.
5681,29/10/2006,India,Mahore,1,1,2,A woman is killed in a Mujahideen IED attack.
5682,29/10/2006,Sudan,Jabel Moun,92,0,92,Nearly one-hundred innocent people are massacred by an Arab militia backed by the Islamic government.  At least thirty-three are children.
5683,29/10/2006,Afghanistan,Oruzgan,1,8,9,"A Taliban bombing kills a NATO soldier and injures eight other people, including civilians."
5684,29/10/2006,India,Pulwama,1,0,1,A 24-year-old civilian is kidnapped and brutally murdered by the Mujahideen.
5685,30/10/2006,Thailand,Yala,1,0,1,Islamists shoot a man in the head.
5686,30/10/2006,Algeria,Dergana,2,9,11,Islamic rebels kill two people in a second bombing coinciding with an earlier one.
5687,30/10/2006,Algeria,Raghaja,1,14,15,Islamic rebels kill one person in a bombing.
5688,30/10/2006,Iraq,Mahmudiya,12,0,12,"Six victims of sectarian violence are found here, and another six in Suwayra."
5689,30/10/2006,Iraq,Khalis,2,3,5,Two laborers are blown apart by a roadside bomb.
5690,30/10/2006,Iraq,Baghdad,31,60,91,"Sunnis bomb a market, killing over thirty innocents, including Shia laborers looking for work."
5691,30/10/2006,Iraq,Baghdad,9,30,39,"Two Jihad car bombings leave at least nine people dead, and thirty others in agony."
5692,30/10/2006,Iraq,Kirkuk,3,19,22,"A Fedayeen suicide bomber blows himself up in a Kurdish police station, killing three people, including a 3-year-old girl."
5693,30/10/2006,India,Chadol,1,1,2,Two students are abducted by the Mujahideen.  One is murdered in captivity.
5694,31/10/2006,Iraq,Baghdad,23,19,42,A suicidal Sunni bomber takes out two-dozen innocents at a Shia wedding.  The dead included nine children.
5695,31/10/2006,Iraq,Suwayra,8,0,8,Eight victims of sectarian hatred within the Religion of Peace are found in two locations.
5696,31/10/2006,Iraq,Baqubah,10,3,13,"Shiite fundamentalists kill ten people, including two shop owners."
5697,31/10/2006,Iraq,Baghdad,4,13,17,Two Jihadi car bombings leave four dead.
5698,31/10/2006,Afghanistan,Ghazni,1,2,3,A policeman is killed by a suicide bomber.
5699,31/10/2006,Afghanistan,Nuristan,3,1,4,Three NATO soldiers on patrol are killed in a roadside attack by religious extremists.
5700,31/10/2006,Chad,Amtiman,128,0,128,"One-hundred and twenty-eight black Africans are massacred by Arab extremists in a racial attack.  Homes, warehouses and shops are set ablaze in the village."
5701,31/10/2006,Pakistan,Azad Kashmir,1,0,1,A Christian missionary is shot to death by Islamic radicals.
5702,1/11/2006,England,Blackburn,5,0,5,A conservative Muslim man burns his family to death in a fire over concerns that they were becoming too Westernized.
5703,1/11/2006,Iraq,Mosul,9,0,9,"Islamic terrorists kill nine people, one of whom was burned."
5704,1/11/2006,Iraq,Baghdad,12,24,36,Four Jihad bombings leave at least a dozen people dead.
5705,1/11/2006,Iraq,Baghdad,35,0,35,"Thirty-five victims of sectarian hatred within the Religion of Peace are found in several locations, tortured and executed."
5706,1/11/2006,Thailand,Pattani,1,0,1,Muslim militants murder a postman.
5707,1/11/2006,India,Lancha,1,0,1,The Mujahideen kill a former member who renounced violence.
5708,1/11/2006,Pakistan,Bajaur,1,0,1,The Taliban abduct and murder a tribesman.
5709,2/11/2006,Iraq,Udhaim,7,0,7,Two separate Jihad attacks on fuel trucks leave seven innocents dead.
5710,2/11/2006,Iraq,Mahmudiya,5,4,9,"A car-bomb kills one man, and four others are found blindfolded and executed in a separate attack by Jihadis."
5711,2/11/2006,India,Drug Teng,1,0,1,The Mujahideen abduct a man from his home and hang him.
5712,2/11/2006,India,Baramulla,1,0,1,A civilian is murdered by Islamists at a hospital.
5713,2/11/2006,India,Srinagar,1,2,3,A cop is gunned down by Jihadis.
5714,2/11/2006,Iraq,Baghdad,7,45,52,"Sunnis car-bomb a Shia marketplace, killing at least seven people and leaving dozens more in agony."
5715,2/11/2006,Iraq,Baghdad,3,0,3,"Sunni gunmen murder a university professor, his wife and son in a shooting attack."
5716,2/11/2006,Afghanistan,Adraskan,6,3,9,Religious extremists murder six Afghan policemen in a highway attack.
5717,2/11/2006,Algeria,Tachebenk,8,0,8,Eight Algerian soldiers are massacred in an ambush by Islamic fundamentalists.
5718,3/11/2006,Pakistan,Makeen,1,0,1,Islamic extremists behead a cleric and pin a note to the body.
5719,3/11/2006,India,Anantnag,1,0,1,The Mujahideen kill a man at a wedding.
5720,3/11/2006,Afghanistan,Khost,2,1,3,Two Pakistani truck drivers are shot to death by the Taliban.
5721,3/11/2006,Thailand,Yala,1,1,2,A 43-year-old Buddhist man is gunned down by radical Muslims as he is traveling with his wife.
5722,3/11/2006,Thailand,Yala,1,0,1,A Buddhist woman is shot to death by Muslim radicals at a health clinic.
5723,3/11/2006,Thailand,Yala,1,0,1,Muslim gunmen murder a 25-year-old man at a school.
5724,3/11/2006,Philippines,Mindanao,3,5,8,"MILF terrorists open fire on a group of civilians, killing three."
5725,3/11/2006,Pakistan,Quetta,2,5,7,"A suicide bomber drives his truck into a police headquarters, killing two officers."
5726,3/11/2006,Chechnya,Grozny,1,3,4,"The Mujahideen bomb a bridge, killing one person and injuring three others."
5727,3/11/2006,Iraq,Baghdad,6,6,12,Three family members are among six people killed in two attacks by Muslim terrorists.
5728,3/11/2006,Iraq,Baghdad,58,0,58,"Fifty-seven bodies and a severed head are found in the capital, all victims of sectarian hatred within the Religion of Peace."
5729,3/11/2006,Iraq,Madaen,4,0,4,Jihadis blow up four civilians traveling in a car.
5730,4/11/2006,Thailand,Narathiwat,1,0,1,Islamic terrorists shoot a man to death at a fish shop.
5731,4/11/2006,Thailand,Narathiwat,1,0,1,A 41-year-old man is gunned down by Islamists in front of his garage.
5732,4/11/2006,Chad,Bandikao,56,41,97,Arab militias massacre over fifty Africans in a sustained attack on their village.
5733,4/11/2006,Iraq,Baghdad,4,2,6,"In a brutal attack, Islamic gunmen approach a car and machine-gun four children sitting to death inside it."
5734,4/11/2006,Pakistan,Inzar,1,0,1,A pro-government tribal elder is killed by the Taliban.
5735,4/11/2006,Thailand,Songkhla,1,0,1,A Buddhist rubber trader is shot to death by Muslim radicals.
5736,4/11/2006,Iraq,Udhaim,5,2,7,A Sunni assassination attempt kills five presidential bodyguards with a roadside bomb.
5737,4/11/2006,Iraq,Baghdad,4,5,9,Two separate attacks by sectarian rivals leave four people dead.
5738,4/11/2006,Iraq,Mosul,5,0,5,Five people are murdered by Islamic terrorists in a series of shooting attacks.
5739,4/11/2006,Somalia,Baidoa,2,4,6,"Islamic militants attack a transport, killing two Somali troops."
5740,4/11/2006,Iraq,Baghdad,27,0,27,Twenty-seven victims of sectarian hatred within the Religion of Peace are found bound and executed.
5741,4/11/2006,Iraq,Latifiya,2,3,5,Islamic gunmen murder a mother and her child.
5742,4/11/2006,Thailand,Pattani,1,0,1,A government official is murdered by Islamists.
5743,5/11/2006,Thailand,Yala,2,3,5,"Thai Islamists bomb a military truck, killing two soldiers."
5744,5/11/2006,India,Sunervani,1,3,4,An 8-year-old boy is blown apart in a Mujahideen bombing.
5745,5/11/2006,Iraq,Adamiya,2,4,6,Terrorists kill two people in a mortar attack on a residential neighborhood.
5746,5/11/2006,Thailand,Pattani,1,0,1,Muslims kill a 44-year-old civilian.
5747,5/11/2006,Thailand,Yala,2,0,2,A 61-year-old Buddhist man and his daughter are gunned down by militant Muslims.
5748,5/11/2006,Thailand,Narathiwat,1,0,1,A 55-year-old villager is murdered by Islamic gunmen.
5749,5/11/2006,Thailand,Pattani,1,0,1,A 56-year-old Buddhist man is shot to death by Muslim extremists.
5750,5/11/2006,India,Manglogi,4,0,4,"Three women and a man, all members of the same family, are slaughtered by Islamic militants angry that the family would not let their teenage daughter marry a terrorist."
5751,6/11/2006,India,Nalwa Nullah,1,0,1,The Mujahideen shoot a civilian to death as he is returning home.
5752,6/11/2006,Chechnya,Grozny,1,3,4,Jihad warriors kill a policeman with a landmine.
5753,6/11/2006,Ingushetia,Ordzhonikidze,1,0,1,"A woman is shot to death in front of her son, in her home, by radical Muslims angry at her religious practices."
5754,7/11/2006,Chad,Koloy,6,8,14,"Arab militias attack an African village, killing at least six innocents."
5755,7/11/2006,Thailand,Narathiwat,1,0,1,A 36-year-old janitor is murdered by Islamic gunmen as he is on his way to work.
5756,7/11/2006,Thailand,Pattani,1,0,1,Muslims shoot a Buddhist civilian to death.
5757,7/11/2006,Thailand,Yala,1,0,1,A Buddhist teacher is murdered by Islamists as he is riding his motorcycle.
5758,7/11/2006,Thailand,Narathiwat,1,0,1,A 42-year-old man is gunned down by Muslim radicals.
5759,7/11/2006,Iraq,Baghdad,10,0,10,Ten victims of sectarian hatred within the Religion of Peace are found shot to death over a 24-hour period.
5760,7/11/2006,Iraq,Mahmudiya,2,0,2,"Islamic terrorists kill two people, one of who is beheaded."
5761,7/11/2006,Iraq,Fallujah,3,8,11,Students are among the casualties as Jihadis end the lives of three civilians with a bombing.
5762,7/11/2006,Thailand,Pattani,1,0,1,A teacher is murdered by Islamic extremists as he is traveling home.
5763,7/11/2006,Thailand,Pattani,2,0,2,A man and wife are gunned down by Islamic radicals.
5764,7/11/2006,Chechnya,Tai,7,1,8,Islamic terrorists kill seven Russian policemen in a brutal ambush in a remote area.
5765,7/11/2006,Iraq,Suwayra,15,0,15,Fifteen people are murdered by their sectarian rivals and dumped in a river.
5766,7/11/2006,Iraq,Adhamiya,5,26,31,Five residents are killed when Islamic terrorists send mortar rounds into a neighborhood.
5767,7/11/2006,Iraq,Baghdad,21,25,46,A Fedayeen suicide bomber sends twenty-one innocent cafe patrons to Allah
5768,7/11/2006,India,Sarmarg,1,0,1,A man is killed in his home by Islamic radicals.
5769,8/11/2006,Sudan,Abu Jira,5,0,5,The Janjaweed massacre another five villagers.
5770,8/11/2006,Afghanistan,Zabul,2,5,7,Two Afghan police are killed in an ambush by Taliban extremists.
5771,8/11/2006,Iraq,Baghdad,8,24,32,"Sunnis rain down bombs on a soccer field, killing eight youths playing a game."
5772,8/11/2006,Pakistan,Dargai,42,20,62,"A suicide bomber, wrapped in a prayer shawl, runs into the midst of Pakistani soldiers exercising in an area and slaughters dozens."
5773,8/11/2006,Iraq,Mosul,6,0,6,Six people are gunned down by sectarian rivals.
5774,8/11/2006,Iraq,Muqdadiya,8,6,14,Jihadis kill four people with a marketplace car-bombing and gun down four members of a family in a separate attack.
5775,8/11/2006,Iraq,Mahmudiya,6,25,31,"Islamic terrorists car-bomb a market, killing six innocents."
5776,8/11/2006,Iraq,Baghdad,10,21,31,"Sunnis send mortars into two Shiite neighborhoods and a government building, killing ten people."
5777,8/11/2006,India,Warpora,1,0,1,A 50-year-old woman is shot to death by the Mujahideen.
5778,9/11/2006,Thailand,Yala,0,13,13,Thirteen people are injured when Thai Islamists bomb eight car showrooms.
5779,9/11/2006,Thailand,Pattani,1,0,1,A Buddhist civilian is gunned down by Muslim militants in front of a school.
5780,9/11/2006,Iraq,Baghdad,18,93,111,Eighteen people are killed in five terrorist bombings.
5781,9/11/2006,Iraq,Baghdad,26,0,26,Twenty-six victims of sectarian hatred within the Religion of Peace are found murdered in the city.
5782,9/11/2006,Thailand,Pattani,1,1,2,Two men are shot at by Islamists while helping to build a house.  One dies of wounds suffered.
5783,9/11/2006,Thailand,Pattani,1,0,1,A groundskeeper is murdered by militant Muslim gunmen while cutting grass.
5784,9/11/2006,Iraq,Latifiya,18,0,18,Eighteen victims of sectarian hatred within the Religion of Peace are found in the Sunni triangle outside the capital.
5785,9/11/2006,Iraq,Tal Afar,4,8,12,Jihadis kill four Iraqis in a roadside attack.
5786,9/11/2006,India,Qazigund,1,0,1,"A woman is murdered by the Mujahideen, who dump her body in a field."
5787,9/11/2006,India,Thannamandi,1,1,2,"The Mujahideen assassinate an off-duty soldier, and injure a neighbor coming to his rescue."
5788,9/11/2006,Algeria,Bouira,11,13,24,Eleven Algerian soldiers are ambushed and killed by the Salafist Group for Preaching and Combat.
5789,10/11/2006,Algeria,T'Kout,1,0,1,Islamic fundamentalists behead a shepherd and place his head on a pole.
5790,10/11/2006,India,Rawuchh,1,0,1,"Two days after a Mujahideen ambush, a civilian is succumbs to injuries."
5791,10/11/2006,India,Pulwama,6,50,56,"Six people, including four girls, are killed by the shrapnel of a grenade thrown by Muslim militants."
5792,10/11/2006,Iraq,Tal Afar,5,17,22,Five people are killed by a Fedayeen suicide car-bomber.
5793,10/11/2006,Iraq,Yusufiya,14,0,14,Fourteen people sleeping in their home are kidnapped by Muslim terrorists and murdered.
5794,10/11/2006,Iraq,Mosul,1,0,1,"A woman is kidnapped, tortured and executed by Islamic militants."
5795,10/11/2006,Pakistan,Shakai,4,2,6,"al-Qaeda backed militants four people, including a pro-government tribal leader, in a bombing attack on their vehicle."
5796,11/11/2006,Sudan,Western Darfur,11,8,19,"Sudanese government troops raid a village, killing eleven civilians, including a woman burned to death in her house."
5797,11/11/2006,Iraq,Baghdad,10,0,10,Terrorists kill ten people on a bus and kidnap fifty more.
5798,11/11/2006,Iraq,Baghdad,5,0,5,"A woman is among five people kidnapped, tortured and murdered by Islamic terrorists."
5799,11/11/2006,Iraq,Zaghinya,2,0,2,"A Fedayeen suicide bomber blows two innocent people to bits, including a woman."
5800,11/11/2006,Iraq,Baghdad,10,38,48,Eight people are killed when Sunnis car-bomb a shopping district.  Two foreign journalists are killed in a separate attack.
5801,11/11/2006,Thailand,Pattani,1,0,1,A 48-year-old farmer is murdered by Islamists as he is walking home.
5802,11/11/2006,Thailand,Yala,2,0,2,Islamists gun down two police officers and take their guns.
5803,11/11/2006,Sudan,Sirba,31,40,71,"Arab militia fighters on horseback attack a refugee camp, killing over thirty displaced persons."
5804,11/11/2006,Iraq,Tal Afar,6,10,16,"A suicide bomber drives a car into an Iraqi police checkpoint, killing six officers."
5805,12/11/2006,Iraq,Baghdad,3,15,18,Three children are killed when Sunni terrorists car-bomb a school.
5806,12/11/2006,Sudan,Madu,6,0,6,"Six people are killed by Islamic militias, including four children thought to have been burned alive."
5807,12/11/2006,Iraq,Baghdad,25,0,25,Twenty-five victims of Islamic sectarian violence are found bound and executed.
5808,12/11/2006,Iraq,Baqubah,50,0,50,"Fifty bodies are found dumped behind a power company building, victims of sectarian hatred within the Religion of Peace."
5809,12/11/2006,Thailand,Narathiwat,1,1,2,A man is gunned down in a tea shop by Islamic terrorists.
5810,12/11/2006,Iraq,Baghdad,35,58,93,Two suicide bombers massacre thirty-five innocent people waiting in front a police recruiting station.
5811,12/11/2006,Iraq,Baghdad,4,0,4,Sunni gunmen storm a gas station and kill four employees.
5812,12/11/2006,Thailand,Narathiwat,1,1,2,"A man is murdered, and his wife critically injured, in an ambush by Muslim terrorists while shopping."
5813,13/11/2006,Iraq,Baghdad,5,0,5,Five oil company employees are shot to death.  One was a woman.
5814,13/11/2006,Iraq,Kirkuk,4,0,4,Four elementary school teachers are murdered in their vehicle by Islamic terrorists.
5815,13/11/2006,Iraq,Baghdad,46,0,46,"Forty-six victims of sectarian hatred within the Religion of Peace are found bound, tortured and executed."
5816,13/11/2006,Iraq,Yusufiya,5,0,5,"Five people are brutally killed by Muslim terrorists, including at least one that was beheaded."
5817,13/11/2006,Thailand,Narathiwat,1,0,1,A rubber tapper is murdered by Islamic extremists.
5818,13/11/2006,Thailand,Yala,1,0,1,Muslim militants machine-gun a 53-year-old man to death as he is sitting in his pickup truck.
5819,13/11/2006,Iraq,Baghdad,20,18,38,A suicidal Sunni murders twenty passengers in a minibus with an incendiary device strapped to his body.
5820,13/11/2006,Pakistan,Quetta,2,15,17,A 10-year-old girl is one of two people killed when a bicycle bomb goes off in a market.
5821,13/11/2006,India,Sofshali,1,0,1,The Mujahideen murder a man in his home.
5822,13/11/2006,India,Mehar,1,0,1,A civilian is abducted from his home and then beheaded by Muslim militants.
5823,14/11/2006,Iraq,Basra,4,1,5,Four British soldiers patrolling a waterway in a boat are blown apart in a terror attack.
5824,14/11/2006,Pakistan,Thari Mirwah,2,0,2,A man uses an axe to murder his daughter and their boyfriend after learning of 'un-Islamic' behavior between them.
5825,14/11/2006,India,Kashmir,0,40,40,Forty people are injured in two Hizb-ul Mujahideen car bombings.
5826,14/11/2006,Iraq,Mosul,11,0,11,Eleven people are murdered by sectarian rivals.
5827,14/11/2006,Iraq,Baghdad,10,25,35,"Sunnis car-bomb a market, killing at least ten innocents."
5828,14/11/2006,Iraq,Baqubah,10,0,10,Ten kidnap victims are found executed.
5829,14/11/2006,Iraq,Baghdad,7,27,34,A woman and child are among the Shias killed in a car bombing near a mosque.
5830,15/11/2006,Iraq,Baghdad,55,0,55,"Fifty-five victims, mostly of a sectarian kidnapping, are found bound, tortured and murdered."
5831,15/11/2006,Thailand,Yala,1,0,1,Islamists shoot a man to death as he is taking his children to school.
5832,15/11/2006,Israel,Sderot,1,2,3,A 57-year-old woman is killed in a Palestinian rocket attack on her neighborhood.  A survivor loses both legs.
5833,15/11/2006,Iraq,Latifiya,10,0,10,Ten bodies found are thought to be those of Shiites abducted by Sunnis a few days earlier.
5834,15/11/2006,Iraq,Mosul,6,0,6,"Gunmen murder six people, including a woman, in separate Jihad attacks."
5835,15/11/2006,Iraq,Baghdad,12,33,45,Muslim bombers blow apart a dozen people waiting in line at a fuel station.
5836,15/11/2006,Iraq,Baghdad,3,15,18,At least three people are killed when Islamic terrorists bomb a funeral.
5837,15/11/2006,Sudan,Deir Mazza,52,12,64,"Dozens of civilians, including women and children, are killed in an attack by Arab militias backed by the Islamic Republic of Sudan."
5838,16/11/2006,Iraq,Baghdad,9,2,11,Sunni fundamentalists murder nine workers at a bakery.
5839,16/11/2006,Pakistan,Bara,22,5,27,Twenty-two people are killed in sectarian violence between rival factions of the Religion of Peace.
5840,16/11/2006,Iraq,Baghdad,43,18,61,Thirty-five victims of sectarian hatred within the Religion of Peace are found.  Six separate bombings leave another eight dead.
5841,16/11/2006,Thailand,Narathiwat,1,0,1,A Buddhist woman who worked as a schoolteacher is brutally shot to death by Muslim militants.
5842,16/11/2006,Chad,Koloy,1,3,4,"Arab militias kill a ""Doctors without Borders"" volunteer."
5843,17/11/2006,Somalia,Mogadishu,1,3,4,"Islamists fire into a crowd of people protesting their ban on khat, killing a teenage boy."
5844,17/11/2006,Iraq,Kirkuk,3,1,4,A man and his baby daughter are among four people shot at by Islamic terrorists.
5845,17/11/2006,Iraq,Baghdad,20,0,20,Twenty people are killed in sectarian violence in at least three separate attacks.
5846,17/11/2006,Pakistan,Lahore,1,7,8,A bomb on a passenger van kills one and injures seven.
5847,17/11/2006,Thailand,Narathiwat,1,27,28,Twenty-seven people are injured when Islamists set off three bombs.  A flower seller is killed.
5848,17/11/2006,Thailand,Pattani,1,0,1,A Buddhist villager is murdered by Muslim terrorists while shopping at a market.
5849,17/11/2006,Thailand,Pattani,1,0,1,A Buddhist security guard is murdered by Islamic extremists.
5850,17/11/2006,Thailand,Yala,1,0,1,Islamists shoot a man off of his motorcycle.
5851,17/11/2006,Thailand,Yala,1,0,1,A Buddhist ice-cream seller is gunned down by Islamic terrorists.
5852,17/11/2006,Thailand,Yala,1,0,1,"An elderly Buddhist cattle-raiser is shot to death by Muslims, who then burn his body."
5853,18/11/2006,Iraq,Baghdad,36,3,39,"Thirty-six people are killed in at least three attacks by Muslim terrorists, including a man and his wife brutally gunned down."
5854,18/11/2006,Iraq,Ishaqi,7,0,7,Seven Shia are murdered by Sunni extremists.
5855,19/11/2006,Somalia,Bardaleh,6,20,26,Six Ethiopian soldiers are ambushed and killed by Islamists.
5856,19/11/2006,Thailand,Pattani,1,0,1,Muslims gun down a middle-aged Buddhist taxi driver standing in line for food.
5857,19/11/2006,Thailand,Yala,1,0,1,A 68-year-old Buddhist man is nearly decapitated by Muslim attackers.
5858,19/11/2006,Chechnya,Kurchaloi,3,0,3,Three occupants of a car are slaughtered by Jihad fighters.
5859,19/11/2006,Iraq,Baghdad,13,48,61,"Thirteen people are killed in two coordinated bombings, one at a bus stop."
5860,19/11/2006,Iraq,Hilla,22,44,66,"In a senseless attack on laborers looking for work, Sunni extremists massacre nearly two dozen in a suicide bombing."
5861,19/11/2006,Iraq,Baghdad,45,0,45,Forty-five victims of sectarian hatred within the Religion of Peace are found bound and executed around the city.
5862,19/11/2006,Thailand,Hat Yai,1,0,1,Islamists murder a civilian and dump his body in a ditch.
5863,19/11/2006,Thailand,Narathiwat,3,0,3,Islamists drive up to three men having tea and pound them with automatic weapons for 30 seconds.
5864,19/11/2006,India,Cheke Natnussa,2,0,2,A forest employee and a civilian are murdered in their home by the Mujahideen.
5865,19/11/2006,Iraq,Sadiya al-Jabal,8,2,10,"Eight laborers are machine-gunned to death at point blank range by Sunni ""freedom fighters."""
5866,19/11/2006,Iraq,Hawi Jah,3,0,3,Jihadis kill three children with explosives.
5867,19/11/2006,Pakistan,Razmak,1,0,1,Islamists murder a cleric and pin a note to his body.
5868,20/11/2006,Iraq,Tal Afar,3,0,3,A Fedayeen suicide bomber kills three other people.
5869,20/11/2006,Iraq,Taji,5,0,5,"Extremists kidnap five men from a restaurant, torture and murder them."
5870,20/11/2006,Iraq,Dujayl,7,0,7,Seven men are kidnapped and brutally killed by Muslim terrorists.
5871,20/11/2006,Thailand,Sungai Kolok,2,16,18,"Muslim terrorists detonate a bomb at a market, killing two people."
5872,20/11/2006,Iraq,Baghdad,14,0,14,Fourteen victims of sectarian hatred within the Religion of Peace are found bound and executed.
5873,20/11/2006,Iraq,Mosul,3,4,7,Three people are killed by a suicide bomber.
5874,20/11/2006,Iraq,Ramadi,2,6,8,Two people are killed by a suicide bomber.
5875,20/11/2006,Iraq,Baghdad,2,0,2,A doctor and an actor are murdered by Islamic gunmen in separate attacks.
5876,20/11/2006,Iraq,Baghdad,3,5,8,Jihadis kill three people with a bomb at a market.
5877,21/11/2006,Lebanon,Beirut,1,0,1,A Christian leader is gunned down by Muslim terrorists supported by Syria.
5878,21/11/2006,Afghanistan,Helmand,2,0,2,"Religious extremists attack a police station, kidnap two officers, then kill them in captivity."
5879,21/11/2006,India,Awantipora,1,0,1,The Mujahideen abduct and hang a post-graduate student.
5880,21/11/2006,India,Mamoosa,1,0,1,A 50-year-old Christian convert is gunned down by members of his former religion.
5881,21/11/2006,Iraq,Baghdad,7,0,7,Seven students riding home in a minibus are slaughtered by Sunni extremists.
5882,21/11/2006,Iraq,Baghdad,35,19,54,Islamic terrorists kill thirty-five people in a series of attacks on civilians.
5883,21/11/2006,Iraq,Suwayrah,7,0,7,Muslim terrorists kill six people and dump their bodies in a river.
5884,21/11/2006,Iraq,Latifiyah,6,0,6,"Sunnis kidnap, torture and kill six Shiites."
5885,21/11/2006,Iraq,Baqubah,19,5,24,Five separate Jihad attacks against civilians leaves about twenty dead.
5886,21/11/2006,Afghanistan,Kandahar,1,0,1,A female legislator's husband is mowed down by the Taliban at a bakery.
5887,22/11/2006,Pakistan,Tando Masti,2,0,2,"An imam shoots his daughter to death, and a second family member murders another girl on suspicion of sexual activity with two males."
5888,22/11/2006,Israel,Sderot,1,0,1,An Israeli man is killed by Palestinians firing Qassam rockets into his town.
5889,22/11/2006,Iraq,Baghdad,52,0,52,Police report finding fifty-two victims of sectarian hatred with the Religion of Peace around the capital.
5890,22/11/2006,Iraq,Mosul,14,0,14,"Fourteen people, including three women, are murdered by Islamic terrorists."
5891,22/11/2006,Iraq,Iskandariya,7,1,8,Jihadis kill seven people with a bomb.
5892,22/11/2006,Thailand,Narathiwat,2,0,2,A husband and wife are pulled from their pickup truck and brutally killed by radical Muslims.  The woman's body is burned.
5893,23/11/2006,Iraq,Baghdad,9,3,12,Nine people are killed in a retaliatory Shia mortar attack for a massive bombing.
5894,23/11/2006,Iraq,Baghdad,202,217,419,Sunni terrorists murder over two-hundred innocents in five massive bombings spaced minutes apart.
5895,23/11/2006,Thailand,Narathiwat,1,0,1,Islamists gun down a rubber-tapper on his way to work.
5896,23/11/2006,Thailand,Pattani,1,0,1,A 40-year-old Buddhist teacher is shot to death by Muslim militants.
5897,23/11/2006,Thailand,Yala,1,0,1,Islamists murder a young man as he is sitting in his car.
5898,23/11/2006,Thailand,Pattani,1,0,1,A man is murdered near his home by Islamic gunmen.
5899,24/11/2006,Pakistan,Sharif Chachar,1,0,1,"A 15-year-old girl is hacked to death with an axe in an honor killing by her father, who suspected her of illicit relations."
5900,24/11/2006,Iraq,Baghdad,30,0,30,"Thirty bodies are found dumped over a 24-hour period, victims of sectarian hatred."
5901,24/11/2006,Iraq,Baghdad,25,14,39,Shia militia are responsible for twenty-five Sunni deaths.
5902,24/11/2006,Thailand,Pattani,1,0,1,A school administrator is shot and then burned to death by Muslim terrorists.
5903,24/11/2006,Thailand,Narithiwat,1,0,1,Islamists break into a man's home and kill him.
5904,24/11/2006,Iraq,Tal Afar,23,43,66,A double suicide attack near a car dealership leaves nearly two dozen people dead and many more in agony.
5905,24/11/2006,Afghanistan,Khost,2,1,3,"Taliban extremists attack a convoy of trucks, killing two Pakistani drivers."
5906,24/11/2006,Algeria,Biskra,5,0,5,Two civilians are among three people killed in an ambush by the Salafist Group for Preaching and Combat.
5907,24/11/2006,India,Rampur,8,2,10,Terrorists kill eight people in a shootout with security forces.
5908,25/11/2006,Iraq,Khaldiya,4,9,13,"Four people, including two Iraqi children, are killed by a suicide bomber."
5909,25/11/2006,Iraq,Diyala,21,0,21,Sunni extremists invade two homes and murder twenty-one men in front of their families.
5910,25/11/2006,Iraq,Baghdad,25,0,25,Twenty-five victims of sectarian hatred within the Religion of Peace are found executed around the city.
5911,25/11/2006,Thailand,Yala,1,2,3,"Muslims fire into a Buddhist-owned store, killing the owner and injuring two others."
5912,25/11/2006,Thailand,Yala,3,0,3,Three Buddhist pig hunters are shot and hacked to death by Muslim radicals.
5913,26/11/2006,Thailand,Pattani,1,1,2,A Buddhist rubber-tapper is murdered by radical Muslims.
5914,26/11/2006,Thailand,Narathiwat,1,0,1,A 24-year-old villager is shot to death by Islamic terrorists.
5915,26/11/2006,Thailand,Narathiwat,1,1,2,A 46-year-old Buddhist man is shot off the back of a motorcycle while riding with his wife.
5916,26/11/2006,Thailand,Yala,2,0,2,Islamic militants approach two police officers at a food market and shoot them at point-blank range.
5917,26/11/2006,Afghanistan,Paktika,15,25,40,A Fedayeen suicide bomber walks into a restaurant and slaughters fifteen innocents.
5918,26/11/2006,Iraq,Basra,4,0,4,"Four people, including a woman, are dragged from their car and brutally shot to death by Muslim gunmen."
5919,26/11/2006,Iraq,Haswa,5,23,28,"Jihadis car-bomb a crowded market, killing at least five innocents."
5920,26/11/2006,Iraq,Haqlaniya,11,0,11,"In a vicious attack, radical Muslims pull ten men and one boy out of a van and shoot them to death."
5921,26/11/2006,Iraq,Iskandiriya,8,28,36,Eight patrons at a market are blown apart by a Jihad car-bombing.
5922,26/11/2006,Iraq,Baqubah,25,0,25,"Terrorists kidnap and execute twenty-five people, including seven teenagers."
5923,27/11/2006,Pakistan,Kahero Golo,1,0,1,A young woman is shot to death by her brother in an 'honor killing.'
5924,27/11/2006,Iraq,Mosul,2,0,2,Sunnis shoot an off-duty policeman and his mother to death as they are heading to the man's wedding.
5925,27/11/2006,Iraq,Baghdad,44,0,44,Forty-four victims of sectarian hatred within the Religion of Peace are found in an around the city.
5926,27/11/2006,Iraq,Muqdidiya,5,25,30,"Muslim terrorists shoot a mobile telephone shop owner dead, then plant bombs to kill on-lookers."
5927,27/11/2006,Pakistan,Makeen,1,0,1,"A moderate cleric is assassinated by Taliban supporters, who pin a note to the body."
5928,27/11/2006,Chechnya,Gudermes,1,2,3,A Russian is killed by Jihad gunmen while traveling in a car.
5929,27/11/2006,Afghanistan,Kandahar,2,0,2,Two Canadian soldiers are killed on the road by a Fedayeen suicide bomber.
5930,28/11/2006,Thailand,Yala,2,0,2,A Buddhist husband and wife are murdered by Islamic gunmen as they return home.
5931,28/11/2006,Iraq,Kirkuk,1,12,13,A religious fanatic straps explosives to his body and kills at least one civilian.
5932,28/11/2006,Iraq,Baghdad,4,40,44,"Islamic terrorists bomb a hospital, killing four Iraqis."
5933,28/11/2006,Iraq,Baghdad,36,23,59,Thirty-six victims of sectarian violence are found as a Jihad mortar attack injures twenty-three others.
5934,28/11/2006,Afghanistan,Herat,1,1,2,A suicide bomber kills a policeman who is trying to stop him from hurting others.
5935,28/11/2006,Dagestan,Khasavyurt,1,0,1,An apostate is killed with a bomb.
5936,29/11/2006,Pakistan,Sukkur,4,0,4,A man kills his three daughters and a daughter in law on suspicion of adultery.
5937,29/11/2006,Iraq,Mosul,2,23,25,A suicide bomber kills a civilian.  Elsewhere a teacher is kidnapped and murdered.
5938,29/11/2006,Iraq,Samarra,6,4,10,Six Iraqi police are killed when Sunni extremists set off a car bomb.
5939,29/11/2006,Iraq,Baghdad,52,0,52,Fifty-two victims of sectarian hatred within the Religion of Peace are found in various locations.
5940,29/11/2006,Afghanistan,Kandahar,2,0,2,Two civilians are murdered by a Fedayeen suicide bomber.
5941,29/11/2006,Iraq,Baqubah,29,0,29,A mass grave containing the bodies of twenty-nine recent victims of Sunni-Shia violence unearthed.
5942,30/11/2006,Thailand,Pattani,0,1,1,A 75-year-old man is beaten in his home and set on fire by Muslim radicals.
5943,30/11/2006,Thailand,Narathiwat,1,0,1,A 44-year-old man is murdered by Islamic gunmen.
5944,30/11/2006,Thailand,Narathiwat,1,1,2,"Thai Islamists gun down a woman in a tea house, severely injuring her daughter as well."
5945,30/11/2006,Somalia,Baidoa,4,5,9,"A botched suicide bombing attempt leaves at least four people dead, not including the bombers."
5946,30/11/2006,Iraq,Samarra,6,4,10,A car bomb near a police station kills a half-dozen innocents.
5947,30/11/2006,Iraq,Baghdad,4,22,26,"Three Jihad bombings kill at least four people.  Elsewhere, a teacher is shot to death."
5948,1/12/2006,India,Mangalore,1,0,1,A Hindu leader is brutally assaulted by twelve Muslims with a sword as he is working in his office.
5949,1/12/2006,Iraq,Baquba,3,2,5,"Islamic gunmen open fire on a family vehicle, killing three members."
5950,1/12/2006,Iraq,Mosul,4,29,33,Two children are among four horribly killed by a Fedayeen suicide bomber.
5951,1/12/2006,Iraq,Kirkuk,2,4,6,Two civilians are killed by a Fedayeen suicide bomber.
5952,1/12/2006,Iraq,Baghdad,25,35,60,"Two car bombs, one at a market, leave five civilians dead and dozens more in agony.  Twenty bodies are also found."
5953,1/12/2006,Iraq,Rashidiya,4,3,7,"Jihadis mortar a residential neighborhood, killing four innocents."
5954,1/12/2006,Iraq,Mosul,14,0,14,Fourteen laborers are kidnapped by Islamic terrorists and executed in captivity.
5955,2/12/2006,Thailand,Narathiwat,2,0,2,"Muslim terrorists fire into a grocery store, killing the owner and an elderly female customer."
5956,2/12/2006,Thailand,Yala,1,1,2,A 34-year-old truck driver is murdered by Islamic gunmen as he is traveling with his wife.
5957,2/12/2006,Thailand,Pattani,1,0,1,A 60-year-old food vendor is murdered by a Muslim posing as a customer.
5958,2/12/2006,Pakistan,Nushki,1,0,1,"A young boy is killed in a bomb blast, believed set by Taliban-backed militants."
5959,2/12/2006,Iraq,Baghdad,44,0,44,Forty-four bullet-riddled victims of sectarian hatred within the Religion of Peace are found.
5960,2/12/2006,Iraq,Baghdad,51,90,141,Sunnis blow over fifty fellow Muslims to Allah in a triple marketplace bombing that leaves blood and body parts scattered.
5961,2/12/2006,Pakistan,Naushki,1,1,2,Taliban-backed militants thought responsible for a bombing in a remote area.
5962,2/12/2006,Iraq,Baghdad,2,6,8,Two family members are killed when Jihadis fire a rocket at their home.
5963,2/12/2006,Iraq,Khalis,2,3,5,"Sunni radicals attack a funeral procession, killing two Shias."
5964,2/12/2006,Pakistan,Bara Qadim,4,2,6,Four tribal leaders are killed when their car is attacked over a religious dispute.
5965,2/12/2006,Pakistan,Peshawar,1,0,1,A bicycle bomb kills a passerby outside the U.S. consulate.
5966,3/12/2006,Iraq,Mosul,1,0,1,A 69-year-old Christian church leader is kidnapped and murdered by Islamic extremists.
5967,3/12/2006,Iraq,Baghdad,50,0,50,Fifty victims of sectarian hatred within the Religion of Peace are found bound and executed in various locations.
5968,3/12/2006,Thailand,Narathiwat,1,0,1,A 35-year-old rubber-tapper is murdered by radical Islamic gunmen while working at his plantation.
5969,3/12/2006,Afghanistan,Kandahar,8,19,27,"Three civilians are killed in a suicide attack, and several more in other shootings across the city."
5970,3/12/2006,Thailand,Yala,2,0,2,Two men are casually murdered by Muslim gunmen while drinking tea in a shop.
5971,3/12/2006,Iraq,Latifiya,3,2,5,"Sunni gunmen open up on a family car, killing three people."
5972,3/12/2006,Iraq,Kirkuk,3,2,5,A Fedayeen suicide car bomber kills two and injures three.
5973,3/12/2006,Iraq,Mosul,8,4,12,"Two people are killed in a suicide bombing, and six others from gunshot wounds by Islamic terrorists."
5974,3/12/2006,Iraq,Baghdad,3,15,18,Jihadis kill three civilians with a car-bomb near a bakery.
5975,3/12/2006,Pakistan,Bannu,1,1,2,An Uzbeki suicide bomber takes out a policeman (and himself).
5976,3/12/2006,India,Baramulla,1,0,1,A civilian is gunned down by the Mujahideen.
5977,4/12/2006,Israel,Kafr Qassem,1,0,1,A Muslim woman is shot by a 70-year-old relative in an 'honor killing.'
5978,4/12/2006,India,Sopore,1,0,1,A 20-year-old man is gunned down by the Mujahideen.
5979,4/12/2006,Thailand,Yala,2,0,2,A father is killed in his vehicle in an Islamist attack.  His 3-year-old daughter clings to life for a few hours before dying as well.
5980,4/12/2006,Thailand,Narathiwat,1,0,1,Muslim radicals murder a woman as she is leaving a market.
5981,4/12/2006,Thailand,Pattani,2,0,2,"Two men, including a 51-year-old rubber tapper are shot to death in separate attacks."
5982,4/12/2006,Iraq,Baqubah,4,0,4,Four engineers are brutally gunned down by Islamic terrorists.
5983,4/12/2006,Iraq,Mosul,11,5,16,Seven civilians are among eleven killed in two separate Jihad attacks.
5984,4/12/2006,Iraq,Baghdad,52,0,52,Fifty-two victims of sectarian hatred within the Religion of Peace are found executed over 24 hours.
5985,5/12/2006,Thailand,Yala,2,18,20,Muslims kill two Buddhist men with a bomb at a vegetable market.
5986,5/12/2006,Iraq,Baghdad,8,23,31,Three separate Jihad bombings leave eight dead.  One was at a hospital.
5987,5/12/2006,Iraq,Baghdad,14,4,18,Sunnis stop a bus carrying Shias and gun down fourteen in cold blood.
5988,5/12/2006,Iraq,Baghdad,16,25,41,Sixteen people are killed and dozens of others horribly burned when Sunni terrorists bomb a petrol station.
5989,5/12/2006,India,Varmul,1,15,16,A boy is killed when Muslim militants toss a grenade into the street.
5990,5/12/2006,Thailand,Narathiwat,2,0,2,A 13-year-old boy is among two people brutally shot to death by Muslim militants.
5991,6/12/2006,Thailand,Narathiwat,1,0,1,A shopkeeper is murdered by Islamic terrorists posing as customers.
5992,6/12/2006,Thailand,Pattani,2,0,2,Two cops are gunned down by Muslim radicals.
5993,6/12/2006,Thailand,Yala,2,1,3,"Islamists open fire on a group of Buddhist civilians in front of a school, killing two."
5994,6/12/2006,Thailand,Yala,1,2,3,A Thai soldier is killed by a remote control device.
5995,6/12/2006,Afghanistan,Kandahar,7,3,10,Another suicide bombing takes the lives of seven people.
5996,6/12/2006,Iraq,Baghdad,10,54,64,"Jihadis mortar a market, killing at least ten shoppers."
5997,6/12/2006,Thailand,Yala,1,0,1,A Buddhist man is gunned down by Muslim radicals.
5998,6/12/2006,India,Srinagar,0,15,15,Islamic militants injure fifteen people with a grenade attack on a city street.
5999,6/12/2006,Iraq,Baghdad,13,70,83,A suicide bombing on a minibus and a separate rocket attack leave thirteen civilians dead.
6000,6/12/2006,Iraq,Mahmudiya,3,0,3,"Three people are kidnapped, blindfolded and executed by Muslim rivals."
6001,6/12/2006,Iraq,Khalis,1,8,9,"Islamic gunmen attack a bus carrying farm workers, killing one."
6002,6/12/2006,Iraq,Iskandariya,4,12,16,"A Fedayeen suicide bomber blows himself up in a shop, killing the owner and three other innocents."
6003,6/12/2006,Afghanistan,Herat,1,1,2,"Taliban extremists open fire on a car, killing one occupant."
6004,7/12/2006,Afghanistan,Kandahar,2,7,9,Two civilians are killed by a Fedayeen suicide bomber.
6005,7/12/2006,Saudi Arabia,Jeddah,2,0,2,Two prison guards are killed in a shooting attack by Islamic extremists.
6006,7/12/2006,Thailand,Yala,3,0,3,A family of three is murdered in cold blood by Islamists.  The victims include a 1-year-old child.
6007,7/12/2006,India,Brinti Batpora,1,0,1,The Mujahideen murder a civilian in his home.
6008,7/12/2006,Jordan,Amman,2,0,2,"A young couple in their early 20's is shot to death by the girl's father, who suspected them of having sex."
6009,8/12/2006,India,Zachaldara,1,0,1,Muslim terrorists murder a dentist.
6010,8/12/2006,Iraq,Baghdad,23,11,34,Scattered shootings and a bombing leave about two dozen Iraqis dead at the hands of Islamic terrorists.
6011,8/12/2006,Afghanistan,Kunar,5,0,5,"Religious extremists murder a grandmother, mother and two daughters, along with a grandson, in an invasion on their home."
6012,9/12/2006,Sudan,al-Fashir,2,8,10,Militant Muslims shoot a shop owner and one other civilian to death.
6013,9/12/2006,Afghanistan,Paktia,6,0,6,Six Afghans are killed by a Taliban bomb.
6014,9/12/2006,Iraq,Kirkuk,1,0,1,A hairdresser is gunned down by religious fundamentalists.
6015,9/12/2006,Iraq,Baghdad,43,0,43,"Forty-three bodies, at least three of which were missing heads, are found in Baghdad, victims of sectarian hatred."
6016,9/12/2006,Thailand,Narathiwat,1,0,1,A 37-year-old civilian is gunned down by Muslim radicals.
6017,9/12/2006,Iraq,Karbala,8,36,44,A suicidal Sunni murders eight Shia civilians with a bomb near a mosque.
6018,9/12/2006,Afghanistan,Muradabad,2,0,2,The Taliban kill two translators in a mine attack.
6019,9/12/2006,Sudan,Sirba,22,10,32,"Arab militias attack a bus, killing twenty-two African civilians."
6020,10/12/2006,Iraq,Baghdad,4,0,4,A man and his three sons are brutally murdered in their home by the Religion of Peace.
6021,10/12/2006,Iraq,Baghdad,5,0,5,Five Shiite brothers are murdered in their home by Sunni gunmen.
6022,10/12/2006,Iraq,Baghdad,17,0,17,Seventeen victims of sectarian hatred within the Religion of Peace are found executed.
6023,10/12/2006,Iraq,Kirkuk,1,0,1,Fundamentalists murder a 15-year-old worker at a bakery.
6024,10/12/2006,Iraq,Baghdad,2,6,8,Two children are killed in an attack on a family vehicle by Islamic terrorists.
6025,10/12/2006,Thailand,Yala,2,0,2,Two rubber workers are murdered on the job by Islamic gunmen.
6026,10/12/2006,Thailand,Pattani,1,1,2,A woman is gunned down by the Religion of Peace in a shooting attack that leaves her husband injured.
6027,10/12/2006,Pakistan,Punjabi Dob,1,1,2,Taliban-backed separatists kill a man and injure his mother in a mine attack.
6028,10/12/2006,Pakistan,Tirah,4,0,4,Four people are killed in sectarian violence with the Religion of Peace.
6029,10/12/2006,Algeria,Algiers,1,8,9,"Islamic fundamentalists stage an ambush on a convoy of foreign civilians, killing the driver."
6030,10/12/2006,Thailand,Pattani,2,0,2,A 28-year-old rubber-tapper and his father are murdered by Islamists.
6031,10/12/2006,Somalia,Baidoa,20,0,20,About twenty people are killed when Islamists attack a government-held town.
6032,11/12/2006,Pal. Auth.,Gaza,3,1,4,Three young children are killed by Hamas gunmen.  (Hamas means 'Islamic Resistance').
6033,11/12/2006,Turkey,Bursa,1,0,1,A 23-year-old woman is stabbed 27 times by her father in an 'honor killing.'
6034,11/12/2006,Iraq,Baghdad,10,18,28,Four Jihad bombings leave at least ten people dead.
6035,11/12/2006,Iraq,Tuz Khurmato,6,1,7,"Sectarian extremists storm a house, killing six members of the same family."
6036,11/12/2006,Iraq,Mosul,4,0,4,Terrorists massacre four brothers sitting in their car.
6037,11/12/2006,Sudan,Hashaaba,8,0,8,"Eight civilians, including a mother and her five young children, are killed in a government air strike on their village."
6038,11/12/2006,Iraq,Baghdad,46,0,46,Forty-six victims of sectarian violence within the Religion of Peace are found blindfolded and executed.
6039,12/12/2006,Afghanistan,Khost,1,1,2,A 13-year-old girl is killed after Muslim militants open fire on security forces.
6040,12/12/2006,Afghanistan,Lashkar Gah,8,8,16,A suicide bomber on foot sends eight innocents to Allah.
6041,12/12/2006,Thailand,Pattani,1,1,2,Islamists open fire on a teacher and a medical doctor.
6042,12/12/2006,Iraq,Baghdad,71,236,307,"Freedom fighters slaughter dozens of day laborers looking for work by first luring them with promises of jobs, then setting off coordinated suicide car bombs."
6043,12/12/2006,Iraq,Mosul,4,0,4,An elderly woman is among four people murdered by Islamic gunmen.
6044,12/12/2006,Iraq,Riyadh,3,2,5,Jihadis murder a mother and her two children in an attack on their house.
6045,12/12/2006,Iraq,Kirkuk,5,15,20,A Fedayeen suicide bomber ends the lives of five other people.
6046,12/12/2006,Iraq,Baghdad,47,0,47,Forty-seven victims of sectarian violence within the Religion of Peace are found bound and executed.
6047,13/12/2006,Thailand,Yala,1,0,1,A 69-year-old Buddhist man is killed in his home by Muslim radicals.
6048,13/12/2006,Thailand,Yala,1,0,1,A 55-year-old Buddhist man is gunned down by Muslim radicals.
6049,13/12/2006,Pal. Auth.,Gaza,1,0,1,Palestinian gunmen force a judge to his knees on the sidewalk and shoot him in the head.
6050,13/12/2006,Iraq,Baghdad,11,27,38,"Jihad bombers attack a crowded bus stop, packed with Shia laborers, women and children, killing at least eleven."
6051,13/12/2006,Thailand,Yala,2,1,3,Radical Muslims storm an office and shoot two Buddhist engineers to death.
6052,13/12/2006,Iraq,Riyadh,17,15,32,A Jihad attack on a checkpoint leaves seven Iraqi soldiers dead.  Ten other bodies are found elsewhere.
6053,13/12/2006,Iraq,al-Hesna,9,0,9,"Sunnis enter a family home and slaughter four men, two women and three children."
6054,13/12/2006,Iraq,Baghdad,5,10,15,Five people are killed in a residential district by Jihad car bombs.
6055,14/12/2006,Afghanistan,Qalat,4,25,29,A suicide bomber kills four civilians on a crowded street and injures two dozen more.
6056,14/12/2006,Iraq,Baghdad,47,7,54,"Forty-five victims of sectarian hatred within the Religion of Peace are found dead, in addition to a car bombing.  Some were decapitated."
6057,14/12/2006,India,Mamoosa,1,0,1,"A convert to Christianity, and father of four, is gunned down in broad daylight by Islamic radicals."
6058,14/12/2006,Iraq,Mahaweel,2,6,8,Two people are killed by a Jihad car bombing.
6059,14/12/2006,Iraq,al-Lij,2,0,2,Two people are tortured and shot to death by religious rivals.
6060,15/12/2006,India,Chandiyal,1,0,1,Two al-Badr militants kidnap a young girl from her house and then execute her as a rescue attempt is made.
6061,15/12/2006,Iraq,Mosul,18,0,18,Eighteen people are killed over a 24 hour period by Muslim gunmen.
6062,15/12/2006,Afghanistan,Paktia,1,5,6,An Afghan soldier is killed when a suicide bomber rams his car into a convoy.
6063,16/12/2006,India,Pateli Daraj,2,0,2,A young girl is among two people killed their home by the Mujahideen.
6064,16/12/2006,Iraq,Iskandiriyah,2,1,3,A 4-year-old girl is among two people killed by Religion of Peace terrorists.
6065,16/12/2006,Iraq,Baghdad,53,0,53,"Muslim terrorists dump 53 bodies in at least two locations, victims of sectarian violence."
6066,17/12/2006,India,Tenkasi,1,0,1,A Hindu leader is hacked to death by a Muslim gang.
6067,17/12/2006,Iraq,Rutba,5,0,5,Islamic militants torture and shoot five people to death.
6068,17/12/2006,Chad,Aradib,15,0,15,"Fifteen civilians are killed by Arab militias, including a man who was disemboweled and a woman set on fire."
6069,18/12/2006,Iraq,Baghdad,1,2,3,Islamic militants murder a woman at an education ministry building.
6070,18/12/2006,Iraq,Saidiya,5,19,24,"Jihadis bomb a vegetable market, killing five civilians."
6071,18/12/2006,Afghanistan,Bazar Talukan,26,0,26,The Taliban murder twenty-six young men and hang their headless bodies from trees.
6072,18/12/2006,Iraq,Baghdad,44,0,44,Forty-four victims of sectarian violence within the Religion of Peace are found over 24 hours.
6073,18/12/2006,Iraq,Diyala,4,0,4,Four tribal leaders are abducted and executed.
6074,19/12/2006,Iraq,Baqubah,12,0,12,Two women are among a dozen people murdered by Islamic terrorists.
6075,19/12/2006,Iraq,Baghdad,53,0,53,Fifty-three victims of sectarian hatred within the Religion of Peace are found murdered over a 24 hour period.
6076,19/12/2006,Thailand,Narathiwat,1,0,1,Islamists murder a 27-year-old civilian.
6077,19/12/2006,Thailand,Pattani,1,0,1,A 33-year-old Buddhist man is shot and set on fire by Muslim radicals in front of his home.
6078,20/12/2006,Iraq,Baghdad,7,8,15,A university professor and his family are among seven people senselessly murdered by Muslim terrorists.
6079,20/12/2006,Iraq,Mosul,11,0,11,Eleven people are murdered by Islamic terrorists.
6080,20/12/2006,Iraq,Baghdad,11,31,42,A Fedayeen suicide bomber punches his ticket to paradise on the souls of eleven innocents.
6081,20/12/2006,Iraq,Baghdad,73,0,73,Seventy-three victims of sectarian hatred within the Religion of Peace are found over 24 hours.
6082,20/12/2006,Thailand,Yala,1,0,1,Islamists brutally murder a 69-year-old Buddhist man in his home.
6083,20/12/2006,Thailand,Yala,1,0,1,A 55-year-old Buddhist rubber-tapper is senselessly gunned down by Islamic gunmen.
6084,21/12/2006,Thailand,Pattani,1,1,2,A female Buddhist teacher is gunned down by Muslim militants.
6085,21/12/2006,Afghanistan,Herat,4,6,10,Four civilians are killed when the Taliban bomb a bridge.
6086,21/12/2006,Afghanistan,Khost,3,2,5,Religious extremists kill three Afghan police officers with a bomb.
6087,21/12/2006,Iraq,Baghdad,15,15,30,At least fifteen Iraqis are killed when a Fedayeen suicide bomber attack an academy.
6088,21/12/2006,Iraq,Baghdad,2,2,4,A suicide bomber murders two civilians.
6089,21/12/2006,Iraq,Kirkuk,2,0,2,A man and his wife are brutally gunned down by Muslim militants.
6090,22/12/2006,Afghanistan,Kabul,1,7,8,An attempted suicide attack on a lawmaker kills a bystander.
6091,22/12/2006,India,Sopore,2,5,7,Two civilians are killed when the Mujahideen attack a convoy.
6092,22/12/2006,Afghanistan,Tirin Kot,5,0,5,Five policemen are murdered in an attack by Taliban extremists.
6093,22/12/2006,Bangladesh,Binnakuri,1,0,1,A man is murdered by the Jama'atul Mujahideen.
6094,22/12/2006,India,Ajas,1,0,1,Lashkar-e-Toiba terrorists gun down a civilian.
6095,22/12/2006,Thailand,Pattani,1,0,1,"A 54-year-old Buddhist man is shot to death by Muslim militants, who then set his body on fire."
6096,22/12/2006,Pakistan,North Waziristan,1,5,6,"Pro-Taliban militants open fire on a van, killing one and injuring five."
6097,22/12/2006,Iraq,Samarrah,2,4,6,"Freedom fighters detonate a car bomb in front of a family home, killing a man, his wife, and injuring their four young children."
6098,23/12/2006,Thailand,Narathiwat,1,0,1,Muslim terrorists sneak into a home and kill a man as he is watching television.
6099,23/12/2006,Pakistan,Dera Ismail Khan,1,0,1,A Shiite professor is gunned down near his home by Sunni radicals.
6100,23/12/2006,Iraq,Baghdad,47,0,47,Police recover forty-seven victims of sectarian hatred within the Religion of Peace over a 24-hour period.
6101,23/12/2006,Iraq,Hawija,2,0,2,"Jihadis bomb a passenger car, killing two occupants."
6102,23/12/2006,Iraq,Diwaniya,2,0,2,"Two people are kidnapped by Islamic militants, blindfolded and executed."
6103,23/12/2006,Sudan,Tim,18,8,26,Eighteen civilians are killed by military forces of the Islamic Republic of Sudan.
6104,24/12/2006,Iraq,Hawija,2,0,2,Two Shiite brothers are ruthlessly gunned down by Sunni terrorists.
6105,24/12/2006,Iraq,Baghdad,36,0,36,Thirty-six victims of sectarian hatred within the Religion of Peace are found here and in Mosul
6106,24/12/2006,India,Pattan,1,0,1,A civilian is gunned down by the Mujahideen.
6107,24/12/2006,Pakistan,Dera Ismail Khan,4,8,12,"Shiites open fire on a Sunni funeral, killing four mourners."
6108,24/12/2006,Pakistan,Bajur,1,0,1,An off-duty police officer is sprayed with automatic weapons fire by Muslim militants.
6109,24/12/2006,Iraq,Muqdadiya,7,30,37,A Fedayeen suicide bomber slaughters seven Iraqi policemen in their station and causes severe injury to thirty others.
6110,24/12/2006,Thailand,Pattani,1,0,1,A 34-year-old Buddhist villager is murdered by Islamic radicals after dropping his daughter off at school.
6111,24/12/2006,Thailand,Pattani,1,0,1,An off-duty Thai soldier is shot to death by Jihadis while riding a motorcycle.
6112,25/12/2006,Iraq,Baghdad,3,1,4,Jihadis kill three military police with a roadside bomb.
6113,25/12/2006,Thailand,Pattani,1,0,1,A 36-year-old civilian is murdered by Muslim terrorists.
6114,25/12/2006,Iraq,Baghdad,3,20,23,"A suicide bomber sends three others to Allah, and injures nearly two dozen people sitting on a crowded bus."
6115,25/12/2006,Iraq,Baghdad,10,15,25,"Sunnis detonate a car bomb in a commercial center, killing ten innocents."
6116,25/12/2006,India,Chingam,1,0,1,A civilian is shot to death by the Mujahideen.
6117,25/12/2006,Iraq,Baqubah,6,0,6,"Six people are kidnapped, bound and executed by Islamic rivals."
6118,25/12/2006,Pakistan,Dera Murad Jamali,3,0,3,"Three people, including a woman, are shot to death by a Muslim concerned about illicit sexual relations."
6119,26/12/2006,Israel,Ramle,1,0,1,A divorced mother is gunned down in front of her home in an 'honor killing'.
6120,26/12/2006,Iraq,Kirkuk,2,3,5,A child and an elderly man are killed when Sunni terrorists detonate a bomb.
6121,26/12/2006,Iraq,Baghdad,54,50,104,Several terror attacks and victims of sectarian violence add up to over four dozen people killed by Islamic terrorists.
6122,26/12/2006,Iraq,Baghdad,25,55,80,More than two-dozen innocents are blown to bits by a Jihad car bomb in a retail district.
6123,26/12/2006,Thailand,Narathiwat,3,0,3,Militant Muslims shoot three Buddhist civilians to death in separate attacks.
6124,26/12/2006,Pakistan,Peshawar,1,3,4,"Radicals bomb an airport, killing one other person."
6125,26/12/2006,India,Pulwama,2,2,4,"Two people, including a civilian, are killed in a Mujahideen ambush."
6126,26/12/2006,Iraq,Baghdad,17,35,52,"Shiites bomb a Sunni mosque, killing over a dozen innocent people."
6127,27/12/2006,Afghanistan,Takhtapul,1,3,4,A Pakistani truck driver is killed in a Taliban ambush.
6128,27/12/2006,Thailand,Yala,1,0,1,A Buddhist civilian is gunned down by radical Muslims.
6129,27/12/2006,Thailand,Yala,1,0,1,A 52-year-old farmer is shot to death by Islamic terrorists.
6130,27/12/2006,Thailand,Pattani,1,0,1,A man is brutally murdered by radical Muslims while having tea in a shop.
6131,27/12/2006,Iraq,Ramadi,2,3,5,"Muslim terrorists enter a policeman's home, kill him and a woman, and shoot three others."
6132,27/12/2006,Iraq,Baghdad,40,0,40,Forty victims of sectarian hatred within the Religion of Peace are found tortured and executed.
6133,27/12/2006,Iraq,Talbiya,8,10,18,"Sunnis car bomb a Shia neighborhood, killing eight people."
6134,28/12/2006,Iraq,Baghdad,41,0,41,Forty-one victims of sectarian hatred within the Religion of Peace are found over a 24 hour period.
6135,28/12/2006,Iraq,Baghdad,17,60,77,Separate bombings leave at least seventeen innocents dead at the hands of Islamic terrorists.
6136,28/12/2006,Iraq,Mosul,5,19,24,"Two people are killed by a suicide bomber in a minibus, and three others are kidnapped and beheaded."
6137,28/12/2006,India,Nadihal,1,0,1,A civilian is shot to death by the Mujahideen.
6138,29/12/2006,Yemen,Saada,5,0,5,"Shiite radicals open fire on a military checkpoint, killing five Yemeni soldiers."
6139,29/12/2006,Dagestan,Makhachkala,1,0,1,A religious leader is murdered by Islamists.
6140,29/12/2006,India,Srinagar,1,0,1,Islamic militants trigger an IED blast in the heart of the capital.
6141,29/12/2006,Thailand,Yala,2,0,2,"Two Buddhist teachers are shot, brutally dragged from their truck and set on fire by militant Muslims."
6142,29/12/2006,Thailand,Pattani,1,0,1,Muslim radicals gun down a 50-year-old storeowner in his shop.
6143,29/12/2006,Thailand,Narathiwat,1,0,1,A village defense volunteer is ambushed and murdered by Islamists.
6144,29/12/2006,Pakistan,Damadola,13,6,19,Thirteen people are killed when al-Qaeda backed militants stage a rocket attack on a village.
6145,29/12/2006,Iraq,Khalis,13,17,30,"A suicide bomber attacks a Shia mosque, killing thirteen people."
6146,30/12/2006,Iraq,Baghdad,12,0,12,A dozen victims of sectarian hatred within the Religion of Peace are found dead across the capital.
6147,30/12/2006,Thailand,Yala,1,0,1,Islamists gun down a government official.
6148,30/12/2006,Iraq,Mahmudiya,4,0,4,Four people are tortured and shot to death by Islamic terrorists.
6149,30/12/2006,Iraq,Najaf,36,58,94,Another three dozen Shiites are blown up at a market by determined Sunni bombers.
6150,30/12/2006,Iraq,Tal Afar,5,8,13,A suicide bomber straps explosives to his body and murders five people.
6151,30/12/2006,Iraq,Baghdad,36,77,113,Sunni bombers slaughter three dozen Shia civilians in a triple bombing of a residential neighborhood.
6152,30/12/2006,India,Pampore,2,3,5,"Lashkar-e-Taiba militants fire into a market, killing a civilian and a security guard."
6153,30/12/2006,Sudan,Kutum,5,0,5,"The Islamic Republic of Sudan stages an air force bombing run over a village, killing at least five civilians."
6154,31/12/2006,Thailand,Bangkok,3,40,43,"Jemaah Islamiyah bomb New Years Eve celebrations in the capital, leaving three people dead and forty injured."
6155,31/12/2006,Iraq,Baghdad,4,12,16,Two children are among four people murdered by Jihadis in three attacks.
6156,1/1/2007,Afghanistan,Herat,2,1,3,Religious extremists murder two policemen with a bomb.
6157,1/1/2007,Iraq,Baghdad,40,0,40,Forty victims of sectarian hatred within the Religion of Peace are found in several locations.
6158,1/1/2007,Iraq,Baqubah,4,0,4,Radical Sunnis gun down a moderate and three aides.
6159,1/1/2007,Iraq,Mosul,3,0,3,Three brothers are murdered by sectarian rivals.
6160,2/1/2007,Pakistan,Chak Saboo,2,0,2,A married couple is burnt alive in front of their children because the woman was kidnapped and raped.
6161,2/1/2007,Iraq,Nahrawan,5,0,5,"Five civilians are kidnapped, tortured and executed by Jihadis."
6162,2/1/2007,Iraq,Baghdad,49,4,53,Forty-nine victims of sectarian strife between Sunnis and Shia are found dead.  A mortar attack kills four other civilians.
6163,2/1/2007,Thailand,Narathiwat,1,0,1,An anti-terror Muslim leader is gunned down by Islamists while leaving a cemetery.
6164,3/1/2007,Pal. Auth.,Beit Lahiya,2,17,19,A woman and Fatah official are shot dead by Hamas terrorists in separate incidents.  Seventeen others are injured.
6165,3/1/2007,Iraq,Baghdad,45,0,45,Forty-five victims of sectarian violence between Sunnis and Shia are found dead.
6166,3/1/2007,Somalia,Jilib,2,2,4,"An Islamist stages a Fedayeen attack, killing two unsuspecting Ethiopians."
6167,3/1/2007,India,Kandi,1,2,3,"Islamic rebels ambush a security patrol, killing one member."
6168,3/1/2007,Thailand,Yala,2,0,2,"A 70-year-old man is gunned down, along with his son-in-law, by Islamic militants."
6169,3/1/2007,Pal. Auth.,Beit Lahiya,3,0,3,"Hamas ambush a car carrying Fatah members, killing three of them."
6170,4/1/2007,Pal. Auth.,Jabalya,7,36,43,"Hamas militants fire rockets into a Fatah leader's home, killing him and six others."
6171,4/1/2007,Iraq,Hilla,4,0,4,Four people are kidnapped and shot to death by Islamic terrorists.
6172,4/1/2007,Iraq,Baghdad,13,22,35,"Sunni terrorists detonate two car bombs, killing thirteen people in a residential district."
6173,4/1/2007,Pakistan,Peshawar,1,0,1,Three Sunnis murder a Shia leader.
6174,4/1/2007,Thailand,Narathiwat,1,1,2,Muslim gun down a Buddhist teenager.
6175,4/1/2007,Iraq,Baghdad,47,0,47,Islamic militants take care of forty-seven Iraqis in various attacks.  Four are beheaded.
6176,5/1/2007,Ethiopia,Kofele,1,0,1,A Christian is beaten to death by Muslims with a metal bar.
6177,5/1/2007,Pakistan,Tando Adam,1,0,1,A young man guns down his aunt on suspicion that she was engaged in adultery.
6178,5/1/2007,Somalia,Mogadishu,1,0,1,"An Islamic militant tosses a grenade into the street, killing a civilian."
6179,5/1/2007,Iraq,Baghdad,47,0,47,Another forty-seven victims of sectarian hatred within the Religion of Peace are found executed.
6180,5/1/2007,Iraq,Iskandariya,3,0,3,Three people are kidnapped and tortured to death by Islamic militants.
6181,5/1/2007,Pal. Auth.,Mughazi,1,0,1,Hamas gunmen murder a critic at a refugee camp.
6182,5/1/2007,Iraq,Baghdad,4,11,15,"Jihadis drop bombs on a market, killing four shoppers."
6183,6/1/2007,Iraq,Mosul,6,0,6,Six people are gunned down by Muslim terrorists.
6184,6/1/2007,Iraq,Baghdad,44,0,44,Forty-four additional victims of sectarian violence within Islam are found executed.
6185,6/1/2007,Iraq,Baghdad,27,0,27,Police find twenty-seven victims of sectarian violence killed in gruesome fashion by Religion of Peace rivals.
6186,6/1/2007,India,Shopian,3,23,26,Three people are killed in a Mujahideen grenade attack on a market.
6187,6/1/2007,India,Dangiwacha,1,0,1,A civilian is gunned down on the job by the Mujahideen.
6188,6/1/2007,Afghanistan,Khost,1,0,1,A security official is shot to death by religious extremists.
6189,7/1/2007,Pakistan,Mansehra,1,0,1,A young woman is murdered by her brother for pursuing an education.  The brother claims she 'met Allah's destiny.'
6190,7/1/2007,Somalia,Mogadishu,1,1,2,Islamic militants kill a young girl with automatic weapons fire.
6191,7/1/2007,Afghanistan,Khost,4,2,6,Two women and two children are blown to bits by Islamic bombers.
6192,7/1/2007,India,Baramulla,2,0,2,Two civilians are murdered by the Mujahideen.  One has his throat slit.
6193,7/1/2007,Iraq,Hilla,2,11,13,A Jihad car bombing kills two civilians.
6194,7/1/2007,Iraq,Suwayra,4,0,4,"Four people are kidnapped and executed, one by decapitation."
6195,7/1/2007,Iraq,Baghdad,23,7,30,Two dozen people lose their lives to sectarian violence in three attacks.
6196,7/1/2007,India,Andergam,1,0,1,A 16-year-old student is gunned down in his home by Islamic radicals.
6197,8/1/2007,Thailand,Songkhla,1,0,1,"A Buddhist teacher, brutally beaten into a coma by a Muslim mob seven months earlier, finally expires."
6198,8/1/2007,Iraq,Baghdad,15,15,30,Fifteen cleaning contractors are brutally murdered in a Sunni assault on their bus.
6199,8/1/2007,India,Indergam,1,0,1,A 9th grade student is shot to death by the Mujahideen.
6200,8/1/2007,Iraq,Mosul,5,0,5,Five people are gunned down by sectarian rivals.
6201,8/1/2007,Iraq,Baghdad,6,0,6,Sunnis gun down six members of a Shiite family as they are moving their furniture.
6202,8/1/2007,Iraq,Baghdad,32,16,48,At least four separate Jihad attacks leave nearly three dozen civilians dead.
6203,9/1/2007,Pakistan,Qamber,2,0,2,A man kills his sister and her lover in an 'honor' killing.
6204,9/1/2007,Pakistan,Jacobabad,2,0,2,Two brothers are shot to death in a coordinated terror attack concerning an issue of sexual impropriety.
6205,9/1/2007,Pakistan,Hangu,1,0,1,A newspaper journalist is beheaded by Islamic militants.
6206,9/1/2007,Thailand,Pattani,1,0,1,A janitor is murdered by Islamists shortly after dropping his daughter off at school.
6207,9/1/2007,Iraq,Baghdad,46,0,46,Forty-six victims of sectarian hatred between Sunnis and Shia are found around the country.
6208,10/1/2007,Israel,Haifa,1,0,1,A teacher is murdered by her cousin in a suspected 'honor' attack.
6209,10/1/2007,Thailand,Pattani,1,1,2,A female teacher is shot to death by Islamic militants on her way to school.
6210,10/1/2007,Iraq,Baghdad,68,0,68,Sixty-eight victims of Sunni-Shia sectarian violence are found murdered in three cities over a 24-hour period.
6211,10/1/2007,Iraq,Mosul,8,0,8,Eight people are found dead from terror attacks.
6212,10/1/2007,Iraq,Tal Afar,5,16,21,A child is among five people killed in separate suicide bombings.
6213,10/1/2007,Iraq,Karbala,11,14,25,Sunni gunmen massacre Shia pilgrims returning home in a convoy of buses.
6214,10/1/2007,Somalia,Mogadishu,1,0,1,"Islamists fire a rocket into a home, killing a family member."
6215,10/1/2007,Philippines,General Santos,6,23,29,"Six people, including two young children and two woman, are killed in a suspected Abu Sayyaf bomb attack on a lottery office and market."
6216,10/1/2007,Philippines,Cotabato,1,0,1,Muslim militants kill a garbage collector with a bomb.
6217,11/1/2007,Iraq,Khadra,5,0,5,Five off-duty policemen are gunned down in cold blood by Sunni terrorists.
6218,11/1/2007,Indonesia,Poso,1,0,1,A police officer at a funeral for a terrorist is beaten to death by an angry Muslim mob.
6219,12/1/2007,Thailand,Pattani,2,0,2,Two Buddhist men are murdered by Religion of Peace gunmen in separate attacks.
6220,12/1/2007,Thailand,Narathiwat,1,0,1,Militant Muslims gun down a village guard outside his home.
6221,12/1/2007,Iraq,Baghdad,11,0,11,Ten intact bodies and one severed head are discovered by police.
6222,12/1/2007,Iraq,Ishaqi,3,0,3,Three civilians are shot to death by Islamic terrorists.
6223,12/1/2007,Thailand,Yala,1,0,1,A 62-year-old civilian is gunned down by Islamic terrorists as he is carrying his 2-year-old grandson on a motorbike.
6224,13/1/2007,Thailand,Pattani,1,0,1,Islamists murder a Buddhist policeman on his way to work.
6225,13/1/2007,Thailand,Yala,1,0,1,A Buddhist firefighter is shot to death by radical Muslims in front of his office.
6226,13/1/2007,Iraq,Kirkuk,2,3,5,Muslim terrorists shoot two engineers to death.
6227,13/1/2007,Dagestan,Aimaumakhi,1,0,1,A policeman is gunned down by suspected Islamic rebels.
6228,13/1/2007,Iraq,Iskandariya,3,1,4,"Terrorists attack a private factory, killing three workers."
6229,14/1/2007,Pakistan,Butkhela,1,1,2,Pro-Taliban militants shoot an Uzbeki man to death.
6230,14/1/2007,Pakistan,Matta,3,0,3,Two girls and their mother are killed in a mine attack by local Taliban.
6231,14/1/2007,Thailand,Pattani,1,0,1,A 31-year-old man is shot off the back of a motorcycle by Islamic terrorists.
6232,14/1/2007,Thailand,Pattani,1,5,6,"Islamic militants bomb a Thai military vehicle, killing one soldier."
6233,14/1/2007,Iraq,Baghdad,41,0,41,Forty-one victims of sectarian violence are found in various locations.
6234,14/1/2007,Iraq,Mosul,14,8,22,Fourteen people are murdered in separate attacks by Muslim radicals.
6235,14/1/2007,Thailand,Pattani,2,0,2,"A married couple is murdered by Islamic radicals at the entrance to their business.  The man is decapitated.  A note pinned to the body says, 'We kill all Buddhists.'"
6236,14/1/2007,Thailand,Yala,1,0,1,Muslims gun down another Buddhist civilian.
6237,15/1/2007,India,Hajan,1,0,1,Islamic terrorists shoot dead a man shopping at a market.
6238,15/1/2007,India,Sumbar,1,0,1,A civilian is abducted by the Mujahideen and shot to death in captivity.
6239,15/1/2007,Thailand,Yala,1,1,2,A 58-year-old Buddhist man is murdered by Islamists in an attack that also leaves his wife injured.
6240,15/1/2007,Thailand,Pattani,1,0,1,A man is shot to death by radical Muslims.
6241,15/1/2007,Iraq,Baqubah,11,0,11,"Eleven people are kidnapped by sectarian rivals, bound, gagged and executed."
6242,15/1/2007,Iraq,Baghdad,7,5,12,Two separate bombings leave seven Iraqis dead.
6243,15/1/2007,Iraq,Mosul,5,28,33,A Fedayeen suicide bomber sends five Kurds to Allah.
6244,16/1/2007,Iraq,Baghdad,70,180,250,"Islamic terrorists manage to slaughter at least seventy students, mostly female, at a university using a car bomb and then a suicide bomber on foot to catch the survivors!"
6245,16/1/2007,Iraq,Baghdad,16,11,27,Jihadis kill ten civilians in a drive-by shooting and another six with a car bomb.
6246,16/1/2007,Iraq,Mosul,12,0,12,"Twelve people, including at least one woman, are murdered by Muslim gunmen."
6247,16/1/2007,Thailand,Narathiwat,1,2,3,Islamic militants kill a village chief with a roadside bomb.
6248,16/1/2007,Iraq,Baghdad,15,74,89,"Sunnis target Shia civilians in a marketplace, killing at least fifteen with a suicide attack."
6249,16/1/2007,Iraq,Iskandariya,2,0,2,Freedom fighters kill an Iraqi woman and her son in a mortar attack.
6250,16/1/2007,Israel,Juarish,1,0,1,A 19-year-old woman is shot to death in her own bed by relatives for violating the family's honor.
6251,17/1/2007,India,Wagoora,1,0,1,Local Mujahideen shoot an electrical employee to death.
6252,17/1/2007,Iraq,Kirkuk,10,42,52,"A suicide truck bomber drives into an Iraqi police station, killing ten people."
6253,17/1/2007,Iraq,Baghdad,4,10,14,An American woman working for an NGO is among three civilians murdered in a bomb attack.
6254,17/1/2007,Iraq,Baghdad,30,0,30,Police find thirty victims of sectarian violence in and around the city.  Most were tortured and shot.
6255,17/1/2007,Iraq,Mosul,10,0,10,Ten victims of sectarian violence are delivered to the morgue.
6256,17/1/2007,Iraq,Baghdad,15,33,48,"Sunnis car bomb a Shia market, killing fifteen patrons."
6257,17/1/2007,Thailand,Songkhla,1,0,1,Muslim radicals murder a Buddhist rubber-tapper.
6258,17/1/2007,Thailand,Yala,1,0,1,A 42-year-old Buddhist scrap dealer is shot dead by Muslim terrorists in front of his home.
6259,18/1/2007,Thailand,Narathiwat,1,1,2,Muslim gunmen kill a 68-year-old man and injure his son.
6260,18/1/2007,Afghanistan,Paktika,1,5,6,A suicide bomber kills an Afghan soldier.
6261,18/1/2007,Thailand,Narathiwat,1,0,1,A Buddhist woman working as a health care volunteer is murdered by Islamic gunmen.
6262,18/1/2007,India,Nayidgam,1,0,1,A mechanic is abducted and beheaded by the Mujahideen.
6263,18/1/2007,Iraq,Baghdad,10,30,40,"Sunnis bomb a vegetable market, killing ten patrons."
6264,18/1/2007,Iraq,Mosul,13,21,34,"Thirteen people are killed in shootings, including one on a wedding party, and a Fedayeen suicide blast."
6265,18/1/2007,Iraq,Baghdad,12,34,46,A series of terrorist bombings leave at least eleven people dead.
6266,18/1/2007,Iraq,Baghdad,26,0,26,Twenty-six people are found shot and tortured to death by sectarian rivals.
6267,19/1/2007,Iraq,Yusufiya,4,0,4,"Two very young children, ages 1 and 5, are among four killed in a bombing by Sunni militants."
6268,19/1/2007,Iraq,Karbala,4,0,4,Four American soldiers are abducted and brutally killed in captivity by Islamic militants.
6269,19/1/2007,Turkey,Istanbul,1,0,1,"An advocate for the victims of Armenian genocide is gunned down by a Muslim who says, 'I killed the infidel.'"
6270,19/1/2007,Iraq,Hilla,1,0,1,Fundamentalists murder a butcher.
6271,20/1/2007,Somalia,Mogadishu,4,0,4,Four civilians are killed in an Islamic attack.
6272,20/1/2007,Iraq,Mosul,7,2,9,Seven people are gunned down by sectarian rivals.
6273,20/1/2007,Iraq,Iskandariya,4,4,8,Four people are murdered by Islamic terrorists.
6274,20/1/2007,Iraq,Baghdad,40,10,50,Religious violence claims the lives of at least forty people in various attacks.
6275,20/1/2007,Thailand,Narathiwat,1,2,3,A noodle vendor is shot to death in front of his 12-year-old daughter by Muslim militants.
6276,20/1/2007,Philippines,Parang,1,7,8,Abu Sayyaf terrorists kill a Filipino soldier in an ambush.
6277,21/1/2007,India,Baramulla,1,12,13,A grenade attack by the Mujahideen eventually kills one of thirteen people injured.
6278,21/1/2007,Algeria,Jijel,1,8,9,"The Salafist Group for Preaching and Combat, kills an Algerian soldier in a bomb attack."
6279,21/1/2007,Iraq,Mosul,9,4,13,A woman is among nine people killed by Jihadis in shooting and bombing attacks.
6280,21/1/2007,Thailand,Narathiwat,1,0,1,A middle-aged Buddhist man is gunned down by militants as he is standing in front of his home talking with friends.
6281,21/1/2007,Iraq,Karrada,6,15,21,A half-dozen people are incinerated in a suspected suicide blast on a minibus.
6282,22/1/2007,Iraq,Baghdad,1,1,2,Fundamentalists murder a female teacher on her way to work at a girl's school.
6283,22/1/2007,Iraq,Baghdad,88,190,278,"Sunni extremists score big at a market, killing nearly ninety unsuspecting Shia shoppers with coordinated bombs."
6284,22/1/2007,Pakistan,Miran Shah,5,20,25,Four Pakistani soldiers and a female passerby are killed in a Fedayeen suicide attack on a checkpoint.
6285,22/1/2007,Iraq,Khalis,12,39,51,A dozen civilians are killed in an Islamic bombing attack.
6286,22/1/2007,Iraq,Baghdad,30,0,30,Thirty victims of sectarian violence are found bound and executed.
6287,22/1/2007,Iraq,Rutba,4,0,4,"Four people are kidnapped, tortured and executed by sectarian rivals."
6288,22/1/2007,Syria,Damascus,1,0,1,"A 16-year-old girl is stabbed five times in the back and neck by her brother, angry that she had been raped."
6289,23/1/2007,Chechnya,Kurchaloi,1,0,1,Jihadis shoot a police officer to death.
6290,23/1/2007,Iraq,Suwayra,6,9,15,Radical Sunnis wipe out five members of a Shia family and one other in a terror attack.
6291,23/1/2007,Iraq,Tal Afar,2,0,2,Two teachers are shot to death by radicals.
6292,23/1/2007,Iraq,Fallujah,3,0,3,Three butchers are killed by Islamic fundamentalists.
6293,23/1/2007,Thailand,Yala,1,0,1,A Buddhist man is murdered by Islamists as he drove his 7-year-old son home from school.
6294,23/1/2007,Thailand,Narathiwat,2,0,2,Two men are gunned down in a drive-by shooting by Islamists.
6295,23/1/2007,Afghanistan,Uruzgan,9,0,9,Nine Afghan policemen are murdered in a Taliban ambush in a remote area.
6296,23/1/2007,India,Bandina,3,2,5,"The Mujahideen blow up a passing security vehicle, killing three occupants."
6297,23/1/2007,Afghanistan,Khost,10,14,24,A Taliban suicide bomber blows ten Afghan civilians to Allah.
6298,23/1/2007,Jordan,Amman,1,0,1,"A 17-year-old girl is shot four times in the head by her father, who thought she had had sex. An autopsy showed she was a virgin."
6299,23/1/2007,Iraq,Baghdad,17,0,17,Seventeen victims of sectarian hatred within the Religion of Peace are found executed.
6300,24/1/2007,Iraq,Baghdad,4,3,7,A suicide bomber kills four Iraqis.
6301,24/1/2007,Iraq,Baghdad,33,0,33,Thirty-three victims of sectarian hatred are found murdered.
6302,24/1/2007,Somalia,Mogadishu,2,1,3,Two civilians are killed when Islamic militias fire mortars into an airport.
6303,24/1/2007,Iraq,Baghdad,2,0,2,A female bank employee and a professor are murdered by Jihadis in separate attacks.
6304,25/1/2007,Philippines,Midsayap,1,0,1,At least one person is killed when Moro terrorists attack a group of families.
6305,25/1/2007,Pakistan,Hangu,2,4,6,Two passersby are killed in a car bombing.
6306,25/1/2007,Somalia,Kismayo,1,1,2,An Ethiopian solider is shot to death by Muslim militants.
6307,25/1/2007,Thailand,Narathiwat,1,1,2,A young man is gunned down by Islamic terrorists.
6308,25/1/2007,Thailand,Pattani,1,0,1,A 57-year-old Buddhist man is murdered by Islamic radicals on his way to work.
6309,25/1/2007,Iraq,Baghdad,7,30,37,Seven people are killed in separate marketplace bombings by Islamic terrorists.
6310,25/1/2007,Iraq,Fallujah,2,0,2,A boy and an elderly woman are murdered by Muslim bombers.
6311,25/1/2007,Iraq,Baghdad,26,64,90,Over two-dozen people are blown to bits by Sunni bombers in a shopping district.  Dozens more suffer injury.
6312,25/1/2007,Iraq,Baghdad,42,17,59,Forty-two victims of sectarian hatred within the Religion of Peace are found over a 24-hour period.
6313,26/1/2007,Pakistan,Khan Yunis,1,1,2,"al-Qaeda militants ambush a police patrol, killing an officer."
6314,26/1/2007,Pal. Auth.,Gaza,2,0,2,A man and a 16-year-old are killed in separate Hamas attacks.
6315,26/1/2007,Pal. Auth.,Khan Yunis,1,0,1,A 2-year-old girl is killed when Islamic factions clash in Gaza.
6316,26/1/2007,Pakistan,Islamabad,1,6,7,"A suicide bomber blows himself up outside the Marriott hotel, killing a guard."
6317,26/1/2007,Iraq,Baghdad,15,55,70,"Sunnis target innocent Iraqis at a pet fair, killing over a dozen with a shrapnel bomb."
6318,26/1/2007,India,Tanur,1,5,6,A Hindu activist is hacked to death by Muslim gangs.
6319,26/1/2007,Iraq,Baghdad,29,14,43,Twenty-seven people are kidnapped and murdered by Jihadis.  Two others are killed by a suicide bomber.
6320,26/1/2007,Sudan,Magwe,1,2,3,An Indian peacekeeper is gunned down by suspected Jihadis.
6321,26/1/2007,Thailand,Pattani,1,4,5,Islamists gun down a cop and injure four civilians with a bomb blast.
6322,27/1/2007,Afghanistan,Kunar,1,3,4,Taliban terrorists kill an Afghan contractor during an ambush on a security base.
6323,27/1/2007,Yemen,Saada,6,20,26,Radical Shiites ambush and kill six Yemeni soldiers.
6324,27/1/2007,Iraq,Baghdad,13,43,56,Two suicidal Sunnis murdered at least thirteen Shias in an attack at a market.
6325,27/1/2007,Iraq,Baghdad,40,0,40,Two women are among forty bodies found around the city as Sunnis and Shias go at it.
6326,27/1/2007,Pakistan,Peshawar,14,60,74,"A suicide bomber targets a crowd leaving a mosque, killing at least fourteen."
6327,27/1/2007,Algeria,Skikda,1,4,5,"Islamic fundamentalists ambush a police station, killing one officer."
6328,27/1/2007,Pakistan,Babar Kuch,2,3,5,A rocket attack by Taliban-backed militants on a civilian vehicle leaves two dead.
6329,27/1/2007,Iraq,Baghdad,5,3,8,"Sunnis storm a Shia home, killing five members of the same family."
6330,28/1/2007,Pakistan,Punjab,2,0,2,A couple in their 40's are tied to a tree and stoned to death for adultery.
6331,28/1/2007,Iraq,Baghad,14,64,78,Four Jihad bombings leave fourteen people dead and over sixty injured.
6332,28/1/2007,Iraq,Kirkuk,16,34,50,"Two separate suicide bombings, one at a market, leave sixteen innocents dead."
6333,28/1/2007,Iraq,Baghdad,29,0,29,Twenty-nine victims of sectarian hatred are found executed across the city.
6334,28/1/2007,Thailand,Pattani,1,0,1,A Buddhist man is killed in a Muslim drive-by attack.
6335,28/1/2007,Thailand,Yala,1,0,1,A 33-year-old woman is shot to death by Islamic terrorists.
6336,28/1/2007,Iraq,Ramadi,5,10,15,Two children are among five killed by a Fedayeen suicide bomber.
6337,28/1/2007,Philippines,Rangaban,1,1,2,"Moro Islamic Front terrorists attack a village, killing one defender and injuring another."
6338,28/1/2007,Iraq,Baghdad,5,20,25,Five school girls are killed when freedom fighters mortar a school.
6339,29/1/2007,Israel,Eilat,3,3,6,Three Israelis are murdered by an al-Aqsa suicide bomber at a bakery.
6340,29/1/2007,Algeria,Batna,5,0,5,"Islamic fundamentalists open up on a checkpoint with automatic weapons, killing five Algerian security staff at point-blank range."
6341,29/1/2007,Iraq,Tuz Khurmato,5,0,5,"Sunnis blast a Shiite mosque, killing five worshippers."
6342,29/1/2007,Chechnya,Gudermes,4,0,4,Four Russians are killed in a shooting and suicide attack by Islamic militants.
6343,29/1/2007,India,Kishtwar,2,2,4,"The Mujahideen attack Indian troops, killing two."
6344,29/1/2007,Thailand,Songkhla,3,1,4,Two Buddhist couples are brutally assaulted by Muslim radicals.  Three people are killed.
6345,29/1/2007,Pakistan,Dera Ismail Khan,2,7,9,"A suicide bomber blows himself up at a park, killing two other people."
6346,29/1/2007,India,Gorakhpur,1,0,1,A Hindu man is killed by a mob of angry Muslims.
6347,29/1/2007,Iraq,Baghdad,4,5,9,"Sunnis plant a bomb on a minibus, killing four passengers."
6348,29/1/2007,Iraq,Zaafaraniya,16,28,44,"Jihadis stage a mortar attack on a residential area, killing sixteen innocents."
6349,29/1/2007,Thailand,Yala,1,0,1,Islamists shoot a civilian off his motorcycle.
6350,29/1/2007,Thailand,Yala,1,0,1,A teenager dies after his throat is slashed and he is stabbed by radical Muslims.
6351,29/1/2007,Thailand,Pattani,1,0,1,Muslim militants gun down a man driving his wife to work.
6352,30/1/2007,Afghanistan,Herat,0,12,12,"A Fedayeen suicide bomber rams his truck into an Afghan convoy, injuring a dozen innocents."
6353,30/1/2007,Pakistan,Hangu,2,14,16,Two Afghan refugees are killed by Sunni extremists following a Shia religious festival.
6354,30/1/2007,Iraq,Baghdad,25,9,34,Sectarian violence within the Religion of Peace leaves over two dozen dead in various attacks.
6355,30/1/2007,Iraq,Ramadi,16,0,16,A suicide truck bomber kills sixteen people.
6356,30/1/2007,Iraq,Khanaqin,13,39,52,"A Shiite religious ceremony is the target of a deadly roadside bomb, as Sunnis rack up more dead Shia."
6357,30/1/2007,Iraq,Balad Ruz,23,57,80,A suicidal Sunni blows two-dozen Shia worshippers to Allah at a mosque.
6358,30/1/2007,Iraq,Adhamiya,17,72,89,"Jihadis rain down mortars on a residential area, killing seventeen innocent Iraqis."
6359,31/1/2007,Thailand,Pattani,1,3,4,Islamists kill a villager with a bomb.
6360,31/1/2007,Pakistan,Hangu,2,1,3,Two people inside a house are killed in a sectarian mortar attack.
6361,31/1/2007,Bangladesh,Dhaka,1,1,2,A policeman is killed in a bomb attack by suspected Islamic extremists.
6362,31/1/2007,Thailand,Yala,1,6,7,A 59-year-old rubber tapper is murdered in drive-by shooting by Islamists.
6363,31/1/2007,Iraq,Baghdad,12,22,34,"Sectarian violence around the city leaves at least a dozen dead, including a decapitation."
6364,31/1/2007,Iraq,Fallujah,7,0,7,"Seven people, including a teenager, are gunned down by Jihadis."
6365,31/1/2007,Iraq,Baghdad,4,0,4,"Three university professors and a student, kidnapped by Islamic militants three days earlier, are found dead."
6366,1/2/2007,Thailand,Yala,1,1,2,Islamists gun down a civilian and seriously injure his wife in the attack.
6367,1/2/2007,Thailand,Pattani,1,0,1,Another ice-cream vender is murdered by Islamists - this one while driving to work.
6368,1/2/2007,Iraq,Mosul,4,0,4,A college dean and two students are among four people murdered by Jihadis.
6369,1/2/2007,Iraq,Hillah,73,150,223,Two Islamic suicide bombers take out dozens of innocent people in a coordinated attack on a packed market.
6370,1/2/2007,Iraq,Baghdad,46,71,117,Sectarian violence leaves about four dozen Iraqis dead.
6371,1/2/2007,Yemen,Saada,10,20,30,Shiite radicals kill ten Yemeni soldiers in an attack on a roadblock.
6372,1/2/2007,Somalia,Mogadishu,3,1,4,Two children are among three civilians killed in separate rocket attacks by the Islamic militia.
6373,1/2/2007,Thailand,Pattani,1,0,1,"Muslims shoot a Buddhist ice cream vendor to death, then chop off his head and leave the body sitting up in the vehicle."
6374,1/2/2007,Pakistan,Peshawar,2,4,6,"A man and his wife are killed, and their four children injured in a bomb blast."
6375,1/2/2007,Pakistan,Miran Shah,3,2,5,"Three people, including an engineer and a road inspector are killed by al-Qaeda backed militants."
6376,1/2/2007,Pakistan,North Waziristan,1,0,1,"A man is beheaded by Islamic militants, who then pin a note to the body."
6377,2/2/2007,Pal. Auth.,Gaza,17,185,202,"Seventeen people, including children, are killed in sectarian fighting between Muslim militias over a 24-hour period."
6378,2/2/2007,Iraq,Yusufiyah,3,11,14,Two children are among three Iraqi civilians killed by Islamic terrorists.
6379,2/2/2007,Pal. Auth.,Gaza,15,90,105,Hamas sniper set up around a Palestinian training camp and fire into it.  Some fifteen people are killed and nearly a hundred others injured.
6380,3/2/2007,Iraq,Baghdad,25,12,37,Over two-dozen people are killed in sectarian violence within the Religion of Peace.
6381,3/2/2007,Iraq,Mahmudiya,8,12,20,At least eight people are killed in a Jihad car bombing on a market.
6382,3/2/2007,Iraq,Falluja,5,0,5,"Five people are kidnapped, executed and dumped by sectarian rivals."
6383,3/2/2007,India,Pulwama,4,6,10,"Mujahideen ambush a group of policemen, killing at least four."
6384,3/2/2007,Iraq,Baghdad,135,359,494,A single Fedayeen suicide bomber racks up over one-hundred and thirty civilians at a market.  Nearly four-hundred others suffer injury.
6385,3/2/2007,Pakistan,Tank,2,6,8,Two Pakistani soldiers are killed when a suicide bomber rams into their convoy.
6386,3/2/2007,Dagestan,Makhachkala,3,0,3,Militants kill three policemen in two coordinated attacks.
6387,4/2/2007,India,Srinagar,1,0,1,A man is shot dead by the Mujahideen.
6388,4/2/2007,Iraq,Baghdad,31,76,107,A series of bombings by Islamic terrorists leave thirty-one innocent people dead.
6389,4/2/2007,Iraq,Baghdad,3,0,3,A woman and her two children are killed when Jihadis mortar a house.
6390,4/2/2007,Iraq,Baghdad,33,0,33,Thirty-three bodies are found as sectarian violence within the Religion of Peace rages.
6391,4/2/2007,Pal. Auth.,Gaza,2,0,2,Two more Palestinians die from a Hamas sniper attack.  One is 17-years-old.
6392,4/2/2007,Thailand,Pattani,1,0,1,A Buddhist school official is murdered by Muslim terrorists.
6393,4/2/2007,Thailand,Narathiwat,1,0,1,A 68-year-old Buddhist man is shot off his motorbike by Islamic radicals.
6394,5/2/2007,Pakistan,Bajaur,2,1,3,Pro-government tribal leaders are killed by al-Qaeda supported militants.
6395,5/2/2007,Iraq,Baghdad,24,108,132,"Three car bombs, one at a children's hospital, rack up about twenty dead civilians for Sunni Jihadis."
6396,5/2/2007,Iraq,Baghdad,25,0,25,Twenty-five victims of sectarian hatred within the Religion of Peace are found tortured and executed.
6397,5/2/2007,Iraq,Haditha,6,0,6,Six people are found murdered by Jihadis.
6398,6/2/2007,Pakistan,Islamabad,0,10,10,A suicide bomber blows himself up in a botched attack on the city's main airport.
6399,6/2/2007,India,Pukharni,1,0,1,Terrorists kill a boy with a landmine.
6400,6/2/2007,India,Bandipora,1,0,1,A civilian is kidnapped and killed by the Mujahideen.
6401,6/2/2007,Thailand,Narathiwat,1,0,1,Muslims hack a 37-year-old laborer to death with machetes.
6402,6/2/2007,Thailand,Pattani,1,2,3,A man is shot to death while riding a motorbike with his wife and 3-year-old daughter.
6403,6/2/2007,Pakistan,Miran Shah,2,0,2,Islamic terrorists bind two men and then shoot them to death.
6404,6/2/2007,Iraq,Mosul,1,0,1,A woman is shot to death by Islamic gunmen.
6405,6/2/2007,Iraq,Baghdad,27,19,46,Sectarian hatred within the Religion of Peace leaves over two dozen dead.
6406,7/2/2007,Iraq,Baghdad,39,0,39,Thirty-nine people are killed in at least four separate Jihad attacks.
6407,7/2/2007,Iraq,Mosul,2,0,2,A man and his wife are killed in their home by Islamic militants.
6408,7/2/2007,Pakistan,Sindh,1,0,1,"The remains of a Hindu man, kidnapped and murdered by Islamists, are found six months later."
6409,7/2/2007,Iraq,Suwayra,7,23,30,Three car bombs take the lives of seven innocent people.
6410,7/2/2007,Pakistan,Darra Adam Khel,1,1,2,al-Qaeda militants gun down a Pakistani ISI agent in an attack on his vehicle.
6411,7/2/2007,Chechnya,Vedeno,1,0,1,A local official bleeds to death after Jihadis blow off his foot with a bomb.
6412,7/2/2007,Afghanistan,Shindand,3,2,5,Three Afghan cops are killed by a remote-controlled device.
6413,7/2/2007,Afghanistan,Kandahar,2,6,8,"Two Afghans are killed, and six wounded, by a Taliban bomb planted on a motorbike."
6414,7/2/2007,Somalia,Mogadishu,2,7,9,Two children are reported killed in a mortar attack by Islamic militias.
6415,8/2/2007,India,Baharabad,1,2,3,A man is gunned down in a Muslim shooting attack that leaves his wife and one other injured.
6416,8/2/2007,Iraq,Haditha,7,3,10,"A suicide bomber attacks a police station, killing seven people inside."
6417,8/2/2007,Iraq,Mosul,45,10,55,"Forty-five people are killed in three locations in the country, as Islamists vow to keep killing."
6418,8/2/2007,Iraq,Aziziya,17,27,44,"Islamic terrorists bomb a vegetable market, netting seventeen dead Iraqis."
6419,8/2/2007,Iraq,Iskandariya,7,10,17,Jihadis use mortars to kill seven residents.
6420,8/2/2007,Iraq,Rafiyaat,14,1,15,Gunmen storm a house and shoot fourteen men from the same family to death.
6421,8/2/2007,India,Aragam,4,1,5,"A brutal ambush by Islamic militants leaves four people dead, including a civilian."
6422,8/2/2007,Thailand,Pattani,1,0,1,A 72-year-old Buddhist man is beheaded by Islamists.
6423,8/2/2007,UAE,Dubai,1,0,1,"A man kills his 22-year-old sister on suspicion that she was having an affair, based on a mobile phone picture."
6424,8/2/2007,India,Hajin,1,2,3,A pro-India political figure is gunned down in an attack that also injures his wife.
6425,8/2/2007,Iraq,Balad,10,0,10,Ten men are gunned down by sectarian rivals.
6426,9/2/2007,Iraq,Baghdad,11,0,11,Eleven people are found dead hours after being kidnapped by Muslim terrorists.
6427,9/2/2007,Afghanistan,Kandahar,4,3,7,Four Afghan policemen are killed in a Taliban ambush.
6428,9/2/2007,Thailand,Narathiwat,1,0,1,Islamists shoot a 20-year-old civilian to death at a tea shop.
6429,9/2/2007,Iraq,Hilla,2,8,10,"Jihadis plant a bomb at a market, killing two people."
6430,10/2/2007,Thailand,Pattani,1,0,1,A 56-year-old truck driver is gunned down on the job by Islamic radicals.
6431,10/2/2007,Somalia,Mogadishu,3,3,6,Three people are killed when Islamists bomb a market.
6432,10/2/2007,Somalia,Mogadishu,5,10,15,Two girls are among five killed in two rocket attacks after Islamic groups vow to step up the violence.
6433,10/2/2007,Iraq,Baghdad,3,5,8,A Jihad car bombing kills at least three people at an intersection.
6434,10/2/2007,Iraq,Mussayab,3,2,5,Three members of a Shiite family are killed in their home by Islamic gunmen.
6435,10/2/2007,Iraq,Baghdad,5,10,15,Five people near a bakery are killed by a Sunni suicide bomber.
6436,10/2/2007,Iraq,Mosul,8,0,8,Eight young border guard recruits are brutally gunned down in a machine-gun assault by Muslim gunmen.
6437,11/2/2007,Iraq,Baghdad,35,0,35,Thirty-five people are found dead in various locations from sectarian violence.
6438,11/2/2007,India,Kangan,1,0,1,A cop is gunned down by the Mujahideen.
6439,11/2/2007,Iraq,Tikrit,11,15,26,Eleven people are killed by a suicidal Sunni in an explosives-laden car.
6440,11/2/2007,Thailand,Yala,3,0,3,Three villagers are shot to death by Muslim militants.  The victims included two women.
6441,11/2/2007,Somalia,Kismayu,4,20,24,"Islamic extremists toss a grenade into a parade, killing four people."
6442,12/2/2007,Afghanistan,Zabul,2,1,3,Two policemen are killed when Taliban militants ambush their vehicle.
6443,12/2/2007,Iraq,Mosul,3,0,3,"A student is among three people kidnapped, tortured and killed by Islamic extremists."
6444,12/2/2007,Iraq,Baghdad,43,26,69,"Sectarian violence within the Religion of Peace claims four dozen lives, including a market bombing."
6445,12/2/2007,Iraq,Baghdad,79,165,244,"Sunnis bomb a Shia market with three coordinated blasts, sending blood and body parts across several blocks."
6446,12/2/2007,Thailand,Pattani,1,0,1,A Buddhist man is killed in a public phone booth in front of his wife and son.
6447,12/2/2007,Somalia,Mogadishu,2,4,6,"Islamists lob mortars into a home, killing a father and his 6-year-old son."
6448,12/2/2007,Somalia,Mogadishu,1,3,4,A woman is killed when Somali Islamists lob a mortar into her home.
6449,13/2/2007,USA,"Salt Lake City, UT",5,4,9,"A Muslim immigrant enters a gift shop and mows down five people buying Valentines Day cards, in a brutal hate crime."
6450,13/2/2007,Algeria,Algiers,6,30,36,Six people are killed in at least four deadly bombings by Islamic fundamentalists across the country.
6451,13/2/2007,Lebanon,Bikfaya,3,19,22,"Following threats by Islamic groups, two coordinated bomb blasts rip through a Christian town, killing at least three persons."
6452,13/2/2007,Iraq,Mahmudiya,3,0,3,Three people are kidnapped and brutally tortured to death by sectarian rivals.
6453,13/2/2007,Iraq,Baghdad,22,44,66,"Separate car bombings, including a suicide bomber near a college, leaves nearly two-dozen people dead."
6454,13/2/2007,Iraq,Nahrawan,5,12,17,"Jihadis lob mortars into a town, indiscriminately killing five people."
6455,14/2/2007,Iraq,Baghdad,4,10,14,Four Christians are killed in an Islamic car bombing of their hospital.
6456,14/2/2007,Iraq,Baghdad,6,30,36,Three Jihad car bombings leave six people dead.
6457,14/2/2007,Iraq,Ramadi,5,20,25,A Fedayeen suicide bomber sends five souls to Allah.
6458,14/2/2007,Yemen,Saada,2,2,4,Two members of the military are killed in an ambush by radical Shiites.
6459,14/2/2007,Pakistan,Dera Ismail Khan,1,0,1,A Shiite cleric is gunned down in a sectarian attack.
6460,14/2/2007,Thailand,Yala,1,0,1,A 30-year-old rubber tapper is murdered by Islamic radicals.
6461,14/2/2007,Thailand,Narathiwat,1,0,1,A Buddhist man is shot to death by Muslims while riding his motorcycle.
6462,14/2/2007,Thailand,Yala,2,0,2,"A Buddhist father and son, selling herbal medicines by the roadside are brutally gunned down by Islamic gunmen."
6463,14/2/2007,Thailand,Narathiwat,1,1,2,A married couple is attacked by Muslim radicals.  The wife dies from injuries.
6464,14/2/2007,Thailand,Yala,1,5,6,One person is killed in a bomb attack by radical Muslims.
6465,14/2/2007,Iran,Zahedan,18,0,18,A radical Sunni group takes credit for a bomb attack on a bus carrying Revolutionary Guards.  Eighteen are killed.
6466,15/2/2007,Iraq,Al Gasreen,8,14,22,Women and children are among eight civilians killed in a Jihad mortar attack on a civilian area.
6467,15/2/2007,Iraq,Baghdad,27,45,72,Two car bombings and a shooting attack on a bus full of women combine with twenty other bodies found victimized by Islamic terrorists.
6468,15/2/2007,Iraq,Kirkuk,3,5,8,Jihadis set up a fake checkpoint and gun down three Iraqis.
6469,15/2/2007,Somalia,Mogadishu,4,5,9,Children are among four killed by mortar fire from Islamic militias.
6470,16/2/2007,Pakistan,Bajaur,1,3,4,Pro-Taliban militants kill a doctor with a roadside bomb
6471,16/2/2007,Iraq,Baghdad,15,0,15,Fifteen victims of sectarian hatred are found in the capital and in Mosul.
6472,16/2/2007,Somalia,Mogadishu,1,12,13,"Islamic militias lob a mortar into a displaced persons camp, killing a refugee."
6473,17/2/2007,Iraq,Karbala,2,0,2,Two people are kidnapped and beheaded by Islamic terrorists.
6474,17/2/2007,Iraq,Hilla,2,0,2,A woman and her young daughter are stabbed to death by Jihad militants.
6475,17/2/2007,Iraq,Kirkuk,11,83,94,Sunnis murder at least eleven Kurdish shoppers with a double car-bombing along a crowded market area.
6476,17/2/2007,Thailand,Narathiwat,1,0,1,"A hunter and his dog are shot and hacked to death by Islamists, who then burn the bodies."
6477,17/2/2007,Pakistan,Quetta,16,30,46,Sixteen people are murdered when a suicide bomber blows himself up inside a packed courtroom.
6478,17/2/2007,India,Koti Nullah,1,0,1,The Mujahideen abduct a civilian from his home and kill him in captivity.
6479,18/2/2007,Iraq,Fallujah,13,0,13,"al-Qaeda lines up a family of thirteen, including an elderly woman and two boys, and shoots them to death."
6480,18/2/2007,Thailand,Yala,3,24,27,Three more people are killed in separate bombings.
6481,18/2/2007,Thailand,Narathiwat,1,22,23,"Islamists stage a series of bombings against karaoke bars, killing at least one person."
6482,18/2/2007,Somalia,Mogadishu,4,0,4,A car explosion at a soccer stadium kills four people.
6483,18/2/2007,Somalia,Mogadishu,1,2,3,"Islamic gunmen attack a car carrying Somalis, killing at least one."
6484,18/2/2007,Afghanistan,Farah,4,2,6,Four policemen are killed in a suspected Taliban bomb attack.
6485,18/2/2007,Pakistan,Turab Gholato,2,0,2,Two children are killed by a landmine planted by Taliban-backed militants.
6486,18/2/2007,Iraq,Balad,6,0,6,The bodies of six victims of sectarian hatred are found around the country.
6487,18/2/2007,Iraq,Baghdad,7,11,18,Seven people are murdered in at least two separate Jihad attacks.
6488,18/2/2007,Iraq,Baghdad,60,131,191,Sixty Iraqis shopping at a market are blown to bits by Islamic Freedom Fighters.  Over a hundred others are injured.
6489,18/2/2007,Thailand,Pattani,3,0,3,Three Chinese Buddhists are gunned down in a brutal assault by Islamic radicals.
6490,19/2/2007,Iraq,Mosul,8,0,8,Eight people are kidnapped and shot to death by sectarian rivals.
6491,19/2/2007,Iraq,Dhuluiya,5,10,15,A suicide bomber murders five other people.
6492,19/2/2007,Iraq,Baghdad,30,40,70,"Ten people are killed in twin roadside blasts and a minibus attack, and another twenty victims of sectarian violence are found elsewhere."
6493,19/2/2007,Iraq,Ramadi,11,4,15,Two Fedayeen suicide bombers kill eleven other people along a city street.
6494,19/2/2007,Pakistan,North Waziristan,1,0,1,"Islamists cut off a man's head, hands and feet.  Dumping the body along with a note."
6495,19/2/2007,Thailand,Yala,1,1,2,Another bombing kills another Thai.  This time a soldier leaving his home.
6496,19/2/2007,Iraq,Tal Afar,4,5,9,A 12-year-old boy is among four people killed when terrorists booby-trap a house.
6497,19/2/2007,India,Moghal Maidan,1,2,3,A security patrol is brutally ambushed by the Mujahideen.
6498,20/2/2007,USA,"Nashville, TN",0,1,1,A Muslim cab driver runs over a Christian after arguing about religion.  The young man's ankle and hip are broken by the vehicle.
6499,20/2/2007,Iraq,Baghdad,33,0,33,Thirty-three victims of sectarian hatred within the Religion of Peace are found in the capital and in Mosul.
6500,20/2/2007,Somalia,Mogadishu,16,40,56,"Islamic militias rain down mortars on areas of the city, killing at least sixteen residents."
6501,20/2/2007,Pakistan,Gujranwala,1,0,1,A woman is shot to death by an Islamic extremist for not wearing a head scarf.
6502,20/2/2007,Iraq,Taji,5,138,143,"Islamic terrorists explode a truck near a restaurant, spreading chlorine gas over an area."
6503,20/2/2007,Iraq,Baghad,10,31,41,"Two Jihad bombings, one a gas station and the other at a vegetable market, kill ten innocent people."
6504,20/2/2007,Iraq,Baghdad,7,15,22,"A suicidal Sunni attacks a Shia funeral procession, killing seven innocents."
6505,20/2/2007,India,Anantnag,2,0,2,Two guards are killed by the Al-Mansooran terrorist group.
6506,20/2/2007,Thailand,Songkhla,1,0,1,A village chief is gunned down by Islamic radicals.
6507,21/2/2007,Somalia,Mogadishu,2,0,2,Two men are gunned down by suspected Islamists in separate attacks.
6508,21/2/2007,Thailand,Narathiwat,1,1,2,"Islamic radicals fire on two brothers, killing one."
6509,21/2/2007,Thailand,Narathiwat,1,0,1,A 55-year-old Buddhist woman is shot to death by Muslim radicals.
6510,21/2/2007,Afghanistan,Shindand,1,2,3,A female Spanish soldier is killed when Islamic radicals explode a mine under her truck.
6511,21/2/2007,Sudan,Umm Dhai,20,0,20,Arab militias backed by the Islamic Republic massacre another twenty villagers.
6512,21/2/2007,Thailand,Narathiwat,1,0,1,Militant Muslims shoot a teacher to death as he is riding to work.
6513,21/2/2007,Iraq,Najaf,11,38,49,Sunni terrorists murder eleven people with a suicide bomb blast.
6514,21/2/2007,Iraq,Baghdad,6,73,79,Six people are killed in a chlorine bomb attack by freedom fighters.
6515,21/2/2007,Pakistan,Badar,1,0,1,A civilian is gunned down in what appears to be a random terror attack.
6516,21/2/2007,Pakistan,Tank,1,0,1,A tribal elder is killed in his home by al-Qaeda backed militants.
6517,21/2/2007,Iraq,Baghdad,20,0,20,Twenty victims of sectarian hatred are found around the capital.
6518,22/2/2007,India,Wahipora,1,0,1,"A man is abducted by the Mujahideen, who kill him in captivity."
6519,22/2/2007,India,Damhal Khushipora,1,0,1,Terrorists shoot a civilian to death.
6520,22/2/2007,Iraq,Kirkuk,5,0,5,"Five people are kidnapped, tortured and shot to death by sectarian rivals."
6521,22/2/2007,Pakistan,Allah Bux Brohi,2,0,2,Two girls are hacked to death by their families for premarital sex.
6522,22/2/2007,Thailand,Narathiwat,1,1,2,A civilian is shot to death in a drive-by shooting by Muslim gunmen.
6523,23/2/2007,Philippines,Lamitan,1,0,1,Abu Sayyaf suspected in the murder of a man riding his bicycle.
6524,23/2/2007,Somalia,Mogadishu,9,20,29,At least three separate attacks by Islamic militias leave nine civilians dead.
6525,23/2/2007,Chechnya,Gudermes,5,3,8,Five police officers are killed in a bombing by Jihad fighters.
6526,23/2/2007,Thailand,Narathiwat,1,0,1,A 24-year-old man is murdered by Muslim radicals while sitting in a tea shop.
6527,23/2/2007,Iraq,Baghdad,6,8,14,A child is among six people killed by Islamic terrorists.
6528,24/2/2007,Thailand,Pattani,1,4,5,A 28-year-old civilian is gunned down by Muslim militants in front of his home.
6529,24/2/2007,India,Habbaniyah,1,0,1,The Mujahideen gun down a cop.
6530,24/2/2007,Iraq,Habbaniyah,52,110,162,"Over fifty innocent people are massacred by suicide bombers, who drive through the wall of a mosque on their way to paradise."
6531,24/2/2007,Iraq,Baghdad,23,33,56,Multiple Jihad attacks leave about two dozen people dead.
6532,25/2/2007,Pakistan,Larkana Tehsil,0,3,3,Three Hindu woman are gang-raped in their home at gunpoint by a Muslim gang.
6533,25/2/2007,Israel,Hebron,1,0,1,An Israeli settler is stabbed to death by Palestinian militants.
6534,25/2/2007,Pakistan,Kahan,3,0,3,A woman and two children are killed when Taliban-backed militants fire a rocket into a home.
6535,25/2/2007,Iraq,Baghdad,19,4,23,Nineteen people are murdered by Islamic terrorists in various attacks.
6536,25/2/2007,Iraq,Mosul,24,0,24,"Sectarian factions go on a killing spree, taking down at least two dozen Iraqis."
6537,25/2/2007,Iraq,Baghdad,42,55,97,"Suicide bombers strike a university, slaughtering at least forty innocents in the reception area."
6538,26/2/2007,Afghanistan,Khost,1,7,8,A policeman is killed when he tries to stop a suicide bomber from entering a station.
6539,26/2/2007,Iraq,Baghdad,6,31,37,Six people are killed when Islamic terrorists bomb a public works factory.
6540,26/2/2007,Iraq,Baghdad,4,0,4,A Scottish man is among four killed by a roadside bomb.
6541,26/2/2007,Afghanistan,Kandahar,2,1,3,A suicide bomber kills two civilians.
6542,26/2/2007,Saudi Arabia,Medina,4,0,4,A 17-year-old boy is among four French nationals brutally gunned down by Islamic purists.
6543,26/2/2007,Iraq,Baghdad,25,0,25,Twenty-five people are murdered in sectarian attacks within the Religion of Peace.
6544,27/2/2007,Iraq,al-Baaj,4,6,10,A suicide bomber walks into the reception area of a cement company and kills four other people.
6545,27/2/2007,Pakistan,Jandola,1,0,1,"A teacher is abducted and beheaded by militant Muslims, who then dump his body in a sack."
6546,27/2/2007,India,Wagoora,1,0,1,A man who was shot by the Mujahideen a week earlier succumbs to his injuries.
6547,27/2/2007,Afghanistan,Bagram,23,11,34,A Fedayeen suicide bomber blows apart two-dozen innocent lives.
6548,27/2/2007,Iraq,Mosul,7,42,49,Seven people are murdered when a suicide truck bomber detonates along a city street.
6549,27/2/2007,Pal. Auth.,Gaza,3,0,3,Three prostitutes are gunned down in suspected honor killings by religious fundamentalists.
6550,27/2/2007,Iraq,Baghdad,16,42,58,At least sixteen people are murdered in various attacks by Islamic terrorists.
6551,27/2/2007,Algeria,Ain Rich,3,1,4,Three security officers are killed in separate attacks by Islamic fundamentalists.
6552,28/2/2007,Iraq,Habaniya,4,14,18,"Jihadis lob mortars into a residential area, killing four people."
6553,28/2/2007,Iraq,Baghdad,16,0,16,Ten victims of sectarian violence are found murdered in the capital; six in Mosul.  Two were beheaded
6554,28/2/2007,Thailand,Pattani,1,0,1,A 59-year-old teacher is gunned down by Islamic terrorists.
6555,28/2/2007,Thailand,Narathiwat,1,0,1,Muslim militants shoot a middle-aged rubber worker to death by the side of the road.
6556,28/2/2007,Iraq,Muqdadiya,2,0,2,Two brothers are shot to death by sectarian terrorists.
6557,28/2/2007,Iraq,Baghdad,12,23,35,"Two car bombs, one a suicide blast and the other at a vegetable market, leave at least a dozen people dead."
6558,28/2/2007,Thailand,Pattani,1,0,1,A 48-year-old Buddhist is brutally shot to death by Muslim militants.
6559,1/3/2007,India,Kishtwar,2,0,2,A man and his father are killed inside their home by Harkat-ul-Jehad Islamic terrorists.
6560,1/3/2007,Jordan,Amman,1,0,1,A 23-year-old man strangles his 43-year-old aunt to death on the (erroneous) suspicion that she was not a virgin.
6561,1/3/2007,Pakistan,Punjab,1,0,1,"A Muslim murders a heretic after shouting, 'You are an infidel.'"
6562,1/3/2007,Iraq,Baghdad,16,4,20,At least two separate terror attacks leave sixteen people dead.
6563,1/3/2007,Afghanistan,Garmser,1,0,1,An Afghan doctor is kidnapped and murdered by extremists.
6564,1/3/2007,Afghanistan,Farah,3,48,51,"Taliban terrorists detonate a bomb by remote control, killing at least three civilians.  Ten children are among the injured."
6565,1/3/2007,Somalia,Mogadishu,1,0,1,Islamic insurgents kill the bodyguard of a government official.
6566,1/3/2007,Iraq,Fallujah,7,6,13,Seven people at a wedding party are murdered by a terrorist bombing.
6567,2/3/2007,Pakistan,Multan,3,8,11,"A bicycle bomb targets an anti-terror judge, killing at least three people."
6568,2/3/2007,Chechnya,Lada,2,1,3,A policeman and his wife are slaughtered in an ambush by Jihad warriors on their vehicle.
6569,2/3/2007,Thailand,Narathiwat,1,0,1,Islamic terrorists shoot a man to death while he is sitting in his pickup truck.
6570,2/3/2007,Iraq,Diyala,18,0,18,"Eighteen policemen are kidnapped by al-Qaeda and executed in captivity.  A video shows the killers screaming, ""Allah akbar,"" as they do their work."
6571,2/3/2007,Iraq,Baghdad,16,17,33,"Sunnis car bomb a used car lot, killing at least Shia patrons.  Six bodies are found elsewhere."
6572,2/3/2007,Iraq,Ramadi,2,0,2,Terrorists shoot to death two members of a soccer team.
6573,2/3/2007,Iraq,Iskandariya,4,10,14,"Freedom fighters lob mortars into a residential neighborhood, killing four people."
6574,2/3/2007,Afghanistan,Kunar,1,2,3,"Taliban terrorists attack a police station, killing an officer."
6575,3/3/2007,Thailand,Yala,1,0,1,A man is shot to death by Muslim radicals while on his way to work at a rubber plantation.
6576,3/3/2007,Thailand,Narathiwat,2,0,2,Two teenage girls are murdered by Islamists as they are on their way to take a school exam.
6577,3/3/2007,Afghanistan,Sangin,2,0,2,Two British soldiers are killed when Taliban militants fire rockets into their camp.
6578,3/3/2007,Indonesia,Ambon,0,13,13,At least a dozen people are injured in a nail bomb blast.  Children are among the casualties.
6579,3/3/2007,Afghanistan,Herat,2,17,19,Two Afghan civilians are blown to bits by a bomb planted by religious extremists.
6580,3/3/2007,Thailand,Pattani,1,0,1,A civilian is shot and killed by Muslim militants.
6581,3/3/2007,Algeria,Ain Defla,4,5,9,Four oil workers are murdered by Islamic fundamentalists while traveling in a bus.
6582,3/3/2007,Iraq,Tikrit,3,3,6,Three Iraqis are killed in a terrorist bombing.
6583,3/3/2007,Iraq,Latifiya,3,0,3,Freedom fighters murder a mother and her two children with a roadside bomb.
6584,3/3/2007,Iraq,Yusufiya,6,0,6,Six members of one family are shot to death inside their home by Sunnis angry that they were seeking peace with Shias.
6585,3/3/2007,Iraq,Ramadi,12,22,34,A child is among a dozen people blown to bits by a Fedayeen suicide bomber.
6586,4/3/2007,Afghanistan,Nangarhar,16,25,41,The Hezb-e-Islami terrorist groups takes responsibility for a suicide attack that kills sixteen Afghan civilians.
6587,4/3/2007,India,Dharmari,1,0,1,A civilian is shot dead by the Mujahideen.
6588,4/3/2007,Iraq,Baghdad,34,7,41,Thirty-four  people are killed by Islamic bombers and gunmen over a 24-hour period.
6589,4/3/2007,Iraq,Mosul,21,0,21,Four brothers are among twenty-one people murdered by Islamic terrorists in at least three attacks.
6590,4/3/2007,Algeria,Beni Yeni,7,1,8,"Islamic fundamentalists ambush a police convoy, killing seven people."
6591,4/3/2007,Afghanistan,Khost,2,10,12,"The Taliban attack a forest ranger station, killing two innocent people."
6592,4/3/2007,Pakistan,Nawabshah,2,0,2,A Muslim man hacks his sister and her lover to death with a hatchet in an honor killing.
6593,5/3/2007,Sudan,Graida,2,0,2,Two African Union peacekeepers are murdered by suspected Arab militias.
6594,5/3/2007,Somalia,Mogadishu,7,2,9,"Islamic militias are suspected in three separate shooting attacks that leave seven people dead, including business leaders."
6595,5/3/2007,Thailand,Pattani,2,0,2,Two Buddhist rice paddy workers are murdered by Muslim gunmen as they are working.
6596,5/3/2007,Thailand,Yala,2,0,2,Two men are gunned down by radical Muslims in a drive-by shooting.
6597,5/3/2007,Thailand,Yala,1,0,1,A 21-year-old Buddhist man is shot to death by Muslim insurgents while standing in a phone booth.
6598,5/3/2007,Iraq,Baghdad,26,54,80,Over two dozen people are slaughtered by a Fedayeen suicide bomber along a city street.
6599,5/3/2007,Iraq,Baghdad,13,27,40,Children are among those killed when Sunnis attack Shia pilgrims in at least three separate bombing and shooting attacks.
6600,5/3/2007,Iraq,Sulaiman Bek,4,0,4,Four people are tortured and shot to death by Islamic militants.
6601,5/3/2007,Thailand,Narathiwat,1,0,1,A 70-year-old Buddhist man is shot to death by militant Muslims.
6602,5/3/2007,Thailand,Yala,1,3,4,"Two married couples are targeted by Muslim gunmen, resulting in one death and three injuries."
6603,5/3/2007,Iraq,Baghdad,25,0,25,Twenty-five victims of sectarian hatred are found executed.
6604,6/3/2007,Iraq,Tikrit,14,76,90,Sunni gunmen shoot fourteen Shia pilgrims to death in at least four shooting attacks around the country.
6605,6/3/2007,Iraq,Mosul,5,18,23,"Terrorists set off a car bomb, killing five civilians."
6606,6/3/2007,Iraq,Baghdad,18,36,54,"Three car bombs set by radical Sunnis target Shia pilgrims, killing at least eighteen."
6607,6/3/2007,Iraq,Hilla,93,150,243,"Sunnis suicide bombers attack Shia pilgrims walking in a procession, killing about one-hundred in a brutal attack."
6608,6/3/2007,Afghanistan,Nangarhar,8,35,43,A highway attack by the Taliban leaves eight civilians dead and over thirty-five injured.
6609,6/3/2007,Thailand,Narathiwat,1,0,1,A 35-year-old Buddhist is murdered by militant Muslims in a drive-by attack.
6610,6/3/2007,Pakistan,Kandhkot,1,0,1,A woman is shot to death by her brother-in-law on suspicion of having an affair.
6611,6/3/2007,Philippines,Mindanao,1,2,3,"Moro Islamic Front terrorists attack a government post, killing a solider."
6612,6/3/2007,Pakistan,South Waziristan,7,1,8,"Uzbeki Mujahideen attack a local chieftain's home, killing his brothers.  Four others are killed in the ensuing gunfight."
6613,7/3/2007,Iraq,Baghdad,22,49,71,Sunnis kill another twenty-two Shia pilgrims walking by the side of the road in four separate attacks.
6614,7/3/2007,Somalia,Mogadishu,12,19,31,"Islamic militias ambush a Ugandan convoy, killing a dozen civilians along a city street."
6615,7/3/2007,Pakistan,Sui,1,12,13,"Terrorists detonate a bomb, killing a pro-government tribal elder and wounding 12 others."
6616,7/3/2007,Iraq,Diwaniya,2,0,2,Freedom fighters kill a police officer and his 10-year-old son.
6617,7/3/2007,Iraq,Balad Ruz,30,25,55,"A Fedayeen suicide bomber blows himself up in a cafe, taking the lives of thirty innocent people."
6618,7/3/2007,Thailand,Pattani,1,2,3,"A Buddhist man is shot to death by Islamic terrorists, who also injure his wife and a 7-year-old girl."
6619,7/3/2007,Thailand,Yala,1,1,2,"A 58-year-old Buddhist rubber tapper is beheaded by Muslim radicals, who then set his body on fire."
6620,8/3/2007,Pakistan,Tank,1,0,1,A Sunni activist is gunned down by radical Shias while sitting in a cafe.
6621,8/3/2007,Afghanistan,Mirwais Mena,1,5,6,"Three children are among five civilians injured by a suicide bomber.  Elsewhere, a German aid worker is killed."
6622,8/3/2007,Iraq,Hawija,3,0,3,"Jihadis kill two civilians with a bomb, and another in a shooting attack."
6623,9/3/2007,Pakistan,Dera Ismail Khan,1,0,1,A Shia businessman is shot to death by Sunni radicals.
6624,9/3/2007,Thailand,Narathiwat,1,0,1,"Islamists enter a grocery store pretending to be customers, then shoot the owner to death."
6625,9/3/2007,Pakistan,North Waziristan,1,0,1,An Afghan refugee is executed by Taliban militants.
6626,9/3/2007,India,Melapalayam,1,0,1,A 35-year-old woman is pelted with stones and stabbed to death by members of al-Umma for having an affair.
6627,9/3/2007,Iraq,Baghdad,10,0,10,Ten victims of sectarian hatred within the Religion of Peace are found murdered..
6628,9/3/2007,Afghanistan,Arghandab,2,6,8,Two civilians are killed and six wounded by a roadside bomb attack.
6629,10/3/2007,Pakistan,North Waziristan,1,0,1,A Pakistani solider is shot to death by Islamic militants at a checkpoint.
6630,10/3/2007,Iraq,Kirkuk,3,55,58,"Jihadis rocket a bus station, killing at least three innocents."
6631,10/3/2007,Iraq,Baghdad,27,37,64,Freedom fighters murder over two-dozen Iraqis in at least five separate attacks.
6632,10/3/2007,Afghanistan,Arghastan,8,2,10,Religious extremists cross over from Pakistan and kill eight Afghan border guards.
6633,10/3/2007,Somalia,Mogadishu,1,1,2,A bomb kills one person at a pasta factory.
6634,10/3/2007,Pakistan,Dera Ismail Khan,1,1,2,A government employee is killed by radical Sunnis while buying milk at a grocery.
6635,10/3/2007,Thailand,Yala,2,0,2,A Buddhist man and wife are brutally slain by Muslim gunmen as they are driving home from market.
6636,10/3/2007,Pakistan,Dwatoi,1,0,1,A Pakistani soldier is killed by radical militants along the Afghan border.
6637,10/3/2007,India,Srinagar,1,2,3,One member of a security patrol is killed when the Mujahideen hurl a grenade at them.
6638,10/3/2007,India,Tral,2,0,2,Two civilians are killed when fleeing militants use them as human shields.
6639,11/3/2007,Iraq,Baghdad,20,0,20,Twenty victims of sectarian hatred are found executed in various parts of the city.
6640,11/3/2007,Somalia,Mogadisuh,4,0,4,Four civilians are gunned down in separate attacks.
6641,11/3/2007,Afghanistan,Khost,4,0,4,Four policemen are killed in a terrorist bombing.
6642,11/3/2007,Iraq,Mussayab,5,7,12,Jihadis kill five people in two separate attacks.
6643,11/3/2007,Iraq,Baghdad,10,8,18,A suicide bomber kills ten fellow human beings.
6644,11/3/2007,Iraq,Karbala,32,25,57,"A suicidal Sunni targets a truck carrying Shia pilgrims, managing to murder over thirty."
6645,11/3/2007,Thailand,Narathiwat,1,0,1,A 60-year-old rubber tapper is shot to death by Islamists.
6646,11/3/2007,Thailand,Yala,2,0,2,"Two Buddhists, a brother and sister, are murdered by radical Muslims as they are returning from their rubber plantation."
6647,12/3/2007,Thailand,Pattani,3,10,13,"Islamists set off a bomb, injuring ten people, behead a migrant worker and shoot two more to death."
6648,12/3/2007,Pakistan,Jandola,1,0,1,al-Qaeda militants kidnap and behead a civilian.
6649,12/3/2007,Iraq,Kirkuk,4,0,4,Four firemen are killed by Islamic terrorists in a bombing.
6650,12/3/2007,Iraq,Baghdad,15,0,15,Fifteen victims of sectarian hatred within the Religion of Peace are found around the city.
6651,12/3/2007,Afghanistan,Bakwa,9,1,10,"Religious extremists blow up an Afghan police convoy, killing nine officers."
6652,12/3/2007,Somalia,Mogadishu,2,0,2,Islamic militias attack Ethiopian troops.  A boy and a woman are killed in the crossfire.
6653,12/3/2007,Iraq,Iskandariya,2,2,4,"Jihadis mortar a soccer field, killing two boys."
6654,12/3/2007,Somalia,Mogadishu,1,3,4,At least one person is killed when an Islamist tosses a bomb into a restaurant.
6655,12/3/2007,Pakistan,Dera Ismail Khan,1,0,1,A Shia rickshaw driver is gunned down by Sunni radicals.
6656,12/3/2007,Pakistan,Belod,3,0,3,Two men and a woman are shot and stoned to death for adultery by the Lashkar-Islam group.
6657,13/3/2007,Pakistan,Borianwala,2,0,2,A young woman and her lover are gunned down by her father and brothers in an honor killing.
6658,13/3/2007,Iraq,Mosul,18,4,22,Eighteen victims of sectarian violence are found over a 48-hour period.
6659,13/3/2007,Iraq,Baghdad,30,7,37,At least thirty people are killed in six separate bombing and shooting attacks by Islamic terrorists.
6660,13/3/2007,Pakistan,Dera Ismail Khan,2,1,3,"Two people, including a teacher, are gunned down in separate sectarian attacks."
6661,13/3/2007,Afghanistan,Lashkar Gah,1,6,7,A suicide bomber murders at least one other person.
6662,13/3/2007,Afghanistan,Spin Boldak,3,6,9,"Three civilians are blown to bits by a suicide bomber, who detonates in a crowd of people."
6663,13/3/2007,Somalia,Mogadishu,1,3,4,The 12-year-old son of the president is killed in a mortar attack by Islamic militias.
6664,13/3/2007,Somalia,Sheik Sufi,3,1,4,"Islamic militias fire shells into a neighborhood, killing three civilians."
6665,13/3/2007,Yemen,Saada,12,0,12,Twelve Yemeni soldiers are killed in a clash with radicals Shias.
6666,14/3/2007,Afghanistan,Khost,5,38,43,"A suicide bomber wearing a Muslim prayer cap strikes near a police patrol, killing five other people."
6667,14/3/2007,Afghanistan,Faryab,1,1,2,Taliban militants shoot a police officer off of a motorbike.
6668,14/3/2007,Thailand,Yala,9,1,10,"Islamists bomb a bus full of Buddhists, then shoot all of the victims at close range.  Two teenage girls are among those massacred."
6669,14/3/2007,Iraq,Hillah,3,0,3,Three off-duty policemen are brutally gunned down by Islamic terrorists.
6670,14/3/2007,Iraq,Mosul,2,4,6,Jihadis kill a man and his young child with mortars.
6671,14/3/2007,Iraq,Tuz Khurmato,10,15,25,"A suicide bomber yells, ""Allah Akbar,"" then blasts the life out of ten people at a market."
6672,14/3/2007,Iraq,Baqubah,4,0,4,Four decapitated heads are found.
6673,14/3/2007,Thailand,Yala,2,11,13,"Radicals throw a bomb into a coffee shop, killing two innocents."
6674,14/3/2007,Thailand,Yala,1,11,12,"Islamists bomb a moderate mosque, killing at least one person."
6675,14/3/2007,Somalia,Mogadishu,1,0,1,A human rights activist is gunned down while drinking tea at a shop.
6676,14/3/2007,Iraq,Baghdad,17,0,17,Freedom fighters murder seventeen Iraqis.
6677,15/3/2007,Iraq,Mosul,4,11,15,Two separate Jihad attacks leave four people dead.
6678,15/3/2007,Iraq,Iskandariya,6,23,29,Jihadis kill six passengers in a car-bomb attack on a bus.
6679,15/3/2007,Iraq,Baghdad,8,25,33,A Fedayeen suicide bomber takes out eight Iraqis and injures two dozen more.
6680,15/3/2007,Thailand,Narathiwat,1,0,1,A Muslim terrorist shoots an office worker three times in the back before fleeing.
6681,16/3/2007,Somalia,Mogadishu,7,1,8,"Islamic militias bomb a house, killing seven people, including four children."
6682,16/3/2007,Pal. Auth.,Gaza,1,0,1,A government official is killed by a Hamas gunmen.
6683,16/3/2007,India,Baramulla,1,7,8,"The Mujahideen throw a bomb into a bus stop, killing one person."
6684,16/3/2007,Afghanistan,Kabul,1,0,1,The Taliban execute the captured Afghan driver of an Italian journalist.
6685,16/3/2007,Iraq,Fallujah,8,350,358,"Freedom fighters unleash suicide chlorine bombers on a populace, killing at least eight and injuring hundreds."
6686,16/3/2007,Iraq,Baghdad,12,0,12,Twelve people are killed by sectarian Jihadis in at least two attacks.
6687,16/3/2007,Iraq,Mosul,4,0,4,"Terrorists slay two men and two women, but leave two infants alive beside the bodies."
6688,17/3/2007,Iraq,Mahmudiya,2,0,2,Two people are tortured to death by Islamic terrorists.
6689,17/3/2007,Iraq,Baghdad,19,0,19,Sunni-Shia sectarian violence leaves at least nineteen dead.
6690,17/3/2007,Afghanistan,Farah,2,0,2,Two policemen are killed during an ambush on their convoy by religious extremists.
6691,17/3/2007,Afghanistan,Kandahar,2,2,4,Two children are murdered by a suicide bomber.
6692,17/3/2007,Thailand,Songkhla,3,7,10,"Muslim terrorists attack a boarding school with bullets and bombs, killing three children and injuring at least seven more."
6693,18/3/2007,Iraq,Iskandariya,2,0,2,A woman and her daughter are killed when Freedom Fighters lob a mortar into their home.
6694,18/3/2007,Iraq,Mosul,4,0,4,Four people are kidnapped and killed by Islamic terrorists.
6695,18/3/2007,Iraq,Ramadi,9,0,9,Nine Iraqi policemen are tortured and then decapitated by Sunni militants.
6696,18/3/2007,Somalia,Kismayo,1,0,1,Islamic insurgents assassinate a police chief.
6697,18/3/2007,Thailand,Songkhla,2,2,4,"Two Buddhist factory workers, a mother and daughter, are shot to death by Islamic terrorists."
6698,18/3/2007,Thailand,Songkhla,1,0,1,A Buddhist man is shot off of his motorcycle by Muslim radicals.
6699,18/3/2007,Pakistan,Mardan,1,0,1,"Religious extremists gun down a watchman, then set fire to four music shops."
6700,18/3/2007,Iraq,Baghdad,6,30,36,"Sunni terrorists detonate a car bomb in a Shia neighborhood, killing six residents."
6701,18/3/2007,Somalia,Mogadishu,2,18,20,Two people are killed when Islamic militias bomb a restaurant.
6702,19/3/2007,Thailand,Pattani,3,3,6,Three Buddhist women are shot to death by militant Muslims while riding to work at a farm.
6703,19/3/2007,Pakistan,Jacobabad,1,0,1,A woman is killed by her brother for having 'illicit' relations outside of marriage.
6704,19/3/2007,Iraq,Baghdad,4,25,29,"Sunni radicals plant a bomb in a Shia mosque, killing four worshippers."
6705,19/3/2007,Iraq,Kirkuk,12,39,51,Jihadis massacre a dozen Iraqis with car bombs.
6706,19/3/2007,Pakistan,Tank,1,0,1,A policeman is shot to death by Taliban militants.
6707,19/3/2007,Pakistan,South Waziristan,2,6,8,Two children are killed in crossfire between rival Islamist groups.
6708,19/3/2007,Afghanistan,Kabul,1,5,6,A 15-year-old boy is killed by a suicide bomber.
6709,20/3/2007,Afghanistan,Zabul,1,0,1,An Afghan driver's decapitated body is found a week after he was killed by the Taliban.
6710,20/3/2007,Thailand,Narathiwat,1,2,3,Muslim radicals murder a Thai soldier and injure two others in a shooting attack.
6711,20/3/2007,Somalia,Mogadishu,6,36,42,"Four Somali and two Ethiopian soldiers are killed by Islamists, who drag the bodies of several through the streets."
6712,20/3/2007,Somalia,Mogadishu,3,0,3,Three civilians are killed when Islamic militias mortar a neighborhood.
6713,20/3/2007,Iraq,al-Touz,2,0,2,Two brothers are killed by Muslim terrorists.
6714,20/3/2007,Iraq,Baghdad,43,36,79,Forty-three victims of sectarian hatred within the Religion of Peace lose their lives in at least three separate attacks.
6715,20/3/2007,Iraq,Mosul,12,40,52,A suicide bomber is one of two Sunni extremists who kill innocent people in separate attacks.
6716,21/3/2007,Nigeria,Gombe,1,0,1,"A female Christian teacher is attacked and killed by her students, who accused her of 'desecrating' the Qur'an."
6717,21/3/2007,Iraq,Baghdad,33,0,33,Thirty-three people are killed in sectarian violence within the Religion of Peace.
6718,21/3/2007,Iraq,al-Madaen,8,18,26,"Jihadis slam two mortars into a residential area, killing eight people."
6719,22/3/2007,Iraq,Baghdad,28,5,33,Twenty-eight victims of sectarian violence are killed in various attacks.
6720,22/3/2007,Iraq,Kirkuk,3,7,10,Two Jihad attacks leave three civilians dead.
6721,22/3/2007,India,Kupwara,1,0,1,A policeman dies of injuries suffered in a Mujahideen attack two days earlier.
6722,22/3/2007,Somalia,Kismayo,1,3,4,A woman is killed in a grenade attack.
6723,23/3/2007,Afghanistan,Kandahar,17,4,21,"Taliban extremists ambush a supply convoy, killing two truck drivers and fifteen security guards."
6724,23/3/2007,Iraq,al Bu Ajeel,4,0,4,An infant is among four members of a family murdered inside their home by Muslim gunmen.
6725,23/3/2007,Iraq,Mosul,4,0,4,Two teenagers are among four people slain by Islamic radicals.
6726,23/3/2007,Iraq,Baghdad,26,2,28,A mother and daughter are among two dozen people murdered by sectarian Jihadis.
6727,23/3/2007,Iraq,Baghdad,6,19,25,Six people are killed in a Jihad car bombing at a used car lot.
6728,23/3/2007,Iraq,Baghdad,9,15,24,Nine people are killed during an assassination attempt on the country's vice president by Islamic terrorists.
6729,23/3/2007,Somalia,Mogadishu,2,8,10,Islamic insurgents attack Ethiopian troops.  At least two people are killed.
6730,23/3/2007,Somalia,Mogadishu,11,0,11,"Somali Islamists shoot down a cargo plane with a rocket, killing eleven Belarus civilians."
6731,23/3/2007,Pal. Auth.,Gaza,1,3,4,A 2-year-old child is killed in the crossfire when Fatah and Hamas open up on each other.
6732,23/3/2007,Afghanistan,Kandahar,5,5,10,"In three separate attacks, religious extremists ambush Afghan police, killing at least five."
6733,23/3/2007,India,Shopian,1,0,1,A 16-year-old girl is shot and killed by the Mujahideen.
6734,24/3/2007,Iraq,Fallujah,12,0,12,Sunni terrorists murder a dozen people.
6735,24/3/2007,Iraq,Tal Afar,10,3,13,"A Fedayeen bomber blows himself up in a market, killing eight shoppers at a pastry shop."
6736,24/3/2007,Iraq,Haswa,11,45,56,Eleven people at a rival mosque are killed by a suicidal Muslim blasting his way to paradise.
6737,24/3/2007,Iraq,Baghdad,36,26,62,"A suicide truck bomber kills rival Muslims in a neighborhood, as sixteen bodies are found elsewhere."
6738,24/3/2007,Thailand,Narathiwat,2,0,2,Two Buddhist policemen are shot to death at point-blank range at a market by Muslim radicals.
6739,24/3/2007,Chechnya,Grozny,1,3,4,A Russian is killed in a Mujahideen roadside bomb attack.
6740,24/3/2007,Sudan,Sirba,3,15,18,Three African villagers are killed by Arab militias in a deadly raid.
6741,24/3/2007,Iraq,Baghdad,9,0,9,Nine Iraqi children playing soccer are deliberately machine-gunned to death by Sunni terrorists.
6742,25/3/2007,Iraq,Baghdad,27,33,60,At least twenty-seven people are killed by sectarian violence within the Religion of Peace.
6743,25/3/2007,Iraq,Baqubah,7,0,7,A suicide bomber is one of at least two attacks that leaves seven Iraqis dead.
6744,25/3/2007,India,Tral,1,0,1,A police officer is kidnapped and strangled by the Mujahideen.
6745,25/3/2007,Afghanistan,Maidan Wardak,2,2,4,"The Taliban attack a police station, killing two Afghan officers."
6746,26/3/2007,Iraq,Kirkuk,2,0,2,"Two elderly nuns, aged 79 and 85, are stabbed to death in their home."
6747,26/3/2007,Yemen,Saada,2,0,2,Two Western students (British and French) are killed by radical Shiites.
6748,26/3/2007,Iraq,Baghdad,21,8,29,At least three separate Jihad attacks leave nearly two-dozen Iraqis dead.
6749,26/3/2007,Iraq,Fallujah,3,0,3,Two women and a 14-year-old boy are brutally murdered by Islamic insurgents.
6750,26/3/2007,Pakistan,Tank,2,13,15,"Militants attack a police station, killing two security staff."
6751,26/3/2007,Thailand,Pattani,1,1,2,"Militant Muslims shoot two Buddhist electricians, killing one"
6752,27/3/2007,Iraq,Diwaniya,6,0,6,A half-dozen Iraqis are murdered in Jihad attacks.
6753,27/3/2007,Iraq,Baghdad,19,15,34,At least nineteen people are killed in sectarian violence within the Religion of Peace.
6754,27/3/2007,Iraq,Ramadi,17,32,49,A suicidal Sunni murders seventeen people in a restaurant.
6755,27/3/2007,Iraq,Tal Afar,152,347,499,"Freedom fighters use twin truck bombs at two markets to massacre over one-hundred and fifty Iraqis.  Afterwards, they attack ambulances carrying the wounded."
6756,27/3/2007,Afghanistan,Kabul,1,2,3,Islamic militants kill a Pakistani engineer and injure two Afghans in a shooting ambush.
6757,27/3/2007,Afghanistan,Lashkar Gah,4,4,8,"A religious extremist blows himself up in a police station, killing four people."
6758,27/3/2007,Afghanistan,Bajaur,5,0,5,Islamic terrorists kill four Pakistani intelligence agents on a remote highway.
6759,28/3/2007,Algeria,Kabylie,3,0,3,Three Algerian security forces are attacked and killed by Islamic fundamentalists.
6760,28/3/2007,Afghanistan,Kabul,4,12,16,A suicide bomber kills four people at a market.
6761,28/3/2007,Pakistan,Tank,2,4,6,Two people are killed in a militant attack.
6762,28/3/2007,India,Rajouri,1,0,1,A civilian is beheaded in his village by the Mujahideen.
6763,28/3/2007,Thailand,Yala,1,0,1,Radical Muslims shoot an elderly Buddhist man twice in the chest.  He dies on his way to the hospital.
6764,28/3/2007,Thailand,Pattani,1,1,2,A 35-year-old Buddhist man is murdered by Islamic gunmen in an attack that also injures his wife.
6765,28/3/2007,Iraq,Suwayra,5,0,5,"Five people are kidnapped and killed, including one by beheading."
6766,28/3/2007,Iraq,Baghdad,29,55,84,A chlorine bombing is among four Jihad attacks that leave two dozen Iraqis dead.
6767,28/3/2007,Iraq,Tal Afar,50,70,120,"Sectarian killings net over fifty Iraqis, mostly reprisals for the previous day's bombing."
6768,29/3/2007,Pakistan,Kharian,2,7,9,"An elderly suicide bomber wanders into a group of soldiers, resting after training, and kills two."
6769,29/3/2007,India,Rajouri,5,4,9,Five Hindus working on a remote road are brutally murdered by Islamists.
6770,29/3/2007,Iraq,Mahmudiya,5,20,25,"An eye doctor is gunned down on his way to work, as Islamic terrorists also kill four other innocents with a car bomb."
6771,29/3/2007,Iraq,Khalis,53,103,156,"Sunni terrorists use multiple, coordinated car bombs to slaughter over fifty Iraqi Shias."
6772,29/3/2007,Iraq,Baghdad,41,46,87,At least three Jihad attacks leave more than forty civilians dead.
6773,29/3/2007,Iraq,Baghdad,82,138,220,"Suicide bombers strike a marketplace, massacring over eighty shoppers and leaving more than a hundred others in agony."
6774,29/3/2007,Somalia,Mogadishu,2,12,14,"Islamic militias mortar a mosque, killing two children."
6775,30/3/2007,Iraq,Suwayra,9,0,9,Nine Iraqis are bound and executed by Islamic terrorists here and at Tal Afar.
6776,30/3/2007,Thailand,Pattani,1,4,5,A Buddhist policeman is killed in a Muslim bombing.
6777,30/3/2007,Pakistan,Shen Warsak,2,0,2,Two children are killed when Uzbeki militants fire a rocket into their home.
6778,30/3/2007,Afghanistan,Kandahar,5,1,6,"Religious fundamentalists attack a government checkpoint, killing five Afghans."
6779,30/3/2007,Iraq,Mosul,44,0,44,"Twenty-five victims of sectarian violence are found in Mosul, a dozen in Baghdad, and seven in Baqubah."
6780,31/3/2007,Thailand,Narathiwat,2,0,2,An elderly Buddhist couple is murdered in their store by Islamic gunmen posing as customers.
6781,31/3/2007,Thailand,Pattani,1,0,1,A retired teacher is shot to death by radical Muslims.
6782,31/3/2007,Chad,Tiero and Marena,200,0,200,"Janjaweed militias surround two African villages and fire into them, killing at least two-hundred Africans, including women and children."
6783,31/3/2007,Iraq,Hilla,4,23,27,Four people are killed when Muslim terrorists detonate a car bomb along a city street.
6784,31/3/2007,Iraq,Kirkuk,8,2,10,Four brothers are among eight civilian workers murdered by Jihadis in an ambush on their bus.
6785,31/3/2007,Iraq,Baghdad,19,22,41,"Freedom fighters car bomb a hospital, killing five Iraqis.  Fourteen bodies are found elsewhere."
6786,31/3/2007,Afghanistan,Kandahar,7,4,11,Seven Afghan cops are killed in a brutal ambush by Taliban extremists.
6787,31/3/2007,Sudan,Bolbol Jazou,30,0,30,Thirty villagers are reported dead in the second town to be attacked by Janjaweed militia.
6788,31/3/2007,Sudan,Nyala,23,0,23,Twenty-three villagers are massacred by Arab militias.
6789,31/3/2007,Thailand,Narathiwat,1,0,1,A 29-year-old man is shot to death by radical Muslims.
6790,31/3/2007,Somalia,Mogadishu,1,4,5,"Islamists fire mortars at the presidential palace, killing at least one person."
6791,1/4/2007,Afghanistan,Mihtarlam,5,6,11,Three children are among five civilians blown up by a suicidal religious extremist.
6792,1/4/2007,Afghanistan,Musa Qala,3,0,3,Three villagers are abducted and hanged by the Taliban.
6793,1/4/2007,Thailand,Pattani,1,0,1,A truck driver is shot to death by Islamic radicals.
6794,1/4/2007,Thailand,Narathiwat,1,0,1,A 34-year-old Buddhist is shot off his motorcycle by militant Muslims while riding to work.
6795,1/4/2007,Sudan,Um Baru,5,0,5,Muslim gunmen shoot five AU peacekeepers to death in an unprovoked attack.
6796,1/4/2007,Iraq,Baghdad,37,22,59,Islamic terrorists rack up three-dozen dead Iraqis in various attacks around the country.
6797,1/4/2007,India,Baramulla,1,0,1,Jihadis shoot a politician to death.
6798,2/4/2007,Pakistan,Shalobar,2,9,11,"Two people, including a student, are killed by gunfire during a sectarian clash."
6799,2/4/2007,Iraq,Baghdad,20,15,35,At least three separate Jihad attacks leave twenty people dead.
6800,2/4/2007,Iraq,Khalis,3,20,23,"A suicide bomber targets a restaurant, killing at least three patrons."
6801,2/4/2007,Iraq,Baqubah,21,0,21,Twenty-one people are abducted and murdered by Jihadis.
6802,2/4/2007,Iraq,Kirkuk,13,167,180,"Radical Sunnis bomb a school, killing thirteen, including eight schoolgirls and a baby.  Nearly two-hundred others are wounded."
6803,2/4/2007,Pakistan,Shin Warsak,2,0,2,"Foreign militants storm a local residence, killing a man and a 15-year-old boy."
6804,2/4/2007,Iraq,Sab al-Bor,1,0,1,An 11-year-old boy has his throat slit by al-Qaeda.
6805,2/4/2007,Afghanistan,Kandahar,3,2,5,"Religious extremists attack a police checkpoint, killing three officers."
6806,3/4/2007,Thailand,Narathiwat,1,1,2,"Islamists shoot at two men riding a motorcycle, killing one."
6807,3/4/2007,Thailand,Pattani,3,0,3,Muslim radicals ambush and kill three Thai policemen.
6808,3/4/2007,Iraq,Baqubah,17,0,17,Jihadis kill seventeen people in attacks in three different cities.
6809,3/4/2007,Iraq,Baghdad,15,2,17,Sectarian attacks at a university and elsewhere leave fifteen Iraqis dead.
6810,4/4/2007,Algeria,Biskra,3,7,10,An al-Qaeda attack leaves three Algerian soldiers dead and seven more injured.
6811,4/4/2007,Thailand,Narathiwat,2,0,2,Islamic radicals open up with automatic weapons on two men leaving a tea shop.
6812,4/4/2007,India,Tral,1,0,1,A woman succumbs to injuries following a Mujahideen attack.
6813,4/4/2007,Iraq,Hilla,3,0,3,Two people are beheaded and a prostitute is stabbed to death by religious fundamentalists.
6814,4/4/2007,Iraq,Kirkuk,11,0,11,Freedom fighters murder eleven power plant workers.
6815,5/4/2007,Iraq,Basra,5,1,6,Iran is suspected to be behind the death of four British soldiers and a civilian in a bomb attack.
6816,5/4/2007,Thailand,Yala,0,16,16,"Radical Muslims bomb a rival mosque, injuring sixteen people."
6817,5/4/2007,Afghanistan,Kandahar,1,7,8,An Afghan police officer is killed when the Taliban bomb his vehicle.
6818,5/4/2007,Afghanistan,Khost,1,3,4,Religious extremists shoot an Afghan interpreter to death.
6819,5/4/2007,Afghanistan,Zabul,5,0,5,Religious extremists kill five Afghans guarding a road.
6820,5/4/2007,Iraq,Diyala,22,0,22,At least two women are among twenty-two people kidnapped and either shot to death or beheaded by the Religion of Peace.
6821,5/4/2007,Iraq,Baghdad,13,0,13,"Gunmen kill thirteen civilians, including a child, in separate attacks."
6822,5/4/2007,Thailand,Narathiwat,1,0,1,Islamic extremists murder a 52-year-old man inside his home.
6823,5/4/2007,Thailand,Narathiwat,1,1,2,A 51-year-old man is ambushed and killed by Islamic terrorists.
6824,5/4/2007,Thailand,Narathiwat,2,0,2,Two civilians are shot to death by Muslim radicals as they are traveling in a car.
6825,5/4/2007,Iraq,Baghdad,1,0,1,A mother of three is kidnapped and shot to death by Sunni terrorists.
6826,6/4/2007,Iraq,Tal Afar,19,5,24,A child is among nineteen people found dead here and in the capital following sectarian terror attacks.
6827,6/4/2007,Iraq,Ramadi,25,30,55,"Freedom fighters use a chlorine truck bomb to kill twenty-five Iraqis, mostly civilians."
6828,6/4/2007,Yemen,Amran,0,30,30,"Radicals rampage through a rival mosque, spraying gasoline and setting people on fire."
6829,6/4/2007,Afghanistan,Kabul,6,4,10,A suicide bomber takes out five civilians and the police officer who tried to stop him.
6830,6/4/2007,Saudi Arabia,Medina,1,2,3,A police officer is killed in an attack by an al-Qaeda suspect.
6831,7/4/2007,India,Baramulla,1,0,1,A civilian is abducted and murdered by the Mujahideen.
6832,7/4/2007,Philippines,Parang,10,2,12,"Ten people, including a civilian, are killed in an ambush by suspected Abu Sayyaf terrorists."
6833,7/4/2007,Afghanistan,Farah,7,4,11,The Taliban murder seven Afghans trying to clear land mines.
6834,7/4/2007,Algeria,Zaccar Forest,9,7,16,Nine Algerian soldiers are ambushed and killed by Islamic fundamentalists.
6835,7/4/2007,Iraq,Karbala,6,0,6,Six shepherds are murdered by Islamic terrorists.
6836,7/4/2007,Iraq,Baqubah,27,2,29,Twenty-seven victims of sectarian violence within the Religion of Peace are found around the city.
6837,7/4/2007,Iraq,Baghdad,15,5,20,Shootings and bombings leave at least fifteen dead.
6838,7/4/2007,Pakistan,Parachinar,10,83,93,Sunni gunmen open up on a crowd of Shias leaving a mosque.  Ten people are killed in the ensuing firefight.
6839,8/4/2007,Afghanistan,Kabul,1,0,1,The Taliban beheads a kidnapped Afghan journalist.
6840,8/4/2007,Pakistan,Wana,2,0,2,A tribal leader and his deputy are shot to death by al-Qaeda backed militants.
6841,8/4/2007,Pakistan,Sadda,2,0,2,Two Sunnis are killed by radical Shia gunmen.
6842,8/4/2007,Pakistan,Boshera,5,0,5,Three women and two children are killed in sectarian violence.
6843,8/4/2007,Pakistan,Karman,1,0,1,A Shia civilian is shot to death by Sunnis.
6844,8/4/2007,Pakistan,Mallikhel,2,0,2,Sunnis murder two Shias in a sectarian attack.
6845,8/4/2007,Pakistan,Chardiwar,2,0,2,Two Shias are gunned down by Sunni terrorists.
6846,8/4/2007,Pakistan,Pewer,4,0,4,Four Shias are shot to death by radical Sunnis.
6847,8/4/2007,Iraq,Baghdad,24,21,45,A suicide car bomber is one of several Jihad attacks that leave two-dozen Iraqis dead.
6848,8/4/2007,Iraq,Mahmoudiyah,18,23,41,"Freedom fighters bomb a hospital, killing eighteen Iraqis."
6849,8/4/2007,Afghanistan,Kandahar,6,0,6,Six Canadians are killed by Taliban extremists in a roadside blast.
6850,8/4/2007,Thailand,Narathiwat,1,0,1,Islamic radicals shoot and kill a civilian outside his home.
6851,8/4/2007,Thailand,Yala,1,0,1,A rubber plantation worker is shot to death by Islamists.
6852,9/4/2007,Thailand,Yala,1,0,1,A Buddhist ice cream vendor is gunned down by Muslim terrorists.
6853,9/4/2007,Thailand,Yala,1,0,1,A 34-year-old Buddhist man is killed in a drive-by shooting by Islamic radicals.
6854,9/4/2007,Thailand,Yala,1,0,1,A 55-year-old truck driver's body is ripped in half by a Muslim bomb.
6855,9/4/2007,Thailand,Pattani,1,0,1,Muslims gun down a Buddhist civilian in a drive-by.
6856,9/4/2007,Afghanistan,Khakraiz,1,0,1,A civilian is killed in a Taliban attack.
6857,9/4/2007,Afghanistan,Zabul,4,19,23,"Religious extremists ambush a military convoy, killing four Afghan soldiers."
6858,9/4/2007,Iraq,Baghdad,17,0,17,The bodies of seventeen victims of sectarian violence within the Religion of Peace are found.
6859,10/4/2007,India,Srinagar,1,10,11,A shopkeeper is killed when Mujahideen terrorists toss a grenade into his store.
6860,10/4/2007,Morocco,Casablanca,1,1,2,A police officer is killed by a suicide bomber.
6861,10/4/2007,Pakistan,Shingak,1,0,1,Sectarian violence within the Religion of Peace claims another life.
6862,10/4/2007,Pakistan,Ibrahimzai,1,0,1,A man is killed in fighting between sectarian factions.
6863,10/4/2007,Pakistan,Balishtkhel,3,0,3,Fighting between Sunnis and Shia leaves three people dead.
6864,10/4/2007,Pakistan,Pir Qayyum,3,0,3,Three people lose their lives in sectarian violence.
6865,10/4/2007,Iraq,Fallujah,10,1,11,"Five victims of sectarian violence are found here, and five others elsewhere."
6866,10/4/2007,Iraq,Hilla,2,4,6,"Islamic terrorists plant a bomb in a home, netting six casualties from the same family."
6867,10/4/2007,Iraq,Baghdad,1,17,18,One 6-year-old boy is killed and seventeen other children and teachers injured when Jihadis send a rocket into a basketball court.
6868,10/4/2007,Iraq,Baghdad,6,11,17,Six people are murdered when Sunni radicals set off a bomb near a university.
6869,10/4/2007,Iraq,Muqdadiyah,21,33,54,A woman with explosives hidden beneath her abaya wades into a crowd of police recruits and slaughters sixteen.  A second bombing kills five more.
6870,11/4/2007,Afghanistan,Kandahar,2,9,11,Nine civilians are wounded by a suicide bomber.  Two Canadians are killed in a separate bombing.
6871,11/4/2007,Thailand,Yala,1,0,1,A 26-year-old Buddhist woman is burned alive by the Religion of Peace.
6872,11/4/2007,Thailand,Narathiwat,1,0,1,A 50-year-old man is murdered by Muslim gunmen.
6873,11/4/2007,Thailand,Yala,2,0,2,A 19-year-old Buddhist man and his mother are gunned down by radical Muslims.
6874,11/4/2007,Algeria,Algiers,33,222,255,Thirty-three people are killed by Islamic fundamentalists in three separate suicide bombings.
6875,11/4/2007,Somalia,Mogadishu,3,0,3,Three people riding a minibus are shot full of holes in an attack by Islamic gunmen.
6876,11/4/2007,Bangladesh,Jhalakathi,1,0,1,Jama'atul Mujahideen is suspected to be behind the assassination of a prosecutor.
6877,11/4/2007,Pakistan,Kurram,3,11,14,Separate missile attacks on three villages by Islamic radicals kill at least three civilians.
6878,11/4/2007,Pakistan,Sadda,27,30,57,Sectarian clashes between Sunni and Shia leave at least twenty-seven dead.
6879,11/4/2007,Iraq,Baghdad,34,8,42,A teacher is among thirty-four people murdered by Islamic terrorists in at least five attacks around the country.
6880,11/4/2007,Iraq,Mosul,2,0,2,A woman journalist and her husband are kidnapped and brutally murdered.  Their bodies are set on fire.
6881,11/4/2007,Sudan,Abujogh Market,40,25,65,Arab militias massacre forty African villagers in an attack with heavy machine-guns.
6882,12/4/2007,Somalia,Mogadishu,52,165,217,Islamic militias shoot rockets and mortars into populated areas in a running battle against the government.
6883,12/4/2007,Iraq,Kirkuk,6,19,25,"Holy warriors bomb a minibus, killing six passengers."
6884,12/4/2007,Iraq,Baghdad,10,30,40,"Jihadis bomb a bridge, killing ten Iraqi commuters."
6885,12/4/2007,Iraq,Baghdad,8,23,31,"A Fedayeen suicide bomber detonates in a parliament building, killing eight fellow Iraqis."
6886,12/4/2007,Somalia,Mogadishu,2,0,2,Two civilians are killed from stray bullets as Islamic militias ambush government troops.
6887,12/4/2007,Pakistan,Chardiwar,5,6,11,"Sunni gunmen raid a Shia village, killing five civilians."
6888,12/4/2007,Pakistan,Miranshah,1,3,4,One civilian is killed when militants fire a rocket into a house.
6889,12/4/2007,Philippines,Indanan,2,10,12,Abu Sayyaf gunmen kill two Filipino soldiers.
6890,12/4/2007,Iraq,Baghdad,19,9,28,Sectarian violence claims the lives of nearly twenty people around the capital.
6891,13/4/2007,India,Batmalu,1,1,2,Hizb-ul-Mujahideen opens fire on a policeman in a brutal attack that also injures a young girl.
6892,13/4/2007,Thailand,Narathiwat,1,0,1,A 19-year-old boy is shot to death by Muslim radicals.
6893,14/4/2007,Afghanistan,Khost,8,6,14,Eight Afghan police are murdered by a Fedayeen suicide bomber.
6894,14/4/2007,Iraq,Karbala,47,224,271,Sixteen children are among 47 Shias slaughtered by a suicidal Sunni bomber at a bus station near a crowded market.
6895,14/4/2007,Thailand,Narathiwat,2,0,2,Islamic terrorists gun down two civilians riding a motorcycle.
6896,14/4/2007,Philippines,Panamao,3,10,13,A child is among three killed when Moro Islamic Front terrorists attack a military camp.
6897,14/4/2007,Algeria,Boumerdes,4,2,6,Four Algerian security are killed in an ambush by Islamic fundamentalists.
6898,14/4/2007,Iraq,Baghdad,29,19,48,Twenty-nine people are murdered by sectarian Jihadis in at least three attacks around the country.
6899,14/4/2007,Iraq,Baghdad,35,50,85,A suicide car bomber kills thirty-five Iraqi commuters on a downtown bridge.
6900,15/4/2007,India,Pulwama,1,0,1,"A Christian church worker is kidnapped, brutally tortured and then beheaded by the Mujahideen."
6901,15/4/2007,Thailand,Narathiwat,1,0,1,"A 70-year-old Buddhist man is shot three times in the torso by Muslim radicals, who then set fire to his body."
6902,15/4/2007,Algeria,Ait Mahmoud,2,0,2,Two Berber civilians are shot to death by five Islamic militants.
6903,15/4/2007,Afghanistan,Spin Boldak,4,1,5,A suicide bomber kills several Afghans in an attack on a highway.
6904,15/4/2007,Iraq,Mosul,4,16,20,Four people are killed when suicidal Sunnis drive bomb-laden trucks into a building.
6905,15/4/2007,Iraq,Baghdad,15,50,65,A coordinated bomb attack on a market leave about fifteen patrons dead and another fifty in agony.
6906,15/4/2007,Iraq,Baghdad,44,43,87,"Several attacks by Jihadis, including three car bombings, leave over forty Iraqi civilians dead."
6907,15/4/2007,India,Munawajji,2,1,3,Two civilians are murdered in a shooting attack on their vehicle by the Mujahideen.
6908,16/4/2007,Iraq,Diyala,1,1,2,Fundamentalists kill a barber in his shop.
6909,16/4/2007,Thailand,Yala,1,0,1,Islamists murder a civilian in a drive-by attack outside a tea shop.
6910,16/4/2007,Thailand,Yala,1,0,1,A town mayor is gunned down in a Muslim terror attack outside his home.
6911,16/4/2007,Thailand,Narathiwat,1,3,4,"Ten Islamic militants open fire on a Thai army base, killing one soldier."
6912,16/4/2007,Afghanistan,Kunduz,10,32,42,A Fedayeen suicide bomber kills ten Afghans and injures another thirty.
6913,16/4/2007,Pakistan,Badh Beer,3,4,7,"Three children are killed, and four others injured when militants toss a grenade into a family home."
6914,16/4/2007,Iraq,Mosul,23,4,27,Two college professors and a 17-year-old boy are two dozen Iraqis murdered in four separate attacks
6915,16/4/2007,Iraq,Baghdad,14,7,21,A female university student is among fourteen people murdered in separate Jihad attacks.
6916,16/4/2007,Pakistan,Kohat-Peshawar,1,2,3,A man is shot to death by Islamic terrorists in an attack on a highway.
6917,16/4/2007,India,Doda,1,1,2,"Two civilians are abducted by the Mujahideen, who kill one in captivity."
6918,16/4/2007,India,Pulwama,1,0,1,Lashkar-e-Toiba militants kill a guard near a railway track.
6919,17/4/2007,Nigeria,Kano,13,0,13,A woman is among thirteen people torn apart by Muslim fundamentalists in a mob attack.
6920,17/4/2007,Afghanistan,Herat,4,3,7,Four children are killed by a bomb planted by religious extremists at their school.
6921,17/4/2007,Afghanistan,Kandahar,5,0,5,"The Taliban bomb a UN vehicle, killing five occupants."
6922,17/4/2007,Iraq,Baghdad,15,16,31,A university professor is among fifteen people gunned down in at least three Jihad attacks.
6923,17/4/2007,Thailand,Narathiwat,2,0,2,"Muslim radicals kill two Buddhist plantation workers with a shotgun, then cut the head off of one."
6924,17/4/2007,Iraq,Hawija,3,4,7,"Jihadis car-bomb a gas station, killing three patrons."
6925,17/4/2007,Iraq,Abu Saida,2,5,7,"Muslim gunmen attack a displaced family, killing two members."
6926,17/4/2007,Iraq,Ramadi,17,0,17,Seventeen people are kidnapped and brutally executed by Islamic terrorists.
6927,17/4/2007,Thailand,Pattani,1,0,1,A Buddhist police officer is gunned down by Muslim radicals.
6928,17/4/2007,Sudan,Sires Umm al-Qura,73,12,85,Government troops of the Islamic republic massacre over seventy African villagers in at least eleven separate attacks over three days.
6929,18/4/2007,Turkey,Malatya,3,3,6,Three Christians working at a Bible distribution company are brutally tortured and murdered by local Islamists.  All three had their throats cut.
6930,18/4/2007,Iraq,Baghdad,22,0,22,"Twenty-two bodies are found here and elsewhere, some of which were beheaded by Islamic radicals."
6931,18/4/2007,Thailand,Narathiwat,1,0,1,Islamic terrorists shoot a 52-year-old civilian to death.
6932,18/4/2007,Thailand,Yala,1,0,1,A 44-year-old civilian is shot off of his motorcycle by Muslim radicals.
6933,18/4/2007,Iraq,Baghdad,192,239,431,"Sunnis slaughter nearly two-hundred Iraqi civilians, mostly Shia women and children in multiple bombing attacks.  Some victims were burned alive in vehicles."
6934,18/4/2007,Somalia,Mogadishu,3,6,9,"Islamic militias rain down mortars over a residential area, killing three civilians."
6935,19/4/2007,Thailand,Narathiwat,2,0,2,Two Buddhist teenage girls are shot to death by Islamists.
6936,19/4/2007,India,Baramulla,1,0,1,The Mujahideen force their way into a home and then shoot a civilian resident to death.
6937,19/4/2007,Somalia,Mogadishu,10,71,81,"At least ten people, mostly civilians are killed when a Muslim suicide bomber detonates his truck near an Ethiopian army base."
6938,19/4/2007,Somalia,Mogadishu,12,20,32,"Islamic militias mortar a crowded market, killing a dozen civilians."
6939,19/4/2007,Iraq,Baghdad,11,34,45,"A Fedayeen suicide bomber drives his truck into a fuel tanker at a gas station, killing eleven innocent people."
6940,19/4/2007,Iraq,Shirqat,4,0,4,"Islamic terrorists set a car on fire, with four people inside."
6941,19/4/2007,Iraq,Baghdad,26,4,30,"Three Jihad attacks leave twenty-six bodies, nearly all civilians, including a teenage girl."
6942,19/4/2007,Philippines,Parang,7,0,7,Seven Christian laborers are kidnapped and beheaded by Moro Islamists.
6943,20/4/2007,India,Rajouri,2,0,2,Islamic terrorists kidnap and behead two Hindu civilians collecting firewood.
6944,20/4/2007,Iraq,Baghdad,25,27,52,Two children are among two dozen Iraqis killed by sectarian Jihadis in various attacks.
6945,21/4/2007,Thailand,Pattani,3,1,4,Three Thai soldiers are killed when local religious extremists set off a bomb.
6946,21/4/2007,Iraq,Kirkuk,4,0,4,Holy Warriors storm a family home and murder two children and their parents.
6947,21/4/2007,Iraq,Khalis,8,0,8,"Eight tortured bodies are found, four of who are beheaded in the Islamic tradition."
6948,21/4/2007,Iraq,Baghdad,13,5,18,A bomb on a bus is among at least two Mujahideen attacks that leave thirteen civilians dead.
6949,22/4/2007,Iraq,Iskandariya,2,0,2,A young girl is among two targets taken out by Islamic gunmen.
6950,22/4/2007,Afghanistan,Khost,10,40,50,Ten civilians are murdered by a suicide bomber at a market.
6951,22/4/2007,Thailand,Pattani,1,1,2,Radical Muslims gun down a husband and injure his wife.
6952,22/4/2007,Pakistan,Mastung,3,0,3,"Three children, ages 2, 5 and 12, are killed when Muslim terrorists throw explosives into a home."
6953,22/4/2007,India,Doda,3,0,3,Lashkar-e-Toiba militants attack and kill three Hizb-ul-Mujahideen who were planning to surrender.
6954,22/4/2007,Afghanistan,Zabul,2,5,7,"Religious extremists bomb a vehicle, killing two Afghan police."
6955,22/4/2007,Afghanistan,Ghazni,1,0,1,"An Afghan intelligence officer is invited into a home, then kidnapped and beheaded by Islamic extremists."
6956,22/4/2007,Iraq,Bashika,23,0,23,"Twenty-three members of a minority religious sect are kidnapped on a bus, taken to a wall and shot to death by the Religion of Peace."
6957,22/4/2007,Iraq,Saidiya,7,42,49,Jihadis blast seven Iraqi civilians to Allah with a car bomb.
6958,22/4/2007,Iraq,Baghdad,13,95,108,"Fedayeen suicide bombers kill 13 people, mostly civilians."
6959,23/4/2007,Somalia,Mogadishu,4,1,5,"A woman is among the dead, and a baby among the wounded, as Somali Islamists continue to pour on the misery."
6960,23/4/2007,Iraq,Mosul,10,20,30,"A suicide bomber rams his car into the offices of a political party, slaughtering ten civilians."
6961,23/4/2007,Iraq,Baqubah,10,23,33,A suicide bomber kills ten Iraqi policemen and injures two dozen more.
6962,23/4/2007,Iraq,Ramadi,19,30,49,Coordinated car bombs take out nineteen innocent lives in the name of Allah.
6963,23/4/2007,Iraq,Baghdad,23,14,37,"A suicidal Sunni attacks a restaurant, blasting eight civilians to death.  Fifteen victims of sectarian violence are found elsewhere."
6964,23/4/2007,Iraq,Diyala,9,20,29,"A Fedayeen suicide bomber attacks an American convoy, killing nine soldiers."
6965,23/4/2007,Thailand,Yala,1,0,1,Islamists shoot and attempt to behead a 40-year-old Buddhist man.
6966,24/4/2007,Afghanistan,Herat,4,2,6,Four Afghans are killed when religious extremists ambush their vehicle.
6967,24/4/2007,Iraq,Baghdad,19,0,19,Nineteen victims of sectarian hatred within the Religion of Peace are found throughout the city.
6968,24/4/2007,Iraq,Baqubah,8,17,25,Eight people are killed by Islamic terrorists.
6969,24/4/2007,Iraq,Ramadi,25,44,69,A suicide truck bomber punches his own ticket to Allah - and that of twenty-five others.
6970,25/4/2007,Afghanistan,Paktia,2,0,2,A census taker and his driver are murdered by religious extremists.
6971,25/4/2007,Somalia,Mogadishu,7,0,7,"Somali Islamists set off a car bomb near a hotel, killing seven innocents."
6972,25/4/2007,Pakistan,Dera Ismail Khan,3,0,3,Two Shia brothers are among three killed in a vicious attack by Sunnis.
6973,25/4/2007,Iraq,Mosul,2,2,4,"Fundamentalists attack a bakery, killing the owner and an assistant."
6974,25/4/2007,Iraq,Balad Ruz,9,16,25,Nine Iraqis are murdered by a suicide bomber.
6975,25/4/2007,Iraq,Baghdad,24,10,34,A Jihad bombing and several sectarian attacks leave two dozen dead.
6976,25/4/2007,Afghanistan,Paktika,7,1,8,Seven Afghan soldiers are killed when the Taliban use a roadside bomb against their vehicle.
6977,26/4/2007,Afghanistan,Barmal,2,0,2,Two civilians are shot to death by suspected Islamic militants.
6978,26/4/2007,Afghanistan,Barmal,1,1,2,A rocket attack by religious extremists leaves at least one civilian dead.
6979,26/4/2007,Afghanistan,Mihtarlam,1,0,1,A civilian is killed in a Taliban bombing.
6980,26/4/2007,Afghanistan,Ghazni,2,0,2,The Taliban murder two government officials.
6981,26/4/2007,Pakistan,Dera Ismail Khan,2,0,2,Two men are gunned down by Islamic militants at an Internet cafe.
6982,26/4/2007,Iraq,Mosul,3,59,62,"Islamic militants set off several bombs, killing at least three civilians."
6983,26/4/2007,Iraq,Baghdad,35,19,54,"Jihadis bomb a university, killing eight people, and murder twenty-seven others in sectarian attacks."
6984,26/4/2007,Lebanon,Sidon,2,0,2,A 12-year-old is among two people kidnapped and murdered in ugly fashion by sectarian rivals.
6985,27/4/2007,Sudan,Gnaya,4,5,9,"Four Christians, including a boy, are shot to death by radical Muslims after showing a 'Jesus' film in a village."
6986,27/4/2007,Chechnya,Shatoi,17,0,17,"Islamic fundamentalists shoot down a Russian helicopter, killing all seventeen aboard."
6987,27/4/2007,Pakistan,North Waziristan,4,0,4,Four people are killed when explosives level a house in the middle of the night.
6988,27/4/2007,Iraq,Hit,10,20,30,A suicide truck bomber takes out ten Iraqis.
6989,27/4/2007,Iraq,Kirkuk,1,0,1,A human rights activist is successfully assassinated by the Religion of Peace.
6990,27/4/2007,Thailand,Pattani,1,0,1,A 70-year-old Buddhist man is shot off of his motorcycle by Islamic 'rebels.'
6991,28/4/2007,Iraq,Mosul,17,0,17,Seventeen bodies are found of kidnapped and murdered victims of the Religion of Peace.
6992,28/4/2007,Thailand,Narathiwat,1,0,1,A 37-year-old civilian is ambushed and killed by radical Muslims.
6993,28/4/2007,Thailand,Narathiwat,1,0,1,A 45-year-old man is killed by Muslim gunmen in a drive-by.
6994,28/4/2007,Iraq,Zafaraniyah,4,3,7,Four Iraqi humanitarian workers are taken down by Islamic gunmen.
6995,28/4/2007,Pakistan,Peshawar,28,35,63,A suicidal religious extremist blows twenty-eight souls to Allah in an assassination attempt on a government minister.
6996,28/4/2007,Iraq,Karbala,60,170,230,"Freedom fighters car-bomb a Shia shrine, killing sixty innocent people."
6997,28/4/2007,Iraq,Baqubah,27,0,27,"Twenty-seven victims of Islamic terrorism are discovered in two locations, handcuffed and tortured."
6998,28/4/2007,Iraq,Baghdad,22,22,44,Twenty-two people are killed in Muslim sectarian attacks.
6999,28/4/2007,Iraq,Baghdad,4,1,5,Freedom fighters massacre four Iraqi humanitarian workers.
7000,29/4/2007,India,Srinagar,1,25,26,A Mujahideen grenade attack on a bus stand leaves a woman dead.
7001,29/4/2007,Pakistan,Naray Dhoke,1,0,1,A militant attack on a security post leaves one officer dead.
7002,29/4/2007,Iraq,Baqubah,12,5,17,A disembodied head and a shooting ambush on a minibus carrying female university students are part of a dozen deaths at the hands of Muslim terrorists.
7003,29/4/2007,Iraq,Kut,1,9,10,A 9-year-old boy is killed when Jihadis bomb a house.
7004,29/4/2007,Iraq,Baghdad,17,8,25,Three street sweepers are among seventeen people murdered by Islamic radicals in separate attacks.
7005,29/4/2007,Thailand,Narathiwat,1,1,2,Muslim gunmen take out a 3-year-old boy riding in a truck.
7006,29/4/2007,Afghanistan,Herat,2,1,3,A Taliban roadside attack kills two Afghan soldiers.
7007,29/4/2007,Thailand,Pattani,1,0,1,A 60-year-old cattleman is murdered by Islamic gunmen.
7008,29/4/2007,India,Kulgam,1,0,1,A civilian is shot to death by the Mujahideen.
7009,29/4/2007,Thailand,Pattani,2,0,2,"Two Buddhists, including a 14-year-old boy, are murdered by militant Muslims.  One is beheaded and both bodies are burned."
7010,30/4/2007,Ethiopia,Jijiga,2,3,5,Two Christians are killed when Muslims bomb a tent gathering.
7011,30/4/2007,Afghanistan,Kandahar,1,3,4,A suicide bomber kills an Afghan citizen in a highway attack.
7012,30/4/2007,Pakistan,Jandola,2,0,2,al-Qaeda militants abduct and behead two civilians.
7013,30/4/2007,Iraq,Baghdad,37,50,87,Nearly forty people are killed in various sectarian attacks within the Religion of Peace.
7014,30/4/2007,Iraq,Khalis,32,52,84,A suicidal Sunni takes out thirty-two mourners at a Shia funeral with an explosives vest.
7015,30/4/2007,Iraq,Ramadi,6,10,16,Freedom fighters murder six Iraqis with a chlorine bomb.
7016,1/5/2007,Iraq,Baqubah,10,0,10,Ten victims of Islamic terrorists are found shot to death.
7017,1/5/2007,Iraq,Baghdad,19,6,25,Nineteen Iraqis are killed in sectarian attacks.
7018,1/5/2007,Thailand,Yala,1,4,5,A man is gunned down by Muslim militants at a gas station.  His wife and young daughter are injured in the attack.
7019,1/5/2007,Thailand,Pattani,1,26,27,Four children are among the injured when Muslim bombers detonate explosives outside a market.
7020,1/5/2007,Iraq,Iskandariyah,14,8,22,"Sunni gunmen fire on Shia vehicles from a highway overpass, killing at least fourteen innocents, including women and children."
7021,2/5/2007,Pakistan,Goorwak,1,0,1,"al-Qaeda-backed militants kidnap a man, then cut off his head."
7022,2/5/2007,Afghanistan,Kabul,1,0,1,A lawmaker is shot to death outside his home.
7023,2/5/2007,Chechnya,Grozny,2,0,2,"Islamic militants set off a remote-controlled bomb, killing two policemen."
7024,2/5/2007,Afghanistan,Paktia,5,2,7,Five Afghan troops are killed when Taliban ambush a Czech diplomat's vehicle.
7025,2/5/2007,India,Handwara,1,0,1,A cop is gunned down by the Mujahideen.
7026,2/5/2007,Iraq,Baghdad,30,0,30,Thirty bodies are found dumped following their execution at the hands of sectarian terrorists.
7027,2/5/2007,Iraq,Mahmoudiya,11,1,12,Jihadis kill eleven people near a minibus with an explosive.
7028,2/5/2007,Iraq,Baghdad,4,35,39,A suicidal Sunni takes out four Shia civilians in a blast.
7029,3/5/2007,Afghanistan,Kabul,1,29,30,"Religious extremists hide a bomb in a fruit cart, killing at least one innocent at a market."
7030,3/5/2007,Thailand,Narathiwat,1,0,1,A villager is shot to death by Muslim radicals.
7031,3/5/2007,Thailand,Pattani,1,0,1,Muslims gun down a policeman guarding a school.
7032,3/5/2007,Afghanistan,Oruzgan,1,0,1,A suicide bomber kills at least one Afghan national.
7033,3/5/2007,Thailand,Pattani,1,0,1,A 35-year-old Buddhist succumbs to injuries suffered from a bomb attack days earlier.
7034,3/5/2007,Iraq,Baiji,6,0,6,Sunnis kidnap and murder six Iraqi policemen.
7035,3/5/2007,Iraq,Baghdad,29,0,29,Four Filipinos are among twenty-nine people killed by Muslim terrorists in separate attacks.
7036,3/5/2007,Iraq,Baghdad,9,0,9,"In a brutal attack, Muslim gunmen storm a home and slaughter a family of nine."
7037,3/5/2007,Afghanistan,Helmand,1,0,1,A British soldier is shot to death by Taliban terrorists while manning a checkpoint.
7038,4/5/2007,Pakistan,Miran Shah,1,0,1,"Islamists open fire on a car, killing the driver."
7039,4/5/2007,Thailand,Yala,3,0,3,A 7-year-old boy and an 11-year-old girl are shot to death along with their father by Islamic 'rebels.'
7040,4/5/2007,Thailand,Yala,1,0,1,Muslim radicals shoot a man to death and throw his body in a river.
7041,4/5/2007,Thailand,Yala,1,0,1,A man is hacked to death by Islamists in public view at a market.
7042,4/5/2007,Iraq,Baghdad,22,2,24,Two guards at a rival mosque are among twenty-two people killed by sectarian terrorists.
7043,4/5/2007,Iraq,Suwayra,8,0,8,Eight people are kidnapped and executed by the Mujahideen.
7044,4/5/2007,Iraq,Fallujah,9,0,9,"Nine people, including four brothers, are kidnapped and executed by the Mujahideen."
7045,4/5/2007,Iraq,Hilla,5,35,40,"Sunnis bomb a Shia mosque, killing at least five."
7046,5/5/2007,Thailand,Yala,1,1,2,"Islamists bomb a public school, killing a guard."
7047,5/5/2007,Afghanistan,Farah,8,2,10,"Taliban fighters attack a small town, killing at least eight Afghans defending it."
7048,5/5/2007,Iraq,Baghdad,16,21,37,"A suicide bomber targets young police recruits, murdering at least sixteen."
7049,5/5/2007,Thailand,Yala,1,0,1,A man is gunned down by Muslim extremists in a drive-by shooting.
7050,5/5/2007,Thailand,Yala,3,0,3,A 2-year-old girl is among three people killed by an Islamic bombing.
7051,5/5/2007,Afghanistan,Helmand,2,0,2,"A suicide bomber rams into a police vehicle, killing two Afghans."
7052,5/5/2007,Iraq,Baghdad,3,0,3,"Terrorists mortar a soccer field, killing three children."
7053,5/5/2007,Iraq,Kannan,4,0,4,Four members of one family are shot to death by Islamic gunmen.
7054,5/5/2007,Pakistan,Dera Ismail Khan,1,0,1,A civilian is gunned down in a sectarian attack.
7055,6/5/2007,Pakistan,Punjab,2,1,3,Sunnis shoot two Shia clerics to death inside a home.
7056,6/5/2007,Iraq,Samarra,12,11,23,A suicide bomber blows a dozen souls to Allah.
7057,6/5/2007,Iraq,Baghdad,28,11,39,Jihadis rack up twenty-eight dead Iraqis in various attacks.
7058,6/5/2007,Iraq,Baghdad,42,70,112,"Sunnis car bomb a crowded market, slaughtering over forty Iraqis."
7059,6/5/2007,Pal. Auth.,Rafah,1,4,5,"Islamic fundamentalists attack a school that ""mixes"" girls and boys in class, killing at least one person."
7060,6/5/2007,Afghanistan,Ghazni,5,2,7,"Religious extremists target a road construction crew with a roadside bomb, killing five members."
7061,6/5/2007,Iraq,Karma,28,12,40,A brutal attack on a wedding party in which twenty-eight people are kidnapped and either beheaded or burned to death.
7062,6/5/2007,Afghanistan,Kabul,2,2,4,Two American prison guards are killed by a militant in an Afghan army uniform.
7063,6/5/2007,Chechnya,Vedeno,4,3,7,Four policemen are killed by Jihad militants.
7064,7/5/2007,Afghanistan,Kabul,1,5,6,A young boy is among the causalities when Islamic extremists fire a rocket into a public building.
7065,7/5/2007,Thailand,Yala,2,1,3,A 70-year-old Buddhist man is among two rubber tappers murdered by Islamic radicals.
7066,7/5/2007,Somalia,Mogadishu,2,7,9,Two children die and seven people are wounded when Islamic militias detonate a bomb in the street.
7067,7/5/2007,Iraq,Khalis,4,0,4,A woodcarver and his three sons are brutally slain inside their shop by Islamic terrorists.
7068,7/5/2007,Iraq,Mandili,4,2,6,"Terrorists open up on a bus with automatic weapons, killing four civilians."
7069,7/5/2007,Iraq,Baghdad,36,4,40,Sectarian hatred within the Religion of Peace accounts for three dozen deaths in at least three attacks.
7070,7/5/2007,Iraq,Ramadi,25,40,65,"Two suicide car bombers massacre over two dozen Iraqis, including those who came to help victims of the first blast."
7071,7/5/2007,Thailand,Yala,1,0,1,A Buddhist plantation worker is shot and set on fire by militant Muslims.
7072,8/5/2007,Thailand,Pattani,1,0,1,A Buddhist man is shot to death by Muslims as he is on his way to work.
7073,8/5/2007,Philippines,Tacurong,8,23,31,Jemaah Islamiyah bombers suspected in blast at a crowded market.  Eight are killed instantly or succumb to wounds.
7074,8/5/2007,Pal. Auth.,Rafah,1,0,1,A man shoots his 35-year-old sister in the head to preserve 'family honor.'
7075,8/5/2007,Afghanistan,Kandahar,1,0,1,A 38-year-old Afghan is murdered by Islamic extremists on his way to work.
7076,8/5/2007,Iraq,Khanaqin,9,23,32,"A suicide bomber kills two people, as seven more Jihad victims are found elsewhere."
7077,8/5/2007,Iraq,Baghdad,28,9,37,Twenty-eight Iraqis are liberated by Freedom Fighters in various attacks.
7078,8/5/2007,Iraq,Diyala,2,0,2,A married couple are shot to death by Islamic terrorists at the school where they work.
7079,8/5/2007,Iraq,Kufa,45,80,125,Up to forty-five Iraqis are blown to bits by a Fedayeen suicide bomber at an open-air market near a school.
7080,8/5/2007,India,Kupwara,1,2,3,An Indian security force member is shot to death by infiltrating terrorists.
7081,9/5/2007,Thailand,Pattani,1,0,1,A hospital worker is killed by Islamic terrorists.
7082,9/5/2007,Thailand,Yala,1,1,2,"A father is murdered, and his 12-year-old son injured, by Muslim radicals."
7083,9/5/2007,Thailand,Narathiwat,7,0,7,Seven Thai soldiers are ambushed with a roadside bomb.  Islamists then shoot the wounded in the head.
7084,9/5/2007,India,Sopore,1,0,1,A 30-year-old shopkeeper is shot to death by the Mujahideen.
7085,9/5/2007,Iraq,Baghdad,32,0,32,Four beheaded bodies are among over thirty victims of sectarian hatred found around the country.
7086,9/5/2007,Iraq,Kirkuk,4,0,4,Four Iraqi journalists are dragged from their car and brutally tortured to death by holy warriors.
7087,9/5/2007,Iraq,Irbil,19,80,99,A suicidal Sunni takes out nineteen innocent people at an oil ministry building in the name of Allah.
7088,9/5/2007,Iraq,al-Jeblah,13,0,13,"Ten women, two children, and one bus driver are massacred by Freedom Fighters up close and personal."
7089,9/5/2007,Somalia,Mogadishu,1,1,2,A woman is killed when Islamic militants hurl a grenade into a market.
7090,10/5/2007,Afghanistan,Paktika,3,7,10,Three Afghan civilians are killed by a suicide bomber.
7091,10/5/2007,Iraq,Baghdad,23,0,23,"Twenty-three victims of sectarian hatred are found, including several women from the same family."
7092,10/5/2007,Iraq,Baghdad,9,0,9,"The 'Islamic Army in Iraq' captures nine Iraqi policemen, forces them to kneel, then shoots each in the back of the head while yelling 'Allah Akbar.'"
7093,10/5/2007,Somalia,Mogadishu,2,1,3,Two civilians are killed when Islamists detonate a roadside bomb.
7094,11/5/2007,Algeria,Jijel,1,2,3,"Fundamentalists bomb a police checkpoint, killing one Algerian."
7095,11/5/2007,Iraq,Fallujah,24,0,24,Two dozen victims of sectarian hatred within the Religion of Peace are found in two locations.
7096,11/5/2007,Iraq,Balad,3,2,5,"Muslim gunmen shoot three women to death, as they are riding in a car."
7097,11/5/2007,Iraq,Baghdad,23,57,80,"Freedom Fighters bomb two bridges, killing two dozen Iraqi commuters and guards."
7098,11/5/2007,Iraq,Mosul,3,0,3,"Three captured Iraqi soldiers are forced to kneel and call on others to join the terrorists, before being brutally executed to shouts of 'Allah Akbar.'"
7099,11/5/2007,Thailand,Narathiwat,1,2,3,A Buddhist villager is shot to death by Muslim radicals.
7100,11/5/2007,Thailand,Narathiwat,2,0,2,"Islamists murder two police officers, then set fire to the bodies."
7101,11/5/2007,Egypt,Behma,0,10,10,"Ten Christians are injured as a Muslim mob rampages through their neighborhood, enraged over the construction of a church."
7102,11/5/2007,India,Kupwara,3,0,3,Three soldiers succumb to injuries suffered in an earlier attack by the Mujahideen.
7103,11/5/2007,Thailand,Narathiwat,1,0,1,An elderly villager is gunned down by militant Muslims in front of a food shop.
7104,12/5/2007,Somalia,Mogadishu,4,3,7,Four people are killed when Islamic militias bomb a vehicle.
7105,12/5/2007,Iraq,Baghdad,19,1,20,Nineteen people are killed by Islamic terrorists in sectarian violence.
7106,12/5/2007,Afghanistan,Kandahar,8,0,8,Eight policemen are murdered in a Taliban ambush.
7107,12/5/2007,Thailand,Yala,3,0,3,Three rubber-tappers are brutally shot to death by Islamic terrorists.
7108,12/5/2007,Thailand,Narathiwat,1,0,1,Muslims gun down a Buddhist civilian in a drive-by attack.
7109,12/5/2007,Thailand,Yala,1,0,1,Islamists shoot a man to death at a wedding party.
7110,13/5/2007,Iraq,Baqubah,16,9,25,A spasm of religious violence leaves a trail of dead women and headless bodies in multiple attacks.
7111,13/5/2007,Iraq,Eweiraj,5,4,9,Islamic gunmen murder five workers at a flour mill.
7112,13/5/2007,Iraq,Baghdad,17,46,63,"Sunni terrorists bomb a restaurant, killing seventeen."
7113,13/5/2007,Iraq,Baghdad,22,0,22,Twenty-two victims of sectarian hatred within the Religion of Peace are found murdered.
7114,13/5/2007,Iraq,Mahmur,32,115,147,A suicide truck bomber murders dozens of Iraqis in an attack on a Kurdish government building.
7115,13/5/2007,Pal. Auth.,Beit Lahiya,2,0,2,Two Palestinians are killed when Hamas gunmen open fire on their car.
7116,13/5/2007,Afghanistan,Nangarhar,1,2,3,An Afghan is killed in a roadside bomb attack by Islamic fundamentalists.
7117,13/5/2007,Thailand,Yala,2,0,2,A husband and wife working at a rubber plantation are shot to death by radical Muslims.
7118,13/5/2007,Somalia,Bakara,1,0,1,Islamic militias are suspected in the assassination of a government official at a market.
7119,13/5/2007,Algeria,Skikda,3,3,6,Three Algerians are killed when fundamentalists bomb their vehicle.
7120,14/5/2007,Iraq,Mosul,26,7,33,Two dozen victims of sectarian violence within Islam are found here and in the capital.
7121,14/5/2007,Iraq,Baghdad,14,18,32,Jihadis net fourteen civilian deaths in two bombing attacks.
7122,14/5/2007,Thailand,Pattani,2,1,3,"A Buddhist married couple are killed, with the father beheaded in front of their 3-year-old daughter by the Religion of Peace."
7123,14/5/2007,Thailand,Yala,2,0,2,Two plantation laborers are shot to death by Muslim militants.
7124,14/5/2007,Afghanistan,Panjwaii,1,1,2,The Taliban kill an Afghan interpreter in a rocket attack.
7125,14/5/2007,Pakistan,Tank,1,2,3,A government soldier is killed when terrorists toss a grenade at his vehicle.
7126,14/5/2007,India,Kupwara,1,0,1,A teacher is shot to death by the Mujahideen.
7127,15/5/2007,Somalia,Bardere,5,15,20,"Islamic fundamentalists toss a grenade into a packed theatre, killing two children and three adults watching a movie."
7128,15/5/2007,Pal. Auth.,Karni,8,0,8,Eight Palestinian police are killed in cold blood by Hamas terrorists.
7129,15/5/2007,Pakistan,Peshawar,25,46,71,"A suicide bomber massacres over two dozen people, mostly Afghan refugees, at a hotel.  These include women and children."
7130,15/5/2007,Iraq,Abu Saida,12,22,34,A suicidal Sunni blows a dozen innocents to Allah.
7131,15/5/2007,Iraq,Baghdad,28,23,51,Muslim terrorists rack up nearly thirty dead Iraqis in various attacks.
7132,15/5/2007,Thailand,Narathiwat,1,0,1,A village chief is shot to death by Islamic radicals while sitting in his car.
7133,16/5/2007,Somalia,Mogadishu,5,5,10,Five Ugandan peacekeepers are murdered in a roadside bombing attack.
7134,16/5/2007,Pal. Auth.,Gaza,1,0,1,A nurse traveling in an ambulance is shot in the head by unknown Muslim gunmen.
7135,16/5/2007,Pal. Auth.,Gaza,8,0,8,"Hamas gunmen fire on a vehicle carrying prisoners, killing seven persons."
7136,16/5/2007,Pal. Auth.,Gaza,6,0,6,"Hamas militants storm a home, line up six men against a wall and shoot them to death."
7137,16/5/2007,Pakistan,Tank,5,12,17,Five civilians waiting for a bus are cut down in a rocket attack by religious extremists.
7138,16/5/2007,Somalia,Shabelle,8,6,14,At least two journalists are among eight killed when Islamic militias riddle their vehicle with automatic weapons.
7139,16/5/2007,Algeria,Constantine,1,2,3,A police officer is killed in a bombing attack by Islamic fundamentalists.
7140,16/5/2007,Iraq,Kirkuk,3,2,5,Jihadis stop a truck hauling concrete and shoot three occupants to death.
7141,16/5/2007,Iraq,Fallujah,7,0,7,Seven tribesman are murdered by a Fedayeen suicide bomber.
7142,16/5/2007,Iraq,Abu Saida,45,60,105,"Freedom fighters detonate a chlorine gas bomb in a town, killing at least forty-five Iraqis."
7143,17/5/2007,Iraq,Baghdad,13,0,13,Thirteen people are kidnapped and tortured to death by Islamic terrorists.
7144,17/5/2007,Iraq,Kirkuk,8,0,8,Eight innocents are blown to bits by a Fedayeen suicide bomber.
7145,17/5/2007,Afghanistan,Kandahar,2,4,6,A suicide attack by religious extremists leaves two civilians dead.
7146,17/5/2007,Afghanistan,Kandahar,7,4,11,"The Taliban kill seven Afghans with separate blasts, including those who rushed to the aid of victims from the first."
7147,18/5/2007,Philippines,Cotabato,3,20,23,An Islamic terror group is suspected in a bombing at a bus terminal that kills a 5-year-old boy and two others.
7148,18/5/2007,Iraq,Baqoubah,9,0,9,Nine people are killed by Muslim terrorists.
7149,18/5/2007,Iraq,Kut,5,0,5,A 12-year-old child is among five people executed by sectarian Jihadis.
7150,18/5/2007,Iraq,Kirkuk,3,0,3,A 7-year-old boy is among three people dragged from a car and shot to death by Freedom Fighters.
7151,18/5/2007,Iraq,Baghdad,31,10,41,Two ABC journalists are among thirty-one Iraqis cut down in various Jihad attacks.
7152,18/5/2007,India,Hyderabad,11,35,46,A pipe-bombing in the washing area of a mosque leaves eleven worshippers dead.
7153,18/5/2007,Thailand,Narathiwat,1,0,1,Muslim radicals gun down a cop.
7154,19/5/2007,Afghanistan,Shinwar,2,3,5,Two Afghans are killed in a Taliban terror bombing.
7155,19/5/2007,Afghanistan,Kunduz,9,14,23,Six civilians are among nine killed by a suicide bomber along a crowded city street.
7156,19/5/2007,India,Baramulla,1,1,2,"The Hizb-ul-Mujahideen opens fire on a security patrol, killing one member."
7157,19/5/2007,Iraq,Basra,15,0,15,Seven janitors are among fifteen innocents kidnapped and tortured by suspected Shia radicals.
7158,19/5/2007,Iraq,Mandali,15,0,15,Fifteen Kurdish villagers are shot to death by Sunni terrorists.
7159,19/5/2007,Iraq,Baghdad,31,20,51,"A market is car-bombed, adding to the toll from random Jihad attacks that leave thirty-one Iraqis dead."
7160,19/5/2007,Thailand,Yala,1,0,1,A 33-year-old Buddhist is shot to death by Muslim terrorists while working his rubber plantation.
7161,19/5/2007,Thailand,Yala,1,0,1,A Buddhist motorcycle mechanic is shot to death by Muslim radicals.
7162,19/5/2007,Thailand,Yala,1,0,1,Islamists gun down a villager in a drive-by attack.
7163,20/5/2007,Lebanon,al-Qalamoun,17,45,62,al-Qaeda linked militants calling themselves 'Fatah al-Islam' kill thirteen Lebanese soldiers and four civilians.
7164,20/5/2007,Somalia,Mogadishu,2,2,4,Islamic militias kill two civilians in a roadside attack.
7165,20/5/2007,Afghanistan,Helmand,11,0,11,Eleven Afghan policemen are brutally slain in a Taliban ambush.
7166,20/5/2007,Iraq,Tikrit,14,0,14,Fourteen victims of sectarian violence are found here and in Kut.
7167,20/5/2007,Iraq,Ramadi,11,52,63,Eleven people are killed when Sunni terrorists detonate a chlorine bomb on a city street.
7168,20/5/2007,Iraq,Baghdad,26,10,36,Jihadis kill over two-dozen Iraqis in various attacks.
7169,20/5/2007,Thailand,Yala,1,1,2,"Muslims open fire on a Buddhist woman and her son, killing the teenage boy."
7170,20/5/2007,Thailand,Pattani,1,0,1,"A Buddhist construction worker is killed by Muslim radicals, who then burn his body."
7171,20/5/2007,Thailand,Narathiwat,1,0,1,A villager is murdered by Islamic terrorists.
7172,20/5/2007,Afghanistan,Gardez,14,31,45,"A suicide bomber blows himself up at a market, slaughtering over a dozen others."
7173,20/5/2007,Lebanon,Beirut,1,10,11,A 63-year-old woman is killed in a bomb attack on a Christian neighborhood.
7174,21/5/2007,Yemen,Sanaa,1,1,2,A bomb hidden in a box kills a young child.
7175,21/5/2007,Afghanistan,Nangarhar,3,7,10,Religious extremists kill three Afghans with a remote-controlled bomb.
7176,21/5/2007,Pakistan,Johar,2,0,2,"In an honor killing, a man kills his sister and her lover over their relationship."
7177,21/5/2007,Israel,Sderot,1,1,2,Palestinians kill a 35-year-old Israeli woman with a rocket.
7178,21/5/2007,Iraq,Hibhib,7,4,11,Women and children are among the casualties when Islamic gunmen fire on a minibus and then set it ablaze.
7179,21/5/2007,Iraq,Baghdad,26,12,38,Random sectarian violence within the Religion of Peace leaves over two dozen dead.
7180,21/5/2007,Lebanon,al-Qalamoun,3,3,6,Three Lebanese soldiers are killed in an attack by Fatah al-Islam.
7181,22/5/2007,Sudan,Liba,2,18,20,"Government militias attack a village, killing at least two residents."
7182,22/5/2007,Thailand,Yala,4,0,4,"A family of four, including two children, are slaughtered in their home by Muslim militants who then set fire to it."
7183,22/5/2007,Iraq,Baqubah,6,0,6,"Islamic gunmen spray the inside of a family car with gunfire, killing six members, included four children."
7184,22/5/2007,Iraq,Baghdad,12,30,42,Twelve university students are killed in two separate attacks by Islamic radicals on their campus and bus.
7185,22/5/2007,Iraq,Baghdad,25,60,85,"Freedom Fighters bomb an open-air market, slaughtering two-dozen shoppers, including women and children."
7186,22/5/2007,Thailand,Yala,1,4,5,Muslims murder a Buddhist man and burn his body.
7187,22/5/2007,India,Reasi,1,0,1,The body of a murdered civilian surfaces.  He had been kidnapped by Muslim militants.
7188,22/5/2007,Iraq,Jalawla,6,0,6,Six young men gathered in front of a home are brutally murdered by Sunni gunmen.
7189,23/5/2007,Saudi Arabia,Riyadh,1,0,1,Saudi religious police handcuff a man and then beat him to death for selling alcohol.
7190,23/5/2007,Iraq,Albo Obaid,17,0,17,"A 17-year-old suicide bomber murders men, women and children inside a family home."
7191,23/5/2007,Iraq,Ramadi,5,0,5,"Five Iraqis are kidnapped, tortured and murdered by the Mujahideen."
7192,23/5/2007,Iraq,Mandali,22,13,35,A suicide bomber kills twenty-two people at a cafe in a horrific massacre.
7193,23/5/2007,Afghanistan,Herat,1,0,1,The Taliban kidnap a civilian and cut off his head.
7194,23/5/2007,Iraq,Baghdad,34,3,37,Jihadis kill three children in a mortar attack and gun down thirty others execution style.
7195,23/5/2007,Afghanistan,Kabul,2,2,4,A Fedayeen suicide bomber kills two people near a road construction site.
7196,23/5/2007,Afghanistan,Maymana,2,4,6,Two people are killed by a suicide bomber.
7197,23/5/2007,Thailand,Pattani,1,0,1,Islamic radicals kill a 40-year-old Buddhist in a drive-by shooting.
7198,23/5/2007,Thailand,Yala,1,0,1,A 48-year-old Buddhist is murdered by Islamists on his way to work.
7199,23/5/2007,Ingushetia,Nazran,7,0,7,Seven people are killed by a suspected suicide bomber.
7200,24/5/2007,Iraq,Fallujah,35,36,71,"Holy Warriors set off a car bomb at a funeral, massacring three dozen mourners."
7201,24/5/2007,Iraq,Baghdad,24,15,39,Two dozen people are murdered in sectarian violence within the Religion of Peace.
7202,24/5/2007,Iraq,Hdad,13,4,17,Sunnis stop a bus carrying Shias and machine-gun eleven to death.  They then place a bomb among the bodies that kills two additional civilians.
7203,24/5/2007,Iraq,Nahr al-Bustan,6,0,6,"Muslim terrorists open fire on villagers, killing six."
7204,24/5/2007,Iraq,Sulaiman Bek,6,6,12,"Militant Islamists bomb a police vehicle, killing six Iraqis."
7205,24/5/2007,Afghanistan,Paktika,7,0,7,Seven Afghans are blown apart by Islamic fanatics.
7206,24/5/2007,Somalia,Mogadishu,2,5,7,Two civilians are killed by a bomb planted by suspected Islamists.
7207,24/5/2007,Thailand,Narathiwat,1,0,1,The bullet-riddled body of a 38-year-old man is found a day after being killed by Muslim militants.
7208,25/5/2007,Thailand,Yala,2,0,2,Two teenagers are savagely gunned down on the side of the road by Muslim radicals.
7209,25/5/2007,Iraq,Baghdad,24,15,39,Islamic terrorists kill two dozen Iraqis in various sectarian attacks.
7210,25/5/2007,Thailand,Yala,1,0,1,Muslims shoot a 40-year-old man in the head and torso.  He succumbs to injuries a day later.
7211,25/5/2007,Thailand,Narathiwat,1,0,1,Muslim radicals assassinate a village head.
7212,26/5/2007,Iraq,Baghdad,29,42,71,"The Religion of Peace car bombs, mortars or shoots to death nearly thirty Iraqi civilians."
7213,26/5/2007,Thailand,Narathiwat,1,0,1,"A 77-year-old rubber tapper is shot to death by Islamic terrorists, who also kill a 23-year-old in a separate attack."
7214,26/5/2007,Somalia,Mogadishu,1,4,5,A teenage shoe-shiner is killed when Islamists detonate a bomb along a street.
7215,26/5/2007,Pakistan,Tank,3,7,10,Three soldiers are killed in a roadside attack by al-Qaeda militants.
7216,26/5/2007,Afghanistan,Ghazni,5,2,7,Five young children are killed by a bomb planted by Islamic fundamentalists.
7217,26/5/2007,Afghanistan,Kandahar,2,3,5,Two Afghans are killed in a Taliban attack on their vehicle.
7218,27/5/2007,Afghanistan,Kandahar,6,0,6,"Religious extremists bomb a police vehicle, then open fire on the survivors."
7219,27/5/2007,Iraq,Ramadi,7,12,19,"Jihadis car bomb a marketplace, killing seven civilians."
7220,27/5/2007,Iraq,Baghdad,4,0,4,"A noted calligrapher, two farmers and a Kurdish singer are shot to death by radical Islamists in separate attacks."
7221,27/5/2007,Iraq,Baghdad,44,0,44,Forty-four victims of sectarian hatred within the Religion of Peace are found dumped.
7222,27/5/2007,Israel,Sderot,1,1,2,Another Israeli civilian is killed in his car by a Palestinian rocket attack.
7223,28/5/2007,Somalia,Mogadishu,1,0,1,A young Islamist shoots a local judge twice in the head.
7224,28/5/2007,Pakistan,Tank,2,6,8,"A Fedayeen suicide bomber rams into a truck carrying Pakistani soldiers, killing two."
7225,28/5/2007,Iraq,Uwaireeg,12,0,12,"A dozen Iraqis are kidnapped, tortured and murdered by Muslim terrorists."
7226,28/5/2007,Iraq,Baghdad,24,90,114,Two dozen people are blown apart by a Jihad truck bombing.
7227,28/5/2007,Iraq,Baghdad,29,81,110,A female university student killed by a sniper is among thirty people who lose their life to various Islamic attacks.
7228,28/5/2007,Thailand,Songkhla,4,23,27,Two children are among four killed when radical Muslims bomb a marketplace.
7229,28/5/2007,Pakistan,Tank,1,1,2,"Islamic militants open fire on a security checkpoint, killing one officer."
7230,28/5/2007,Afghanistan,Kunduz,2,1,3,Two civilians are killed by a Fedayeen suicide bomber.
7231,28/5/2007,Ethiopia,Jijiga,6,40,46,al-Ittihad Al-Islami is thought responsible for a hand grenade attack on a crowd.
7232,28/5/2007,Iraq,Amiriyat al-Falluja,3,0,3,"Gunmen enter a reporter's home and drag him and his father and brother out to an orchard, where they are shot to death."
7233,29/5/2007,Thailand,Songkhla,1,12,13,A victim of a series of bombings from two days earlier dies from injuries - the first fatality.
7234,29/5/2007,Iraq,Baghdad,38,53,91,"Jihadis bomb a bus, killing thirty-eight passengers and passersby."
7235,29/5/2007,Iraq,Baghdad,20,85,105,Twenty patrons of a car parts market are blown to bits by the Religion of Peace.
7236,29/5/2007,Iraq,Baqubah,21,0,21,Twenty-one victims of sectarian hatred are found bound and executed.
7237,29/5/2007,Iraq,Baghdad,30,0,30,Thirty victims of sectarian hatred are found bound and executed by the police.
7238,29/5/2007,Thailand,Pattani,1,0,1,Islamists gun down a 50-year-old man driving his wife to work.
7239,29/5/2007,Lebanon,Nahr el-Bared,1,0,1,A Lebanese soldier dies from injuries suffered at the hands of a Fatah al-Islam sniper.
7240,29/5/2007,Somalia,Mogadishu,2,0,2,Islamic militias kill two civilians in an overnight grenade attack.
7241,29/5/2007,Pakistan,Peshawar,1,8,9,"Militants bomb a non-Sharia court building, killing at least one."
7242,30/5/2007,Somalia,Huriwa,1,0,1,A government official is shot to death by two Islamist gunmen.
7243,30/5/2007,Afghanistan,Helmand,2,1,3,Fundamentalists kill two Afghan guards at a private security firm with a bomb.
7244,30/5/2007,Afghanistan,Uruzgan,4,1,5,Taliban extremists kill four highway guards with a bomb.
7245,30/5/2007,Iraq,Baghdad,24,15,39,Sectarian violence within the Religion of Peace claims the lives of two dozen civilians.
7246,30/5/2007,Iraq,Fallujah,8,36,44,Eight people are killed in Jihad mortar attacks here and in Mahmudiya.
7247,30/5/2007,Pakistan,Quetta,1,8,9,A grenade attack on a barbershop leaves at least one patron dead.
7248,30/5/2007,India,Doda,1,0,1,A police chief is assassinated by the Mujahideen.
7249,31/5/2007,Thailand,Narathiwat,1,0,1,A police officer is shot at point blank range by a Muslim radical pretending to be a customer at a market.
7250,31/5/2007,Pakistan,Guman,13,2,15,"Pro-Taliban militants invade a home, killing thirteen occupants that included two women and many from the same family."
7251,31/5/2007,Iraq,Khalis,4,0,4,Four farmers are gunned down in their orchard by Islamic terrorists.
7252,31/5/2007,Iraq,Fallujah,25,50,75,Twenty-five Iraqis are blown to bits by a suspected al-Qaeda suicide bomber.
7253,31/5/2007,Iraq,Ramadi,5,15,20,A suicide bomber kills five other human beings.
7254,31/5/2007,Thailand,Songkhla,7,0,7,Seven people are gunned down by radicals in front of a mosque.
7255,31/5/2007,Thailand,Yala,12,0,12,"Muslim militants bomb a truck full of Thai soldiers, killing all twelve."
7256,31/5/2007,Iraq,Baghdad,29,0,29,Twenty-nine victims of sectarian hatred within the Religion of Peace are found bound and executed.
7257,31/5/2007,Lebanon,Nahr el-Bared,1,0,1,A solider is killed by a Fatah al-Islam sniper.
7258,1/6/2007,Saudi Arabia,Tabuk,1,0,1,A man is beaten to death by Saudi religious police for inviting an unrelated woman into his car.
7259,1/6/2007,Iraq,Baghdad,25,30,55,"Jihadis rain down mortars on an Iraqi neighborhood, killing at least ten civilians.  Fifteen others are killed elsewhere."
7260,1/6/2007,Iraq,Uweidla,5,25,30,A suicide truck bomber sends five Iraqis to Allah.
7261,1/6/2007,India,Nihama,2,3,5,"Mujahideen militants hurl a grenade at a group of Indian police, killing two."
7262,1/6/2007,India,Baramulla,1,5,6,A policeman is killed in an attack by Lashkar-e-Toiba on a training school.
7263,1/6/2007,Afghanistan,Kunar,2,5,7,The Taliban kill two women in a rocket attack on a series of homes.
7264,1/6/2007,Afghanistan,Kabul,1,0,1,A female journalist is murdered inside her home by religious fanatics.
7265,1/6/2007,Somalia,Mogadishu,1,0,1,Islamists gun down a government official.
7266,2/6/2007,Iraq,Shirqat,5,0,5,A Fedayeen suicide car bomber takes out five Iraqis.
7267,2/6/2007,Iraq,Baghdad,26,23,49,Random Jihad attacks leave at least two dozen Iraqis dead.
7268,2/6/2007,Afghanistan,Ghazni,5,0,5,"Religious extremists attack a man's home, killing his wife, two sons and two other children."
7269,2/6/2007,Algeria,Tizi Ouzou,1,10,11,An Algerian soldier is killed in a bomb attack by armed fundamentalists.
7270,3/6/2007,Somalia,Mogadishu,7,2,9,"Seven Somalis are murdered by a suicide bomber, including a student."
7271,3/6/2007,Iraq,Mosul,4,0,4,Islamists shoot a Catholic priest and three other Christians to death as they are leaving a church.
7272,3/6/2007,Iraq,Baqouba,10,7,17,"Ten people are killed in two separate attacks, including the brutal machine-gunning of minibus passengers."
7273,3/6/2007,Iraq,Baladruz,9,25,34,Jihadis blow nine Iraqis to Allah with a car bomb.
7274,3/6/2007,Iraq,Baghdad,31,5,36,Thirty-one victims of sectarian hatred within Islam are found scattered through the city.
7275,3/6/2007,Thailand,Narathiwat,1,0,1,A teacher is shot to death by Muslim radicals.
7276,3/6/2007,Pakistan,Tehsil Salarzai,5,0,5,Five people are killed in a roadside blast believed to be linked to the Taliban's anti-humanitarian drive.
7277,3/6/2007,Afghanistan,Paktia,1,0,1,The Taliban execute an Afghan government official after keeping him hostage for two days.
7278,3/6/2007,Thailand,Narathiwat,0,17,17,Seventeen men waiting to play soccer are injured by a Muslim bomb.
7279,3/6/2007,Algeria,Kabylia,1,0,1,Islamic fundamentalists kill a security guard.
7280,4/6/2007,Pakistan,Peshawar,1,0,1,A government official is shot to death outside his home in a sectarian attack.
7281,4/6/2007,Somalia,Mogadishu,1,0,1,Islamists hiding their faces murder a visiting mayor.
7282,4/6/2007,Pakistan,Gudar,4,0,4,Four people are shot to death by a Muslim court for the crime of adultery.
7283,4/6/2007,Lebanon,Nahr al-Bared,2,0,2,Two Lebanese soldiers are killed by Fatah-al-Islam radicals.
7284,4/6/2007,India,Poonch,1,2,3,A civilian is killed when Muslim militants lob a grenade in his direction.
7285,4/6/2007,Thailand,Narathiwat,1,2,3,A security guard escorting teachers to school dies in an Islamic bombing.
7286,4/6/2007,Somalia,Bakara,2,0,2,Two policemen are shot to death by an Islamic militant.
7287,4/6/2007,Iraq,Baghdad,5,8,13,Jihadis bomb a residential neighborhood and shoot two brothers to death in a separate attack.
7288,5/6/2007,Afghanistan,Parwan,1,0,1,The female head of a girls' school is shot to death by religious fundamentalists in front of her 8-year-old.
7289,5/6/2007,Iraq,Fallujah,19,25,44,Nineteen attendees at a market are blown to Allah by a Fedayeen suicide car bomber.
7290,5/6/2007,Iraq,Baghdad,33,0,33,Thirty-three people are killed in sectarian violence between Religion of Peace factions.
7291,5/6/2007,Afghanistan,Kandahar,1,0,1,Sunni extremists capture and behead an Afghan doctor.
7292,5/6/2007,Iraq,Basra,9,0,9,Nine barbers are killed by Islamic fundamentalists in three separate attacks over three days.
7293,5/6/2007,Thailand,Narathiwat,1,0,1,A traveling vendor is shot three times in the torso by Islamic gunmen.
7294,6/6/2007,India,Doda,1,0,1,A teenage boy is abducted and murdered by the Mujahideen.
7295,6/6/2007,Thailand,Yala,1,0,1,A 15-year-old boy is murdered by Islamic radicals.
7296,6/6/2007,Thailand,Narathiwat,1,0,1,A 21-year-old man is shot to death by Muslim radicals while returning home on a motorbike.
7297,6/6/2007,Iraq,Balad,2,1,3,Two small girls are killed in a roadside attack by Islamic terrorists.
7298,6/6/2007,Algeria,Tizi Ozo,1,8,9,"Salafists bomb a courthouse, killing at least one Algerian."
7299,6/6/2007,Iraq,Baghdad,39,35,74,Nearly forty Iraqis lose their lives to sectarian hatred within the Religion of Peace in various attacks.
7300,7/6/2007,India,Doda,1,0,1,Islamic terrorists abduct and murder a civilian.
7301,7/6/2007,Thailand,Yala,1,0,1,A Buddhist rubber tapper is shot to death in his home by Islamists.
7302,7/6/2007,Thailand,Narathiwat,1,0,1,A 40-year-old man is murdered by Muslim radicals in a drive-by.
7303,7/6/2007,Afghanistan,Zabul,1,0,1,"Religious extremists attack a police post, killing one Afghan."
7304,7/6/2007,Iraq,Rabea,10,35,45,A Fedayeen bomber sends ten innocent Iraqis to Allah.  Thirty-five others are maimed.
7305,7/6/2007,Iraq,Mosul,5,0,5,A female journalist is brutally gunned down in her home by Sunni terrorists.  Four others are killed elsewhere.
7306,7/6/2007,Iraq,Baghdad,37,15,52,A Jihad bombing and various shooting attacks leave thirty-seven Iraqis dead.
7307,7/6/2007,Lebanon,Beirut,1,0,1,Muslim bombers take out one Christian civilian and injure four others.
7308,7/6/2007,Thailand,Narathiwat,1,0,1,A policeman is shot in front of his wife 14 times at point-blank range by Muslim terrorists at a crowded market.
7309,7/6/2007,Algeria,Beni-Ksila,3,7,10,"al-Qaeda-backed fundamentalists bomb an army patrol, killing three Algerians."
7310,7/6/2007,Pal. Auth.,Rafah,1,5,6,A Fatah cadre is killed in a home by Hamas gunmen.
7311,8/6/2007,Indonesia,Pekanbaru,1,0,1,A Christian schoolteacher is shot to death in front of his 9-year-old son by Muslim extremists.
7312,8/6/2007,Afghanistan,Laghman,1,3,4,At least one Afghan is killed in a Taliban bombing.
7313,8/6/2007,Thailand,Yala,1,22,23,"Islamists bomb a tea house, killing a woman and injuring two dozen others."
7314,8/6/2007,Pakistan,Hub,3,7,10,A bus bombing leaves at least three people dead.
7315,8/6/2007,Iraq,Baqubah,14,3,17,"Fourteen people are killed when al-Qaeda gunmen invade a policeman's home, including his wife and children."
7316,8/6/2007,Iraq,Daqquq,24,30,54,Two dozen people are killed when radical Sunnis bomb Shiite mosques.
7317,8/6/2007,Iraq,Qurna,12,33,45,"Holy warriors bomb a bus station, killing a dozen civilians."
7318,8/6/2007,Pakistan,Alikhel,1,0,1,The Taliban videotape the torture and execution of a local tribesman.
7319,8/6/2007,Sudan,Mutu,2,0,2,Janjaweed militias rack up two more dead African villagers in a raid.
7320,9/6/2007,Pakistan,Mardan,1,0,1,A woman's family stones her to death on suspicion of adultery.
7321,9/6/2007,Afghanistan,Kandahar,1,0,1,Religious extremists kill a man as he leaves a barbershop.
7322,9/6/2007,Afghanistan,Murghab,2,0,2,"The Taliban ambush an Afghan security party, killing two policemen."
7323,9/6/2007,Iraq,Kanaan,5,0,5,Five family members are stopped on a highway and brutally executed by Islamic terrorists.
7324,9/6/2007,Somalia,Mogadishu,2,2,4,Two Somalis are killed by a bombing attributed to the Islamic militias.
7325,9/6/2007,Thailand,Narathiwat,2,0,2,Muslim radicals gun down two villagers riding a motorcycle.
7326,9/6/2007,Iraq,Hilla,14,30,44,A Fedayeen suicide bomber sends fourteen Iraqis to Allah.
7327,9/6/2007,Iraq,Baghdad,30,15,45,Two car bombings and various other Jihad attacks leave thirty people dead.
7328,9/6/2007,India,Pulwama,2,0,2,A man and his son are shot to death by Islamic militants.
7329,9/6/2007,India,Bejbehara,1,0,1,The Mujahideen gun down a cop.
7330,9/6/2007,Iraq,Camp Bucca,6,50,56,"Six Iraqi prisoners are killed in a rocket attack on a prison by ""insurgents."""
7331,10/6/2007,Pal. Auth.,Gaza,1,0,1,"Hamas (""Islamic Resistance"") operatives throw a man to his death from a tower."
7332,10/6/2007,Iraq,Tikrit,14,42,56,A Fedayeen suicide bomber sends fourteen souls to Allah.
7333,10/6/2007,Iraq,Baghdad,20,26,46,"A ""coffin bomb"" adds to the misery as Islamic terrorists kill twenty Iraqis in various attacks."
7334,11/6/2007,Iraq,Mosul,5,0,5,Islamic gunmen storm a home and murder four women and a man.
7335,11/6/2007,Lebanon,Nahr al-Bared,2,1,3,Two Red Cross workers are killed by Fatah al-Islam militants.
7336,11/6/2007,Thailand,Narathiwat,2,0,2,Two female Buddhists teachers are shot to death by Muslim radicals who invade the school with assault weapons.
7337,11/6/2007,Thailand,Narathiwat,1,0,1,A 56-year-old Buddhist is shot to death by Islamists while riding a motorcycle.
7338,11/6/2007,India,Ramban,2,1,3,A civilian and a cop are murdered by Islamic radicals.
7339,11/6/2007,India,Pulwama,1,0,1,The Mujahideen capture a soldier and slit his throat.
7340,12/6/2007,Iraq,Razaliyah,1,0,1,A Christian father of two young children is kidnapped and killed when he refuses to accept Islam.
7341,12/6/2007,Afghanistan,Logar,2,4,6,A female teacher and a 13-year-old girl student are savagely murdered by religious fundamentalists.
7342,12/6/2007,Thailand,Narathiwat,2,0,2,Two Buddhists are brutally murdered by angry Muslims.
7343,12/6/2007,Afghanistan,Lashkar Gah,1,0,1,"A religious extremists blows himself up on a bicycle, killing a nearby police officer."
7344,12/6/2007,Iraq,Khalis,4,4,8,"Jihad gunmen take down four Iraq civilians, including two on a minibus."
7345,12/6/2007,Iraq,Baghdad,33,20,53,Sectarian hatred within the Religion of Peace accounts for thirty-three bodies in multiple attacks.
7346,12/6/2007,Lebanon,Nahr Al-Bared,8,20,28,Eight Lebanese soldiers are killed over the course of two days by Fatah al-Islam militants.
7347,12/6/2007,Pal. Auth.,Gaza,4,0,4,"Hamas militants attack a home with rockets, killing three women and a 14-year-old boy."
7348,12/6/2007,Thailand,Yala,1,0,1,A 60-year-old teacher is shot in the back by Muslim radicals.
7349,13/6/2007,Thailand,Yala,1,0,1,Muslim terrorists kill a 44-year-old man and set fire to thirteen schools.
7350,13/6/2007,Iraq,Mandali,5,10,15,A Fedayeen suicide bomber sends five souls to Allah.
7351,13/6/2007,Iraq,Ramadi,4,11,15,Four Iraqis are killed by a suicide bomber at a police checkpoint.
7352,13/6/2007,Iraq,Baghdad,29,10,39,"Jihads slaughter twenty-nine Iraqis in various attacks, including kidnapping, torture and executions."
7353,13/6/2007,Afghanistan,Mizan,1,0,1,"The Taliban send an RPG into a house, killing a 7-year-old girl."
7354,13/6/2007,Lebanon,Beirut,10,11,21,A prominent anti-Syrian lawmaker and his son are among ten killed in a car bombing.
7355,13/6/2007,Thailand,Narathiwat,1,0,1,"A Buddhist salesman is beheaded by Islamic radicals, who then leave the body and head in separate bags."
7356,13/6/2007,Thailand,Pattani,2,8,10,"Islamists bomb two groups of school guards, killing one in each party."
7357,13/6/2007,Pal. Auth.,Gaza,17,30,47,"Two separate ambushes by Hamas (""Islamic Resistance"") leaves close to twenty victims dead."
7358,14/6/2007,Iraq,Baghdad,14,0,14,Fourteen Iraqi policemen and soldiers are executed on video by terrorists shouting 'God is Great'.
7359,14/6/2007,Iraq,Balad,2,3,5,Islamic terrorists shoot two farmers to death.
7360,14/6/2007,Pal. Auth.,Rafah,7,0,7,Hamas round up seven Palestinian men and shoots them to death in front of their families.  The gunmen then kneel in prayer.
7361,14/6/2007,Thailand,Narathiwat,1,0,1,A 54-year-old man is shot to death by Muslim radicals as he is riding a motorcycle.
7362,14/6/2007,Somalia,Shibis,1,0,1,A man is shot to death by a suspected Islamic militia.
7363,14/6/2007,Somalia,Mogadishu,1,0,1,The Young Mujahideen Movement kill at least one civilian in an automatic weapons attack.
7364,14/6/2007,Pal. Auth.,Gaza,3,0,3,Hamas gunmen walk into a hospital and murder an injured patient as well as two women visiting him.
7365,14/6/2007,India,Kupwara,1,0,1,A man is shot to death in his home by the Mujahideen.
7366,14/6/2007,Pal. Auth.,Gaza,2,0,2,Two employees of the UN refugee relief agency are murdered by Hamas terrorists.
7367,14/6/2007,Pal. Auth.,Gaza City,2,0,2,Two unarmed peace activists are shot to death by Hamas gunmen at a rally.
7368,14/6/2007,Pal. Auth.,Khan Younis,1,0,1,"Hamas members shoot a captured man to death, then stab and stomp on his body."
7369,15/6/2007,Pal. Auth.,Gaza,1,0,1,"After gouging out his left eye, Hamas operatives shoot a 19-year-old man to death."
7370,15/6/2007,Philippines,Davao,10,18,28,"Moro Islamic Liberation Front terrorists leave a bomb on a bus, blasting ten passengers to death."
7371,15/6/2007,Iraq,Mosul,4,0,4,A young boy is among four people killed by Jihadis.
7372,15/6/2007,Iraq,Ramadi,13,0,13,The bodies of thirteen members of an athletic team are found shot to death by Muslim militants.
7373,15/6/2007,Iraq,Baghdad,25,7,32,"Twenty-five victims of sectarian hatred within the Religion of Peace are found, bound and executed."
7374,15/6/2007,Thailand,Pattani,2,0,2,A young Buddhist man is among two civilians murdered by Islamists in separate drive-by attacks.
7375,15/6/2007,Afghanistan,Uruzgan,9,7,16,A suicide bomber kills five children about 12-years of age and four adults.
7376,15/6/2007,Somalia,Baidoa,4,6,10,"Fundamentalists throw grenades into a movie theater showing a foreign film, killing four innocents."
7377,15/6/2007,Thailand,Pattani,3,1,4,"Radical Muslims stop a group of villagers on the road and then open up on them with automatic weapons fire, killing three."
7378,15/6/2007,Thailand,Yala,7,1,8,"Islamists stage a brutal ambush on a Thai security patrol, killing seven members."
7379,15/6/2007,Somalia,Mogadishu,4,10,14,A suicide bomber on a motorcycle slaughters four innocent people.
7380,15/6/2007,Lebanon,Nahr el-Bared,4,6,10,Four Lebanese troops are killed when Fatah al-Islam terrorists blow up a building.
7381,15/6/2007,India,Sopore,2,7,9,Two Indian soldiers are killed in a Mujahideen ambush.
7382,15/6/2007,Ingushetia,Nazran,3,2,5,Two civilians and a police officer are killed in an attack by suspected Islamic extremists.
7383,16/6/2007,Afghanistan,Kabul,4,6,10,A suicide bomber sends four Afghan civilians to Allah.
7384,16/6/2007,Thailand,Narathiwat,1,0,1,An 82-year-old man is shot to death by Muslim terrorists.
7385,16/6/2007,Thailand,Narathiwat,1,0,1,Muslims shoot a middle-aged civilian four times in the chest.
7386,17/6/2007,Iraq,Fallujah,8,16,24,A pregnant woman and her husband are among eight innocents killed in two attacks by Islamic terrorists.
7387,17/6/2007,Iraq,Jizani al-Emam,17,0,17,Seventeen villagers are killed during an attack by the Islamic Army of Iraq.
7388,17/6/2007,Iraq,Kirkuk,3,4,7,Sunni bombers kill three Kurds.
7389,17/6/2007,Afghanistan,Kabul,35,35,70,Three dozen Afghans are blown to Allah by Islamic bombers in an attack on a transportation hub.
7390,17/6/2007,Somalia,Baidoa,1,3,4,A child is killed when Islamists toss a grenade into a bank.
7391,17/6/2007,Afghanistan,Herat,2,0,2,"The Taliban attack a remote police post, killing two officers."
7392,17/6/2007,Afghanistan,Kandahar,4,0,4,Three soldiers and an interpreter are murdered in a Taliban roadside attack.
7393,17/6/2007,Pakistan,Peshawar,1,0,1,The Taliban shoot a suspected narcotics dealer to death.
7394,18/6/2007,Iraq,Baghdad,9,25,34,"Islamic terrorists bomb a gas station, killing nine patrons."
7395,18/6/2007,Iraq,Falluja,5,25,30,Two Jihad bombings leave at least five civilians dead.
7396,18/6/2007,Iraq,Baghdad,33,0,33,Thirty-three victims of sectarian violence are found in different locations.
7397,18/6/2007,Pal. Auth.,Erez,1,3,4,"Hamas gunmen open fire on Palestinians huddled in a tunnel, killing at least one."
7398,18/6/2007,Somalia,Mogadishu,2,7,9,"Islamists manage to kill two children with one bomb, hidden in a garbage pile."
7399,18/6/2007,Lebanon,Narh al-Bared,3,0,3,Three more Lebanese soldiers are killed by Fatah al-Islam militants.
7400,18/6/2007,Somalia,Bakara,1,1,2,A civilian is assassinated at a local market is a suspected Islamic militia attack.
7401,18/6/2007,Thailand,Yala,0,14,14,"Muslims bomb a Buddhist-owned teashop, injuring fourteen patrons."
7402,18/6/2007,Thailand,Pattani,1,0,1,A 23-year-old soldier is killed in an ambush by Muslim militants.
7403,18/6/2007,Pakistan,Jundo,1,0,1,A man kills his daughter for marrying the 'wrong' man.
7404,19/6/2007,Iraq,Baghdad,87,224,311,"Sunnis bomb an area outside a Shia mosque, sending eighty-seven souls to Allah and injuring over two-hundred others."
7405,19/6/2007,Afghanistan,Uruzgan,14,110,124,"Islamic militants attack a village, murdering ten civilians and four Afghan police."
7406,19/6/2007,Lebanon,Nahr al-Bared,2,0,2,Fatah al-Islam radicals kill two more Lebanese troops.
7407,19/6/2007,Thailand,Pattani,3,0,3,Thai Muslims kill three occupants of a vehicle with a roadside bomb.
7408,19/6/2007,Iraq,Tal Afar,2,0,2,A woman and a child are killed in a mortar attack by Sunni radicals.
7409,19/6/2007,Iraq,Mosul,1,0,1,A female college student is shot to death by Islamic fundamentalists.
7410,19/6/2007,Iraq,Baghdad,23,19,42,Jihadis kill two dozen Iraqis in various shooting and mortar attacks.
7411,19/6/2007,Thailand,Narathiwat,1,1,2,Islamists shoot a 27-year-old student to death in a drive-by attack.
7412,20/6/2007,Somalia,Mogadishu,2,0,2,"Islamic militias fire RPGs into a government building, killing at least two people."
7413,20/6/2007,Afghanistan,Kandahar,3,0,3,Three Canadian peacekeepers are killed in a roadside attack by Islamic extremists.
7414,20/6/2007,Iraq,Mosul,5,8,13,Two children and three women are killed in a mortar attack by Islamic terrorists.
7415,20/6/2007,Iraq,Baghdad,34,9,43,Sectarian Jihadis rack up thirty-four more dead Iraqis in various attacks.
7416,20/6/2007,Thailand,Pattani,1,0,1,Muslim gunmen shoot an off-duty Buddhist policeman to death in front of his wife.
7417,20/6/2007,Afghanistan,Khost,3,4,7,Talibanis enter a mosque and shoot three Afghan civilians to death.
7418,20/6/2007,Afghanistan,Zabul,2,1,3,"Religious extremists fire on a UN relief convoy, killing two Afghans."
7419,20/6/2007,India,Baramulla,1,2,3,A Harkat-ul-Mujahideen militant kills a homeowner with a grenade.  The man's daughter and son are injured.
7420,21/6/2007,Pal. Auth.,Nablus,1,0,1,A 32-year-old civilian is killed by Islamic gunmen.
7421,21/6/2007,Thailand,Narathiwat,1,0,1,"Muslim shoot a 29-year-old, then attempt to behead him.  The man bleeds to death."
7422,21/6/2007,Thailand,Narathiwat,1,0,1,A 54-year-old Buddhist is shot to death by Muslim radicals.
7423,21/6/2007,Pakistan,Khapianga,3,0,3,A roadside blast kills three farmers.
7424,21/6/2007,Afghanistan,Nangarhar,3,1,4,Three Afghan cops are gunned down in a Taliban attack.
7425,21/6/2007,Somalia,Mogadishu,5,10,15,"An Islamic militant tosses a grenade into a market, killing five people on the spot."
7426,21/6/2007,Iraq,Soliman Bek,15,66,81,"Suicidal Sunnis drive a truck full of explosives into a building, murdering at least fifteen people."
7427,21/6/2007,Iraq,Bahraz,3,15,18,Sunnis kill three villagers in a sustained attack on a Shia town.
7428,22/6/2007,India,Doda,1,0,1,The Mujahideen abduct and kill a civilian.
7429,22/6/2007,Algeria,Bouira,2,1,3,Two security guards are killed by two homemade bombs.
7430,22/6/2007,Thailand,Yala,2,5,7,"Muslim bombers target a Buddhist-owned teashop, killing three innocents."
7431,22/6/2007,Pakistan,Bannu,1,30,31,Radical Muslims attempt to attack a religious festival with small-arms fire and a grenade.  One guard is killed.
7432,22/6/2007,Thailand,Yala,3,10,13,Three young boys are shot full of holes in the name of Allah at a tea shop.
7433,22/6/2007,Thailand,Yala,1,0,1,A 16-year-old Buddhist girl is shot to death by radical Muslims.
7434,22/6/2007,Pakistan,Khar,1,0,1,"Islamic extremists behead a man, then attach a note to the body."
7435,22/6/2007,Iraq,Fallujah,5,57,62,A store bombing and a suicide attack on a telecom company net five dead Iraqis for freedom-fighting terrorists.
7436,23/6/2007,Afghanistan,Helmand,2,0,2,Two Estonian mine-sweepers are killed in a Taliban rocket strike.
7437,23/6/2007,Lebanon,Nahr el-Bared,3,0,3,Three Lebanese troops are killed by a Fatah al-Islam bomb.
7438,23/6/2007,Iraq,Kufa,2,0,2,Muslim terrorists shoot a married couple to death.
7439,23/6/2007,Iraq,Hillah,2,18,20,Two people are killed in an Islamic terrorist car bombing.
7440,23/6/2007,Iraq,Baghdad,18,2,20,Sectarian Jihadis rack up eighteen dead Iraqis in various attacks.
7441,23/6/2007,Pakistan,Karam Kot,4,1,5,Four Pakistani troops are killed when terrorists bomb their vehicle.
7442,23/6/2007,Somalia,Mogadishu,1,0,1,A off-duty cop is gunned down by an Islamist.
7443,23/6/2007,Thailand,Narathiwat,1,0,1,A 42-year-old Buddhist laborer is brutally killed and then set on fire by Muslim terrorists.
7444,24/6/2007,Afghanistan,Kandahar,3,2,5,"Religious extremists attack a police station, killing three Afghans."
7445,24/6/2007,Iraq,Khalis,3,3,6,Islamic terrorists kill three girls and injure their mother and father in a bomb attack on the family vehicle.
7446,24/6/2007,Somalia,Mogadishu,2,0,2,A man and a woman are shot to death by a suspected Muslim militant.
7447,24/6/2007,Lebanon,Dardara,6,2,8,Militant Islamists kill six UN Peacekeepers with a powerful suicide bomb.
7448,24/6/2007,Iraq,Balad,1,0,1,Fundamentalists assassinate a feminist.
7449,24/6/2007,Iraq,Mosul,2,0,2,"Two women, including a female journalist, are gunned down by Muslim radicals."
7450,24/6/2007,Iraq,Baghdad,14,6,20,The head of a children's hospital is among fourteen people murdered by Islamic terrorists.
7451,24/6/2007,Thailand,Pattani,2,0,2,"Two elderly Buddhist brothers are murdered by radical Muslims, who then burn their bodies."
7452,24/6/2007,Thailand,Narathiwat,2,0,2,Two Thai rangers are shot by Islamic terrorists while riding motorcycles.
7453,25/6/2007,India,Doda,2,14,16,"The Mujahideen toss a grenade into a bus stand, killing two people."
7454,25/6/2007,Iraq,Baghdad,12,21,33,A Fedayeen bomber blasts a dozen people at a peace and reconciliation conference to death.
7455,25/6/2007,Iraq,Baiji,27,62,89,"Suicide bombers ram an explosives-laden truck into a gate, killing over two dozen innocents in the blast."
7456,25/6/2007,Iraq,Mosul,3,42,45,Three civilians are killed when Islamic terrorists bomb a residential area.
7457,25/6/2007,Iraq,Baghdad,16,3,19,Jihadis rack up sixteen dead Iraqis in various attacks.
7458,25/6/2007,Lebanon,Nahr al-Bared,2,0,2,A soldier and a civilian are killed by a Fatah al-Islam sniper.
7459,25/6/2007,Thailand,Narathiwat,2,0,2,Two middle-aged men are gunned down in separate attacks by Muslim radicals.
7460,25/6/2007,Somalia,Hurwa,2,2,4,A woman and a man are killed when Islamic militias slam a rocket into their house.
7461,26/6/2007,Somalia,Mogadishu,1,3,4,"Islamists detonate a roadside bomb, killing one bystander."
7462,26/6/2007,Somalia,Mogadishu,6,9,15,Five cleaning women are among six killed by an Islamic bomb.
7463,26/6/2007,Iraq,Basra,1,0,1,A religious cleric is gunned down by Muslim rivals.
7464,26/6/2007,Thailand,Pattani,1,4,5,"A Muslim radical calmly fires into a Buddhist tea shop, killing at least one patron."
7465,26/6/2007,India,Pulwama,1,0,1,Militant Islamists abduct a constable from his home and behead him.
7466,26/6/2007,Bangladesh,Nilphamari,0,10,10,Ten Christian converts from Islam are savagely beaten by a Muslim mob.
7467,27/6/2007,Iraq,Mosul,2,0,2,Two Christians are murdered by Sunni radicals.
7468,27/6/2007,Thailand,Yala,3,17,20,"Muslims kill three people at a market, by hiding a bomb in a basket."
7469,27/6/2007,Iraq,Al Khalis,19,28,47,"Islamic terrorists barrage a residential area with mortars, killing at least nineteen innocents."
7470,27/6/2007,Iraq,Baghdad,21,0,21,Twenty-one victims of sectarian violence between Sunni and Shia are found bound and executed.
7471,27/6/2007,Iraq,Baghdad,10,24,34,"Islamic terrorists set off two car bombs, killing ten people."
7472,27/6/2007,Iraq,Samarrah,11,6,17,"Eleven Iraqis are killed in at least two separate Jihad attack, here and in Kirkuk."
7473,27/6/2007,Somalia,Mogadishu,2,2,4,Two civilians are killed when Muslim terrorists toss a grenade into a market.
7474,27/6/2007,Somalia,Bardhere,1,1,2,The driver of a vehicle is killed in a bombing attack by Muslim militants.
7475,27/6/2007,Somalia,El-Berde,2,0,2,"Two humanitarian workers, one a doctor, are brutally gunned down."
7476,28/6/2007,Somalia,Mogadishu,2,4,6,"Islamic terrorists target a security convoy along a busy road, killing two members."
7477,28/6/2007,Afghanistan,Paktika,1,8,9,An 18-year-old Afghan civilian is killed by a Fedayeen suicide bomber.
7478,28/6/2007,Thailand,Songkhla,1,0,1,A 51-year-old village guard is shot to death by Jihadis as he is returning home.
7479,28/6/2007,Iraq,Baghdad,25,50,75,Sunni radicals blow twenty-five innocent people to Allah at a bus stop.
7480,28/6/2007,Iraq,Baghdad,30,34,64,Several mortar attacks and shootings leave thirty Iraqis dead at the hands of Islamic terrorists.
7481,28/6/2007,Thailand,Yala,2,0,2,Two teenagers are shot to death by Muslim terrorists.
7482,28/6/2007,India,Ramban,1,0,1,A civilian is abducted and beheaded by the Religion of Peace.
7483,28/6/2007,India,Pulwama,1,16,17,"Lashkar-e-Toiba militants attack a security patrol, killing one member."
7484,28/6/2007,Afghanistan,Kabul,3,8,11,Two American civilians and an Afghan woman are killed by a Fedayeen suicide bomber.
7485,29/6/2007,Pakistan,FATA Region,1,0,1,An Afghan civilian is kidnapped and beheaded by Islamic militants.
7486,29/6/2007,Iraq,Kut,11,1,12,A university professor is shot several time in the head and neck.  Ten others are also murdered by Muslim terrorists.
7487,29/6/2007,Iraq,Mosul,3,0,3,Three women are murdered by Islamic gunmen.
7488,29/6/2007,Iraq,Baghdad,15,11,26,At least three women are among fifteen people shot to death or blown up by Muslim terrorists.
7489,29/6/2007,Iraq,Mishada,8,5,13,A Fedayeen suicide bomber murders eight Iraqis.
7490,29/6/2007,Pakistan,Larkana,2,0,2,A man shoots his wife and sister-in-law to death in an 'honor killing.'
7491,29/6/2007,Pakistan,Tirah,1,0,1,Lashkar-i-Islam militants stone a man to death.
7492,29/6/2007,Afghanistan,Khost,1,0,1,Religious extremists kidnap and behead a language interpreter.
7493,30/6/2007,Chechnya,Vedeno,1,2,3,"Holy Warriors ambush a security patrol, killing one member."
7494,30/6/2007,Iraq,Asiriya,2,12,14,"Two children are killed, and a dozen more injured, when Jihadis mortar a soccer field."
7495,30/6/2007,Iraq,Fallujah,4,0,4,Four people are beheaded by Islamic terrorists.
7496,30/6/2007,Iraq,Muqdadiyah,25,22,47,A suicidal Sunni sends over two-dozen innocent people to the grave with a market blast.
7497,30/6/2007,Iraq,Ferris,40,0,40,Children are beheaded as al-Qaeda massacres an entire village of Iraqis.
7498,30/6/2007,Iraq,Baghdad,16,8,24,Sixteen Iraqis are murdered in various sectarian attacks.
7499,30/6/2007,Thailand,Yala,1,0,1,Islamic militants murder a 53-year-old man.
7500,30/6/2007,Scotland,Glasgow,0,5,5,"Hoping for mass casualties, Islamic radicals ram a car filled with gas canisters into the main entrance of an airport."
7501,30/6/2007,India,Pulwama,1,0,1,A civilian is abducted and murdered by the Mujahideen.
7502,30/6/2007,Somalia,Mogadishu,1,0,1,Islamic militias assassinate a government official.
7503,1/7/2007,Chechnya,Grozny,2,2,4,A landmine attack kills two Russians.
7504,1/7/2007,Afghanistan,Helmand,1,4,5,A British soldier is killed by a suicide bomber.
7505,1/7/2007,Iraq,Ramadi,7,20,27,Seven Iraqi police are killed in separate suicide attacks by Fedayeen.
7506,1/7/2007,Iraq,Mosul,19,0,19,At least nineteen bodies surface around the country of civilians kidnapped and executed by the Mujahideen.
7507,1/7/2007,Iraq,Baghdad,18,12,30,A suicide bombing and other Jihad attacks account for fifteen dead Iraqis.
7508,1/7/2007,Thailand,Pattani,1,2,3,"Muslim terrorists fire on a group of young students, killing a 58-year-old teacher and injuring two boys, ages 9 and 11."
7509,1/7/2007,Thailand,Pattani,1,2,3,"A woman is killed, and two other people injured when Islamic gunmen fire into a Buddhist tea shop."
7510,2/7/2007,Thailand,Yala,1,0,1,Muslim radicals murder a 47-year-old rubber tapper on his way to work.
7511,2/7/2007,Thailand,Narathiwat,1,0,1,A 28-year-old villager is shot to death by Islamists.
7512,2/7/2007,Somalia,Horuwa,1,0,1,Two militant Muslims corner and gun down a government official.
7513,2/7/2007,Yemen,Marib,10,8,18,"Eight Spanish tourists and their two drivers are murdered by an al-Qaeda suicide bomber, who rams into their convoy."
7514,2/7/2007,Afghanistan,Kandahar,7,0,7,Seven Afghan cops are blown to bits by a Taliban roadside bombing.
7515,2/7/2007,Iraq,Baghdad,9,33,42,"Sunni radicals car bomb a Shia neighborhood, sending at least nine innocents to Allah."
7516,2/7/2007,Iraq,Baghdad,26,18,44,Sectarian terror attacks between Sunnis and Shias leave over two dozen dead.
7517,2/7/2007,Pakistan,Mir Ali,1,1,2,al-Qaeda backed militants kill a Pakistani who resists kidnapping.
7518,2/7/2007,Afghanistan,Khost,1,1,2,An education director is gunned down by religious extremists.
7519,3/7/2007,Thailand,Narathiwat,1,0,1,A young woman is shot to death by Muslims as she is picking up food for her mother.
7520,3/7/2007,Pakistan,Islamabad,3,0,3,"A Pakistani soldier, businessman and a cameraman are shot to death by student radicals at a madrassah."
7521,3/7/2007,Iraq,Baghdad,18,40,58,"Sunni bombers send eighteen market-goers straight to Allah, while leaving another forty in agony."
7522,3/7/2007,Iraq,Baghdad,24,4,28,Three sewer workers and two gardeners are among two dozen people killed in random Jihad attacks.
7523,3/7/2007,India,Rajouri,1,1,2,"Hizb-ul-Mujahideen terrorists attack a security patrol, killing one member."
7524,4/7/2007,England,Sheffield,1,0,1,A Muslim gang beats a man to death for adultery.
7525,4/7/2007,Iraq,Baghdad,23,9,32,"A woman and her daughter, and two journalists, are among two dozen people murdered by Islamic terrorists in various attacks."
7526,4/7/2007,Iraq,Ramadi,14,17,31,Fourteen innocents are blown to bits by Jihadi car bombers.
7527,4/7/2007,Iraq,Baiji,7,18,25,"Sunnis bomb a restaurant, killing seven people."
7528,4/7/2007,Pal. Auth.,Gaza,1,0,1,A civilian is killed in a shootout between two Islamist groups.
7529,4/7/2007,Pakistan,Swat,1,4,5,"Pro-Taliban militants fire a rocket into a police station, killing one officer."
7530,4/7/2007,Pakistan,Bannu,11,6,17,Two children are among eleven people killed when a suicide car bomber rams into a group of vehicles.
7531,4/7/2007,Iraq,Mosul,2,0,2,Islamists abduct and murder two members of a religious minority sect.
7532,4/7/2007,India,Kupwara,1,0,1,A man is killed in a Mujahideen landmine attack.
7533,4/7/2007,Pakistan,Charbagh,1,0,1,al-Qaeda militants gun down a policeman on his way to work.
7534,4/7/2007,Pakistan,Swat,4,2,6,Four civilians are killed when a Muslim terrorist tosses a grenade onto a city street.
7535,4/7/2007,Afghanistan,Kandahar,7,0,7,Six Canadians and one Afghan are killed by a roadside bomb planted by religious extremists.
7536,5/7/2007,Algeria,Tizi Ouzou,1,0,1,An Algerian soldier is killed by a remote-controlled bomb planted by fundamentalists.
7537,5/7/2007,Iran,Takestan,1,0,1,Authorities stone a man to death for adultery.
7538,5/7/2007,Somalia,Bossaso,1,0,1,A government employee is gunned down at a restaurant.
7539,5/7/2007,Thailand,Narathiwat,1,0,1,A civilian is gunned down by militant Muslims.
7540,5/7/2007,Iraq,Baghdad,18,30,48,Eighteen people at a wedding party are blown to bits by Sunni car bombers.
7541,5/7/2007,Iraq,Baghdad,24,4,28,Sectarian Jihadis kidnap and execute two dozen dead Iraqis.
7542,5/7/2007,Afghanistan,Zherai,2,0,2,Religious extremists hang two men 'before the public.'
7543,5/7/2007,Afghanistan,Spin Boldak,8,11,19,"A suicidal Sunni rams an Afghan convoy with an explosives-laden car, killing eight."
7544,5/7/2007,Thailand,Narathiwat,1,0,1,A 32-year-old rubber worker is shot to death by Islamic militants.
7545,6/7/2007,England,Stoke,1,0,1,"A father of seven is stabbed to death by his Muslim neighbors, apparently over his anti-immigration views."
7546,6/7/2007,Somalia,Mogadishu,1,0,1,A government official is assassinated by members of an Islamic militia.
7547,6/7/2007,Iraq,"Ahmad Maref,",26,33,59,"Islamic terrorists send a suicide bomber into a market, killing over two dozen shoppers."
7548,6/7/2007,Iraq,Tikrit,7,9,16,"Sunni gunmen attack the home of a peaceful Sheikh, killing seven members of his family."
7549,6/7/2007,Iraq,Mosul,2,0,2,A Kurdish married couple is shot to death by Sunni terrorists.
7550,6/7/2007,Iraq,Mahmudiya,3,0,3,Two people are tortured to death by the Mujahideen.  A child is killed in a separate attack in Umm Hilayil
7551,6/7/2007,Pakistan,Islamabad,2,0,2,Two students are executed by mosque radicals over their plans to surrender to police.
7552,6/7/2007,Pakistan,North Waziristan,2,4,6,An attack by radical Islamists leaves at least two tribesmen dead.
7553,6/7/2007,Thailand,Yala,1,0,1,An elderly rubber worker is murdered by Muslim extremists.
7554,6/7/2007,Somalia,Afgoi,1,0,1,A bus station guard is shot to death by Islamic gunmen.
7555,6/7/2007,Somalia,Mogadishu,5,0,5,Five children are killed when a landmine planted by Islamic militias explodes.
7556,6/7/2007,Thailand,Pattani,1,0,1,A 50-year-old Buddhist woman is shot to death by Islamists in her store.
7557,6/7/2007,Pakistan,Dir,4,1,5,A suicide bomber on a bicycle kills four Pakistani soldiers.
7558,6/7/2007,Somalia,Huriwa,4,6,10,Islamists kill four more children with a roadside bomb.
7559,7/7/2007,Afghanistan,Kandahar,6,0,6,Six Afghan police are ambushed and killed by the Taliban.
7560,7/7/2007,Afghanistan,Kunar,1,8,9,A 10-year-old boy is killed when Islamic terrorists fire a rocket into his home.
7561,7/7/2007,Iraq,Khanaqeen,22,15,37,A Fedayeen suicide bomber kills two dozen innocents at a funeral.
7562,7/7/2007,Iraq,Baghdad,19,0,19,Nineteen people are kidnapped and executed by Islamic terrorists.
7563,7/7/2007,Iraq,Kirkuk,5,0,5,Five civilians are murdered by the Mujahideen in two separate attacks.
7564,7/7/2007,Iraq,Mashahidah,8,0,8,Eight Iraqi soldiers are killed in a brutal and senseless attack on their checkpoint.
7565,7/7/2007,Afghanistan,Uruzgan,1,0,1,Religious extremists kidnap a man from his home and then shoot him to death.
7566,7/7/2007,Iraq,Tuz Khurmatu.,156,255,411,"Sunnis launch a very successful attack against Shia civilians, blasting to death over one-hundred and fifty at an open-air market."
7567,7/7/2007,Chechnya,Grozny,2,1,3,A police officer and an engineer are killed in separate attacks by Jihadis.
7568,8/7/2007,Pakistan,Bajur,1,7,8,"Islamic militants detonate a bomb under a police vehicle, killing one officer."
7569,8/7/2007,Pakistan,Islamabad,1,0,1,A Pakistani solider is killed by an Islamist sniper outside a mosque.
7570,8/7/2007,Pakistan,Bannu,1,3,4,Islamic militants attack a security patrol with grenades.
7571,8/7/2007,Iraq,Samawa,3,0,3,A woman and two children are killed when Islamic terrorists lob a mortar into their home.
7572,8/7/2007,Iraq,Haswa,23,27,50,Two dozen young Iraqi police recruits are killed when Fedayeen suicide bombers ram into their truck.
7573,8/7/2007,Iraq,Baghdad,15,33,48,Three Jihad car bombings leave fifteen civilians dead.
7574,8/7/2007,Iraq,Baghdad,29,0,29,"Twenty-nine bodies are found, victims of sectarian hatred within the Religion of Peace."
7575,8/7/2007,Iraq,Baghdad,2,0,2,"The bodies of a husband and wife, kidnapped by al-Qaeda, surface with slit throats."
7576,8/7/2007,Afghanistan,Kandahar,2,0,2,Two civilians are beheaded by the Taliban.
7577,8/7/2007,Somalia,Mogadishu,1,0,1,Islamic gunmen shoot a policeman three times in the head.
7578,9/7/2007,Somalia,Beledweyne,1,0,1,Muslim gunmen kill a Doctors Without Borders physician.
7579,9/7/2007,Chechnya,Vedeno,3,5,8,"Mujahideen stop a Russian vehicle with a landmine, then shoot the occupants."
7580,9/7/2007,Pakistan,Peshawar,3,1,4,Three Chinese motorcycle workers are shot to death by Islamic radicals.
7581,9/7/2007,Iraq,Baghdad,31,24,55,Various bombing and shooting attacks by Jihadis leave over thirty people dead.
7582,9/7/2007,Iraq,Mada'en,12,0,12,A dozen workers at a Pepsi plant are abducted and slaughtered by Shia terrorists.
7583,9/7/2007,Iraq,Balad,9,20,29,A roadside bombing leaves nine Iraqis dead.
7584,9/7/2007,Afghanistan,Herat,4,12,16,"A religious extremist opens fire inside an Afghan army camp, killing four people."
7585,9/7/2007,Iraq,Ghazaliya,4,0,4,Four members of a family are kidnapped and strangled by Islamic terrorists.
7586,9/7/2007,Somalia,Mogadishu,3,8,11,At least three civilians are killed when Islamists lob grenades into a market.
7587,10/7/2007,Somalia,Mogadishu,2,5,7,Two civilians are killed when a grenade is thrown into a busy marketplace.
7588,10/7/2007,Afghanistan,Deh Rawud,17,30,47,"A suicide bomber detonates at a market, killing seventeen innocents, including children."
7589,10/7/2007,Iraq,Sherween,18,40,58,Eighteen villagers are killed when al-Qaeda militants stage an assault.
7590,10/7/2007,Iraq,Tikrit,12,0,12,A dozen people are shot to death by Islamic terrorists.
7591,10/7/2007,Iraq,Nasariyah,3,1,4,Three children die in separate Jihad attacks.
7592,10/7/2007,Iraq,Baghdad,26,15,41,Twenty-six people are killed in sectarian violence within the Religion of Peace.
7593,10/7/2007,Thailand,Yala,1,0,1,A 48-year-old Buddhist man is shot to death in his car by Muslim radicals.
7594,10/7/2007,Thailand,Narathiwat,1,0,1,"A village chief is ambushed and killed on the road by Muslim terrorists, as he is driving home football players."
7595,10/7/2007,Pakistan,Kohat,1,11,12,Islamic militants kill one soldier at a checkpoint.
7596,10/7/2007,Philippines,Basilan,14,9,23,Abu Sayyaf militants kill 14 members of a search party looking for a kidnapped priest.  At least ten are beheaded.
7597,10/7/2007,Pal. Auth.,Gaza,1,0,1,Hamas militants strangle a 31-year-old man.
7598,11/7/2007,Philippines,Al-Barka,1,0,1,Abu Sayyaf terrorists murder a civilian.
7599,11/7/2007,Thailand,Narathiwat,1,0,1,A Buddhist civilian is murdered in a drive-by shooting attack by Muslim radicals.
7600,11/7/2007,Algeria,Tigzirt,1,1,2,Fundamentalists kill a security guard with a bomb.
7601,11/7/2007,Iraq,Garma,21,50,71,"Two al-Qaeda suicide bombers attack a reconciliation meeting at a residence, then two others kill emergency responders."
7602,11/7/2007,Iraq,Baghdad,32,17,49,Thirty victims of sectarian hatred within the Religion of Peace are found executed.
7603,11/7/2007,Afghanistan,Paktia,4,0,4,Religious extremists ambush and kill four Afghans.
7604,11/7/2007,Thailand,Narathiwat,1,0,1,Islamists murder a rubber worker on his plantation.
7605,11/7/2007,Algeria,Lakhdria,10,35,45,At least ten people are killed when a teenage suicide bomber detonates near a sports venue.
7606,11/7/2007,Somalia,Mogadishu,7,4,11,Islamists kill civilians and police by throwing grenades into a market.
7607,11/7/2007,Thailand,Patani,1,0,1,A 58-year-old man is murdered by Muslim radicals as he tends his garden.
7608,11/7/2007,Somalia,Mogadishu,2,0,2,Two people are killed by an Islamist mortar attack.
7609,12/7/2007,Lebanon,Nahr al-Bared,4,9,13,Islamic militants kill four Lebanese soldiers.
7610,12/7/2007,Iraq,Karbala,4,2,6,"Islamic terrorists attack a family car, killing four members."
7611,12/7/2007,Iraq,Mosul,5,15,20,Jihadis car bomb and shoot five Iraqis to death.
7612,12/7/2007,Iraq,Baghdad,28,0,28,Twenty-eight victims of sectarian violence between Shia and Sunni are found executed.
7613,12/7/2007,Thailand,Narathiwat,2,0,2,Muslims shoot an elderly Buddhist couple to death as they are riding to a market.
7614,12/7/2007,Pakistan,Miranshah,3,3,6,A Religion of Peace suicide bomber strolls into an office and kills three workers.
7615,12/7/2007,Pakistan,Swat,5,3,8,Five Pakistanis are killed in a suicide attack on a police vehicle.
7616,12/7/2007,Somalia,Mogadishu,3,9,12,"Three Somali civilians, including two construction workers are killed in separate attacks by Islamic grenade throwers."
7617,12/7/2007,Afghanistan,Khost,6,0,6,Six Afghans are slaughtered when religious extremists attack their patrol.
7618,12/7/2007,Iraq,Tal Afar,7,4,11,"A suicide bomber attacks a wedding, killing seven guest who try and stop him."
7619,12/7/2007,Thailand,Narathiwat,1,0,1,"Muslim radicals shoot a man, then set him on fire under a bridge."
7620,12/7/2007,Thailand,Pattani,1,0,1,Islamists slash the throat of a 29-year-old man and throw him into a river.
7621,12/7/2007,Pakistan,Spin Wam,1,0,1,al-Qaeda backed militants cut the head off of a civilian.
7622,13/7/2007,Lebanon,Nahr al-Bared,11,50,61,Fatah al-Islam terrorists kill eleven Lebanese soldiers with rockets and sniper fire.
7623,13/7/2007,Pakistan,Miranshah,3,0,3,Three tribal leaders are shot to death at a market by Islamic militants.
7624,13/7/2007,Iraq,Muqdadiyah,12,0,12,Sunni gunmen massacre a family of twelve Shia in their home.
7625,13/7/2007,India,Reasi,1,0,1,Police recover the body of a man abducted from his home by militants a month earlier.
7626,13/7/2007,Iraq,Baghdad,2,6,8,Sunnis kill two Shia civilians with a car bomb.
7627,13/7/2007,Iraq,Baghdad,5,9,14,Jihadis gun down five policemen in an attack on their checkpoint.
7628,13/7/2007,Somalia,Huriwa,2,0,2,Two men are shot to death by suspected Islamic militias.
7629,14/7/2007,Afghanistan,Paktia,2,0,2,Two men are gunned down by religious extremists.
7630,14/7/2007,Pakistan,Essa,1,0,1,A Pakistani soldier is shot to death by an Islamic militant at a checkpoint.
7631,14/7/2007,Pakistan,North Waziristan,23,27,50,A Fedayeen suicide bomber sends twenty-three Pakistani soldiers to Allah.
7632,14/7/2007,Iraq,Hillah,9,3,12,"Jihadis barge into a house and murder nine members of a family, including women and children."
7633,14/7/2007,Iraq,Suwayra,6,0,6,Six people are murdered by Islamic radicals and thrown into a river.
7634,14/7/2007,Iraq,Baghdad,7,15,22,"Sunnis bomb a gas station, killing at least seven people lining up for fuel."
7635,14/7/2007,Iraq,Baghdad,28,12,40,Jihadis manage to kill twenty-eight Iraqis in various shooting and bombing attacks.
7636,14/7/2007,Thailand,Songkhla,2,0,2,Two civilians are ambushed and murdered by Islamic radicals.
7637,14/7/2007,Thailand,Narathiwat,1,0,1,Muslim terrorists shoot a 66-year-old farmer to death.
7638,14/7/2007,Somalia,Mogadishu,1,1,2,Islamists kill a woman and injure her 8-month-old baby in a grenade attack.
7639,15/7/2007,Iraq,Aziziya,2,0,2,A woman and her 8-year-old son are brutally gunned down by Muslim terrorists.
7640,15/7/2007,Iraq,Baghdad,10,25,35,Sunnis kill ten with a car bombing along a city square.
7641,15/7/2007,Iraq,Baghdad,22,0,22,"Twenty-two victims of sectarian violence are found, including several women."
7642,15/7/2007,Pakistan,Dera Ismail Khan,25,61,86,Twenty-five innocents are blown to bits by a Fedayeen suicide bomber on foot.
7643,15/7/2007,Thailand,Narathiwat,1,0,1,A 52-year-old railway worker is shot to death by Islamists on his way to work.
7644,15/7/2007,Pakistan,Swat,17,47,64,Civilians are among seventeen people blasted to death by a suicide bomber on a highway.
7645,15/7/2007,Thailand,Yala,1,1,2,A Muslim who 'switched sides' is shot to death at a market.  His wife is seriously injured.
7646,15/7/2007,Somalia,Mogadishu,3,0,3,Two civilians and a government official are killed when an Islamist hurls a grenade into a municipal office.
7647,15/7/2007,Afghanistan,Paktika,5,2,7,Religious extremists kill five highway construction workers with a bomb.
7648,15/7/2007,Afghanistan,Paktika,1,3,4,One person is killed when Islamists fire a rocket into his home.
7649,16/7/2007,Philippines,Tugas,2,1,3,"Abu Sayyaf militants ambush a security patrol, killing two members."
7650,16/7/2007,Afghanistan,Helmand,3,2,5,Five Afghans are killed in a roadside bombing by Taliban extremists.
7651,16/7/2007,Iraq,Baghdad,2,5,7,Two sisters are killed when they are taken hostage by Muslim terrorists and forced into a explosives-laden car.
7652,16/7/2007,Iraq,Kirkuk,85,180,265,Sunni suicide truck bombers massacre eighty-five Iraqi civilians near a Kurdish political office.
7653,16/7/2007,Iraq,Baghdad,39,45,84,Muslim terrorists rack up forty dead Iraqis in various sectarian attacks.
7654,16/7/2007,Iraq,Samarrah,5,0,5,Armed Jihadis shoot five people in the head.
7655,16/7/2007,Pal. Auth.,Gaza,1,0,1,Hamas militants kidnap and suffocate a 45-year-old man.
7656,16/7/2007,Afghanistan,Kandahar,1,0,1,A Taliban attack leaves one Afghan dead.
7657,16/7/2007,Somalia,Mogadishu,3,4,7,Two civilians are among three killed by Islamic militants in two attacks.
7658,16/7/2007,Ingushetia,Ordzhonikidzevskaya,3,7,10,A Christian woman and her two children are murdered in their home by Islamic gunmen.  Seven mourners are injured when their funeral is bombed two days later.
7659,17/7/2007,Lebanon,Nahr el-Bared,4,0,4,Four Lebanese troops are killed by Fatah al-Islam snipers.
7660,17/7/2007,Iraq,Muqdadiya,14,0,14,Twelve members of one family are massacred by Islamic terrorists in their home.  Two women are gunned down elsewhere in the city.
7661,17/7/2007,Thailand,Narathiwat,1,0,1,A man is shot to death outside a school by militant Muslims.
7662,17/7/2007,Pakistan,Islamabad,13,45,58,A suicide bomber detonates in a crowd a political rally.  Thirteen innocents are killed.
7663,17/7/2007,Thailand,Narathiwat,1,1,2,Islamic radicals shoot a soldier to death by the side of a road.
7664,17/7/2007,Lebanon,Nahr el-Bared,4,0,4,Fatah al-Islam snipers pick off four Lebanese soldiers.
7665,17/7/2007,Iraq,Baghdad,20,20,40,Sunnis send a suicide bomber into a Shia residential neighborhood to blast twenty innocents to death.
7666,17/7/2007,Iraq,Samarra,1,3,4,A hospital director is gunned down by militant Muslims.
7667,17/7/2007,Iraq,Baghdad,31,10,41,Jihadis ring up over thirty dead Iraqis in various shooting and bombing attacks.
7668,17/7/2007,Somalia,Mogadishu,1,4,5,At least one person is killed when Islamic militants throw a grenade into a market.
7669,17/7/2007,Thailand,Yala,1,31,32,A double bomb attack by Islamic radicals at a railway station leaves at least one person dead and thirty-one injured.
7670,17/7/2007,Iraq,Dulayiya,29,4,33,"Nearly thirty men, women and children gathered for a soccer game are hacked and shot to death by radical Sunnis."
7671,17/7/2007,Pakistan,Khar Banda,1,0,1,A civilian is abducted and beheaded by the Taliban.
7672,17/7/2007,India,Poonch,2,8,10,"Lashkar-e-Toiba terrorists attack a security patrol, killing two members."
7673,17/7/2007,India,Baltal,1,17,18,"Islamists toss a grenade into a crowd of Hindu pilgrims, killing one."
7674,17/7/2007,Pakistan,Mir Ali,5,0,5,A suicide bomber murders five people at a checkpoint.
7675,18/7/2007,Philippines,Lamitan,1,0,1,A Sunni missionary is dismembered by Abu Sayyaf militants on suspicion of spying.
7676,18/7/2007,Russia,Kizilyurt,4,3,7,Islamic separatists are suspected in the bombing of a school playground that kills four policemen.
7677,18/7/2007,Afghanistan,Khost,3,0,3,A suicide bomber blasts three Afghans to Allah.
7678,18/7/2007,Afghanistan,Zabul,7,4,11,Seven Afghan police officers are murdered in a brutal ambush by religious extremists.
7679,18/7/2007,Pakistan,Miranshah,16,14,30,"al-Qaeda backed militants ambush an army convoy with rockets, killing sixteen Pakistanis."
7680,18/7/2007,Pakistan,Bajaur,1,0,1,Islamists kidnap and behead a civilian.
7681,18/7/2007,Iraq,Khalis,7,0,7,Seven bus passengers are brutally shot to death by Islamic gunmen.
7682,18/7/2007,Iraq,Baghdad,17,18,35,A series of Sunni bomb attacks kills at least seventeen innocents.
7683,18/7/2007,Iraq,Baghdad,22,12,34,Random sectarian attacks leave twenty-two Iraqis dead.
7684,18/7/2007,Iraq,Baghdad,4,4,8,Four electrical workers are killed when Jihadis target their minibus with a truck bomb.
7685,18/7/2007,Afghanistan,Kandahar,2,0,2,Taliban extremists murder two police officers riding bikes.
7686,18/7/2007,Somalia,Mogadishu,2,3,5,Two people are killed when radical Muslims shell a market.
7687,18/7/2007,Nigeria,Sokoto,1,0,1,A Sunni cleric is assassinated by a rival Shiite militia.
7688,19/7/2007,Iraq,Baghdad,20,4,24,A man killed in front of his wife and children is among twenty victims of Jihad sectarian violence around the city.
7689,19/7/2007,Nigeria,Sokoto,1,0,1,A Sunni mob beats a Shia to death.
7690,19/7/2007,Iraq,Khalis,5,4,9,"Islamic gunmen attack a village, killing five residents."
7691,19/7/2007,Chechnya,Assinovskaya,2,3,5,Two policemen are killed when Mujahideen attack their post.
7692,19/7/2007,Afghanistan,Fayzabad,1,25,26,Women and children are among the casualties of a suicide bombing.
7693,19/7/2007,Pakistan,Hub,30,28,58,Thirty people are slaughtered when Sunni bombers target Chinese engineers along a road.
7694,19/7/2007,Pakistan,Hangu,8,22,30,At least eight are killed when suicide bombers ram their vehicle into a police training facility.
7695,19/7/2007,Afghanistan,Helmand,6,2,8,"Religious extremists ambush a police car, killing a dozen Afghans at point-blank range."
7696,19/7/2007,Somalia,Baruha,1,0,1,Islamists shoot a civilian in the head as he is holding a child.
7697,19/7/2007,Pakistan,Kohat,18,19,37,"Fedayeen suicide bombers hit a mosque inside an army base, blasting eighteen people to death."
7698,19/7/2007,Somalia,Mogadishu,6,3,9,Children playing soccer are hit by mortars fired by Islamists.  Six are killed and three injured.
7699,20/7/2007,Pakistan,Miran Shah,4,6,10,Four innocents are killed by a suicide car bomber.
7700,20/7/2007,Afghanistan,Kandahar,3,0,3,Taliban militants murder three civilians with a roadside bomb.
7701,20/7/2007,Afghanistan,Helmand,2,2,4,Two civilians are killed by a car bomb.
7702,20/7/2007,India,Rajouri,1,15,16,A civilian is shot to death outside his home and Islamic terrorists throw a grenade at Hindu pilgrims in a separate attack.
7703,20/7/2007,Somalia,Mogadishu,1,0,1,Islamists gun down a drug store owner in his shop.
7704,20/7/2007,Iraq,Baghdad,2,2,4,A ruthless attack by Mujahideen leaves two Australian civilians dead.
7705,20/7/2007,Iraq,Baghdad,16,0,16,Sixteen victims of sectarian violence are found scattered around the city.
7706,20/7/2007,Nigeria,Sokoto,5,0,5,A man is burned to death in his home is among five killed in sectarian clashes between Sunni and Shia.
7707,21/7/2007,Somalia,Mogadishu,2,3,5,Two civilians are murdered when a terrorist throws a grenade into a marketplace.
7708,21/7/2007,Iraq,Mosul,26,6,32,A cafe showing a soccer match is one site among several Jihad targets as twenty-six people are killed.
7709,21/7/2007,Iraq,Baghdad,28,31,59,Islamic 'insurgents' rack up twenty-eight dead Iraqis in several bombing and shooting attacks.
7710,21/7/2007,Ingushetia,Karabulak,1,0,1,Muslim gunmen assassinate a government official in charge of 'ethnic relations'.
7711,21/7/2007,Thailand,Pattani,0,6,6,A 10-year-old boy and 13-year-old girl are among the casualties when Islamic radicals bomb a rice shop.
7712,21/7/2007,Algeria,Crete,1,2,3,"Islamic fundamentalists attack a group of soldiers, killing one."
7713,22/7/2007,Iraq,Jurf al-Milih,5,12,17,A Fedayeen truck bomber takes out five Sunni leaders for talking peace with Shiites.
7714,22/7/2007,Iraq,Khanqeen-Buhriz,6,0,6,Six delivery truck drivers are murdered by the Religion of Peace.
7715,22/7/2007,Iraq,Baghdad,22,20,42,A bombing and several shooting attacks leave twenty-two Iraqis dead at the hands of Freedom Fighters.
7716,22/7/2007,Lebanon,Tanbourit,1,4,5,Shiites shoot Christian villagers who complained of harassment.
7717,22/7/2007,India,Ramban,1,0,1,Hizb-ul-Mujahideen terrorists kidnap and kill a former member who wanted out.
7718,22/7/2007,Afghanistan,Kabul,1,0,1,"The Taliban kill a German hostage, abducted four days earlier."
7719,22/7/2007,Pal. Auth.,Gaza,3,0,3,Three sisters are brutally tortured and stabbed to death over suspicion of 'immoral' activities.  Two are teenagers.
7720,22/7/2007,Somalia,Mogadishu,1,3,4,A civilian is killed when Muslim militants throw a grenade in a marketplace.
7721,23/7/2007,India,Kishtwar,1,0,1,The Mujahideen kidnap and execute a 22-year-old man who was collecting firewood.
7722,23/7/2007,India,Anantnag,1,1,2,"Islamic militants ambush a security patrol, killing one member."
7723,23/7/2007,Thailand,Narathiwat,1,0,1,A 35-year-old is shot to death while fishing in a pond.
7724,23/7/2007,Algeria,Boumerdes,1,8,9,An Algerian security personnel is killed in a bomb attack by Islamic fundamentalists.
7725,23/7/2007,Iraq,Muqdadiyah,2,1,3,Muslim gunmen take down two electrical workers.
7726,23/7/2007,Iraq,Khanqeen,5,3,8,Five truck drivers are murdered by Islamic terrorists.
7727,23/7/2007,Iraq,Ramadi,7,0,7,A female suicide bomber murders seven Iraqi policemen.
7728,23/7/2007,Iraq,Baghdad,17,49,66,Three separate car bombings by Muslim terrorists end the lives of seventeen Iraqi civilians.
7729,23/7/2007,Iraq,Baghdad,26,6,32,Violence in the name of Allah leaves over two dozen dead in various attacks.
7730,23/7/2007,Somalia,Mogadishu,7,0,7,A woman is among seven victims of an Islamic grenade attack in a commercial district.
7731,23/7/2007,Thailand,Yala,1,1,2,A 46-year-old construction worker is shot to death by Muslim militants.
7732,23/7/2007,Pakistan,Kagai,2,0,2,Two men are abducted by al-Qaeda militants and executed by having their throats slit.
7733,24/7/2007,Iraq,Hillah,32,68,100,"A suicide bomber detonates in a marketplace across from the maternity ward of a hospital, killing over thirty innocents."
7734,24/7/2007,Somalia,Mogadishu,3,0,3,A pregnant woman is among three civilians killed when Islamists toss a grenade into a market.
7735,24/7/2007,Pakistan,Bannu,10,40,50,"Muslim terrorists fire rockets into a village, killing ten civilians."
7736,24/7/2007,Pakistan,Dattakhel,4,0,4,"Islamic militants attack a security post, killing four members."
7737,25/7/2007,India,Doda,1,0,1,A civilian is abducted and murdered by the Mujahideen.
7738,25/7/2007,Iraq,Baghdad,58,125,183,Islamic terrorists stage two massive car bombings that slaughter over fifty Iraqis celebrating their country's soccer win in the street.
7739,25/7/2007,Iraq,Kirkuk,2,0,2,Two farmers are shot to death by Muslim radicals.
7740,25/7/2007,Iraq,Diyala,9,0,9,Nine young men are kidnapped and beheaded by Sunni terrorists.
7741,25/7/2007,Iraq,Baghdad,23,14,37,Various Jihad bombing and shooting attacks leave about two dozen Iraqis dead.
7742,25/7/2007,Afghanistan,Kandahar,1,0,1,The Taliban shoot a Christian man to death.
7743,25/7/2007,Somalia,Mogadishu,5,9,14,At least three civilians are killed when Islamists bomb an intersection.
7744,26/7/2007,Pakistan,Lahore,1,0,1,"A Muslim woman is shot in the head by her son, who suspected her of 'illicit relations.'"
7745,26/7/2007,Somalia,Mogadishu,2,3,5,Two civilians are killed by a landmine planted by Islamic militias.
7746,26/7/2007,Pakistan,Tiarza,1,2,3,A Pakistani soldier is killed when Taliban militants fire a rocket into a base.
7747,26/7/2007,Somalia,Mogadishu,4,3,7,"Islamists hurl a grenade into a coffee shop, killing four civilians."
7748,26/7/2007,Somalia,Mogadishu,1,0,1,A local official is gunned down by Islamic militants while walking home.
7749,26/7/2007,Iraq,Kirkuk,25,85,110,"Sunni terrorists explode a massive bomb next to a kabob shop, killing over two-dozen innocent people."
7750,26/7/2007,Iraq,Baghdad,61,94,155,Jihadis murder at least sixty Iraqis with a parked car bomb at a busy market.
7751,26/7/2007,Iraq,Tal Abta,6,13,19,"A suicide bomber detonates outside a police station, killing six others."
7752,26/7/2007,Thailand,Narathiwat,1,0,1,Islamic terrorists attack two groups of teachers with roadside bombs and shoot a 44-year-old man to death.
7753,26/7/2007,India,Ramban,1,0,1,A civilian is kidnapped from his home and murdered in captivity by the Mujahideen.
7754,27/7/2007,Thailand,Yala,1,1,2,A man is shot twice in the head by militant Muslims.
7755,27/7/2007,Iraq,Samarrah,7,0,7,Seven Iraqi policemen are killed in a Sunni bombing.
7756,27/7/2007,Iraq,Baghdad,10,2,12,An engineer and his wife are among ten people murdered by Jihadis in various attacks.
7757,27/7/2007,Dagestan,Makhachkala,2,1,3,Islamic terrorists kill an anti-terror cleric and his brother by bombing their car.
7758,27/7/2007,Ingushetia,Magas,1,0,1,Muslim separatists stage a deadly rocket attack on a government building.
7759,28/7/2007,Pakistan,Maidan,3,0,3,Three policemen are brutally murdered by Islamic militants in an ambush.
7760,28/7/2007,Iraq,Baghdad,5,22,27,"Sunnis set off a car bomb in a commercial district, killing five people."
7761,28/7/2007,Pakistan,Islamabad,14,60,74,A Fedayeen suicide bomber kills at least fourteen in an attack on a hotel.
7762,28/7/2007,Pal. Auth.,Al Bureij,1,0,1,A young woman is stabbed to death over 'immoral behavior.'
7763,28/7/2007,Thailand,Narathiwat,1,0,1,A 38-year-old mother of three succumbs to her injuries three days after a Religion of Peace bomb attack.
7764,29/7/2007,India,Srinagar,7,19,26,"Seven people, including two young girls, are killed when Islamic radicals bomb a bus."
7765,29/7/2007,Iraq,Balad,6,1,7,"Jihadis lob mortars into a residential neighborhood, killing six people."
7766,29/7/2007,Iraq,Tuz Khormato,7,6,13,Sunnis gun down six soccer fans celebrating the country's recent win.
7767,29/7/2007,Iraq,Balad Ruz,3,25,28,Islamic terrorists kill three people with multiple bombs at a market.
7768,29/7/2007,Somalia,Mogadishu,2,5,7,Two civilians are killed when Islamic radicals throw grenades into the electronics area of a market.
7769,29/7/2007,Thailand,Narathiwat,2,0,2,"Two men, one a work-placement employee, are shot to death by Muslim radicals in separate attacks."
7770,29/7/2007,Somalia,Mogadishu,2,0,2,Two guards at a market are shot to death by Islamic militants.
7771,29/7/2007,Afghanistan,Kandahar,13,8,21,"Taliban extremists attack a private aid convoy, killing thirteen guards."
7772,30/7/2007,Pakistan,Punjab,1,0,1,A Christian man is shot to death by two Muslims.
7773,30/7/2007,Pakistan,Miranshah,7,1,8,Four civilians are among seven killed by Taliban militants in two separate attacks.
7774,30/7/2007,India,Ramban,1,0,1,Hizb-ul-Mujahideen members kidnap and behead a government teacher.
7775,30/7/2007,India,Kishtwar,1,0,1,A civilian is abducted and murdered by the Mujahideen.
7776,30/7/2007,Iraq,Kirkuk,4,0,4,A woman is among four people shot to death by Islamic radicals.
7777,30/7/2007,Iraq,Balad,4,6,10,A suicide bomber kills six people with a loaded fuel truck.
7778,30/7/2007,Iraq,Baghdad,12,47,59,At least a dozen Iraqis are killed in three bomb attacks by Islamic terrorists.
7779,30/7/2007,India,Pulwama,2,6,8,Two children (ages 12 and 14) are killed when Islamists throw grenades at a tourist vehicle.
7780,31/7/2007,Pakistan,Bannu,1,4,5,"Religious extremists ambush a group of soldiers, killing one."
7781,31/7/2007,Somalia,Mogadishu,5,3,8,"Islamic terrorists blow up a minibus, killing five civilian passengers that included a woman."
7782,31/7/2007,Iraq,Baghdad,12,12,24,A teacher and an engineer are among a dozen people shot and killed in various Jihad attacks around the country.
7783,31/7/2007,Somalia,Mogadishu,3,4,7,A 4-year-old child is among three people killed in a brutal rocket attack by Islamists shouting 'Allah Akbar.'
7784,31/7/2007,Afghanistan,Kabul,1,0,1,The Taliban murder a 29-year-old Christian man taken hostage.
7785,31/7/2007,Ingushetia,Magas,1,3,4,"Muslim gunmen attack a bus carrying police officers, killing one."
7786,1/8/2007,Thailand,Narathiwat,2,0,2,A father and son are murdered by Islamic terrorists at their home.
7787,1/8/2007,Thailand,Yala,1,0,1,A 62-year-old man is shot to death by radical Muslims.
7788,1/8/2007,Iraq,Baghdad,50,60,110,"A Fedayeen suicide bomber detonates at a petrol station, killing at least fifty innocents."
7789,1/8/2007,Iraq,Baghdad,15,25,40,At least fifteen people are blown to bits when a suicide bomber detonates in a city square.
7790,1/8/2007,Iraq,Baghdad,12,20,32,A dozen civilians are killed in various Religion of Peace attacks around the city.
7791,1/8/2007,Iraq,Baqubah,25,40,65,"Islamic terrorists bomb a marketplace, killing twenty-five patrons."
7792,1/8/2007,Lebanon,Nahr al-Bared,1,0,1,A Fatah al-Islam sniper kills a Lebanese soldier.
7793,1/8/2007,Thailand,Narathiwat,1,11,12,A Buddhist woman is blown to bits when Muslim radicals bomb a shopping district.
7794,1/8/2007,Thailand,Yala,2,1,3,"Islamists ambush a group guarding a train station, killing two members."
7795,1/8/2007,Somalia,Mogadishu,3,6,9,A young boy is killed when Islamists throw a grenade into a market.  Two other bodies are found nearby.
7796,1/8/2007,Afghanistan,Kabul,1,5,6,A suicide bomber kills an Afghan truck driver.
7797,1/8/2007,Lebanon,Nahr el-Bared,4,0,4,Four Lebanese soldiers are killed by Fatah al-Islam snipers and bombers.
7798,1/8/2007,Iraq,Hibhib,14,0,14,Fourteen villagers are kidnapped and executed by Sunni militants.
7799,1/8/2007,Pakistan,Bannu,1,0,1,Talibanis murder a Pakistani soldier taken hostage.
7800,2/8/2007,Somalia,Mogadishu,8,20,28,A mother and her two daughters are among eight killed when Islamic militias rain down mortars on a neighborhood.
7801,2/8/2007,Pakistan,Sargodha,1,1,2,"A Fedayeen fires at police, killing one in a suicide bid."
7802,2/8/2007,Iraq,Hibhib,15,17,32,Fifteen people are killed when a suicide bomber detonates along a city street.
7803,2/8/2007,Iraq,Kirkuk,5,0,5,Five brothers who worked as day laborers are kidnapped and executed by Muslim terrorists.
7804,2/8/2007,Iraq,Balad,1,6,7,A young girl is killed in a mortar barrage by Muslim terrorists.
7805,2/8/2007,Iraq,Baghdad,30,8,38,Sectarian Jihadis shoot or blast thirty Iraqis to death in various attacks.
7806,2/8/2007,Thailand,Pattani,2,8,10,Two Thai soldiers are killed in separate bombing and shooting attacks.
7807,2/8/2007,Somalia,Balad,1,4,5,An grenade attack on Ethiopians leaves one dead.
7808,3/8/2007,Iraq,Muhbabiya,17,0,17,"Seventeen women, children and elderly Iraqis are found in a mass grave following an al-Qaeda massacre."
7809,3/8/2007,Philippines,Koronadal,1,12,13,A Christian pastor is killed in a bus bombing by a group linked to the Moro Islamic terror group.
7810,3/8/2007,Pakistan,Swat,2,6,8,A suicide bomber kills two people and injures six from the same family.
7811,3/8/2007,Afghanistan,Kunar,3,5,8,The Taliban kill three Afghan police with a bomb attack on their vehicle.
7812,3/8/2007,Somalia,Mogadishu,1,0,1,Islamists force their way into a home to shoot a government official to death.
7813,3/8/2007,Iraq,Diyala,4,9,13,Muslim gunmen murder two children and two adults in a brutal attack on a home.
7814,3/8/2007,Iraq,Baghdad,13,0,13,Thirteen victims of sectarian violence are found scattered throughout the city.
7815,3/8/2007,India,Banihal,0,24,24,Two dozen people are injured when Islamic terrorists toss a grenade into a crowded marketplace.
7816,4/8/2007,Saudi Arabia,Riyadh,2,2,4,Two maids are beaten to death by seven family members who accuse them of practicing 'black magic.'
7817,4/8/2007,Somalia,Suuq Baad,2,6,8,Two people are killed when Islamic militants hurl grenades into a crowded market.
7818,4/8/2007,Afghanistan,Kandahar,4,0,4,Four civilians are blown to bits when Holy Warriors target their vehicle with a roadside bomb.
7819,4/8/2007,Afghanistan,Logar,4,3,7,Four Afghan police are killed when Sunni terrorists rocket their vehicle.
7820,4/8/2007,Dagestan,Sergokala,1,2,3,A police officer is gunned down by Islamic militants.
7821,4/8/2007,Afghanistan,Kandahar,2,0,2,Two civilians are killed by a Fedayeen suicide bomber.
7822,4/8/2007,Pakistan,Miranshah,4,6,10,Four Pakistanis are killed when Taliban militants attack a check-point.
7823,4/8/2007,Pakistan,Parachinar,8,43,51,"At least eight people, including two young children, are killed when a suicide bomber attacks a car showroom and taxi stand."
7824,4/8/2007,Iraq,Baghdad,26,13,39,A doctor is among over two dozen people killed by sectarian Jihadis in various attacks.
7825,4/8/2007,Somalia,Mogadishu,1,3,4,"Islamists recruit a teenager to throw a grenade into a funeral procession, killing one."
7826,4/8/2007,Thailand,Pattani,1,0,1,A 45-year-old guard is shot to death at point-blank range by Muslim radicals.
7827,4/8/2007,Thailand,Yala,3,0,3,Three civilians in a pick-up truck are ambushed and murdered by Islamic terrorists.
7828,4/8/2007,Afghanistan,Kabul,3,2,5,A religious extremist kills three civilians in a suicide blast.
7829,5/8/2007,Chechnya,Tsa-Vedeno,3,0,3,"Three people, including a child, are burned to death in their car by Holy Warriors."
7830,5/8/2007,Thailand,Narathiwat,2,0,2,Two Thai soldiers on motorcycles are shot and killed by Muslim radicals.
7831,5/8/2007,Afghanistan,Kunar,5,6,11,Five Afghan police are murdered in two terror attacks by religious extremists.
7832,5/8/2007,Iraq,Mosul,6,0,6,"Two children are among six people kidnapped, tortured and executed by Islamic terrorists."
7833,5/8/2007,Iraq,Mahmudiya,2,5,7,A suicide bomber slays two innocents at an auto repair shop.
7834,5/8/2007,Iraq,Baghdad,32,14,46,Sectarian Jihadis rack up over thirty Muslim rivals in various attacks.
7835,5/8/2007,Afghanistan,Kandahar,2,0,2,Taliban extremists kill two civilians with a roadside blast.
7836,5/8/2007,India,Doda,1,9,10,"The Mujahideen gun down a cop and throw a grenade into a market, injuring nine civilians."
7837,6/8/2007,Thailand,Narathiwat,1,0,1,Muslim terrorists shoot a man to death in his home.
7838,6/8/2007,Iraq,al-Aameryia,36,0,36,Thirty-six Iraqi heads are liberated from their bodies by Islamic Freedom Fighters.
7839,6/8/2007,Iraq,Qabak,33,54,87,"A suicidal Sunni manages to kill thirty-four innocents in a Shiite neighborhood, which include seventeen children and ten women."
7840,6/8/2007,Iraq,Karbala,1,0,1,Islamic terrorists shoot the chairwoman for a humanitarian organization two times in the head.
7841,6/8/2007,Iraq,Baghdad,34,32,66,Thirty-four people are killed in various Religion of Peace attacks around the city.
7842,6/8/2007,Thailand,Yala,1,0,1,Muslim terrorists gun down a 61-year-old civilian on his way home.
7843,6/8/2007,India,Pulwama,1,0,1,A civilian is abducted four days earlier and murdered by the Mujahideen.
7844,7/8/2007,Thailand,Yala,1,0,1,A man is murdered and his body burned by Islamic separatists.
7845,7/8/2007,Thailand,Pattani,2,2,4,A roadside bombing by Muslim radicals leaves two Thai soldiers dead.
7846,7/8/2007,Somalia,Banadir,2,4,6,A mother and her 11-year-old daughter are killed when Islamists detonate a roadside bomb.
7847,7/8/2007,Iraq,Salah al Khalaf,7,8,15,Seven civilians are killed in a Mujahideen car bombing at a market.
7848,7/8/2007,Chechnya,Grozny,2,0,2,Two Russians are shot to death in a Mujahideen ambush.
7849,7/8/2007,Pakistan,Banda,1,0,1,A security patrol member is blown apart by Islamists while fetching water from a stream.
7850,7/8/2007,Iraq,Samarra,5,2,7,Three women and two children are killed in a Jihad mortar attack.
7851,7/8/2007,Iraq,Muqdadiya,1,1,2,"Muslim gunmen open fire on children, killing one."
7852,7/8/2007,Iraq,Baghdad,21,9,30,Sectarian Jihadis rack up twenty-one dead Iraqis in various attacks.
7853,7/8/2007,Pal. Auth.,Gaza,2,5,7,"Two Gaza children, ages 6 and 8, are killed by a rocket fired at Israel by a Palestinian Islamic group."
7854,8/8/2007,Iraq,Baqubah,4,4,8,Four members of a family are murdered inside their home by Islamic terrorists.
7855,8/8/2007,Iraq,Baqubah,5,10,15,"A fundamentalist bomber detonates himself in a barbershop, killing five innocents."
7856,8/8/2007,Iraq,Samarra,8,2,10,Jihadis kill eight Iraqis with mortars.
7857,8/8/2007,Iraq,Hawija,2,6,8,An infant and one other person are killed by Muslim terrorists.
7858,8/8/2007,Iraq,Baghdad,15,19,34,A little girl is among those killed by Freedom Fighters in various attacks on civilians.
7859,8/8/2007,Thailand,Pattani,2,0,2,Muslim gunmen storm a medical clinic and murder two Buddhist workers.
7860,8/8/2007,Thailand,Yala,1,0,1,A 66-year-old man is brutally shot to death by Islamists as he is walking in his orchard.
7861,8/8/2007,Thailand,Yala,2,0,2,Two men are shot to death by Muslim radicals.
7862,8/8/2007,Somalia,Mogadishu,4,0,4,Four people are shot to death by Islamic militias in separate attacks.
7863,8/8/2007,Pakistan,Chargano,5,10,15,"The Taliban lay siege to a village, killing five and wounding ten."
7864,8/8/2007,Thailand,Yala,2,0,2,"Muslims decapitate two elderly Buddhists, then set fire to their houses."
7865,9/8/2007,Pakistan,Mir Ali,2,0,2,Two tribesman are murdered by Taliban loyalists.
7866,9/8/2007,Turkey,Kars,2,0,2,"A 19-year-old boy beats his sister and divorced mother to death at the request of his father to 'clean the honor of his family."""
7867,9/8/2007,Somalia,Mogadishu,1,0,1,A woman dies from shrapnel injuries following a Religion of Peace grenade attack in a commercial district.
7868,9/8/2007,Philippines,Maimbung,21,2,23,"Abu Sayyaf terrorists ambush a security patrol, killing nine members.  A dozen more are cut down in the ensuing firefight."
7869,9/8/2007,Iraq,Baghdad,22,8,30,A man and his wife are among two dozen people killed by sectarian Jihadis in various attacks.
7870,9/8/2007,Thailand,Narathiwat,5,0,5,Five people are gunned down by Islamic radicals in separate drive-by attacks.
7871,10/8/2007,Somalia,Mogadishu,3,0,3,Three civilians are killed when Islamic militias attack with mortars and heavy machine guns.
7872,10/8/2007,Thailand,Narathiwat,1,1,2,Two men are shot by Muslim radicals.  Only one survives.
7873,10/8/2007,Somalia,Mogadishu,3,0,3,Three government officials are assassinated by Muslim militants as they are walking home.
7874,10/8/2007,Afghanistan,Badghis,7,0,7,Seven Afghans are killed when Taliban extremists ambush a security patrol.
7875,10/8/2007,Iraq,Kirkuk,8,45,53,"Islamic terrorists bomb a market, killing eight patrons."
7876,10/8/2007,Iraq,Ein Zala,4,14,18,Four Kurds are killed in a suicide bomb by Sunni fanatics.
7877,11/8/2007,Pakistan,Hangu,3,2,5,Three police are murdered by Islamic militants.
7878,11/8/2007,Somalia,Mogadishu,2,2,4,A journalist is killed by Islamic militias as he is returning from the funeral of a colleague murdered dies earlier.
7879,11/8/2007,Iraq,Ishaqi,4,0,4,Islamic extremists kill and dismember four people.
7880,11/8/2007,Iraq,Qadisiya,6,0,6,Jihadis kill six Iraqis with a roadside bomb.
7881,11/8/2007,Iraq,Baghdad,14,17,31,Fourteen people are killed in sectarian violence within the Religion of Peace.
7882,12/8/2007,Algeria,Amdjoudh,3,0,3,Islamic fundamentalists kill three members of a security patrol with a bomb.
7883,12/8/2007,India,Doda,1,0,1,The Mujahideen shoot a policeman to death as he is walking home.
7884,12/8/2007,Pakistan,Miranshah,1,0,1,Two Afghan civilians are kidnapped and beheaded by Muslim radicals in separate incidents.
7885,12/8/2007,Iraq,Hilla,3,0,3,Two women are among three people killed by Islamic terrorists.
7886,12/8/2007,Iraq,Baghdad,20,22,42,Sectarian Jihadis rack up twenty Iraqi scalps.
7887,12/8/2007,Pakistan,Peshawar,1,0,1,A Sunni is gunned down by Shia radicals.
7888,13/8/2007,Afghanistan,Spin Boldak,5,3,8,Religious extremists kill five Afghan police with a roadside bomb.
7889,13/8/2007,India,Bandipore,4,11,15,Four civilians are killed when Mujahideen militants hurl a grenade into a crowded street.
7890,13/8/2007,Russia,Novgorod,0,60,60,"A militant Islamic group derails a commuter train with a bomb, injuring sixty people."
7891,13/8/2007,Pakistan,Swat,4,6,10,Four people are killed when Islamic terrorists detonate a roadside bomb against a passing vehicle.
7892,13/8/2007,Lebanon,Nahr al-Bared,1,0,1,A Fatah al-Islam sniper murders a Lebanese soldier.
7893,13/8/2007,Somalia,Mogadishu,1,2,3,A young boy is killed when Islamic militias assault a police station.
7894,13/8/2007,Somalia,Mogadishu,1,0,1,A man sitting in a tea shop is assassinated by Muslim radicals.
7895,13/8/2007,Iraq,Samarrah,3,0,3,Three civilians are shot and killed by Islamic terrorists.
7896,13/8/2007,Iraq,Khanaqin,5,4,9,Radical Shiites kill five policemen with a bomb.
7897,13/8/2007,Somalia,Mogadishu,3,12,15,Three civilians are killed when Islamic militants bomb a passenger bus.
7898,13/8/2007,Thailand,Narathiwat,1,0,1,A 38-year-old trader is murdered by Islamic gunmen.
7899,14/8/2007,Pakistan,Jandola,1,0,1,Islamic radicals kidnap and behead a Pakistani soldier.
7900,14/8/2007,Afghanistan,Zhari,7,0,7,Six Afghan civilians and their guard are killed in an al-Qaeda rocket attack on their minibus.
7901,14/8/2007,Iraq,Sinjar,796,1500,2296,Five separate suicide bombings by al-Qaeda militants targeted at a religious minority group kill nearly eight hundred innocents.
7902,14/8/2007,Iraq,Suwayra,3,0,3,"Sunni extremists invade the home of a policeman and shoot his pregnant wife, son and brother to death."
7903,14/8/2007,Iraq,Ghraiya,4,0,4,"Jihadis kill three women and a man, who are sleeping on the roof of their home."
7904,14/8/2007,Iraq,Khalis,15,0,15,Fifteen Iraqi men are kidnapped and murdered by Islamic extremists.
7905,14/8/2007,Thailand,Yala,1,0,1,Muslim radicals stab a 56-year-old man to death at his rubber plantation.
7906,14/8/2007,Thailand,Narathiwat,1,2,3,A 26-year-old man is shot to death by Muslim militants.
7907,15/8/2007,Somalia,Afgoye,2,12,14,"Militant Muslims throw a grenade into a market, killing two people."
7908,15/8/2007,Somalia,Mogadishu,6,1,7,Islamists kill six Somalis in two separate attacks.
7909,15/8/2007,Afghanistan,Kabul,3,1,4,Religious extremists kill three German police officers with a roadside bomb.
7910,15/8/2007,Iraq,Hilla,5,12,17,A suicide bomber kills five people inside a judge's home.
7911,15/8/2007,Iraq,Kirkuk,5,30,35,"Islamic terrorists car bomb a marketplace, killing five people."
7912,15/8/2007,Iraq,Baghdad,22,4,26,Jihad attacks leave twenty-two Iraqis dead.
7913,15/8/2007,Chechnya,Avturi,1,0,1,A government official is killed when the Mujahideen attack his vehicle with grenades.
7914,15/8/2007,Chechnya,Grozny,1,0,1,A policeman is killed in a drive-by attack from militant Muslims.
7915,15/8/2007,Pakistan,Swabi,2,0,2,A teacher and student are killed when Islamists bomb a house.
7916,16/8/2007,Somalia,Mogadishu,2,0,2,Islamic gunmen shoot two civilians to death at a market.
7917,16/8/2007,Somalia,Mogadishu,2,3,5,Two Somalis are killed in a mine attack by Islamic militias.
7918,16/8/2007,Pakistan,Spinwara,2,4,6,Two soldiers are killed in an al-Qaeda IED attack.
7919,16/8/2007,Iraq,Baghdad,10,20,30,Ten Iraqis are blown apart when Islamic terrorists detonate a car bomb on a public square.
7920,16/8/2007,Iraq,Baghdad,19,0,19,Nineteen victims of sectarian Jihadis are discovered by police.
7921,16/8/2007,Pakistan,Bajaur,2,2,4,A tribal elder and his guard are killed in a bombing by Islamists.
7922,17/8/2007,Iraq,Haditha,3,0,3,"Three people are kidnapped, tortured and shot to death by sectarian rivals."
7923,17/8/2007,Iraq,Kirkuk,3,42,45,Two separate bombings by Sunni radicals kill three civilians and injure over forty.
7924,17/8/2007,Pakistan,Khyber,7,0,7,Seven people are killed in clashes between radical Islamist groups.
7925,17/8/2007,India,Rajouri,1,0,1,A civilian is kidnapped and killed in captivity by radical Muslims.
7926,17/8/2007,Afghanistan,Kandahar,4,2,6,Three young children under the age of 10 are slaughtered along with their father by a Fedayeen suicide bomber.
7927,17/8/2007,Somalia,Mogadishu,1,1,2,"Islamic militias rocket a house, killing a woman."
7928,17/8/2007,India,Baramulla,2,0,2,A policeman and his elderly father are brutally murdered inside their home by Islamic militants.
7929,17/8/2007,India,Pulwama,5,3,8,Mujahideen use an IED to kill five Indian soldiers traveling along a road.
7930,18/8/2007,Pakistan,Lakhi Ghulam Shah,2,0,2,A woman and her suspected lover are shot to death by her brother-in-law.
7931,18/8/2007,Afghanistan,Kandahar,15,26,41,"Fifteen Afghans, mostly civilians, are blown to bits by a suicidal Sunni along a highway."
7932,18/8/2007,Pakistan,Miran Shah,1,2,3,"A suicide bomber detonates at an army checkpoint, killing at least one Pakistani."
7933,18/8/2007,India,Kandi,1,0,1,The Mujahideen chop out a 70-year-old man's eyes and behead him.
7934,18/8/2007,Somalia,Mogadishu,2,4,6,An elderly man and a woman are killed in separate attacks by Islamic militias.
7935,18/8/2007,India,Rajouri,1,0,1,The Mujahideen kidnap a civilian and kill him in captivity.
7936,18/8/2007,Pakistan,Jandola,1,0,1,al-Qaeda militants kidnap and behead a teacher.
7937,18/8/2007,Pakistan,Bannu,1,5,6,A cop is killed in a hand grenade attack by Islamic militants.
7938,18/8/2007,Afghanistan,Kandahar,4,3,7,"A Taliban suicide bomber targets a road construction crew, killing four guards."
7939,18/8/2007,Afghanistan,Ghazni,2,2,4,Religious extremists kill two Afghan cops with a roadside bomb.
7940,18/8/2007,Iraq,Khalis,7,35,42,A baby is among seven people killed when Holy Warriors pump mortars and rockets into a residential neighborhood.
7941,18/8/2007,India,Doda,1,0,1,The body of a 26-year-old woman is found murdered days after she was taken by the Mujahideen.
7942,18/8/2007,Pakistan,Bajaur,1,0,1,Taliban militants shoot a man to death in his home.
7943,19/8/2007,Iraq,Baghdad,31,51,82,"A Jihad mortar attack and various shootings leave more than thirty people dead, including children."
7944,20/8/2007,Pakistan,Hangu,4,18,22,A woman passerby is among four killed when a Fedayeen suicide bomber rams into a military vehicle.
7945,20/8/2007,India,Shopian,1,0,1,A farmer is shot to death by the Mujahideen.
7946,20/8/2007,Iraq,Baghdad,20,36,56,Two Jihad bombings and random shootings leave over twenty people dead.
7947,20/8/2007,Iraq,al-Rumeitha,4,2,6,Shiite militants assassinate a provincial governor.
7948,20/8/2007,Sri Lanka,Trincomalee,2,0,2,Two men (ages 29 and 54) are killed by Jihadi gunmen.
7949,21/8/2007,Philippines,Zamboanga,0,14,14,"Abu Sayyaf sympathizers place a bomb at a city plaza, injuring fourteen people."
7950,21/8/2007,Lebanon,Nahr al-Bared,2,0,2,Fatah al-Islam gunmen kill two Lebanese soldiers.
7951,21/8/2007,Iraq,Latifiya,9,2,11,"Nine members of a family, including a baby, are murdered by Shiite radicals inside their home."
7952,21/8/2007,Iraq,Baghdad,17,14,31,Two passengers on a minibus are among fourteen Iraqis murdered by Jihadis in various attacks.
7953,21/8/2007,Thailand,Yala,1,0,1,Muslims kill a man elected to replace another official who was slaughtered along with his family.
7954,21/8/2007,Somalia,Mogadishu,1,5,6,An Islamist walks into a restaurant and shoot a civilian to death.
7955,21/8/2007,Thailand,Narathiwat,1,0,1,"A Buddhist security guard is murdered by Muslim extremists, who then attempt to cut the head from the body."
7956,21/8/2007,Thailand,Pattani,1,0,1,A Buddhist official is gunned down by Islamic radicals.
7957,21/8/2007,Pakistan,Mohallah,1,4,5,A woman is killed when fundamentalists toss a grenade into a brothel.
7958,21/8/2007,Afghanistan,Zabul,6,0,6,Religious extremists ambush and kill six Afghan cops.
7959,21/8/2007,Pakistan,Bannu,4,0,4,"Pro-Taliban militants attack a checkpoint with rockets, leaving three Pakistani soldiers and a woman dead."
7960,21/8/2007,Thailand,Yala,1,0,1,A man is shot to death by Muslim terrorists while sitting in a tea shop.
7961,22/8/2007,Somalia,Suqa Holaha,2,5,7,Two people are killed when Islamists hurl a grenade into the street.
7962,22/8/2007,Somalia,Mogadishu,1,0,1,Islamic militias are suspected in the murder of a civilian at a market.
7963,22/8/2007,Afghanistan,Paktia,2,4,6,Two engineers are shot to death by the Taliban.
7964,22/8/2007,Afghanistan,Khost,4,8,12,A Fedayeen suicide bomber kills four Afghans on a highway.
7965,22/8/2007,Afghanistan,Nuristan,2,11,13,Two Afghan soldiers are killed when religious extremists stage an attack on a base.
7966,22/8/2007,India,Doda,1,0,1,A civilian is abducted and murdered by the Mujahideen.
7967,22/8/2007,Ingushetia,Nazran,1,5,6,"Islamic terrorists attack a security convoy, killing at least one member."
7968,22/8/2007,Iraq,Kufa,1,0,1,A female university professor is stabbed to death by Islamic radicals.
7969,22/8/2007,Iraq,Beiji,45,80,125,"A suicidal Sunni drives a truck bomb into a police station, incinerating twenty-five police and twenty civilians."
7970,22/8/2007,Iraq,Muqdadiyah,6,50,56,A suicide bomber on a motorcycle kills six Iraqis.
7971,22/8/2007,Iraq,Tal Afar,2,5,7,Radical Sunnis take out two pipe layers with a bomb blast.
7972,22/8/2007,Iraq,Tikrit,2,12,14,Jihadis kill two civilians with a roadside bomb.
7973,22/8/2007,Pakistan,Quetta,0,16,16,A barbershop is one of two sites attacked by fundamentalists with grenades.
7974,23/8/2007,Afghanistan,Helmand,3,13,16,Three Afghan civilians are murdered in a Taliban suicide attack.
7975,23/8/2007,Iraq,Baghdad,16,17,33,A child is among sixteen people murdered by Jihadis in various attacks.
7976,23/8/2007,Iraq,Mosul,9,12,21,Nine people are killed in various attacks by Islamic terrorists.
7977,23/8/2007,Iraq,Ibrahim Yehyia,25,20,45,"al-Qaeda militants attack two Sunni villages with mortars and machine guns, killing twenty-five villagers."
7978,23/8/2007,Afghanistan,Zabul,10,0,10,Ten Afghan security guards are massacred in an ambush by Sunni extremists.
7979,23/8/2007,India,Poonch,1,0,1,A policeman is abducted and beheaded by Muslim radicals.
7980,23/8/2007,India,Handwara,1,0,1,Islamic militants shoot an innocent man to death inside his home.
7981,24/8/2007,Thailand,Narathiwat,1,0,1,A 71-year-old man is shot to death by Muslim terrorists as he is riding to a teashop.
7982,24/8/2007,Somalia,El Ilan,1,1,2,"Muslim gunmen open fire on a minibus, killing a journalist."
7983,24/8/2007,Pakistan,Miranshah,5,10,15,Five Pakistanis are killed by a suicide bomber at a check post.
7984,24/8/2007,Iraq,Samarra,3,9,12,An 11-year-old girl is among three people killed in an al-Qaeda attack on their village.
7985,24/8/2007,Iraq,Hawija,1,0,1,Religious fundamentalists murder a barber.
7986,24/8/2007,Iraq,Diwaniya,2,0,2,Sunni gunmen shoot two construction workers to death.
7987,24/8/2007,Pakistan,Dera Ismail Khan,1,0,1,A 22-year-old man is shot to death by sectarian rivals.
7988,24/8/2007,Thailand,Pattani,1,0,1,"A 50-year-old schoolmaster is forced off the road by Muslim radicals, who shoot him and then set fire to his body."
7989,25/8/2007,Iraq,Baghdad,17,30,47,A car bomb attack near a shrine is one of several sectarian attacks that leave at least seventeen people dead.
7990,25/8/2007,Thailand,Pattani,1,12,13,A Buddhist woman is cut down by an Islamic bomb attack in front of a grocery.
7991,25/8/2007,Thailand,Narathiwat,1,0,1,A barber is murdered by Muslim extremists.
7992,25/8/2007,Afghanistan,Kandahar,10,5,15,Religious extremists kill ten Afghans in two bombings.
7993,25/8/2007,India,Hyderabad,42,70,112,"At least forty-two people, including children, are blown to bits by bombs placed at a food stall and an amusement park."
7994,25/8/2007,Iraq,Khan Bani Saad,8,7,15,Eight people are kidnapped and brutally tortured to death by al-Qaeda militants.
7995,26/8/2007,Iraq,Baghdad,12,9,21,"A female pilgrim and several children are among Shias targeted by radical Sunnis, as a dozen people are killed."
7996,26/8/2007,Somalia,Mogadishu,3,5,8,Two young boys and an adult are killed by a bomb planted in a school yard.
7997,26/8/2007,Thailand,Yala,2,0,2,Two rubber tappers are murdered by Islamic radicals while on their way to work.
7998,26/8/2007,Somalia,Mogadishu,2,9,11,Two people are killed in separate grenade attacks by Islamic extremists.
7999,26/8/2007,Pakistan,Swat,4,2,6,A suicide bomber takes out four Pakistanis at a checkpoint.
8000,26/8/2007,Pakistan,Bajaur,1,0,1,A 40-year-old civilian is shot to death by Taliban extremists.
8001,26/8/2007,Iraq,Mahmudiyah,1,2,3,Sunni terrorists take out a child in a mortar attack.
8002,27/8/2007,Iraq,Fallujah,10,11,21,"A suicidal Sunni blows himself up near a rival mosque, taking ten innocents out with him."
8003,27/8/2007,Iraq,Baghdad,15,9,24,"Shia pilgrims are shot dead by Sunni snipers, adding to the sectarian violence."
8004,27/8/2007,Thailand,Pattani,1,0,1,A female teacher is murdered by Muslim radicals in front of her pupils.
8005,27/8/2007,Thailand,Pattani,1,0,1,A second school teacher is murdered by Islamic extremists.
8006,28/8/2007,Afghanistan,Paktia,3,6,9,A religious extremist murders three NATO soldiers helping to build a bridge.
8007,28/8/2007,India,Pulwama,1,0,1,A schoolteacher is abducted and murdered by the Hizb-ul-Mujahideen.
8008,28/8/2007,Thailand,Narathiwat,1,2,3,A guard for the Thai queen is cut down in an ambush by Islamic radicals.
8009,28/8/2007,Thailand,Narathiwat,2,0,2,Two men are killed by militant Muslims in drive-by shootings.
8010,28/8/2007,Thailand,Songkhla,1,0,1,Muslims murder an ice cream vendor on the side of the road.
8011,28/8/2007,Iraq,Karbala,3,1,4,A small boy is among three Shia pilgrims cut down by Sunni snipers.
8012,28/8/2007,Iraq,Baghdad,22,27,49,Sectarian attacks leave two dozen dead.
8013,28/8/2007,Somalia,Mogadishu,4,6,10,Four civilians are pumped full of bullets as Somali Islamists vow to keep 'fighting.'
8014,28/8/2007,Thailand,Pattani,1,0,1,A 40-year-old Buddhist woman is shot to death by Muslim militants as she arrives for work at a rubber plantation.
8015,28/8/2007,Thailand,Pattani,1,0,1,Muslim radicals kill a 67-year-old Buddhist construction worker and then set his body on fire.
8016,28/8/2007,Thailand,Yala,1,0,1,A Buddhist woman is brutally killed by militant Islamists.
8017,29/8/2007,Pakistan,Islamabad,2,0,2,A Christian pastor had his wife are brutally murdered in their home by Muslim gunmen.
8018,29/8/2007,Afghanistan,Bharmal,6,12,18,"An Islamic suicide bomber detonates in a market, killing six innocents."
8019,29/8/2007,Iraq,al-Bu Ajeel,6,0,6,A woman and her five children are murdered when Jihadis storm their home.
8020,29/8/2007,Iraq,Mosul,6,0,6,Six people are brutally killed by Islamic terrorists.  Two are beheaded and one is burned.
8021,29/8/2007,Iraq,Muqdadiyah,8,0,8,Eight Iraqi policemen are killed in a bombing by Sunni radicals.
8022,29/8/2007,Somalia,Mogadishu,2,0,2,Two civilians are shot to death by Islamic militias.
8023,29/8/2007,Thailand,Pattani,1,3,4,Militant Muslims gun down a village head.
8024,30/8/2007,Pakistan,Swat,7,3,10,A brutal attack by Islamic militants on a security patrol leaves seven dead.
8025,30/8/2007,India,Behak,1,0,1,A civilian is abducted and executed by the Mujahideen.
8026,31/8/2007,Afghanistan,Kabul,1,4,5,A suicide bomber pulls his car up next to a crowd of people at an airport and detonates.
8027,31/8/2007,Pakistan,Khairpur,1,0,1,A woman is gunned down by her uncle in the presence of her husband on suspicion of adultery.
8028,31/8/2007,India,Baramulla,1,0,1,A retired policeman is brutally murdered by the Mujahideen.
8029,31/8/2007,Pakistan,Mingora,3,8,11,Three people are killed in a bombing by Muslim radicals.
8030,31/8/2007,Iraq,Kirkuk,1,0,1,Religious fundamentalists gun down a barber.
8031,31/8/2007,Iraq,al-Jallam,4,7,11,A suicide car bomber kills four Iraqi police.
8032,31/8/2007,Afghanistan,Kunar,10,5,15,At least ten Afghan women and children are killed by a Taliban mortar attack on their neighborhood.
8033,31/8/2007,Thailand,Narathiwat,1,0,1,A railroad worker is murdered by Muslim terrorists on the job.
8034,31/8/2007,Ingushetia,Karabulak,3,0,3,"Islamic terrorists murder a female teacher's husband and her two sons, one of whom was disabled, in her home."
8035,31/8/2007,Ingushetia,Nazran,4,0,4,A car bomb takes out four people.
8036,1/9/2007,Iraq,Basra,1,0,1,A Shiite cleric is shot to death by Muslim rivals outside a mosque.
8037,1/9/2007,Iraq,Mosul,6,9,15,A child is among six people killed by Islamic terrorists in two attacks.
8038,1/9/2007,Iraq,Baghdad,24,3,27,"Sectarian Jihadis shoot, blast and stab two dozen to death in various attacks."
8039,1/9/2007,Pakistan,Bajur,5,9,14,A suicide bomber kills five Pakistanis at a police checkpoint.
8040,1/9/2007,Somalia,Mogadishu,2,0,2,Islamic gunmen kill two civilians at point-blank range at a market.
8041,1/9/2007,Thailand,Yala,1,0,1,A 22-year-old Buddhist student is shot to death by Muslims while sitting on his motorcycle.
8042,1/9/2007,Thailand,Pattani,1,0,1,A Thai soldier is killed in a Muslim terror attack.
8043,2/9/2007,India,Kathua,2,0,2,Two children are killed in a Mujahideen bombing.
8044,2/9/2007,Pakistan,Khyber,1,1,2,An Afghan refugee is shot to death by Sunni militants.
8045,2/9/2007,Afghanistan,Kunar,7,0,7,Seven Afghan security personnel are killed in roadside bombings by religious extremists.
8046,2/9/2007,Iraq,Taji,2,8,10,Two Iraqis are murdered by a Fedayeen suicide bomber.
8047,2/9/2007,Iraq,Baghdad,22,16,38,A Jihad car bombing and various shootings leave about two dozen Iraqis dead.
8048,2/9/2007,Pakistan,Wana,4,10,14,"Islamists bomb a pharmacy, killing four civilians."
8049,2/9/2007,Somalia,Suuqa Xoolaha,3,3,6,Islamist terrorists ambush and kill three Somali soldiers.
8050,3/9/2007,Iraq,Ramadi,2,13,15,A suicide bomber blasts two innocent souls to Allah.
8051,3/9/2007,Iraq,Baghdad,18,8,26,Eighteen people are killed by sectarian violence within the Religion of Peace.
8052,3/9/2007,Thailand,Yala,1,1,2,A 55-year-old rubber tapper is shot to death while riding to work with his wife.
8053,3/9/2007,Iraq,Baghdad,8,0,8,Eight electrical workers are kidnapped and murdered by Freedom Fighters.
8054,4/9/2007,Afghanistan,Paktika,2,2,4,"A suicide bomber attempts an assassination, killing two bodyguards instead."
8055,4/9/2007,Pakistan,Rawalpindi,24,74,98,At least two dozen people are murdered when Islamic bombers attack a bus and a bazaar in separate attacks.
8056,4/9/2007,Afghanistan,Kunduz,2,4,6,Two Afghan cops are murdered by a Fedayeen suicide bomber.
8057,4/9/2007,Chechnya,Gukhoi,1,4,5,One person is killed when Islamic gunmen attack a school and a house.
8058,4/9/2007,Pakistan,Kohat,2,0,2,Two civilians are murdered by the Taliban.
8059,5/9/2007,Afghanistan,Helmand,2,3,5,Two Afghan police are killed when religious extremists bomb their vehicle.
8060,5/9/2007,Somalia,Medina,1,0,1,A local soldier guarding a market is shot to death by Islamic militias.
8061,5/9/2007,Thailand,Narathiwat,2,0,2,A 68-year-old man is shot off his motorbike by Muslim terrorists.  Another civilian is killed in a separate drive-by attack.
8062,5/9/2007,Iraq,Mosul,1,28,29,A suicide bomber kills one other person.
8063,5/9/2007,Thailand,Yala,1,4,5,"Islamists bomb a grocery store, killing a man and injuring four, including two children."
8064,6/9/2007,Somalia,Mogadishu,2,0,2,An elderly man and a woman are killed in a violent grenade attack by Islamic militants.
8065,6/9/2007,Pakistan,Bannu,2,0,2,Islamic fundamentalists behead two prostitutes.
8066,6/9/2007,Algeria,Batna,14,107,121,An al-Qaeda linked suicide bomber massacres twenty-two people waiting to see the country's president.
8067,6/9/2007,Somalia,Mogadishu,2,0,2,"Islamic terrorists attack a police station, killing two officers."
8068,6/9/2007,Iraq,Tikrit,3,17,20,"Jihadis bomb a petrol station, killing three innocents."
8069,6/9/2007,Iraq,Baghdad,19,5,24,Nineteen victims of sectarian violence are killed here and in Mosul.
8070,6/9/2007,Thailand,Narathiwat,1,0,1,A rubber tapper is killed when Islamic radicals set off a bomb on his plantation.
8071,6/9/2007,Thailand,Yala,1,2,3,Muslim extremists kill a police officer with a bomb.
8072,7/9/2007,Iraq,Mosul,4,0,4,Radical Sunnis kidnap and murder four policemen.
8073,7/9/2007,Iraq,Kirkuk,3,5,8,An armed attack by Muslim terrorists on a mosque leaves three people dead.
8074,7/9/2007,Uzbekistan,Tashkent,1,0,1,A prominent 55-year-old Jewish man is stabbed to death in a heinous attack.  He was said to have 'misinterpreted the Qur'an'.
8075,7/9/2007,Ingushetia,Nazran,1,0,1,An elderly woman is cut down by Islamic terrorists with automatic weapons at point-blank range.
8076,8/9/2007,Pakistan,Kohistan,4,26,30,"Religious radicals open up on a group of soldiers at point blank range, killing four.  Elsewhere a bomb injures twenty-four civilians."
8077,8/9/2007,Somalia,Mogadishu,1,0,1,A 16-year-old boy is shot three times in the head by suspected Muslim radicals.
8078,8/9/2007,Somalia,Mogadishu,2,0,2,Islamists murder two electronics vendors at an open-air market.
8079,8/9/2007,Afghanistan,Helmand,1,3,4,A suicide bomber kills one other person.
8080,8/9/2007,Afghanistan,Nimroz,2,8,10,"The Taliban attack a food relief convoy, killing two guards."
8081,8/9/2007,Iraq,Diwaniya,1,0,1,Islamic gunmen murder a woman in front of her home.
8082,8/9/2007,Iraq,Baghdad,15,45,60,Jihadis slaughter fifteen people with a car bomb along a city street.
8083,8/9/2007,Iraq,Kufa,5,8,13,Five people are blown apart in a marketplace bombing by Sunni radicals.
8084,8/9/2007,Algeria,Dellys,28,47,75,Twenty-eight innocent people are blown to bits by a teenaged al-Qaeda truck bomber.
8085,8/9/2007,Thailand,Yala,1,0,1,Terrorists murder a 30-year-old Buddhist woman.
8086,8/9/2007,Thailand,Songkhla,1,0,1,A plantation worker is shot to death in front of his wife by militant Muslims.
8087,8/9/2007,Somalia,Mogadishu,7,0,7,A man disguised in a burqa massacres seven local soldiers in a brutal grenade attack.
8088,9/9/2007,India,Kolkata,1,0,1,A Muslim is murdered for his intention to convert to Hinduism.
8089,9/9/2007,Iraq,Basra,2,0,2,"Two headless bodies, including that of a woman, are found."
8090,9/9/2007,Iraq,Mosul,4,8,12,Three woman and a man are murdered in their home by Islamic terrorists.
8091,9/9/2007,Iraq,Mahmudiya,2,7,9,A Fedayeen suicide bomber kills two civilians.
8092,9/9/2007,Iraq,Balad,4,15,19,A suicide bomber in a fuel tanker kills four local soldiers.
8093,9/9/2007,Iraq,Baiji,7,2,9,"Sunni radicals assault a police station, killing seven officers."
8094,9/9/2007,Ingushetia,Malgobek,1,2,3,"The Mujahideen ambush local soldiers with grenades, killing one."
8095,9/9/2007,Pakistan,Larkana,1,2,3,A woman is killed for leaving her husband's house without permission by her brother-in-law.
8096,10/9/2007,Sudan,Haskanita,25,0,25,Twenty-five villagers are massacred in an aerial and ground assault by government forces.
8097,10/9/2007,Iraq,Tal Marag,10,78,88,Ten innocents are blown apart by a religious fanatic driving a truck bomb.
8098,10/9/2007,Iraq,Saqlawiyah,4,2,6,A suicide bomber kills four Iraqis at a police checkpoint.
8099,10/9/2007,Iraq,Baghdad,14,19,33,A Jihad car bombing at a hospital is one of several attacks that leave a dozen Iraqis dead.
8100,10/9/2007,Somalia,Mogadishu,4,0,4,Three children and their mother are taken out by Jihadi mortars.
8101,10/9/2007,Thailand,Pattani,1,5,6,A Muslim gunman boards a bus and then shoots a passenger to death.
8102,10/9/2007,Afghanistan,Gereshk,29,57,86,Over two-dozen Afghans are massacred by Taliban suicide bombers in a small town.
8103,10/9/2007,India,Kupwara,1,5,6,A local soldier is killed in a Lashkar-e-Toiba attack.
8104,10/9/2007,Pakistan,Makeen,2,0,2,"A rocket believed to have been fired by Taliban militants hits a house, killing two, including a woman."
8105,11/9/2007,Thailand,Yala,1,0,1,A young Buddhist man is shot to death by Islamists.
8106,11/9/2007,Thailand,Pattani,1,1,2,A middle-aged Buddhist man is shot to death by Muslim radicals while riding his motorbike.
8107,11/9/2007,Ingushetia,Ordzhonikidzov.,3,0,3,Two young men and their father are brutally murdered in their home by suspected Islamic militants.
8108,11/9/2007,Pakistan,Dera Ismail Khan,17,16,33,Seventeen people are killed when a 15-year-old suicide bomber detonates on a minibus.
8109,11/9/2007,Afghanistan,Helmand,2,7,9,Two Afghan truck drivers are murdered by a suicide bomber.
8110,11/9/2007,Israel,Zikim,0,69,69,"Gaza militants fire a rocket into Israel, injuring nearly seventy people."
8111,11/9/2007,Iraq,Baghdad,13,12,25,Sectarian Jihadis rack up thirteen bodies in a 24-hour period.
8112,12/9/2007,Somalia,Mogadishu,1,0,1,Islamic militias assassinate a money changer at a market.
8113,12/9/2007,Afghanistan,Paktia,3,0,3,A civilian and two policemen are killed in two separate Taliban bombings.
8114,12/9/2007,Iraq,Baghdad,28,22,50,Jihadis manage to take down twenty-eight ordinary Iraqis in at least four attacks around the country.
8115,13/9/2007,Iraq,Mosul,2,0,2,A bakery worker is among two people shot to death by Sunni snipers.
8116,13/9/2007,Iraq,Baghdad,17,13,30,A car bombing is one of several Jihad attacks that leaves seventeen civilians dead.
8117,13/9/2007,Iraq,Ramadi,4,0,4,al-Qaeda bombers take down a pro-government Sunni leader and three others.
8118,13/9/2007,Afghanistan,Badakshan,1,0,1,An aid worker is shot to death in a suspected Taliban attack.
8119,13/9/2007,Thailand,Narathiwat,3,0,3,"Three men, including a 28-year-old Buddhist, are shot to death in separate attacks by radical Muslims."
8120,13/9/2007,Somalia,Huriwa,6,0,6,Two civilians and four local policemen are killed in a brutal ambush by Islamic militants.
8121,13/9/2007,Somalia,Mogadishu,1,0,1,A cop is gunned down by Islamists.
8122,13/9/2007,Pakistan,Karachi,7,5,12,Seven people are killed when Islamic fundamentalists toss grenades into a minibus carrying sectarian rivals.
8123,14/9/2007,Pakistan,Peshawar,1,0,1,A pro-peace cleric is assassinated by Islamic radicals.
8124,14/9/2007,Iraq,Baiji,11,16,27,"A suicide bomber detonates his truck next to a restaurant, killing sixteen innocents."
8125,14/9/2007,Iraq,Hawija,1,1,2,Radical Sunnis gun down a woman and injure her daughter.
8126,14/9/2007,Iraq,Baghdad,9,0,9,Three farmer and three beheading victims are among nine people killed in sectarian attacks.
8127,14/9/2007,Thailand,Narathiwat,1,0,1,Muslim gunmen murder a 29-year-old woman.
8128,14/9/2007,Pakistan,Tarbela,17,36,53,A suicide bomber kill seventeen Pakistani soldiers in an attack near a dam.
8129,14/9/2007,Pakistan,Bajaur,2,5,7,Two children are killed when Islamic terrorists plant a bomb near their home.
8130,14/9/2007,India,Baramulla,2,0,2,Two civilians are murdered in their home by the Mujahideen.
8131,14/9/2007,Algeria,Zemmouri,3,5,8,"Three people are killed, and two suffer amputation when Islamic fundamentalists place a bomb in a small town."
8132,14/9/2007,Somalia,Mogadishu,2,5,7,Two civilians are killed in a grenade attack by Islamic militias.
8133,15/9/2007,Iraq,Baghdad,13,2,15,Sectarian Jihadis rack up thirteen dead rivals in various attacks.
8134,15/9/2007,Iraq,Abu Saida,2,0,2,al-Qaeda terrorists kill two Sunni sheikhs.
8135,15/9/2007,Afghanistan,Kunar,3,0,3,Religious extremists kill two children with rockets and behead an adult male.
8136,15/9/2007,Thailand,Pattani,1,3,4,One local soldier is killed when Thai Islamists detonate a bomb.
8137,15/9/2007,Iraq,Baghdad,11,18,29,Two children are among eleven killed by a Fedayeen suicide bomber at a bakery.
8138,15/9/2007,Thailand,Pattani,2,0,2,Two men are murdered in a drive-by shooting by Muslim radicals.
8139,16/9/2007,Iraq,Muqdadiya,14,10,24,al-Qaeda militants shoot fourteen villagers to death in a brutal attack.
8140,16/9/2007,Iraq,Tuz Khormato,8,22,30,A Fedayeen bomber murders eight patrons at a cafe.
8141,16/9/2007,Iraq,Hilla,6,7,13,A child and a pharmacist are among six people killed in separate attacks by Islamic militants.
8142,16/9/2007,Iraq,Baghdad,19,13,32,Various terror attacks leave nineteen Iraqis dead in sectarian violence.
8143,16/9/2007,Nepal,Kapilvastu,2,0,2,"A Hindu taxi driver is among two people beaten to death by a Muslim mob, which also torches hundreds of Hindu houses."
8144,16/9/2007,Thailand,Narathiwat,2,0,2,Two men driving in a vehicle are shot to death in a brutal ambush by Islamic radicals.
8145,17/9/2007,Ingushetia,Gazi-Yurt,1,1,2,Mujahideen snipers kill a border guard.
8146,17/9/2007,Thailand,Yala,1,0,1,A woman is shot to death by Islamic gunmen.
8147,17/9/2007,Pakistan,Waziristan,15,1,16,"Taliban terrorists attack local troops, killing at least fifteen."
8148,17/9/2007,Iraq,Baghdad,21,32,53,"Ramadan violence, including a car bombing at a mosque, leaves twenty-one dead."
8149,17/9/2007,Afghanistan,Helmand,8,7,15,A Fedayeen suicide bomber murders eight Afghans.
8150,17/9/2007,Somalia,Mogadishu,3,2,5,Two people are killed in a grenade attack and a man is shot to death in a separate shooting by Islamic militias.
8151,17/9/2007,Pakistan,Mir Ali,1,0,1,A tribesman is murdered by Muslim militants.
8152,18/9/2007,Thailand,Pattani,2,0,2,A Buddhist is among two civilians killed by Islamic terrorists.
8153,18/9/2007,Thailand,Yala,1,0,1,A school administrator is shot to death by Holy Warriors.
8154,18/9/2007,Thailand,Narathiwat,1,0,1,A man is murdered by Muslim gunmen while escorting teachers to school.
8155,18/9/2007,Iraq,Baghdad,8,15,23,"Jihadis bomb a residential neighborhood, killing eight innocents."
8156,18/9/2007,Iraq,Baghdad,7,30,37,A double car bombing near a morgue sends seven Iraqis to Allah.
8157,18/9/2007,Iraq,Baghdad,17,7,24,Various sectarian attacks leave at least seventeen dead.
8158,18/9/2007,Pakistan,Shawal,1,4,5,"Islamic militants open up on a security patrol with automatic weapons, killing at least one member."
8159,18/9/2007,Somalia,Mogadishu,2,1,3,Two civilians are killed when Islamic militias assault a barracks.
8160,18/9/2007,India,Kosadi,1,3,4,A team of Hindu inspectors are pelted with stones by a Muslim mob.  On member is killed.
8161,19/9/2007,India,Srinagar,3,20,23,Three Indian troops are killed in a brutal ambush on their bus convoy by Lashkar-e-Toiba.
8162,19/9/2007,Iraq,Muqdadiya,9,5,14,A suicide bomber and random Jihad attacks leave nine Iraqis dead.
8163,19/9/2007,Ingushetia,Nazran,4,2,6,"Suspected Islamic militants ambush a police vehicle with automatic weapons, killing two occupants.  Two other cops are killed in a separate bombing."
8164,19/9/2007,Somalia,Mogadishu,2,2,4,A government official and a civilian are murdered by Islamic militias in separate attacks.
8165,19/9/2007,Thailand,Yala,1,0,1,Islamic militants gun down a 45-year-old woman working on a rubber plantation.
8166,19/9/2007,Lebanon,Beirut,9,30,39,Muslim bombers assassinate an anti-Syrian political leader and eight others in a Christian neighborhood.
8167,19/9/2007,Afghanistan,Badghis,4,4,8,Four local police are killed when the Taliban assault a remote police station.
8168,20/9/2007,Pakistan,Bajaur,1,0,1,A tribesman is kidnapped and executed by the Mujahideen.
8169,20/9/2007,Nepal,Kapilvastu,12,24,36,Twelve more Hindu victims of Muslim mob violence are counted.
8170,20/9/2007,Iraq,Mosul,3,0,3,A woman and her daughter are among three people killed by Islamic terrorists.
8171,20/9/2007,Iraq,Baghdad,13,20,33,Thirteen Iraqis are murdered by sectarian Jihadis in at least two attacks.
8172,20/9/2007,Pakistan,Swat,1,4,5,Muslim militants kill a local policeman with a bomb.
8173,20/9/2007,Thailand,Yala,1,0,1,A 23-year-old civilian is shot to death by Muslim radicals.
8174,20/9/2007,Afghanistan,Gereshk,6,0,6,"Six civilians, including women and children, are killed when Taliban 'fighters' use them as human shields."
8175,20/9/2007,India,Pulwama,1,2,3,"The Mujahideen kidnap three villagers, beating two and strangling the third."
8176,21/9/2007,Pakistan,Swat,2,4,6,"Pro-Taliban gunmen attempt to assassinate a former official, killing two others instead."
8177,21/9/2007,Afghanistan,Kabul,2,8,10,A civilian and a French soldier are blown to death by suicide bomber.
8178,21/9/2007,Pakistan,Islamabad,1,0,1,A woman is killed with an axe by her brother-in-law for suspected adultery.
8179,21/9/2007,Iraq,Basra,3,0,3,Three women are killed by suspected fundamentalists over 'immoral activity.'
8180,21/9/2007,Iraq,Yusufiya,3,0,3,Three people are kidnapped and tortured to death by sectarian rival within the Religion of Peace.
8181,21/9/2007,Thailand,Yala,2,0,2,A woman and man are murdered by militant Muslims in separate shooting attacks.
8182,22/9/2007,Pakistan,Sorandara Musakhel,2,0,2,At least two people are killed when a Muslim mob attacks a series of houses following a jirga ruling.
8183,22/9/2007,Iraq,Baqubah,5,0,5,Five Iraqi officers are captured by al-Qaeda and beheaded in video to shouts of 'Allah Akbar!'
8184,22/9/2007,Iraq,Baghdad,9,13,22,Nine people are killed in sectarian violence within the Religion of Peace.
8185,22/9/2007,Thailand,Yala,1,0,1,A 53-year-old man is shot to death by Muslim militants.
8186,22/9/2007,Pakistan,Swat,1,2,3,Islamic militants kill a policeman and capture two others in an assault on a checkpoint.
8187,22/9/2007,Afghanistan,Kunduz,2,4,6,Two local police are murdered by religious extremists.
8188,22/9/2007,Pakistan,Bajaur,3,8,11,Two women are among three killed in Taliban shelling.
8189,22/9/2007,Thailand,Yala,0,9,9,Nine children in a teashop are severely injured in a Muslim bombing.
8190,23/9/2007,Afghanistan,Ghazni,2,0,2,Two civilians are kidnapped and beheaded by the Taliban.
8191,23/9/2007,Iraq,Muqdadiyah,20,5,25,"Twenty bodies, blindfolded and executed, are found in three locations."
8192,23/9/2007,Thailand,Pattani,2,0,2,A young married couple are killed inside their home by Muslim gunmen.
8193,23/9/2007,Pakistan,Malakdin Khel,3,3,6,A woman and her two children are killed in a clash between rival Islamic groups.
8194,23/9/2007,Thailand,Pattani,1,0,1,A 24-year-old female teacher is shot to death by Islamic radicals in her home.
8195,23/9/2007,Pakistan,Degan,2,0,2,Two local villagers are kidnapped and beheaded by the Taliban in separate incidents.
8196,23/9/2007,Afghanistan,Farah,3,10,13,Three local guards are killed when religious extremists attack a civilian convoy.
8197,23/9/2007,Afghanistan,Badakhshan,12,1,13,"The Taliban claim responsibility for the brutal ambush of a minibus, in which a dozen are massacred."
8198,24/9/2007,Iraq,al-Abara,20,0,20,A mass grave is discovered containing twenty students abducted and murdered by Sunni radicals.
8199,24/9/2007,Iraq,Baqubah,26,30,56,"An al-Qaeda  suicide bomber detonates inside a mosque, killing over two dozen people gathering for a reconciliation meeting."
8200,24/9/2007,Iraq,Baghdad,16,3,19,Two children and a woman are among fifteen Iraqis gunned down by Freedom Fighters.
8201,24/9/2007,Iraq,Abu Maria,6,17,23,A Fedayeen suicide bomber kills a half-dozen innocents at an intersection.
8202,24/9/2007,Somalia,Mogadishu,2,0,2,Two local officials are assassinated by Islamic militias.
8203,24/9/2007,Afghanistan,Farah,3,0,3,Islamic fundamentalists kill two Spanish soldiers and an Afghan interpreter in a bomb attack.
8204,24/9/2007,Afghanistan,Baghlan,4,0,4,Sunni terrorists kill four people with a roadside bomb.
8205,24/9/2007,Algeria,Ma-Labiod,1,5,6,Islamic fundamentalists kill a local soldier with a homemade bomb.
8206,25/9/2007,Algeria,Boumerdes,1,0,1,An off-duty prison guard is shot to death by Islamic fundamentalists.
8207,25/9/2007,Algeria,Jijel,3,0,3,Three security guards are murdered when Islamic fundamentalists open up with automatic weapons at point-blank range.
8208,25/9/2007,Thailand,Yala,1,0,1,Teenage Jihadis shoot a 59-year-old Buddhist teacher to death at a bus stop.
8209,25/9/2007,Thailand,Yala,1,0,1,A 22-year-old construction worker is shot to death by Muslim militants.
8210,25/9/2007,Thailand,Yala,2,0,2,Two cop and a security guard are murdered in separate drive-by attacks by Islamic radicals.
8211,25/9/2007,Thailand,Yala,1,2,3,A man is gunned down inside his home by radical Muslims.
8212,25/9/2007,Thailand,Pattani,1,1,2,"Islamists ambush a security patrol, killing one member."
8213,25/9/2007,Afghanistan,Kandahar,5,4,9,Five local cops are killed when a suicide bomber drives up next to them and detonates.
8214,25/9/2007,Somalia,Mogadishu,2,5,7,Two people are killed when Islamic militias stage a terror attack against a police patrol.
8215,25/9/2007,Iraq,Basra,3,20,23,A Fedayeen suicide bomber murders three Iraqis.
8216,25/9/2007,Iraq,Baghdad,15,31,46,Two car bombings and various other Jihad attacks leave fifteen Iraqis dead.
8217,26/9/2007,Iraq,Baghdad,32,28,60,Thirty-two Shiites are massacred by Sunni radicals in a double bombing on their neighborhood.
8218,26/9/2007,Iraq,Sinjar,10,9,19,al-Qaeda bombers kill ten villagers who opposed them by blowing up their home.
8219,26/9/2007,Iraq,Shurqat,7,5,12,Seven Iraqis are killed by two Jihad car bombs.
8220,26/9/2007,Pakistan,Miranshah,2,0,2,Two villagers are kidnapped and beheaded by Taliban extremists.
8221,26/9/2007,Algeria,Boumerdes,2,5,7,"Islamic fundamentalists bomb a police vehicle, killing two officers."
8222,26/9/2007,Pakistan,Orakzai,23,0,23,Sunnis and Shiites clash over ownership of a holy shrine.  Some two dozen are killed in the violence.
8223,26/9/2007,Somalia,Kismayo,1,0,1,Islamists kill a religious cleric in front of his child.
8224,27/9/2007,Algeria,Kabylie,3,0,3,Three Algerian security guards are machine-gunned to death by fundamentalists at a fake road block.
8225,27/9/2007,Iraq,Riyadh,2,0,2,Two brothers are shot to death by sectarian rivals.
8226,27/9/2007,Iraq,Baghdad,14,9,23,At least two women are among fourteen Iraqis murdered by Freedom Fighters.
8227,27/9/2007,India,Pulwama,1,1,2,The Mujahideen abduct and torture two civilians.  One is then shot to death and the other released.
8228,27/9/2007,Somalia,Mogadishu,2,0,2,Two civilians are brutally murdered in separate attacks by suspected Islamic militia.
8229,28/9/2007,Algeria,Ain Ben Soltane,1,2,3,A local soldier is killed in a bomb attack by Islamic fundamentalists.
8230,28/9/2007,Algeria,Boumerdes,2,0,2,Two local soldiers are killed when Islamic fundamentalists attack a supply truck.
8231,28/9/2007,Syria,Aleppo,1,0,1,A cleric is gunned down on suspicion of informing authorities of Jihadi activities.
8232,28/9/2007,Thailand,Narathiwat,1,0,1,A 40-year-old Buddhist is murdered by an Islamic radical posing as a hitchhiker.
8233,28/9/2007,Thailand,Pattani,3,5,8,Three policemen assigned to protect teachers are murdered by Muslim militants.
8234,28/9/2007,Somalia,Mogadishu,4,4,8,Four local soldiers are murdered in an RPG attack by radicals screaming 'Allah Akbar.'
8235,28/9/2007,Pakistan,Tank,1,12,13,Talibanis kill a Pakistani soldier with a remote-controlled bomb.
8236,28/9/2007,Iraq,Qaraqush,1,0,1,A Christian college student is shot nine times by Islamic terrorists.
8237,28/9/2007,Iraq,Saidiya,4,9,13,"Gunmen attack a cafe, killing four civilians."
8238,29/9/2007,Afghanistan,Kabul,30,30,60,A Ramadan suicide bomber murders thirty Afghans aboard a bus.
8239,29/9/2007,Maldives,Male,0,12,12,Twelve Western tourists are injured when Islamists bomb a resort.
8240,29/9/2007,Thailand,Yala,1,1,2,A 42-year-old female garbage collector is among two people gunned down by Muslim terrorists.
8241,29/9/2007,India,Mangam,1,0,1,The Mujahideen abduct a police officer from a home and brutally execute him.
8242,29/9/2007,Iraq,al-Mazra,6,17,23,Six civilians are blown to pieces by Islamic terrorists.
8243,29/9/2007,Iraq,Mosul,10,21,31,A suicide bombing and various shootings leaves ten people dead.
8244,29/9/2007,Iraq,Hamdaniya,4,16,20,Jihadis kill four Iraqis with a car bomb.
8245,29/9/2007,Afghanistan,Sangin,1,0,1,A farmer is shot to death by the Taliban for seeking seed assistance from a humanitarian program.
8246,29/9/2007,Afghanistan,Paktia,3,0,3,Three civilians are killed in a Taliban ambush.
8247,29/9/2007,Nigeria,Kano,10,61,71,"Ten Christians, including a Catholic priest, are murdered over a two day period by a Muslim mob, angered over a cartoon written by one of their own.  Churches are burned as well."
8248,29/9/2007,Dagestan,Gonada,9,0,9,"Islamic gunmen shoot nine people to death, including a cleric who opposed Wahhabism."
8249,30/9/2007,India,Kishtwar,1,0,1,Harkat-ul-Jehad Islami militants shoot a man to death.
8250,30/9/2007,Afghanistan,Kandahar,2,3,5,Two police officers are killed trying to defuse a bomb planted by religious extremists.
8251,30/9/2007,Afghanistan,Ghazni,8,0,8,Eight local police are massacred in an ambush by Sunni radicals.
8252,30/9/2007,Thailand,Narathiwat,2,0,2,Two civilians are shot to death by militant Muslims while riding a motorcycle.
8253,30/9/2007,Pakistan,FATA,1,0,1,A young woman is beheaded for 'immoral activities'.
8254,30/9/2007,Iraq,al-Haswa,3,0,3,Three people are kidnapped and tortured to death by rivals within the Religion of Peace.
8255,30/9/2007,Iraq,Mosul,22,4,26,Twenty-two innocent people are shot or blasted to death by Jihadis in various attacks.
8256,30/9/2007,Afghanistan,Helmand,1,0,1,"A 15-year-old boy is hanged by the Taliban for having US dollars in his pocket, which are then stuffed into his mouth."
8257,1/10/2007,Pakistan,Bannu,16,20,36,"A Shahid disguised with a burka 'martyrs' himself at an outdoor market, taking over a dozen innocents down with him."
8258,1/10/2007,Thailand,Narathiwat,1,14,15,Buddhist monks are among the casualties of a string of bombings that leave at least one dead.
8259,1/10/2007,Iraq,Mosul,1,7,8,A Shahid kills a university professor in a suicide attack.
8260,1/10/2007,Iraq,Baghdad,19,6,25,At least one child is among the casualties of several Jihad attacks around the country.
8261,1/10/2007,India,Doda,1,2,3,A cop is killed in a Mujahideen attack.
8262,1/10/2007,Pakistan,Kurram,2,10,12,Pro-Taliban extremists kill 2 tribesman in a landmine attack on their vehicle.
8263,2/10/2007,Iraq,Dyala,3,0,3,"Muslim gunmen shoot a family of three to death in their car, including a little girl and her two parents."
8264,2/10/2007,Iran,Khash,1,0,1,A Shiite cleric is gunned down by Sunni militants.
8265,2/10/2007,Afghanistan,Kabul,12,15,27,Children are among a dozen innocents massacred by a suicide bomber on a bus.
8266,2/10/2007,Iraq,Baghdad,29,33,62,Thirty people are killed in various suicide bombings and shootings by Holy Warriors around the country.
8267,2/10/2007,Thailand,Pattani,4,0,4,A high school principal is among four civilians shot to death in separate drive-by attacks by Islamic radicals.
8268,2/10/2007,Dagestan,Ogni,2,0,2,An Islamists jogs up next to two policemen on patrol and calmly guns them down.
8269,2/10/2007,Pakistan,Hangu,3,2,5,Three members of a security patrol are gunned down at point-blank range by Islamic radicals.
8270,3/10/2007,Pakistan,Swat,1,2,3,A civilian is killed by a bomb planted by pro-Taliban militants.
8271,3/10/2007,Pakistan,Spin Wam,2,3,5,"Religious extremists attack a checkpoint, killing two local soldiers."
8272,3/10/2007,Thailand,Yala,2,0,2,Two civilians are murdered in separate Mujahideen attacks.
8273,3/10/2007,Thailand,Pattani,1,0,1,A local soldier is shot to death in an Islamist drive-by attack.
8274,3/10/2007,Afghanistan,Khost,2,0,2,Two government employees are gunned down by the Taliban.
8275,3/10/2007,Iraq,Baghdad,13,30,43,Islamic terrorists manage to kill thirteen unsuspecting Iraqis with a car bomb at an intersection.
8276,4/10/2007,Algeria,Boumeredes,1,2,3,Islamic fundamentalists shoot a man to death.
8277,4/10/2007,Thailand,Pattani,2,0,2,Two Buddhists (ages 41 and 65) are separately murdered in cold blood by Muslim militants.
8278,4/10/2007,Pakistan,Bulandkhel,14,5,19,"Religious extremists bomb a passenger bus, killing fourteen civilians."
8279,4/10/2007,Somalia,Mogadishu,4,8,12,Four civilians are murdered by Islamic militias in two grenade attacks.
8280,4/10/2007,Thailand,Narathiwat,3,0,3,An elderly man is among three people shot to death by militant Muslims in separate attacks.
8281,4/10/2007,Pakistan,South Waziristan,3,0,3,Three local soldiers are abducted and murdered in captivity by the Mujahideen.  Their heads and hands are chopped off.
8282,4/10/2007,Afghanistan,Kabul,1,0,1,"An Italian, taken hostage by the Taliban, dies from injuries suffered during the rescue."
8283,4/10/2007,Iraq,Tal Afar,3,57,60,"A suicide bomber detonates in a marketplace, sending at least three innocents to Allah."
8284,4/10/2007,Iraq,Iskandariya,5,1,6,Islamists assassinate the mayor of the town in a bomb attack that kills four others.
8285,4/10/2007,Iraq,Baghdad,20,35,55,"Muslim terrorists kill twenty civilians in various bombings, including one on a minibus and another on a gas station."
8286,4/10/2007,Thailand,Yala,1,0,1,Muslim radicals shoot a man to death as he is having dinner in his home.
8287,5/10/2007,Iraq,Basra,2,0,2,Two clerics are gunned down in targeted sectarian assassinations.
8288,5/10/2007,Thailand,Pattani,1,0,1,A 90-year-old Buddhist man is murdered by Islamic terrorists.
8289,5/10/2007,Somalia,Mogadishu,5,2,7,Islamic militias kill five civilians by hurling hand grenades at them around a main market.
8290,5/10/2007,Philippines,Kidapawan,2,26,28,"Islamists bomb a department store and a market in separate attacks, killing an 8-year-old girl and a 12-year-old girl."
8291,5/10/2007,Somalia,Mogadishu,2,0,2,Two off-duty military men are brutally murdered in their car by Islamists.
8292,5/10/2007,Afghanistan,Sangin,2,0,2,Two children are killed in a suicide bombing by a Holy Warrior.
8293,5/10/2007,Algeria,Tebessa,6,0,6,Six Algerian soldiers are killed in an ambush by Islamic fundamentalists.
8294,6/10/2007,Sudan,Haskanita,86,0,86,Eighty-six villagers are thought to have been massacred in an attack by forces of the Islamic Republic.
8295,6/10/2007,Afghanistan,Kabul,6,12,18,A suicide bomber takes out five Afghan civilians and one US soldier guarding a road.
8296,6/10/2007,Pakistan,Ahmad Khel,1,19,20,"The Mujahideen detonate a bomb near a convoy, killing one local soldier."
8297,6/10/2007,Dagestan,Makhachkala,1,0,1,A policeman is shot to death at point-blank range by a Muslim terrorist.
8298,6/10/2007,Thailand,Pattani,1,0,1,A village leader is cut down on the street in a hail of bullets from Islamic radicals.
8299,6/10/2007,Somalia,Mogadishu,1,4,5,Islamists shoot a security officer to death and injure four civilians.
8300,6/10/2007,Iraq,Mussayab,2,0,2,Islamic terrorists shoot a child to death and behead a college student.
8301,6/10/2007,Somalia,Mogadishu,3,0,3,Two elderly women and one other person are shot to death on the street by Islamic militias.
8302,6/10/2007,Afghanistan,Khost,4,2,6,Two bombings by religious extremists leaves four local police dead.
8303,7/10/2007,Ghana,Ashanti,1,0,1,A father beats his daughter to death for immoral behavior and missing a Ramadan curfew.
8304,7/10/2007,Afghanistan,Ghazni,3,0,3,"The Taliban attack a road construction crew, killing three guards."
8305,7/10/2007,Chechnya,Vedeno,4,10,14,"Holy Warriors attack a police convoy with bombs, killing four local officers."
8306,7/10/2007,Iraq,Baghdad,17,18,35,Various Jihad bombings leave nearly twenty Iraqis dead.
8307,7/10/2007,Pal. Auth.,Gaza,1,0,1,A Christian bookseller is abducted and stabbed to death by Islamic fundamentalists.
8308,7/10/2007,Pakistan,NWFP,2,0,2,Two civilians are abducted and murdered by the Mujahideen in separate incidents.  One is beheaded.
8309,8/10/2007,Iraq,Kirkuk,1,0,1,Fundamentalists murder a barber.
8310,8/10/2007,Somalia,Shiidleey,1,2,3,"A gunman fires into a crowd of people waiting for food, killing an elderly woman."
8311,8/10/2007,India,Warpora-Sopore,1,1,2,A 6-year-old girl is killed when Muslim gunmen fire into a home.
8312,8/10/2007,Afghanistan,Ghazni,2,0,2,Two brothers are brutally slain by religious extremists over charges of working for infidels.
8313,8/10/2007,Iraq,Baghdad,6,36,42,"Islamists car bomb two targets, including a university where women and children are most of the casualties."
8314,8/10/2007,Iraq,Tikrit,3,10,13,A Fedayeen bomber takes out three innocent people.
8315,8/10/2007,Iraq,Diljah,13,22,35,Thirteen civilians are murdered when a suicidal Sunni detonates a car bomb along a street.
8316,9/10/2007,India,Rajouri,1,0,1,The Mujahideen force their way into a civilian's home and murder him.
8317,9/10/2007,India,Baramulla,1,1,2,An 8-year-old girl is shot to death inside her home by the Mujahideen.
8318,9/10/2007,Somalia,Mogadishu,3,0,3,Three civilians are shot to death by the Islamic militias.
8319,9/10/2007,Sudan,Muhajiriya,48,80,128,"The Islamic Republic raids another village, executing as many as fifty civilians in cold blood."
8320,9/10/2007,Iraq,Baiji,22,30,52,al-Qaeda suicide bombers kill twenty-two Sunni villagers.
8321,9/10/2007,Iraq,Hawija,2,0,2,One man is beheaded and another shot to death by Muslim terrorists.
8322,9/10/2007,Iraq,Baghdad,27,86,113,Islamic terrorists manage to kill over two dozen innocents in a string of bombings.
8323,9/10/2007,India,Bandipora,1,0,1,A woman is shot to death by the Mujahideen.
8324,9/10/2007,Pakistan,North Waziristan,4,4,8,Four local soldiers are killed in two attacks by Islamic militants.
8325,9/10/2007,Pakistan,Peshawar,0,25,25,Fundamentalists bomb an 'un-Islamic' music shop.  Over two dozen are injured.
8326,10/10/2007,Somalia,Kismayo,2,10,12,Two civilians are killed when Islamic militias detonate a roadside bomb.
8327,10/10/2007,Afghanistan,Wardak,3,10,13,The Taliban shoot two people to death at a mosque and one other in a separate attack.
8328,10/10/2007,Somalia,Baidoa,3,0,3,A suicide bomber kills three Ethiopians.
8329,10/10/2007,Austria,Wimpassing,1,0,1,"In an 'honor attack' a Muslim shoots a man, then cuts off his penis."
8330,10/10/2007,Thailand,Narathiwat,1,2,3,Islamic gunmen murder a Buddhist man and severely injure his wife and another relative.
8331,10/10/2007,Thailand,Narathiwat,1,0,1,A 43-year-old man is shot to death in front of his children by Muslim radicals.
8332,10/10/2007,Somalia,Baidoa,3,3,6,A Fedayeen suicide bomber kills three soldiers in an attack on their base.
8333,10/10/2007,Iraq,Mosul,7,20,27,A suicide bomber takes out seven innocents in a blast on a political office.
8334,10/10/2007,Iraq,Tikrit,6,10,16,A Jihad bombing leaves six Iraqis dead.
8335,10/10/2007,Pakistan,Quetta,1,0,1,A cleric is gunned down by sectarian rivals.
8336,11/10/2007,India,Ajmer,3,17,20,Three people are killed in a suspected sectarian bombing of a Sufi shrine.
8337,11/10/2007,Thailand,Narathiwat,1,1,2,A Buddhist man and his wife on their way back from a monastery are shot by Muslim radicals.
8338,11/10/2007,India,Pattan,7,8,15,"The Hizbul-Mujahideen bombs a canteen at an army base, killing five local soldiers and two civilians."
8339,11/10/2007,Iraq,Zubaidiya,4,0,4,Two women are among four people killed in separate attacks.
8340,11/10/2007,Iraq,Baquba,5,6,11,A husband and wife are among five people gunned down by Islamic terrorists.
8341,11/10/2007,Iraq,Baghdad,2,3,5,Jihadis kill a father and son with mortar fire on their residence.
8342,11/10/2007,Iraq,Baghdad,8,25,33,A suicide bomber ends the lives of eight people at a cafe.
8343,11/10/2007,Iraq,Kirkuk,8,52,60,Eight Iraqis waiting at a petrol pump are killed by an Islamic car bombing.
8344,11/10/2007,Pakistan,Mohmand,6,0,6,Six civilians are executed by Taliban extremists for 'anti-social' behavior.
8345,11/10/2007,India,Baramulla,2,0,2,Two local soldiers are brutally murdered in an ambush by the Mujahideen on their vehicle.
8346,12/10/2007,Algeria,Tizi Ouzou,1,0,1,A police officer is murdered by Islamic fundamentalists.
8347,12/10/2007,Afghanistan,Helmand,4,7,11,Religious extremists murder four local policemen in a bomb attack.
8348,12/10/2007,Thailand,Yala,4,0,4,Four civilians from the same family are cut apart by automatic weapons as they leave their car.
8349,12/10/2007,Iraq,Baghdad,4,15,19,Jihads manage to kill four Iraqis with a car bomb in a commercial district.
8350,12/10/2007,Iraq,Tuz Khormato,4,21,25,A suicide bomber hides explosives amid candy in order to kill three Kurdish kids and one adult at a playground.
8351,13/10/2007,Nigeria,Bauchi,10,0,10,Ten Christians are killed by a Muslim mob rampaging through a village.  Three churches are burned down as well.
8352,13/10/2007,Afghanistan,Spin Boldak,8,29,37,"A Fedayeen suicide bomber rams into a crowded bazaar, killing at least eight innocents."
8353,13/10/2007,Thailand,Narathiwat,1,1,2,"A 47-year-old Buddhist is killed, and his brother injured, in a Muslim terror attack."
8354,13/10/2007,Pakistan,Swat,4,1,5,Four civilians are killed when Islamic militants bomb their vehicle.
8355,13/10/2007,Nigeria,Gamji Gate,2,0,2,Two young Christians are murdered by Muslim radicals in separate attacks.  One is beaten to death and the other hacked with a sword.
8356,13/10/2007,Iraq,Samarrah,18,27,45,al-Qaeda suicide truck bombers take out eighteen innocent Iraqis in a horrific blast.
8357,14/10/2007,India,Ludhiana,7,30,37,A 10-year-old child is among seven people killed when Islamic fundamentalists bomb a movie theater.
8358,14/10/2007,Ingushetia,Karabulak,3,1,4,An ethnic Russian family is attacked by Muslim gunmen.  Three are murdered.
8359,14/10/2007,Iraq,Baghdad,9,13,22,Women and children are among those blown apart by the Sunni car bombing of a Shiite mosque.
8360,14/10/2007,Iraq,Riyadh,3,2,5,Three Iraqis are shot to death by sectarian Jihadis.
8361,14/10/2007,Iraq,Baquba,12,0,12,A dozen people are kidnapped and killed by sectarian rivals.
8362,14/10/2007,Iraq,Ramadi,4,8,12,A suicide car bomber takes down four Iraqis.
8363,15/10/2007,India,Chandigam,1,2,3,Muslim radicals kill a policeman inside his home.  An elderly woman and 10-year-old girl are shot in a separate attack.
8364,15/10/2007,Afghanistan,Uruzgan,4,2,6,Four members of a family are killed trying to stop a suicide bomber.
8365,15/10/2007,Iraq,Baghdad,4,25,29,Women and children are the casualties of a suicide bombing at a park that leaves at least four people dead.
8366,15/10/2007,Iraq,Diwaniya,5,28,33,Jihadis kill at least five civilians in a mortar and machine-gun attack.
8367,15/10/2007,Iraq,Heit,5,8,13,Five members of the same family are blasted to a pulp by a suicide bomber.
8368,15/10/2007,Iraq,Balad,6,8,14,Six Iraqis are killed by a suicide car bomber.
8369,15/10/2007,Somalia,Beledwyne,3,0,3,Three children under the age of 12 are killed when a mortar fired by suspected Islamic militias hits their house.
8370,16/10/2007,Somalia,Mogadishu,3,6,9,Three residents of a home are killed when Islamic militias hit it with a mortar.
8371,16/10/2007,Iraq,Mosul,16,80,96,Sixteen innocents are blasted to death by a suicide truck bomber.
8372,16/10/2007,Iraq,Fallujah,3,0,3,Three members of the same family are killed by suspected al-Qaeda.
8373,16/10/2007,Iraq,Baqubah,4,0,4,A father and son are among four people killed by sectarian rivals.
8374,16/10/2007,Iraq,Baghdad,14,48,62,Jihadis rack up fourteen Iraqi civilians over a 24-hour period in various shootings and bombings.
8375,17/10/2007,Iraq,Diwaniya,7,0,7,Seven local cops are blown to bits by a Jihadi roadside bomb.
8376,17/10/2007,Somalia,Mogadishu,3,0,3,Jihadis kill a government official and two bodyguards with a roadside bomb.
8377,17/10/2007,Somalia,Mogadishu,9,30,39,Eight civilians are among nine killed when Islamic militants attack a police station with rockets and machine-guns.
8378,17/10/2007,Somalia,Mogadishu,3,5,8,A woman is among three civilians killed by Islamic militias in separate attacks.
8379,17/10/2007,Somalia,Kismayo,1,2,3,A Somali man is gunned down by a Muslim militant.
8380,18/10/2007,Pakistan,Khyber,1,2,3,"A self-proclaimed prophet is quickly shot to death by Islamists, who also injure his family members."
8381,18/10/2007,Ingushetia,Magas,4,0,4,Four local cops are gunned down when Islamic terrorists open fire on their vehicle.
8382,18/10/2007,Afghanistan,Khost,4,3,7,Religious extremists kill four local police with a roadside bomb.
8383,18/10/2007,Somalia,Mogadishu,3,2,5,Three Somalis are gunned down by Islamic militias.
8384,18/10/2007,Iraq,Basra,1,7,8,"Freedom Fighters toss a grenade into a school playground, killing one child and injuring seven others."
8385,18/10/2007,Iraq,Hawija,3,11,14,Sunni radicals kill three Iraqis with a car bomb.
8386,18/10/2007,Pakistan,Karachi,138,550,688,Suicide bombers slaughter over one-hundred and thirty people along a parade route with a double blast.
8387,19/10/2007,Thailand,Yala,2,0,2,An 81-year-old Buddhist man is murdered along with his wife by Islamists in their fruit orchard.
8388,19/10/2007,Thailand,Yala,1,0,1,A 52-year-old man is shot to death by Muslim radicals.
8389,19/10/2007,Pakistan,Dowayzai,12,2,14,"The Taliban brutally executes a dozen villagers, slitting the throats of at least six."
8390,19/10/2007,Thailand,Yala,1,0,1,Muslim gunmen murder a civilian sitting in the back of a tea shop.
8391,19/10/2007,Ingushetia,Chermen,2,1,3,Islamists are suspected in the machine-gunning of local youth at a street corner.
8392,19/10/2007,Iraq,Mussayab,4,0,4,Jihadis kill three women with mortars and execute a kidnapped university professor in a separate incident.
8393,19/10/2007,Philippines,Indanan,2,0,2,Two members of a rival group are shot to death by Abu Sayyaf.
8394,20/10/2007,Pakistan,Bajaur,2,0,2,Two tribal elders are shot to death by Taliban militants.
8395,20/10/2007,Iraq,Baghdad,10,14,24,Ten civilians are killed in various attacks by Jihadis.
8396,20/10/2007,Afghanistan,Paktia,3,4,7,Three Afghans are killed by religious extremists in a bomb attack on their vehicle.
8397,20/10/2007,Chechnya,Grozny,1,0,1,A local cop is gunned down by the Mujahideen.
8398,20/10/2007,Pal. Auth.,Rafah,1,17,18,"Hamas clashes with a rival group, leaving a 50-year-old woman dead."
8399,21/10/2007,Somalia,Mogadishu,7,0,7,Seven civilians are killed during an ambush by Islamic militias.
8400,21/10/2007,Nigeria,Sokoto,3,5,8,Shia militants kill three innocent people in at least two separate attacks.
8401,21/10/2007,Iraq,Fallujah,2,4,6,A suicide car bomber kills two Iraqis at a checkpoint.
8402,22/10/2007,Iraq,Baghdad,12,21,33,A dozen Iraqis are cut down by Jihadis in various bombing and shooting attacks.
8403,22/10/2007,Iraq,Baqubah,3,0,3,Three men are kidnapped and tortured to death by al-Qaeda.
8404,22/10/2007,Iraq,Mosul,6,4,10,A female lawyer is among six people murdered by Islamic terrorists.
8405,22/10/2007,Somalia,Mogadishu,3,3,6,Three children playing in a street are killed by Islamists using a roadside bomb.
8406,22/10/2007,Pakistan,North Waziristan,2,0,2,Two local soldiers are killed in separate attacks by pro-Taliban militants.
8407,23/10/2007,England,Leeds,1,0,1,A 19-year-old Catholic girl is stabbed to death by a Muslim who said she was too 'sexually provocative.'
8408,23/10/2007,Dagestan,Kazbek,1,8,9,"A grenade blast rips through a minibus, killing own woman and injuring seven other passengers."
8409,23/10/2007,Iraq,Basra,1,3,4,"Jihadis mortar a home, killing a mother and injuring her three children."
8410,23/10/2007,Iraq,Baquba,5,10,15,A bombing attack and a separate drive-by shooting leave five civilians dead.
8411,23/10/2007,Iraq,Fallujah,15,0,15,Police discover fifteen people bound and shot to death by Sunni terrorists.
8412,23/10/2007,Thailand,Narathiwat,2,4,6,Two infant children (ages 10 and 12 months) are murdered by Muslim gunmen.
8413,23/10/2007,Thailand,Narathiwat,2,0,2,Two women are shot to death by Islamic radicals.
8414,23/10/2007,Thailand,Narathiwat,5,3,8,Five local civilians are gunned down by militant Muslims in a sudden drive-by attack.
8415,24/10/2007,Pakistan,Miranshah,2,2,4,Two local soldiers are killed when their vehicle crosses a landmine planted by Islamic militants.
8416,24/10/2007,Iraq,Baghdad,9,25,34,"Sunni radical bomb a Shia mosque, killing nine innocents."
8417,24/10/2007,Iraq,Iskandariya,1,0,1,Muslim gunmen kill an Iraqi girl.
8418,24/10/2007,Iraq,Zaghanya,3,0,3,A man and his two sons are shot to death in their home by sectarian terrorists.
8419,24/10/2007,Iraq,Baqubah,3,24,27,"Jihadis lob mortars into a village, killing three residents."
8420,24/10/2007,Somalia,Mogadishu,5,16,21,Islamic militias use a roadside bomb to kill five passengers on a minibus.
8421,24/10/2007,Afghanistan,Khost,1,4,5,A suicide bomber takes down an Afghan official.
8422,24/10/2007,Macedonia,Tanusevci,1,2,3,Muslim terrorists kill a police officer and injure two others in a shooting attack.
8423,24/10/2007,Thailand,Yala,2,0,2,Two young men are gunned down by Muslim radicals as they are walking along a street.
8424,25/10/2007,Dagestan,Adil-Otar,1,1,2,Islamic militants shoot a police officer to death.
8425,25/10/2007,Thailand,Pattani,2,1,3,"A married couple are murdered in their own home by Islamists, who then torch the house."
8426,25/10/2007,Iraq,Khalis,4,0,4,Two woman and two children are killed when Holy Warriors lob mortars into a residential neighborhood.
8427,25/10/2007,Iraq,Baquba,19,26,45,Four children are among nineteen people murdered by Islamic terrorists in separate attacks.
8428,25/10/2007,Iraq,Baghdad,6,0,6,A Sunni school teacher is among six innocents killed by sectarian Jihadis.
8429,25/10/2007,Pakistan,Mangora,24,33,57,At least two dozen local soldiers are blown apart by a Fedayeen suicide bomber.
8430,25/10/2007,Thailand,Narathiwat,0,3,3,A man and his two sons are shot by Muslim gunmen in a drive-by shooting as they are on their way home from a wedding.
8431,25/10/2007,Somalia,Mogadishu,4,7,11,"Islamic militants bomb a livestock market, killing four participants."
8432,25/10/2007,Iraq,Diyala,4,0,4,Holy Warriors kill four children with mortars.
8433,26/10/2007,Iraq,Adhaim,6,5,11,Sunni radicals murder six innocent truck drivers.
8434,26/10/2007,Iraq,Muqdadiyah,1,3,4,A woman is killed by a suicide bomber along a sidewalk.
8435,26/10/2007,India,Baramulla,1,0,1,A 25-year-old man is shot to death by Islamic terrorists.
8436,26/10/2007,Pakistan,Mingora,4,0,4,Religious extremists publicly cut the heads off of four security personnel taken hostage.
8437,27/10/2007,Belgium,Mons,1,0,1,A Pakistani family murders their daughter for moving in with a non-Muslim Belgian.
8438,27/10/2007,Thailand,Pattani,1,0,1,A 50-year-old plantation worker is beheaded by Islamic militants.
8439,27/10/2007,Thailand,Narathiwat,1,14,15,"Muslim radical bomb a restaurant, killing at least one female patron."
8440,27/10/2007,Somalia,Mogadishu,3,3,6,Islamic militias kill three civilians in an RPG attack.
8441,27/10/2007,Afghanistan,Paktika,5,5,10,A civilian and four local soldiers are killed by a Fedayeen suicide bomber.
8442,27/10/2007,Pakistan,Swat,9,0,9,Islamic militants behead two policemen and seven civilians.
8443,27/10/2007,Thailand,Yala,1,1,2,Muslim radicals gun down a 68-year-old man riding home from a tea shop.
8444,27/10/2007,Afghanistan,Ghazni,2,0,2,Two local police are killed in an ambush by religious extremists.
8445,27/10/2007,Iraq,Baghdad,34,27,61,Freedom Fighters kill thirty-four innocent Iraqis in various attacks.
8446,28/10/2007,Iraq,Kut,2,0,2,A woman is among two people gunned down by Islamic terrorists.
8447,28/10/2007,Iraq,Kirkuk,8,28,36,"A suicidal Sunni bomber targets innocent Shia at a bus terminal, killing at least eight."
8448,28/10/2007,Iraq,Baghdad,2,13,15,Two people are killed in a Jihad bombing.
8449,29/10/2007,Iraq,Mosul,8,0,8,"Four women are among eight killed by Islamic gunmen, who catch half their victims after storming a house."
8450,29/10/2007,Iraq,Baquba,30,25,55,A suicide bomber on a bicycle murders thirty Iraqi police officers.
8451,29/10/2007,Iraq,Baiji,8,13,21,"Jihadi car bombers target a pair of homes, killing at least eight people."
8452,29/10/2007,Somalia,al-Baraka,1,0,1,A woman is killed by a bomb set by Islamic militias.
8453,29/10/2007,Afghanistan,Lashkar Gar,5,10,15,A teenage suicide bomber kills three Afghans civilians and two police.
8454,29/10/2007,Thailand,Yala,2,0,2,A young couple in their 20's are murdered by Islamists while standing outside their home.
8455,29/10/2007,Thailand,Pattani,1,0,1,A 35-year-old teacher is killed by Muslim gunmen.
8456,29/10/2007,Thailand,Narathiwat,2,0,2,Two civilians are murdered in a drive-by shooting by Islamists.
8457,30/10/2007,Iraq,al-Shahimiya,1,0,1,Islamic terrorists kidnap and murder an elderly farmer.
8458,30/10/2007,Iraq,Samarrah,4,8,12,Four local cops are murdered by a Sunni car bomb.
8459,30/10/2007,Iraq,Baghdad,8,16,24,Jihadis pick off eight ordinary Iraqis in various bombing and shooting attacks.
8460,30/10/2007,Thailand,Yala,1,3,4,"A 13-year-old Buddhist girl is murdered by Islamic gunmen, who also injure her mother."
8461,30/10/2007,Pakistan,Rawalpindi,7,24,31,"A Fedayeen suicide bomber detonates in a public park, killing seven people."
8462,30/10/2007,Thailand,Narathiwat,1,0,1,Radicals shoot a religious teacher to death.
8463,30/10/2007,Thailand,Pattani,1,0,1,A man is shot to death by Muslim radicals while sitting in a tea shop.
8464,30/10/2007,Pakistan,Bannu,4,4,8,Four local soldiers are killed by a remote-controlled bomb set by pro-Taliban militants.
8465,31/10/2007,Russia,Togliatti,8,50,58,A bomb set on the floor of a commuter bus by suspected Islamic militants kills eight.
8466,31/10/2007,Iraq,Mosul,9,0,9,"Sectarian terrorist kidnap and murder nine people, burning the bodies afterwards."
8467,31/10/2007,Thailand,Yala,2,7,9,"Islamic radicals bomb a karaoke bar, killing one patron, then shoot a 37-year-old man in a separate attack."
8468,31/10/2007,Somalia,Mogadishu,1,0,1,Islamic militias are thought responsible for the brazen murder of a gentle businessman.
8469,1/11/2007,Afghanistan,Nad Ali,5,3,8,"Religious extremists attack a police checkpoint, killing five officers."
8470,1/11/2007,Pakistan,Sargodha,8,40,48,"A suicide bomber rams a bus, killing eight local security personnel."
8471,1/11/2007,Pakistan,Bajaur,2,0,2,Two people are killed when Taliban militants shell their house.
8472,1/11/2007,Thailand,Narathiwat,3,10,13,Islamic radicals kill three men in separate shooting and bombing attacks.
8473,1/11/2007,Iraq,Baqubah,1,2,3,Jihadis manage to kill one child with a bomb and injure two others.
8474,1/11/2007,Iraq,Baghdad,11,25,36,Two bombs (the second in Saadiya) leave eleven Iraqis dead.
8475,2/11/2007,Saudi Arabia,Riyadh,1,0,1,A man is beheaded for the crime of 'sorcery' and for desecrating the Qur'an.
8476,2/11/2007,Thailand,Pattani,1,0,1,A 58-year-old man is shot to death by Islamists while returning home from market.
8477,2/11/2007,Somalia,Mogadishu,5,0,5,"Five Ethiopians are killed in an ambush by Islamists, who then drag the bodies through the streets."
8478,2/11/2007,Iraq,Tuz Khormato,1,1,2,Sunni extremists gun down a university student.
8479,2/11/2007,Thailand,Narathiwat,1,0,1,A 28-year-old plantation worker is murdered by Islamic radicals while walking home.
8480,3/11/2007,Afghanistan,Rashidan,2,0,2,The Taliban kidnap and behead a man and woman.
8481,3/11/2007,Iraq,Khalis,7,10,17,A roadside bombing and separate shooting attacks leave seven people dead.
8482,4/11/2007,Thailand,Yala,2,0,2,A 12-year-old boy and his father are murdered by Islamic gunmen.
8483,4/11/2007,Iraq,Ramadi,40,0,40,"Security forces discover the remains of forty civilians kidnapped, tortured and executed by al-Qaeda."
8484,4/11/2007,Iraq,Baghdad,9,7,16,Two female school principles are among nine people killed is separate attacks by Islamic terrorists.
8485,4/11/2007,Iraq,Baqubah,2,1,3,A woman and girl are killed when Jihadis bomb their home.
8486,4/11/2007,Iraq,Tikrit,6,13,19,A child is among six people killed in two separate Sunni attacks.
8487,4/11/2007,Iraq,Samarra,5,15,20,Five Iraqis are killed by a car bomb set by Islamic terrorists.
8488,4/11/2007,Afghanistan,Ghazni,4,2,6,Religious extremists kill four local cops in a roadside attack.
8489,4/11/2007,Russia,Kabardino-Bal.,9,0,9,"Islamic militants capture, bind, and shoot nine civilian hunters to death in a heavily wooded area."
8490,5/11/2007,Thailand,Pattani,3,0,3,Muslim radicals shoot three people to death as they are riding in a vehicle.
8491,5/11/2007,Thailand,Yala,2,0,2,Two men are gunned down by Islamic extremists.
8492,5/11/2007,Iraq,Baghdad,20,11,31,Twenty Iraqis are killed in various Jihad attacks in the capital and in Mosul.
8493,5/11/2007,Somalia,Suq Bacad,1,0,1,An Ethiopian security guard at a market is assassinated by Islamic gunmen.
8494,5/11/2007,Ingushetia,Magas,3,1,4,Radical Muslims enter a brick factory and shoot three workers to death.
8495,5/11/2007,Thailand,Narathiwat,2,0,2,Two imams are shot to death by religious extremists.
8496,5/11/2007,Pakistan,Kharqamar,1,1,2,A local soldier is killed in a roadside bombing attack by Taliban militants.
8497,6/11/2007,Afghanistan,Lashkar Gah,1,0,1,A government official is murdered by Taliban gunmen.
8498,6/11/2007,Thailand,Narathiwat,2,0,2,Two Buddhist teachers are murdered by Islamic radicals.
8499,6/11/2007,Thailand,Yala,0,27,27,Muslim bombers injure twenty-seven people at a fresh food market.  Several victims lose limbs.
8500,6/11/2007,Afghanistan,Baghlan,75,96,171,Sixty schoolchildren are among more than seventy innocents blown to bits by a Fedayeen suicide bomber at a sugar factory.
8501,6/11/2007,Iraq,Latifiya,4,0,4,Two people are tortured to death by Islamic terrorists.  Two others are beheaded in Dhuluiya.
8502,6/11/2007,Iraq,Mosul,6,0,6,"Six local policemen are shot to death by Jihadis, who then burn the bodies."
8503,6/11/2007,Somalia,Baladweyn,1,0,1,A businessman is shot twice in the head by two suspected Islamic assassins.
8504,7/11/2007,Pal. Auth.,Nablus,1,2,3,Terrorists kill a fellow Palestinian in a roadside attack.  The victim was a laborer.
8505,7/11/2007,Iraq,Wassit,2,0,2,Two children are killed by a roadside bomb planted by Islamic terrorists.
8506,7/11/2007,Iraq,Diwaniyah,2,3,5,Jihadis manage to kill two children in a mortar attack on their village.
8507,7/11/2007,Iraq,Baghdad,8,0,8,A female teacher is among eight people gunned down by Islamic radicals.
8508,7/11/2007,Iraq,Hashimiyat,17,0,17,Seventeen kidnap victims are found bound and executed.
8509,7/11/2007,Thailand,Pattani,3,1,4,Three policemen are killed by a powerful Muslim bomb that throws them into a canal.
8510,7/11/2007,Thailand,Yala,1,5,6,"Islamists attack a security patrol, killing one member."
8511,7/11/2007,Pakistan,Razmak,3,1,4,Three local soldiers are abducted and killed for 'resisting Islam.'
8512,8/11/2007,Thailand,Pattani,1,0,1,A local businessman is shot to death by Islamic radicals.
8513,8/11/2007,Iraq,Mandali,12,0,12,Twelve Iraqis are killed over a 24-hour period by Islamic terrorists.
8514,8/11/2007,Iraq,Tal Asquf,1,5,6,"One woman is killed, and five others injured, when a Fedayeen bomber detonates at a campaign office."
8515,8/11/2007,Iraq,Garma,6,4,10,Radical Sunnis kill six local cops with a roadside bomb.
8516,8/11/2007,Pakistan,Tank,1,0,1,A Shiite cleric is gunned down by Sunni radicals.
8517,8/11/2007,Afghanistan,Zabul,7,0,7,Seven local cops are brutally ambushed and murdered by religious extremists.
8518,8/11/2007,Thailand,Yala,1,0,1,A 59-year-old civilian is gunned down outside his home by Islamic militants.
8519,8/11/2007,Pakistan,Bannu,1,0,1,The Mujahideen shoot a man to death inside his home.
8520,9/11/2007,Iraq,Balad Ruz,3,5,8,Three children are killed in a Jihad mortar attack.
8521,9/11/2007,Iraq,Khalis,7,4,11,Seven Iraqis are murdered in a suicide bombing.
8522,9/11/2007,Iraq,Albu Ajeel,3,3,6,Three villagers are killed in an assault by Muslim gunmen.
8523,9/11/2007,Iraq,Baqubah,1,6,7,Islamic terrorists kill a child in a bomb attack on a family.
8524,9/11/2007,Pakistan,Peshawar,4,3,7,Four people are killed when a suicide bomber on foot darts into their home.
8525,9/11/2007,Afghanistan,Zabul,4,2,6,Religious extremists murder four local cops by firing point-blank into their vehicle.
8526,9/11/2007,Iraq,Baghdad,2,0,2,Two male gynecologists are killed by Islamic fundamentalists determined that men should not see the private parts of women.
8527,9/11/2007,Thailand,Yala,2,0,2,A woman and her son are murdered by Islamic gunmen while walking home.
8528,9/11/2007,India,Pattan,4,3,7,Lashkar-e-Toiba militants gun down four local soldiers.
8529,9/11/2007,Thailand,Narathiwat,2,0,2,Two civilians are shot to death by Muslim radicals while talking out on their front yard.
8530,10/11/2007,India,Baramulla,1,6,7,Mujahideen kill one police officer in an attack on a hotel.
8531,10/11/2007,Afghanistan,Kunduz,1,3,4,A civilian is killed in an attack by a Fedayeen bomber.
8532,10/11/2007,Iraq,Baghdad,16,30,46,Sixteen people are killed in various attacks by Islamic terrorists around the country.
8533,11/11/2007,Somalia,Mogadishu,2,0,2,Two local guards are gunned down at a market by Islamic militia.
8534,11/11/2007,Afghanistan,Herat,6,1,7,Six tribal elders are brutally ambushed and shot to death by Islamic radicals.
8535,11/11/2007,India,Kishtwar,1,0,1,A political activist is kidnapped and murdered by the Mujahideen.
8536,11/11/2007,India,Sopore,1,0,1,"Islamic militants ambush a road-opening ceremony, killing a security guard."
8537,11/11/2007,Iraq,Baghdad,8,9,17,A 12-year-old girl is among eight innocents killed by Islamic terrorists in various attacks.
8538,11/11/2007,Iraq,Baqubah,1,1,2,"Sunni gunmen attack a university, killing one student."
8539,11/11/2007,Afghanistan,Helmand,3,0,3,A woman and two children are killed when Talibanis use them as human shields.
8540,11/11/2007,Afghanistan,Helmand,3,0,3,A suicide bomber takes out three Afghan civilians.
8541,12/11/2007,Iraq,Baqubah,1,0,1,Fundamentalists gun down a university professor.
8542,12/11/2007,Pal. Auth.,Gaza,7,50,57,"Hamas gunmen open fire on an Arafat rally, killing seven participants."
8543,12/11/2007,Pakistan,Miranshah,1,9,10,"Talibanis bomb a convoy of vehicles, killing a local soldier."
8544,13/11/2007,Iraq,Qadir Kam,5,0,5,al-Qaeda is suspected to be behind the brutal slaying of a family of five in their home.
8545,13/11/2007,Iraq,Kirkuk,2,1,3,A policeman is killed in his car along with his 13-year-old son.  The boy's mother is injured in the Sunni attack.
8546,13/11/2007,Philippines,Manila,4,9,13,"A lawmaker, his driver and two staffers are blown apart by a bomb planted by Muslim militants."
8547,13/11/2007,Iraq,Mosul,5,0,5,A woman and child are among five people killed by Islamic terrorists.
8548,13/11/2007,Pakistan,Peshawar,1,0,1,Islamic fundamentalists kill a 12-year-old boy inside an Internet cafe with a planted bomb.
8549,14/11/2007,Ingushetia,Nazran,1,0,1,A police officer is assassinated by Muslim separatists as he leaves his home.
8550,14/11/2007,Pakistan,Saidu Sharif,4,4,8,Two civilians are among four killed when Islamic militants fire rockets into an airport.
8551,14/11/2007,Tajikistan,Dushanbe,1,0,1,A street-sweeper is killed by a bomb planted outside a government building.
8552,14/11/2007,Iraq,Hilla,2,10,12,Two people are killed by a Fedayeen suicide attack on a home.
8553,14/11/2007,Iraq,Iskandariya,2,6,8,A suicide bomber kills two Iraqis at a tribal chiefs meeting.
8554,14/11/2007,India,Srinagar,1,0,1,Islamists assassinate a political leader outside a mosque.
8555,15/11/2007,Jordan,Amman,1,0,1,"A 33-year-old divorced woman is beaten and strangled by her brother, who was concerned about her ""reputation."""
8556,15/11/2007,Thailand,Pattani,1,0,1,"Islamic terrorists open fire on an off-duty policeman sitting in his truck, killing him."
8557,15/11/2007,Iraq,Mahaweel,1,0,1,A 25-year-old woman is tortured to death by militant Muslims.
8558,15/11/2007,Iraq,Baghdad,1,0,1,A female school principal is shot to death by Islamic radicals.
8559,15/11/2007,Pakistan,North Waziristan,2,3,5,Two local soldiers are killed in separate terror bombings by Taliban militants.
8560,15/11/2007,Afghanistan,Paktia,3,0,3,"A teacher, killed for teaching English, is among three people shot to death by the Taliban."
8561,15/11/2007,Thailand,Narathiwat,1,1,2,A woman is shot and killed by Muslim terrorists while riding home with her daughter.
8562,15/11/2007,Iraq,Kirkuk,6,24,30,Children walking to school account for the bulk of casualties as a suicide car bomber detonates in front of them.  Six are killed.
8563,16/11/2007,Afghanistan,Kandahar,4,0,4,Four local policemen are blown to bits by a bomb planted by religious extremists.
8564,16/11/2007,Thailand,Yala,1,0,1,A 42-year-old hospital worker is murdered by Islamic gunmen on his way to work.
8565,16/11/2007,Pakistan,Parachinar,45,100,145,"At least forty people, including two doctors, are killed in a bitter street clash between Sunni and Shia."
8566,16/11/2007,Somalia,Mogadishu,1,0,1,A 'street boy' is killed when Islamic terrorists attack a group of Ugandan peacekeepers.
8567,16/11/2007,Iraq,Sadiyah,2,0,2,Two brothers are kidnapped and murdered by sectarian rivals.
8568,16/11/2007,Afghanistan,Kandahar,2,1,3,Taliban kill two newly-married women with a rocket assault on their vehicle.
8569,16/11/2007,Afghanistan,Kabul,13,0,13,Religious extremists kill thirteen local police in two ambushes in eastern provinces.
8570,17/11/2007,Afghanistan,Nangarhar,1,2,3,An Afghan civilian is killed by a suicide bomber.
8571,17/11/2007,Pakistan,Mir Ali,1,0,1,A woman is killed by an al-Qaeda bomb planted outside her home.
8572,17/11/2007,Pakistan,Parachinar,46,80,126,Another forty-six people are killed in sectarian violence between Sunnis and Shia.
8573,17/11/2007,Iraq,Baghdad,30,0,30,"Thirty Shia bodies, many of them children, are discovered in a house in a predominantly Sunni area."
8574,17/11/2007,Iraq,Mosul,10,0,10,Ten people are gunned down or found dead at the hands of Sunni terrorists.
8575,17/11/2007,Somalia,Mogadishu,2,6,8,Two civilians on a minibus are killed in a roadside bomber attack by Islamists.
8576,17/11/2007,Afghanistan,Sangisar,3,0,3,A Taliban road mine kills two Canadians and their Afghan interpreter.
8577,17/11/2007,Thailand,Yala,2,0,2,Islamists shoot a middle-aged married couple to death in their home.
8578,18/11/2007,Pakistan,Nowshera,1,0,1,Muslim militants kill a railway worker with a bomb.
8579,18/11/2007,Iraq,Baqubah,6,7,13,A suicide bomber wades into a group of children receiving candy from US soldiers and detonates.  At least six are killed.
8580,18/11/2007,Afghanistan,Girishk,2,3,5,Two local policemen are killed in a Taliban ambush.
8581,18/11/2007,Afghanistan,Badakshan,2,0,2,Islamists kill a teacher and her driver in a highway ambush.
8582,18/11/2007,Iraq,Baghdad,10,21,31,"Islamic terrorists detonate a car bomb along a city street, killing ten Iraqis."
8583,18/11/2007,Iraq,Mosul,3,16,19,Three civilians are killed by a car bomb detonated by Sunni radicals.
8584,18/11/2007,Afghanistan,Uruzgan,5,0,5,"Five local policemen are kidnapped, tortured, and murdered by religious extremists, who hang the mutilated bodies on display."
8585,19/11/2007,Pakistan,Parachinar,12,50,62,A dozen more people are killed in Sunni-Shia mob violence.
8586,19/11/2007,Pakistan,Kurram,8,18,26,"Sectarian extremists lob a mortar into a market, killing eight people."
8587,19/11/2007,Russia,Nalchik,1,2,3,A Russian policeman is killed in a shooting attack by Mujahideen.
8588,19/11/2007,Iraq,Basra,6,2,8,Jihadis kill five children and their mother with a Katusha rocket.
8589,19/11/2007,Iraq,Tikrit,8,0,8,"Five policemen are found murdered as the bodies of three civilians, including a 3-year-old boy, are discovered elsewhere."
8590,19/11/2007,Afghanistan,Nimroz,7,14,21,Seven people are blown to bits by a suicide bomber.
8591,19/11/2007,Pal. Auth.,Kedumim,1,0,1,A 29-year-old Israeli father is shot to death by Palestinian terrorists.
8592,19/11/2007,Pakistan,Darra Adamkhel,3,0,3,Three truck drivers are kidnapped and beheaded by the Taliban.
8593,20/11/2007,Australia,Hampton Park,1,0,1,A woman is strangled to death with her own veil by her husband in an honor killing after threatening to leave him.
8594,20/11/2007,India,Kulgam,1,0,1,A baker is abducted and murdered by the Mujahideen.
8595,20/11/2007,Pakistan,North Waziristan,1,3,4,A civilian is killed in an Islamist rocket attack.
8596,20/11/2007,Pakistan,Parachinar,6,4,10,A fourth day of Sunni-Shia violence yields six more bodies.
8597,20/11/2007,India,Baramulla,2,0,2,The Mujahideen shoot two people to death in separate attacks.
8598,20/11/2007,Iraq,Baghdad,37,25,62,Thirty-seven people are killed in various attacks by Islamic terrorists around the country.
8599,20/11/2007,Pakistan,Parachinar,28,27,55,Twenty-eight more people are killed in clashes between Sunni and Shia.
8600,20/11/2007,Afghanistan,Ghazni,2,4,6,"Islamic extremists attack a road construction crew, killing two people."
8601,21/11/2007,Iraq,Muwaili,40,0,40,"An al-Qaeda mass grave is found containing forty bodies, including that of children."
8602,21/11/2007,Iraq,Ramadi,6,22,28,"Sunni radicals bomb a courthouse, killing six people."
8603,21/11/2007,Pakistan,Swat,4,0,4,Four members of the same family are killed in a mortar attack by Muslim militants.
8604,21/11/2007,Thailand,Pattani,4,6,10,"Islamists shoot four Buddhists to death at point-blank range, then plant a bomb that injures six others."
8605,21/11/2007,India,Rajouri,1,0,1,"A civilian is abducted and beheaded by the Mujahideen, who also torch his house."
8606,22/11/2007,Pakistan,Lower Kurram,3,0,3,Three people are killed in sectarian attacks.
8607,22/11/2007,Somalia,Mogadishu,3,5,8,Three civilians are killed in an ambush by Islamic militants.
8608,22/11/2007,Russia,Bratsk,5,13,18,A young girl is among five people are killed when Islamic radicals bomb a passenger bus.
8609,22/11/2007,Thailand,Narathiwat,2,0,2,Two brothers are shot to death by Muslim militants as they are riding a motorcycle.
8610,22/11/2007,Pakistan,FATA,2,0,2,Two civilians are shot to death in separate attacks by sectarian rivals.
8611,22/11/2007,Philippines,Kidapawan,1,7,8,"A gang linked to Islamic militants plants a bomb at a shopping mall, killing one person."
8612,22/11/2007,Iraq,Mosul,3,22,25,Jihadis kill two people with a car bomb and behead a university professor in a separate incident.
8613,22/11/2007,Iraq,Howr Rajab,22,8,30,"al-Qaeda terrorists attack two Iraqi villages, killing over twenty innocent people."
8614,23/11/2007,Thailand,Yala,1,0,1,A 45-year-old man is killed outside his home by Islamic militants.
8615,23/11/2007,Iraq,Baghdad,15,55,70,Fifteen innocent people are slaughtered by Jihadi bombers at a pet market.
8616,23/11/2007,Iraq,Mosul,21,21,42,Islamic terrorists massacre twenty-one Iraqis with twin bombings.
8617,23/11/2007,India,Uttar Pradesh,14,80,94,"Harkat-ul-Jehadi Islamia terrorists bomb three separate Indian cities, killing at least fourteen Hindu."
8618,23/11/2007,Afghanistan,Kandahar,7,6,13,Religious extremists behead seven Afghan police officers.
8619,23/11/2007,Iraq,Jalawla,2,0,2,A husband and wife are beheaded in front of their children by religious extremists.
8620,23/11/2007,Pakistan,Parachinar,50,0,50,Renewed violence between Shia and Sunni reportedly leaves about fifty dead.
8621,24/11/2007,Pakistan,Rawalpindi,30,55,85,"Suicide bombers kill thirty Pakistanis in two separate attacks, one on a bus."
8622,24/11/2007,Afghanistan,Kabul,7,9,16,Three children are among seven people murdered by a Fedayeen suicide bomber.
8623,24/11/2007,Thailand,Narathiwat,2,0,2,An older Buddhist couple is murdered by Islamic gunmen in a drive-by attack.
8624,24/11/2007,Thailand,Yala,1,0,1,A middle-aged man is shot to death by Islamists while sitting in a tea shop.
8625,24/11/2007,Iraq,Fallujah,2,0,2,"Two people are kidnapped, tortured and murdered by Islamic radicals."
8626,25/11/2007,Iraq,Baghdad,9,0,9,"Nine Iraqi cops are taken hostage, force to kneel, and shot in the back of the head by their Muslim brothers."
8627,25/11/2007,Iraq,Shab,11,0,11,Seven children are among eleven family members slaughtered by sectarian rivals in their home.
8628,25/11/2007,Iraq,al-Zab,1,5,6,A suicide bomber kills one Iraqi and injures five more.
8629,25/11/2007,Iraq,Baghdad,11,36,47,Eleven civilians are killed in two separate car bombings.
8630,25/11/2007,Thailand,Pattani,1,0,1,A disabled woman is shot to death as she leaves her plantation.
8631,26/11/2007,Afghanistan,Paktia,4,2,6,Religious extremists kill four Afghans with a roadside bomb.
8632,26/11/2007,Iraq,Mosul,4,2,6,Jihadis murder four people.  A woman is also gunned down in Basra.
8633,26/11/2007,Thailand,Narathiwat,1,0,1,"Islamic terrorists shoot a civilian off his motorcycle, then walk over and put a bullet in his head."
8634,26/11/2007,Thailand,Yala,1,0,1,A 54-year-old man is murdered by Muslim terrorists on his way to work.
8635,26/11/2007,Afghanistan,Kabul,4,0,4,Four civilians are killed by a bomb planted by religious extremists.
8636,26/11/2007,Somalia,Mataban,6,0,6,Six civilians are killed when Islamic militias attack Ethiopian troops in a populated area.
8637,27/11/2007,Somalia,Mogadishu,1,1,2,Islamic militias gun down a vendor at a market.
8638,27/11/2007,Iraq,Baqubah,9,15,24,"A suicide bomber disguised as a shepherd manages to kill nine Iraqis, including three women."
8639,27/11/2007,Afghanistan,Kabul,2,7,9,A suicide bomber kills two civilians walking along a road.
8640,28/11/2007,Iraq,Haditha,5,30,35,"Jihadis lob mortars into a residential area, killing five civilians."
8641,28/11/2007,Chechnya,Grozny,1,0,1,A local cop is gunned down by the Mujahideen.
8642,28/11/2007,Pakistan,Punjab,1,0,1,A father chops his daughter to death with an axe over her affair with a boy.
8643,28/11/2007,Thailand,Narathiwat,2,0,2,Two Buddhist fishermen are abducted and brutally beheaded by Islamic terrorists.
8644,28/11/2007,Thailand,Narathiwat,1,0,1,"Islamists shoot, stab, then nail a man to a wooden cross and leave on the road to die."
8645,29/11/2007,Thailand,Pattani,1,0,1,A 58-year-old orchard worker is shot to death by radical Muslims.
8646,29/11/2007,Somalia,Mogadishu,15,23,38,Islamic militants open fire on a security team hunting for munitions in a residential area.  Some fifteen civilians are killed.
8647,29/11/2007,Iraq,al-Salaam,12,25,37,A Jihad rocket attack leaves a dozen villagers dead.
8648,29/11/2007,Pakistan,North Waziristan,5,4,9,"Religious militants bomb a convoy, killing five local soldiers."
8649,29/11/2007,Afghanistan,Baghlan,1,1,2,The Taliban shoot a local police officer to death.
8650,29/11/2007,India,Baramulla,1,0,1,A 60-year-old civilian is shot to death by the Mujahideen.
8651,30/11/2007,Iraq,Baghdad,17,34,51,Seventeen Iraqis are killed in various attacks by Islamic terrorists around the country.
8652,30/11/2007,Somalia,Borbhere,1,0,1,A man is shot to death in a mosque by three Islamic radicals.
8653,30/11/2007,Philippines,Sulu,8,0,8,Eight local soldiers are killed in an ambush by Muslim extremists.
8654,1/12/2007,Thailand,Yala,1,0,1,Islamic terrorists shoot a man to death outside a mosque.
8655,1/12/2007,Afghanistan,Lashkar Gah,3,0,3,Three civilians are killed by a roadside bomb planted by religious extremists.
8656,1/12/2007,Iraq,Madaen,1,6,7,A suicide bomber kills an Iraqi at a traffic checkpoint.
8657,1/12/2007,Iraq,Dwelah,13,14,27,"al-Qaeda gunmen storm a village, killing over a dozen innocents."
8658,1/12/2007,Somalia,Mogadishu,2,4,6,"Islamists toss a grenade into a market, killing two civilians."
8659,2/12/2007,Somalia,Medina,2,5,7,Islamists kill two civilians with a roadside bomb.
8660,2/12/2007,Somalia,Mogadishu,2,0,2,Two civilians are shot in the head by Islamic militia members.
8661,2/12/2007,Iraq,Garma,20,0,20,The bodies of three children are among twenty found at a house previously occupied by Islamic terrorists.
8662,2/12/2007,Iraq,Mosul,6,0,6,Six civilians are murdered by Islamic terrorists in various attacks.
8663,2/12/2007,Iraq,Iskandariya,4,2,6,Four civilians are killed at their own mosque by sectarian rivals.
8664,2/12/2007,Pakistan,Charsadda,3,5,8,"Religious extremists open fire on a cockfight, killing three civilians."
8665,2/12/2007,India,Sopore,1,0,1,Muslim militants abduct a 22-year-old seminary student and slit his throat.
8666,2/12/2007,Thailand,Narathiwat,2,0,2,Two civilians are shot to death in their pickup truck by Muslim radicals.
8667,2/12/2007,Iraq,Baqubah,4,4,8,A suicide bomber blows apart four Iraqis.
8668,3/12/2007,Pakistan,Qila Saifullah,6,6,12,The Taliban is suspected in the bombing of a school that leaves six teenaged boys dead.
8669,3/12/2007,Somalia,Mogadishu,5,0,5,A father and son are among five people killed by Islamists in three separate attacks.
8670,3/12/2007,Afghanistan,Nimruz,4,7,11,Four Afghans are blown to bits by a suicide bomber.
8671,3/12/2007,Iraq,Basra,15,9,24,Three teachers are among fifteen people targeted and murdered by Islamic radicals.
8672,3/12/2007,Iraq,Hawija,2,0,2,Two people are brutally killed and burned by al-Qaeda terrorists.
8673,3/12/2007,Iraq,Ramadi,3,1,4,Three local police are killed by a Fedayeen suicide bomber.
8674,3/12/2007,India,Anantnag,1,0,1,A 25-year-old civilian is abducted and shot to death by the Harkat-ul-Mujahideen.
8675,4/12/2007,Iraq,Jalawla,8,30,38,A suicide bomber sends eight innocent souls to Allah.
8676,4/12/2007,Iraq,Baghdad,23,0,23,Two dozen people are killed by sectarian rivals and thrown into a lake.
8677,4/12/2007,Thailand,Narathiwat,4,20,24,"Four people are killed when Islamists bomb a restaurant, two at the scene and the four others in the hospital."
8678,5/12/2007,Russia,Stary Cherek,1,0,1,A police officer is gunned down by Muslim militants.
8679,5/12/2007,Iraq,Baghdad,15,33,48,Sunni radicals massacre fifteen Shiites with a bomb placed outside their mosque.
8680,5/12/2007,Iraq,Baqubah,5,20,25,Islamic terrorists kill five Iraqis with a car bomb along a city street.
8681,5/12/2007,Somalia,Hiran,2,3,5,Two local soldiers are ambushed and murdered by Islamic militants.
8682,5/12/2007,Afghanistan,Kabul,12,14,26,"A Fedayeen bomber boards a minibus and detonates, killing a dozen Afghans, including four children."
8683,6/12/2007,Iraq,Diyala,9,7,16,al-Qaeda gunmen massacre nine Iraqi cops at point-blank range at a checkpoint.
8684,6/12/2007,Iraq,Kut,1,0,1,Suspected fundamentalists shoot a woman to death.
8685,7/12/2007,Pakistan,Charsadda,1,3,4,Muslim militants kill a local policeman in an ambush on a security post.
8686,7/12/2007,Iraq,Diyala,24,25,49,Suicide bombers take out two dozen Iraqis in three attacks.
8687,8/12/2007,Afghanistan,Farah,8,6,14,Eight local police are killed in two separate ambushes by religious militants.
8688,8/12/2007,Afghanistan,Helmand,1,0,1,The Taliban hang a 12-year-old boy from a tree.
8689,8/12/2007,Iraq,Wasit,4,0,4,Radical Sunnis are suspected in a rocket attack on a Shia house in which a family of four is killed.
8690,8/12/2007,Iraq,Mahmudiya,1,2,3,Jihadis kill one child in a mortar attack.
8691,8/12/2007,Iraq,Baiji,7,15,22,A female suicide bomber kills seven Iraqis.
8692,9/12/2007,Iraq,Mosul,1,0,1,A Christian girl is shot to death at a marketplace by Islamists.
8693,9/12/2007,Iraq,Hilla,6,0,6,Muslim bomber take out six Iraqis with a roadside attack.
8694,9/12/2007,Pakistan,Swat,9,8,17,Children are among nine killed when a suicide car bomber rams a police checkpoint.
8695,9/12/2007,India,Ramban,1,0,1,A Hindu police officer is shot to death by Muslim militants.
8696,9/12/2007,Somalia,Mogadishu,1,3,4,A civilian is killed when Islamists attack Ethiopian troops near a marketplace.
8697,9/12/2007,Russia,Nevinnomysk,2,4,6,"Islamic terrorists bomb a passenger bus, killing two Russians."
8698,10/12/2007,Somalia,Mogadishu,2,5,7,Two more civilians are killed when Islamic militants hurl grenades at a passing patrol.
8699,10/12/2007,Iraq,Baghdad,12,48,60,Two Jihad mortar attacks leave a dozen Iraqis dead.
8700,10/12/2007,Pakistan,Swat,0,5,5,"A suicide bomber targets a busload of children, injuring five."
8701,10/12/2007,Canada,Toronto,1,0,1,A 16-year-old girl is strangled to death by her father for refusing to wear the hijab.
8702,11/12/2007,Iraq,Basra,2,0,2,"Islamic radicals kill a Christian brother and sister, then dump their bodies at a garbage site."
8703,11/12/2007,Algeria,Algiers,37,100,137,At least thirty-seven people are blown to bits by two separate al-Qaeda car bombings on a UN building and a courthouse.
8704,11/12/2007,Afghanistan,Panjwayi,2,0,2,A child is among two people murdered by a Fedayeen suicide bomber.
8705,11/12/2007,Afghanistan,Kandahar,5,0,5,Five Afghan guards are killed when their convoy is ambushed by religious extremists.
8706,11/12/2007,Thailand,Yala,1,0,1,Muslim radicals shoot a teacher to death in his own home.
8707,11/12/2007,Somalia,Hodan,1,0,1,A local soldier is murdered by Islamic gunmen.
8708,11/12/2007,Iraq,Baghdad,7,13,20,The head of a hospital is among seven people murdered by Islamic terrorists in separate attacks.
8709,12/12/2007,Thailand,Narathiwat,1,0,1,A man is gunned down in a drive-by shooting by Islamic radicals.
8710,12/12/2007,Iraq,Saidiya,2,0,2,Sectarian Jihadis enter a school and shoot two teachers to death.
8711,12/12/2007,Iraq,Baghdad,5,13,18,Five people are killed when Islamic terrorists booby-trap a car with a bomb.
8712,12/12/2007,Iraq,Amarah,28,135,163,Twenty-eight people are blown to bits by three coordinated Jihad car bombs.
8713,12/12/2007,Lebanon,Baabda,2,10,12,Muslims militants assassinate a military general with a bomb blast in a Christian neighborhood.
8714,12/12/2007,Pakistan,North Waziristan,6,20,26,"Religious extremists attack a local military convoy, killing six Pakistanis."
8715,12/12/2007,Iraq,Khanaquin,4,10,14,"Jihadis bomb a gas station, killing four civilians."
8716,13/12/2007,Iraq,Mosul,1,0,1,Fundamentalists kill a female hairdresser in her home.
8717,13/12/2007,Iraq,Hit,2,14,16,A Fedayeen suicide car bomber takes out two Iraqis.
8718,13/12/2007,Iraq,Tikrit,2,0,2,A father and son are shot to death by Islamic militants.
8719,13/12/2007,Iraq,Muqdadiyah,16,0,16,Sixteen beheaded victims of Sunni terrorists are found in a mass grave.
8720,13/12/2007,Afghanistan,Uruzgan,2,0,2,A 60-year-old woman is beheaded by the Taliban along with her grandson.
8721,13/12/2007,Pakistan,Quetta,8,18,26,At least eight people are killed by suicide bombers in two attacks.
8722,13/12/2007,Afghanistan,Tirin Kot,6,6,12,Religious extremists plant a landmine in the road that kills six civilians.
8723,13/12/2007,Somalia,Mogadishu,11,40,51,"Islamic militias send mortar rounds into a marketplace, killing nearly a dozen civilians."
8724,14/12/2007,Afghanistan,Balkh,3,0,3,Three local soldiers are pulled from their vehicle and machine-gunned to death by Taliban militants.
8725,14/12/2007,Pal. Auth.,Gaza,3,30,33,"A suspected Hamas operative tosses a grenade into a funeral, killing three mourners."
8726,14/12/2007,Algeria,Oum El Drou,5,0,5,Five civil servants are killed by a bomb planted by Islamic fundamentalists.
8727,15/12/2007,Iraq,Baghdad,6,23,29,"Two bombings and a shooting, at least one by al-Qaeda, leave six Iraqis dead."
8728,15/12/2007,Somalia,Mogadishu,2,12,14,"Two civilians are killed by Islamic militias, one in a gun battle and the other execution-style."
8729,15/12/2007,Pakistan,Naushehra,5,11,16,Three civilians are among five murdered by a Fedayeen suicide bomber on a bicycle.
8730,15/12/2007,Afghanistan,Kabul,5,2,7,Five civilians are killed by a Taliban car bombing along a city street.
8731,16/12/2007,Turkey,Barakli,0,1,1,"A 65-year-old priest is stabbed during mass by a young Muslim angered over Christian ""proselytizing."""
8732,16/12/2007,Afghanistan,Khost,2,0,2,Two civilians are blasted to Allah by Muslim militants.
8733,16/12/2007,Pakistan,Khar,1,0,1,Religious extremists abduct and behead a local soldier.
8734,16/12/2007,Iraq,Mosul,4,0,4,A woman is among four people murdered by Islamic terrorists.
8735,16/12/2007,Thailand,Pattani,1,1,2,"Two teenage boys are shot off their motorcycle by Muslim gunmen, one dies."
8736,16/12/2007,Pakistan,Bajaur,1,3,4,A local soldier is shot to death by Muslim terrorists.
8737,17/12/2007,Iraq,Balad Ruz,7,24,31,Children are among seven killed by a suicide bicycle bomber at a marketplace.
8738,17/12/2007,Afghanistan,Uruzgan,5,0,5,"A bicycle bomber murders a family of five, including three children."
8739,17/12/2007,Somalia,Mogadishu,4,4,8,"Islamic militants are suspected of firing a mortar shell into a market, killing four civilians."
8740,17/12/2007,Pakistan,Kohat,12,5,17,A teenage suicide bomber kills twelve off-duty soldiers returning from a soccer game.
8741,17/12/2007,Afghanistan,Ghazni,2,0,2,Two local cops are gunned down by religious extremists.
8742,17/12/2007,Pakistan,Banda,2,6,8,Two children are killed during a rocket attack by Islamic militants.
8743,17/12/2007,Somalia,Mogadishu,12,24,36,Three children in their mother are among a dozen civilians killed when suspected Islamists shell a marketplace.
8744,17/12/2007,Thailand,Yala,1,0,1,A migrant worker is murdered by Islamic terrorists.
8745,18/12/2007,Philippines,Basilan,2,5,7,Abu Sayyaf gunmen kill two Filipino troops in an ambush.
8746,18/12/2007,Iraq,Abbara,16,28,44,Sixteen people sitting in a cafe are blown to bits by a Fedayeen suicide bomber.
8747,18/12/2007,Iraq,Mosul,10,2,12,"Yazidi tribesman are the target of radical Sunnis, who manage to kill ten."
8748,18/12/2007,Iraq,Baquba,2,15,17,Children are among the casualties as a suicide bomber detonates along a city street.
8749,18/12/2007,Iraq,Baghdad,7,12,19,"Jihadis take out seven Iraqis in multiple attacks, including a university professor."
8750,18/12/2007,Thailand,Yala,4,0,4,"Four local guards are shot to death by Muslim radicals, who then behead one of the bodies."
8751,18/12/2007,Afghanistan,Farah,15,9,24,Fifteen Afghans guarding a fuel tanker are murdered in cold blood by a Taliban ambush.
8752,18/12/2007,Iraq,Muqdadiyah,26,0,26,"A Sunni 'torture house' is discovered, with 26 bodies buried in a mass grave."
8753,19/12/2007,Thailand,Narathiwat,3,1,4,"Islamic gunmen on motorcycles brutally assault a car carrying bank employees, killing three."
8754,19/12/2007,Thailand,Pattani,1,0,1,A 42-year-old man is shot to death by militant Muslims.
8755,20/12/2007,Iraq,Baghdad,3,27,30,"Fundamentalists bomb a liquor store, killing three passersby."
8756,20/12/2007,Iraq,Kanaan,12,28,40,A Fedayeen suicide bomber kills a dozen people at a Sunni council meeting.
8757,21/12/2007,Afghanistan,Kandahar,3,2,5,"Religious extremists decapitate an Afghan, then plant a bomb on the body, killing two others."
8758,21/12/2007,Iraq,al-Salam,1,2,3,Jihadis manage to kill one child with a mortar attack on a residential neighborhood.
8759,21/12/2007,Iraq,Yusufiya,5,8,13,A suicidal Sunni takes out five Iraqis in a bombing.
8760,21/12/2007,Pakistan,Kanaan,56,100,156,"A Fedayeen, carrying a bomb packed with nails and bomb bearings, detonates in a mosque, killing at least fifty."
8761,21/12/2007,Thailand,Yala,1,0,1,A 47-year-old man is shot dead outside a mosque by Muslim radicals.
8762,22/12/2007,Iraq,Baghdad,4,6,10,A Fedayeen suicide bomber ends the lives of four Iraqis.
8763,22/12/2007,Somalia,Baidoa,1,0,1,Two members of an Islamic militia assassinate a local judge.
8764,22/12/2007,Somalia,Mogadishu,5,8,13,Islamic militias kill five Somalis with a rocket and small-arms fire attack.
8765,23/12/2007,India,Kayamkulam,1,0,1,A Hindu activist is hacked to death by a gang of radical Muslims.
8766,23/12/2007,Chechnya,Grozny,1,4,5,Mujahideen gunmen kill a police officer.
8767,23/12/2007,Iraq,Mahmudiya,6,0,6,An al-Qaeda car bomb kills six Sunnis.
8768,23/12/2007,Pakistan,Kurrum,3,0,3,Sunni-Shia sectarian violence leaves three dead.
8769,23/12/2007,Pakistan,Mingora,14,30,44,Fourteen people are murdered by a suicide car bomber.
8770,24/12/2007,Mauritania,Nouakchott,4,1,5,Four French tourists (family members) are shot in cold blood by three members of a regional al-Qaeda network.
8771,24/12/2007,Somalia,Baidoa,3,7,10,Two children are among three killed in an Islamist grenade attack on a family vehicle.
8772,24/12/2007,Pakistan,Parachinar,3,24,27,Three people are killed in a second day of sectarian violence.
8773,24/12/2007,Iraq,Samarra,2,4,6,Two civilians are killed in a roadside Jihad bombing.
8774,24/12/2007,Thailand,Yala,2,0,2,Two Buddhists are murdered in a drive-by attack by Islamic radicals.
8775,24/12/2007,Thailand,Yala,1,0,1,A 58-year-old villager is shot to death by militant Muslims.
8776,25/12/2007,Afghanistan,Kandahar,1,4,5,"Taliban extremists detonate explosives, killing one civilian."
8777,25/12/2007,Iraq,Baiji,29,80,109,Nearly thirty Iraqis are blown apart by a suicidal Sunni along a city street.
8778,25/12/2007,Iraq,Baqubah,10,21,31,"A suspected al-Qaeda suicide bomber attacks a funeral, killing ten mourners."
8779,26/12/2007,Pakistan,Kurrum,32,40,72,Thirty-two people are killed in clashes between Sunni and Shia rivals.
8780,26/12/2007,Iraq,Mosul,3,2,5,"Jihadis plant a bomb in a garbage pile, killing three children."
8781,26/12/2007,Iraq,Diyala,17,0,17,Seventeen al-Qaeda victims are found shot in the back of the head.
8782,26/12/2007,Pakistan,Sadda,25,26,51,"Another two dozen people are killed, as the Taliban sets fire to villagers in a sectarian dispute."
8783,26/12/2007,Thailand,Narathiwat,1,0,1,A 49-year-old man is shot to death in a drive-by shooting by Muslim militants.
8784,26/12/2007,Thailand,Pattani,3,0,3,"Islamic terrorists use children in a school as human shields to ambush a group of local soldiers, killing three."
8785,27/12/2007,Iraq,Baghdad,2,12,14,"Jihadis blast a minibus with a roadside bomb, killing two civilians."
8786,27/12/2007,Pakistan,Rawalpindi,23,50,73,A suicide attack kills former prime minister Benazir Bhutto and at least twenty supporters along a city street.
8787,27/12/2007,Somalia,Bakara,1,4,5,Islamic militias kill one civilian in a grenade attack.
8788,27/12/2007,Mauritania,El Ghallawiya,3,0,3,Three local soldiers are killed by suspected Islamic militants in an ambush.
8789,27/12/2007,Pakistan,Kurram,27,42,69,Sectarian violence between Sunni and Shia leaves another two dozen dead.
8790,28/12/2007,Israel,Hebron,2,1,3,Two young Israeli hikers are gunned down by Palestinian terrorists.
8791,28/12/2007,Somalia,Siinka Dheer,2,0,2,Two local soldiers are shot to death by Islamic gunmen.
8792,28/12/2007,Pakistan,Manglore,4,4,8,Four people are blown to bits by an Islamist bombing.
8793,28/12/2007,Thailand,Narathiwat,1,0,1,A local cop is gunned down by religious extremists.
8794,28/12/2007,India,Poonch,1,0,1,A civilian is abducted from his home and murdered by the Mujahideen.
8795,28/12/2007,Iraq,Baghdad,14,64,78,Jihadis murder fourteen Iraqis with a car bomb.
8796,29/12/2007,Afghanistan,Kandahar,16,0,16,Sixteen Afghan police are murdered in an attack by religious extremists.
8797,29/12/2007,Pakistan,Parachinar,13,9,22,Thirteen people are killed in fighting between Sunni and Shia.
8798,29/12/2007,Afghanistan,Helmand,2,0,2,Religious extremists kill two civilians in a roadside blast.
8799,29/12/2007,Afghanistan,Wardak,8,0,8,Eight Afghans are murdered in a Taliban ambush.
8800,29/12/2007,Iraq,Mosul,4,11,15,Freedom fighters kill four Iraqi policemen.
8801,29/12/2007,Iraq,Baghdad,1,0,1,Sectarian fundamentalists gun down a teacher.
8802,29/12/2007,Somalia,Mogadishu,1,0,1,A 17-year-old Islamic militant plants a bomb that kills a former mayor's deputy.
8803,30/12/2007,Somalia,Mogadishu,10,9,19,"Islamic extremists attack a group of local soldiers, killing ten."
8804,30/12/2007,Somalia,Mogadishu,6,1,7,A pregnant mother and her five young children are killed by a mortar round during an attack on Ethiopians by Islamic militias.
8805,30/12/2007,Afghanistan,Uruzgan,4,0,4,Four local soldiers are murdered by a Taliban bombing.
8806,30/12/2007,Iraq,Baquba,3,0,3,The bodies of three people are found near an al-Qaeda torture chamber.
8807,30/12/2007,Thailand,Yala,1,0,1,A 26-year-old man is shot to death by militant Muslims.
8808,31/12/2007,Pakistan,Kurram,11,15,26,Eleven more people are killed in clashes between Sunni and Shia.
8809,31/12/2007,Dagestan,Derbent,1,0,1,A man is killed in a car bombing planted by suspected Islamists.
8810,31/12/2007,Chechnya,Grozny,2,0,2,Two police officers are killed in separate Mujahideen attacks.
8811,31/12/2007,Iraq,Tarmiya,12,7,19,Five schoolchildren are among a dozen Iraqis blown apart by a suicide bomber.
8812,31/12/2007,Iraq,Maysan,3,0,3,Three teachers are gunned down by sectarian fundamentalists.
8813,31/12/2007,Thailand,Yala,1,27,28,Islamists kill one person in a series of bomb attacks on restaurants and entertainment venues.
8814,1/1/2008,USA,"Irving, TX",2,0,2,A Muslim immigrant shoots his two daughters to death on concerns about their 'Western' lifestyle.
8815,1/1/2008,Pakistan,Kahna,2,0,2,A young couple in their 20's is gunned down by family members for having sex.
8816,1/1/2008,Pakistan,Kurram,2,5,7,Two people are killed in fighting between rival Muslim groups.
8817,1/1/2008,India,Rampur,7,3,10,"Lashkar-e-Toiba terrorists carry out an attack on a security base, killing at least seven people."
8818,1/1/2008,Iraq,Baghdad,36,38,74,"A Fedayeen suicide bomber wades into a funeral and detonates, killing thirty-six people."
8819,1/1/2008,Iraq,Jalawla,5,0,5,Freedom Fighters abduct and murder an Iraqi policeman and four members of his family.
8820,1/1/2008,Iraq,Tahwelah,2,0,2,Radical Sunnis gun down a Shia man and his 16-year-old son.
8821,1/1/2008,Sudan,Khartoum,2,0,2,A US diplomat and his driver are killed in a shooting claimed by Islamic militants.
8822,2/1/2008,Iraq,Baghdad,6,0,6,Freedom Fighters shoot five children and their father to death in a minivan at point-blank range.
8823,2/1/2008,Somalia,Afgoye,3,24,27,"Islamists bomb a local market, killing three civilians."
8824,2/1/2008,Somalia,Mogadishu,1,0,1,"Suspected Islamists storm an aid office, killing a local guard."
8825,2/1/2008,Pakistan,Kurram,11,13,24,Eleven people are killed in a sectarian clash between Sunni and Shia.
8826,2/1/2008,Iraq,Baqubah,10,28,38,A female suicide bomber sends ten Iraqis to Allah.
8827,2/1/2008,Afghanistan,Helmand,1,1,2,Taliban militants shoot a local soldier to death.
8828,2/1/2008,Afghanistan,Kandahar,2,0,2,Two border guards are murdered by Islamic extremists.
8829,2/1/2008,Iraq,Muqdadiyah,6,3,9,Sunni radicals gun down six civilians in a drive-by attack.
8830,2/1/2008,Algeria,Naciria,5,20,25,"Islamic fundamentalists bomb a police station, killing at least five people, including a 10-year-old girl."
8831,3/1/2008,India,Shopian,1,0,1,The Mujahideen abduct and execute a civilian.
8832,3/1/2008,Pakistan,Kurram,6,11,17,Six people are killed in violence between Sunni and Shia.
8833,3/1/2008,Thailand,Yala,1,0,1,A 44-year-old Buddhist rubber tapper is murdered by Muslim extremists.
8834,3/1/2008,Thailand,Pattani,1,3,4,A local soldier dies from injuries suffered in a roadside bombing by militant Muslims.
8835,3/1/2008,Thailand,Yala,1,0,1,Islamists gun down a 57-year-old civilian in the street.
8836,3/1/2008,Iraq,Basra,1,0,1,A woman is shot to death by fundamentalists for unIslamic activities.
8837,3/1/2008,Iraq,Khalis,6,3,9,Six Iraqi soldiers are killed inside a home by a bomb set by radical Sunnis.
8838,3/1/2008,Iraq,Baghdad,6,11,17,Six civilians are killed in two separate Jihad attacks.
8839,3/1/2008,Afghanistan,Nimroz,7,12,19,"A Fedayeen suicide bomber detonates in the middle of road construction crew, killing seven workers and their guards."
8840,4/1/2008,Pakistan,Kurram,3,0,3,Fighting between Sunni and Shia leaves three people dead.
8841,4/1/2008,Thailand,Yala,1,2,3,A 43-year-old villager is shot to death by Muslim militants.
8842,5/1/2008,Iraq,Muqdadiyah,6,3,9,"Jihadis bomb a minibus, killing six civilians including women and children."
8843,6/1/2008,Iraq,Baghdad,11,17,28,"A Fedayeen suicide bomber attacks an Iraqi celebration of national unity, killing eleven innocent people."
8844,6/1/2008,Iraq,Muqdadiya,4,0,4,"Islamic radicals kidnap and behead four people, tossing their heads out on a highway."
8845,6/1/2008,Iraq,Baghdad,3,16,19,A Jihad car bombing kills three people and injures sixteen others.
8846,6/1/2008,Pakistan,Peshawar,1,0,1,"Fundamentalists bomb a video shop, killing a security guard."
8847,6/1/2008,Pakistan,Wana,9,8,17,Nine tribal leaders are killed in two separate shooting attacks by Uzbeki Islamic extremists.
8848,7/1/2008,Afghanistan,Spin Boldak,1,4,5,A suicide bomber on a motorcycle kills a local border guard.
8849,7/1/2008,Afghanistan,Helmand,4,4,8,Taliban militants kill four Afghans with a roadside bombing.
8850,7/1/2008,Pakistan,Chugmalai,1,3,4,"Islamic militants attack a security post, killing a local soldier."
8851,7/1/2008,Iraq,Hawija,3,0,3,A married couple and their young son are shot to death by Islamic terrorists.
8852,7/1/2008,Iraq,Baghdad,18,63,81,"Eighteen innocents are killed in two separate bombings, one a Fedayeen attack"
8853,7/1/2008,Iraq,Khanaqeen,6,0,6,"Radical Sunnis abduct, bind and then murder five men.  A carpenter is gunned down in a separate attack."
8854,8/1/2008,Iraq,Madaen,2,5,7,A Fedayeen suicide bomber takes out two Iraqi policemen.
8855,8/1/2008,Somalia,Dibiyada,4,7,11,Four civilians are killed during an ambush by Islamic militants.
8856,9/1/2008,Yemen,Haidan,1,0,1,Shiite militants kill a tribal elder.
8857,9/1/2008,Algeria,Ait Yahia,4,2,6,Islamic fundamentalists kill four local soldiers in a landmine attack.
8858,9/1/2008,Philippines,Jolo,2,0,2,"Two off-duty cops are shot to death by suspected Islamic extremists, while jogging along a road."
8859,9/1/2008,Thailand,Yala,1,0,1,A 34-year-old man riding his motorcycle is murdered by Islamist gunmen.
8860,10/1/2008,Iraq,Baghdad,5,13,18,A pair of Jihad bombings leave five Iraqis dead.
8861,10/1/2008,Pakistan,Lahore,24,80,104,"A suicide bomber attacks a police post, killing two dozen police and civilians alike."
8862,10/1/2008,Thailand,Narathiwat,1,0,1,A Buddhist villager is murdered by Muslim gunmen in an unprovoked attack.
8863,10/1/2008,Thailand,Yala,3,7,10,Three men are shot to death by Muslim terrorists in three separate attacks.
8864,10/1/2008,Yemen,Sa'ada,6,6,12,Six local soldiers are killed in an ambush by Shiite radicals.
8865,11/1/2008,Pakistan,Sheikhupura,1,0,1,A 13-year-old Christian boy is targeted and killed by Muslim gunmen.
8866,11/1/2008,Somalia,Baidoa,1,0,1,Islamic militants shoot an off-duty soldier to death in a marketplace.
8867,11/1/2008,Iraq,Baghdad,4,8,12,"Jihadis bomb a bakery, killing four people."
8868,12/1/2008,Afghanistan,Helmand,1,8,9,"A suicide bomber tries to enter a house, but is stopped short.  He still manages to kill one adult and injure two children."
8869,12/1/2008,Afghanistan,Kandahar,8,0,8,Taliban militants gun down eight Afghan police officers.
8870,12/1/2008,Iraq,Sulaimaniyah,1,0,1,Shia fundamentalists gun down a liquor store owner.
8871,12/1/2008,Iraq,Dhuluiya,6,0,6,Three children are among six killed when al-Qaeda gunmen invade two homes.
8872,12/1/2008,Thailand,Narathiwat,1,0,1,A father is murdered by Muslim gunmen after dropping his daughter off at school.
8873,12/1/2008,Somalia,Baidoa,2,0,2,Two Red Crescent workers are killed by suspected members of an Islamic militia.
8874,13/1/2008,Thailand,Yala,1,0,1,Islamic gunmen shoot a man in the back of the head as he is watching television.
8875,13/1/2008,Algeria,Medea,3,0,3,Islamic fundamentalists machine-gun three kids to death as they are gathering chestnuts.
8876,13/1/2008,Pakistan,Mingora,1,0,1,A civilian who supports a peace initiative is kidnapped by Islamic radicals and murdered.
8877,14/1/2008,Iraq,Buhriz,7,3,10,"Sunni militants booby-trap a home, killing seven Iraqi police."
8878,14/1/2008,Pakistan,Mohmand,7,12,19,Seven local soldiers are killed when Taliban militants ambush a military convoy.
8879,14/1/2008,Pakistan,Karachi,11,52,63,Three children are among eleven killed in a bombing by Islamic militants outside a textile factory.
8880,14/1/2008,Thailand,Narathiwat,8,7,15,"Islamists ambush and kill eight local soldiers in a vicious attack that leaves them beheaded, shot or blasted to death."
8881,14/1/2008,Afghanistan,Kabul,8,6,14,"Religious extremists attack a hotel with suicide vests and machine-guns, managing to kill eight people in the lobby."
8882,15/1/2008,Pakistan,Sararogha,22,0,22,Two dozen local soldiers are killed when religious militants overrun and capture a fort.  Seven are beheaded.
8883,15/1/2008,Thailand,Yala,0,44,44,Islamic bombers injure forty-four people in an attack on market stalls.
8884,15/1/2008,Somalia,Afar-Darjin,2,4,6,"Jihadis kill two civilians with a roadside bomb, four others are injured, including a pregnant woman who loses a leg."
8885,15/1/2008,Somalia,Aymiska,2,0,2,Islamic gunmen shoot two civilians in the head.
8886,15/1/2008,Philippines,Mindanao,1,0,1,A priest resists a kidnapping attempt by Abu Sayyaf terrorists and is shot to death in his chapel.
8887,15/1/2008,Lebanon,Beirut,3,21,24,A car bomb targeting the US embassy kills three passing civilians.
8888,15/1/2008,Israel,Ein Hashlosha,1,0,1,Hamas snipers kill a farm laborer working in a field.
8889,16/1/2008,Iraq,Baquba,8,7,15,A female suicide bomber sends eight Shia souls to Allah.
8890,16/1/2008,Iraq,Tuz Khurmato,2,0,2,A university student is among two people killed by Islamic terrorists.
8891,16/1/2008,Iraq,Baghdad,4,15,19,Two roadside bomb attacks kill four civilians and injure fifteen.
8892,16/1/2008,Somalia,Mogadishu,7,7,14,Jihadis kill seven Ethiopians in a bomb attack that leaves several others 'on the ground screaming in pain.'
8893,16/1/2008,Chechnya,Chechnya,1,6,7,Mujahideen kill a Russian and injure six more in an attack.
8894,17/1/2008,Iraq,Baquba,11,15,26,"A suicidal Sunni bomber detonates inside a Shia mosque, killing eleven worshippers."
8895,17/1/2008,Iraq,Mosul,2,0,2,A human rights activist is among two people shot to death by Freedom Fighters.
8896,17/1/2008,Pakistan,Peshawar,1,0,1,A Christian man (and father of an infant daughter) is brutally gunned down by masked men.
8897,17/1/2008,Pakistan,Peshawar,10,25,35,A young Sunni suicide bomber rushes into a Shia mosque and slaughters ten people.
8898,18/1/2008,Afghanistan,Musa Qala,1,0,1,The Taliban hang an innocent civilian from an electricity pole.
8899,18/1/2008,Iraq,Baghdad,3,2,5,A woman and her two children are murdered by Freedom Fighters in a roadside attack.
8900,18/1/2008,Iraq,Nassiriya,80,120,200,Clashes in two cities between mainstream Shias and the Soldiers of Heaven leave at least eighty dead.
8901,18/1/2008,Iraq,Mo'alimeen,2,4,6,Two children are killed when Jihadis attack their home with an IED.
8902,18/1/2008,Thailand,Pattani,1,2,3,Muslim radicals kill a local soldier outside a mosque.
8903,18/1/2008,Yemen,Hadramout,4,2,6,Two Belgian tourists and two locals are murdered by suspected al-Qaeda.
8904,19/1/2008,India,Budgam,1,20,21,One person is killed in a sectarian clash between Shia groups.
8905,19/1/2008,Thailand,Yala,1,0,1,A 44-year-old butcher is shot to death by Muslim terrorists while riding home.
8906,19/1/2008,Thailand,Pattani,1,0,1,A 20-year-old woman is murdered in a vicious ambush by Islamic extremists.
8907,19/1/2008,Thailand,Yala,1,0,1,Muslim radicals shoot the head of a local health clinic in the back of the head while he is on a lunch break.
8908,19/1/2008,Iraq,Tal Afar,7,20,27,"Sunni radicals send Katyusha rockets into a group of Shia pilgrims, killing at least seven."
8909,19/1/2008,Iraq,Ramadi,7,14,21,Three Fedayeen suicide bombers kill seven Iraqis.
8910,19/1/2008,Afghanistan,Kandahar,5,0,5,A child is among five civilians blown apart by a Taliban roadside bomb.
8911,20/1/2008,Chechnya,Niki-Khita,2,0,2,"Mujahideen gunmen ambush a group of Russians, killing two."
8912,20/1/2008,Afghanistan,Helmand,6,3,9,Religious extremists murder six Afghans transporting construction materials.
8913,20/1/2008,Afghanistan,Zabul,3,0,3,The Taliban kidnap the head of a reconciliation mission and his two drivers. They then execute them in captivity.
8914,20/1/2008,Iraq,Fallujah,6,10,16,A teenage suicide bomber murders at least six other innocents at a celebration.
8915,20/1/2008,Iraq,Balad,5,20,25,"Sunnis rain down mortars on a Shia festival, killing at least five."
8916,20/1/2008,Thailand,Narathiwat,1,0,1,Islamic radicals gun down a 23-year-old villager.
8917,21/1/2008,Iraq,Tikrit,18,22,40,"A suicide bomber attacks a funeral, killing eighteen mourners."
8918,21/1/2008,Iraq,Kalar,2,0,2,A woman and her daughter are shot to death by Muslim radicals.
8919,21/1/2008,Iraq,Qahira,2,9,11,"Jihadis set off a car bomb along a city street, killing two civilians."
8920,21/1/2008,Thailand,Narathiwat,1,0,1,A 53-year-old janitor is shot to death in front of a coffee shop.
8921,21/1/2008,Thailand,Pattani,2,0,2,Two laborers are murdered in a drive-by attack by Muslim extremists.
8922,21/1/2008,Pakistan,Seerikh,1,0,1,A government official is assassinated by suspected al-Qaeda militants.
8923,22/1/2008,Sudan,Sureif Judad,21,0,21,The young and the old are among twenty-one civilians massacred by government-backed militias in an attack on their village.
8924,22/1/2008,Pakistan,Nawaz Kot,1,2,3,"Islamic militants attack a group of local soldiers, killing one."
8925,22/1/2008,Somalia,Mogadishu,2,1,3,A civilian is among two people killed in an ambush by Islamic militia.
8926,22/1/2008,Ingushetia,Nazran,2,3,5,Suspected Mujahideen kill two in a car bomb blast.
8927,22/1/2008,Thailand,Pattani,1,0,1,A 37-year-old villager is pumped full of holes by Muslim gunmen.
8928,22/1/2008,Pakistan,Ladha,5,7,12,"Fedayeen militants attack a military post, killing five local soldiers."
8929,22/1/2008,Philippines,Tawi-Tawi,1,0,1,An innocent vendor is executed after being kidnapped by Abu Sayyaf terrorists for use as a human shield.
8930,22/1/2008,Pakistan,Razmak,2,10,12,"Islamic militants lob rockets into a military compound, killing two local soldiers."
8931,23/1/2008,Pakistan,Karkhano,1,1,2,A suicide bomber manages to kill a civilian.
8932,23/1/2008,Somalia,Mogadishu,1,2,3,A child is killed when Islamic militias mortar an airport.
8933,23/1/2008,Iraq,Baquba,1,21,22,Students and teachers are among the casualties when Jihadis bomb a prep school.
8934,23/1/2008,Iraq,Buhriz,7,0,7,Seven members of the same family are slaughtered by Sunni radicals.
8935,23/1/2008,Iraq,Mosul,60,224,284,"Freedom fighters bomb an apartment building, killing 60 residents and bystanders."
8936,23/1/2008,Iraq,Kirkuk,7,16,23,A Fedayeen suicide bomber kills six Iraqi civilians.
8937,23/1/2008,Thailand,Yala,3,0,3,A Buddhist is among three people murdered by Islamic radicals in separate shooting attacks.
8938,23/1/2008,Chechnya,Grozny,1,1,2,A police officer is gunned down by the Mujahideen.
8939,23/1/2008,India,Doda,1,0,1,"Lashkar-e-Toiba terrorists abduct, torture and murder a civilian."
8940,24/1/2008,Thailand,Pattani,1,0,1,A Buddhist teacher is shot to death by Muslim militants while riding to school.
8941,24/1/2008,Pakistan,Swat,3,2,5,Islamic hardliners murder two brothers and one other man.
8942,24/1/2008,Iraq,Mosul,3,10,13,"A suicide bomber targets police investigating a prior bombing, killing at least three people."
8943,24/1/2008,Somalia,Baidoa,2,1,3,"Two Somalis, including a cafe owner are killed in an ambush by Islamic militia members."
8944,24/1/2008,Turkey,Gaziantep,1,0,1,"al-Qaeda militants open fire on a group of police officers, killing one."
8945,25/1/2008,Thailand,Pattani,1,0,1,A 36-year-old man is murdered by Islamic extremists.
8946,25/1/2008,Lebanon,Beirut,4,38,42,"Islamic terrorists bomb a vehicle, killing a two officials and two civilian bystanders."
8947,25/1/2008,Somalia,Mogadishu,3,9,12,Three Ethiopians are killed when Islamists fire rockets into a group of soldiers at point-blank range.
8948,25/1/2008,Israel,Jerusalem,1,6,7,"Palestinian gunmen fire into an Israeli checkpoint, killing one policeman and wounding six civilians."
8949,25/1/2008,Thailand,Pattani,3,0,3,Three men in their 50's are murdered by Islamic gunmen in separate attacks.
8950,25/1/2008,Pakistan,South Waziristan,2,7,9,"al-Qaeda militants attack a group of local soldiers, killing two."
8951,26/1/2008,Jordan,Jerash,1,0,1,A 17-year-old girl is strangled by her brother for shaming her family.
8952,26/1/2008,Somalia,Mogadishu,3,0,3,Jihadis kill three Somalis with a fragment bomb.
8953,26/1/2008,Pakistan,Khwezai,1,0,1,An Afghan refugee is murdered by the Taliban.
8954,26/1/2008,Thailand,Narathiwat,1,1,2,"Islamic militants open fire on two teenage boys, killing one, whom they then mutilate."
8955,26/1/2008,Thailand,Yala,1,0,1,A 34-year-old man is shot to death by Muslim terrorists while sitting in his car.
8956,27/1/2008,Somalia,Mogadishu,2,2,4,Two civilians are killed when Islamic militias fire rockets into the main airport.
8957,27/1/2008,Iraq,Talibiya,4,0,4,Freedom fighters invade a home and stab a family of four to death.
8958,27/1/2008,Afghanistan,Helmand,2,3,5,"Religious extremists ambush a police vehicle, killing two local cops."
8959,27/1/2008,Thailand,Pattani,1,1,2,A woman is shot to death by Muslim terrorists while a motorcycle.
8960,27/1/2008,Thailand,Pattani,1,0,1,Islamists gun down a trained monkey vendor.
8961,27/1/2008,Somalia,Mogadishu,2,3,5,A man and woman are killed by Islamic militia bombers.
8962,27/1/2008,Pakistan,Makin,3,0,3,The bodies of three soldiers taken hostage by the Taliban are found.
8963,27/1/2008,Pakistan,Orakzai,3,2,5,"Islamic militants attack a check post, killing three local soldiers."
8964,28/1/2008,Iraq,Baghdad,3,10,13,"Jihadis bomb a funeral procession, killing three civilians."
8965,28/1/2008,India,Tenkasi,1,0,1,A gang of Muslims hacks a Hindu man to death.
8966,28/1/2008,Pakistan,Swat,1,0,1,Islamic militants drag a policeman from his house and behead him.
8967,28/1/2008,Somalia,Kismayu,4,0,4,Two humanitarian doctors and a journalist are among four killed in a remote-controlled bomb attack.
8968,28/1/2008,India,Handwara,1,0,1,A 34-year-old man is abducted from his village and murdered by the Mujahideen.
8969,28/1/2008,Somalia,Mogadishu,2,9,11,Two Ethiopian guards at a market are murdered in an ambush by Islamic militias.
8970,29/1/2008,Algeria,Thenia,4,20,24,At least four people are killed in a suicide attack by Islamic radicals.
8971,29/1/2008,Pakistan,FATA,1,0,1,A village elder is abducted and murdered by al-Qaeda terrorists.
8972,29/1/2008,Iraq,Saidiyah,5,2,7,Five Iraqis are killed by a bomb planted by Sunni radicals.
8973,29/1/2008,Afghanistan,Kandahar,3,5,8,Taliban militants kill three civilians in two separate landmine attacks.
8974,29/1/2008,Iraq,Duluiya,3,2,5,Three schoolgirls are killed in a Jihad bombing as they are walking to school.
8975,29/1/2008,Iraq,Muqdadiyah,19,0,19,Nine complete bodies and ten severed heads are discovered - suspected to be al-Qaeda victims.
8976,29/1/2008,Pakistan,Razmak,3,4,7,Three local soldiers are killed in an ambush by Islamic militants.
8977,29/1/2008,Iraq,Baghdad,2,5,7,Two women are killed at a checkpoint by a female suicide bomber.
8978,29/1/2008,Pakistan,Punjab,1,0,1,A 16-year-old Christian is kidnapped and sold for organ harvesting.
8979,30/1/2008,Iraq,Tuz Khormatu,2,0,2,Islamists kidnap and behead two brothers.
8980,30/1/2008,Philippines,Zamboanga,1,1,2,"A woman is killed, and another injured, following an ambush by Moro Islamic terrorists."
8981,30/1/2008,Thailand,Yala,2,0,2,"Two men, ages 32 and 52, are shot to death by Muslim militants in separate attacks."
8982,30/1/2008,Pakistan,NWFP,13,0,13,The bodies of thirteen soldiers taken hostage several days earlier by religious extremists are discovered.
8983,30/1/2008,Iraq,Baghdad,1,3,4,Jihadis manage to kill a young boy with a mortar attack on a neighborhood.
8984,30/1/2008,Thailand,Pattani,1,0,1,A security guard at a car showroom is shot to death by Muslim militants.
8985,31/1/2008,Somalia,Mogadishu,1,0,1,Islamic militias assassinate a government spokesperson.
8986,31/1/2008,Afghanistan,Nuristan,4,0,4,Four construction workers are kidnapped and beheaded by Taliban extremists.
8987,31/1/2008,Afghanistan,Kabul,1,4,5,A suicide bomber kills a passing civilian.
8988,31/1/2008,Afghanistan,Lashkar Gah,5,18,23,Five people are blown to bits by a suicide bomber at a mosque.
8989,31/1/2008,Iraq,Baghdad,11,18,29,A pair of Jihad bombings leave eleven Iraqis dead.
8990,31/1/2008,Somalia,Mogadishu,3,1,4,"Islamic militia stage a drive-by attack on a house, killing three people inside."
8991,1/2/2008,Bangladesh,Cinatuly,1,0,1,An elderly Christian woman dies from burn suffered when a Muslim mob set fire to her home for converting her family members.
8992,1/2/2008,Mauritania,Nouakchott,0,3,3,"Bearded Jihadis shout 'Allah Akbar' and open up on the Israeli embassy with automatic weapons, injuring three bystanders."
8993,1/2/2008,Pakistan,Mir Ali,5,8,13,"A suicidal Sunni rams a police vehicle with an explosives-laden vehicle, killing at least five people."
8994,1/2/2008,Iraq,Mosul,1,0,1,A 12-year-old boy is taken out by Sunni radicals.
8995,1/2/2008,Iraq,Kut,2,4,6,"The Mujahideen fire into a bus terminal, killing two Iraqis."
8996,1/2/2008,Thailand,Narathiwat,2,0,2,Two elderly men are murdered by Islamic gunmen in separate attacks.
8997,1/2/2008,Iraq,Baghdad,99,196,295,"al-Qaeda sends two women with Down's Syndrome into two pet markets, then detonates each remotely, slaughtering about one hundred other innocents."
8998,2/2/2008,Thailand,Yala,1,0,1,A rubber tapper is shot to death by Muslim militants on his way to work.
8999,2/2/2008,Iraq,Mosul,4,9,13,al-Qaeda bombers take out four Sunnis.
9000,2/2/2008,India,Poonch,2,1,3,Two police officers are killed by Lashkar-e-Toiba gunmen.
9001,3/2/2008,Sweden,Malmo,1,0,1,A 16-year-old girl dies after being pushed from the balcony in a suspected honor killing by her brother.
9002,3/2/2008,Iraq,Baquba,4,0,4,"Suspected al-Qaeda gunmen attack a home, killing four young Sunnis."
9003,3/2/2008,Somalia,Mogadishu,8,9,17,"Islamic militia blow up a minibus, killing eight civilians and maiming nine more."
9004,4/2/2008,Thailand,Pattani,1,12,13,"Islamists detonate a bomb outside a boarding school, killing one person."
9005,4/2/2008,Israel,Dimona,1,11,12,A Palestinian suicide bomber murders an Israeli woman at a shopping mall.
9006,4/2/2008,Pakistan,Rawalpindi,8,25,33,"A suicide bomber rams his car into a minibus carrying medical personnel, killing at least eight."
9007,4/2/2008,Pakistan,Sukkur,1,0,1,"A girl is chopped to pieces with an axe by her father, who was concerned about her 'character.'"
9008,4/2/2008,Thailand,Yala,1,0,1,A 30-year-old civilian is shot to death by Muslim militants.
9009,4/2/2008,Iraq,Abu Saida,2,1,3,Jihadis kill a 7-year-old boy and one other civilian in an attack on a minibus.
9010,4/2/2008,Afghanistan,Helmand,5,1,6,Two children and two women are among five members of the same family killed in a roadside attack by religious extremists.
9011,5/2/2008,Iraq,Fallujah,5,4,9,A Fedayeen suicide bomber murder five Iraqis along a city street.
9012,5/2/2008,Iraq,Samarrah,1,0,1,A cleric speaks out against al-Qaeda and is quickly gunned down.
9013,5/2/2008,Iraq,Hillah,1,0,1,A woman is shot to death by Islamic radicals.
9014,5/2/2008,Iraq,Samarrah,55,0,55,"Fifty-five bodies, victims of the Islamic State of Iraq, are found in a mass grave.  Many had been tortured."
9015,5/2/2008,Bangladesh,Rangpur,1,0,1,A convert to Christianity dies from burns suffered when a Muslim mob set fire to her house four weeks earlier.
9016,5/2/2008,Afghanistan,Kandahar,2,0,2,Two Afghan police are killed in a Taliban bombing.
9017,5/2/2008,Somalia,Mogadishu,4,9,13,Two women are among four killed in a marketplace attack by Islamic militias.
9018,5/2/2008,Somalia,Bossaso,25,90,115,Islamic militias claim responsibility for two separate bombings in which 25 African laborers are killed.
9019,6/2/2008,Thailand,Yala,1,0,1,A 21-year-old man is shot to death by Muslim militants.
9020,6/2/2008,Iraq,Kirkuk,2,9,11,A 7-year-old girl and a woman are killed in separate Jihad bombings.
9021,6/2/2008,Iraq,Muqdadiyah,10,0,10,"Ten headless bodies are found, presumably kidnap victims decapitated by the Mujahideen."
9022,6/2/2008,Iraq,Diwaniya,4,9,13,Four people are killed when Jihadis bomb a minibus.
9023,6/2/2008,Pakistan,Khyber,1,2,3,A civilian is killed in a bomb blast.
9024,7/2/2008,Iraq,Muradiyah,4,9,13,A child is killed in a bombing.  Jihadis also invade a home and murder three brothers in a separate attack.
9025,7/2/2008,Iraq,Baghdad,11,18,29,Islamic gunmen shoot eleven people to death in various attacks.
9026,7/2/2008,Thailand,Narathiwat,1,0,1,"Islamic radicals kidnap a young man in his 20's, bind him, slash his throat and then shoot him in the head."
9027,8/2/2008,Algeria,Ain R'Ghiya,8,0,8,Eight security officers are massacred at point-blank range by Islamists with machine-guns.
9028,8/2/2008,Algeria,Boukalfa,1,1,2,Islamic gunmen murder a police officer.
9029,8/2/2008,Iraq,Baquba,13,0,13,Jihadis kill five people in a brutal home invasion as a mass grave is unearthed elsewhere with eight bodies.
9030,8/2/2008,Afghanistan,Ghazni,2,7,9,A child is among two Afghans murdered in a suicide attack by a Fedayeen bomber.
9031,8/2/2008,Sudan,Abu Surouj,200,0,200,The initial death toll from attacks on three villages by government troops and the Janjiweed is put at two-hundred civilians.  An elderly woman and a disabled girl are among several burnt alive.
9032,8/2/2008,India,Poonch,1,0,1,A civilian is shot to death by Muslim terrorists.
9033,9/2/2008,Somalia,Hiiraan,5,9,14,Suspected Islamic militia kill five local soldiers in a brutal ambush.
9034,9/2/2008,Iraq,Baghdad,26,0,26,More than twenty-five victims of sectarian violence are found in at least two locations.
9035,9/2/2008,Pakistan,Charsadda,27,50,77,A Fedayeen suicide bomber slaughters twenty-seven people attending a political rally.
9036,9/2/2008,Nigeria,Kano,3,20,23,"Muslims riot over a cartoon caricature of Muhammad, killing three people with machetes."
9037,9/2/2008,Thailand,Yala,1,0,1,A 29-year-old woman is murdered by Islamic gunmen while she is riding a motorcycle.
9038,9/2/2008,Thailand,Yala,2,0,2,Two middle-aged men are brutally ambushed and killed by Muslim extremists while sitting in a pickup truck.
9039,9/2/2008,Somalia,Mogadishu,2,0,2,Two men are shot to death by Muslim militants in separate terror attacks.
9040,9/2/2008,Afghanistan,Nawa,4,0,4,Three children and a woman are killed when a bomb being constructed by a religious cleric explodes prematurely.
9041,10/2/2008,Iraq,Yathrib,33,51,84,A Fedayeen suicide bomber at a marketplace blasts thirty-three Iraqi shoppers to Allah.
9042,10/2/2008,Iraq,Albo Efan,3,7,10,A suicide attack leaves three civilians dead.  A woman is shot to death elsewhere.
9043,10/2/2008,Iraq,Tal Abta,12,7,19,Two women and four children are among the dead when al-Qaeda gunmen attack a Sunni village.
9044,10/2/2008,Somalia,Baidoa,1,0,1,Islamic gunmen assassinate a government worker.
9045,10/2/2008,Afghanistan,Herat,1,2,3,"Religious extremists ambush a vehicle, killing a young man inside."
9046,10/2/2008,Thailand,Narathiwat,1,1,2,A 65-year-old man is shot to death by Muslim militants while sitting in a tea shop.
9047,11/2/2008,Pakistan,Mir Ali,10,13,23,"A suicide bomber detonates at a political rally, killing ten people."
9048,11/2/2008,Iraq,Baghdad,19,45,64,Nineteen Iraqis are blown to bits when Sunni bombers car bombers attack a petrol station.
9049,12/2/2008,Iraq,Baquba,4,3,7,Four children are killed by Islamic terrorists in two separate attacks - one a bombing and the other a shooting.
9050,12/2/2008,Iraq,Muqdadiyah,20,0,20,Twenty victims of suspected Sunni extremists are discovered in two locations.
9051,12/2/2008,Thailand,Narathiwat,2,0,2,A district chief and his teenage son are shot to death by militant Muslims.
9052,13/2/2008,Somalia,Hegan,1,0,1,Islamic militias assassinate a local official.
9053,13/2/2008,Iraq,Zafariyah,1,1,2,Holy warriors break into a school where they beat a woman and hang her 3-year-old son.
9054,13/2/2008,Iraq,Saadiya,5,2,7,Five construction workers are shot to death by Mujahid.
9055,13/2/2008,Pakistan,Swat,2,3,5,Two people are killed when Muslim militants bomb a civilian convoy.
9056,13/2/2008,Afghanistan,Khost,4,1,5,Four security guards are murdered by Islamic bombers.
9057,13/2/2008,Afghanistan,Helmand,3,4,7,Three local soldiers are killed in a Taliban roadside bombing.
9058,14/2/2008,Iraq,Baghdad,7,36,43,"Jihadis bomb a crowded marketplace, killing at least seven Iraqis."
9059,14/2/2008,Iraq,Awja,9,0,9,"Freedom Fighters shoot a family of nine to death in their home, including children."
9060,14/2/2008,Somalia,Mogadishu,1,4,5,"Islamic militants hurl a grenade into a crowd, killing a school headmaster."
9061,14/2/2008,Thailand,Yala,1,0,1,A laborer is shot to death in front of his wife by militant Muslims.
9062,14/2/2008,Thailand,Narathiwat,2,1,3,Two villagers are murdered by Islamic gunmen.
9063,14/2/2008,Pakistan,Bajaur,3,3,6,Three local soldiers are killed by a Taliban roadside blast as they return from guard duty.
9064,14/2/2008,Algeria,Boumerdes,1,0,1,Islamic terrorists assassinate a security guard.
9065,15/2/2008,Algeria,Bouyara,3,5,8,"Islamic terrorists detonate a bomb at a sports stadium, killing three people."
9066,15/2/2008,Iraq,Tal Afar,4,17,21,Two Fedayeen suicide bombers kill four Shia in an attack on their mosque.
9067,15/2/2008,Afghanistan,Nimroz,4,2,6,Religious extremists gun down four Afghan police officers.
9068,15/2/2008,Pakistan,Peshawar,1,1,2,"Mujahideen attack an army checkpoint with automatic weapons, killing a local soldier."
9069,16/2/2008,Pakistan,Parachinar,47,110,157,A suicide bomber sends at least forty-seven souls to Allah by plowing an explosives-laden car into a political office.
9070,16/2/2008,Thailand,Pattani,1,2,3,An Islamic radical strides into a mosque and blows away a local with a handgun.
9071,16/2/2008,Thailand,Pattani,1,0,1,A gardener is shot to death by Mujahid while sitting outside a teashop.
9072,16/2/2008,Thailand,Narathiwat,1,0,1,A local Buddhist is murdered by Muslim gunmen while riding a motorcycle.
9073,16/2/2008,Afghanistan,Arghandab,101,75,176,"A suicide bomber blows himself up in a crowd of spectators watching a dog-fighting event, killing over one-hundred."
9074,16/2/2008,Pakistan,Swat,2,14,16,A Fedayeen suicide bomber kills two civilians.
9075,16/2/2008,Algeria,Tizi Ouzou,1,4,5,A local soldier is blown to bits by Islamic fundamentalist bombers.
9076,16/2/2008,Somalia,Yaqshid,1,0,1,Islamic militia members assassinate a local official outside a mosque.
9077,16/2/2008,Iraq,Ramadi,5,0,5,Five Iraqis are kidnapped and tortured to death by Freedom Fighters.
9078,16/2/2008,Algeria,Tadmait,3,0,3,Three local soldiers are killed in an ambush by Islamic fundamentalists.
9079,17/2/2008,Iraq,Baghdad,3,12,15,A female suicide bomber at a marketplace sends three shoppers to Allah.
9080,17/2/2008,Iraq,Mosul,4,2,6,Jihadis kill four Iraqis with a remote-controlled bomb.
9081,17/2/2008,Somalia,Mogadishu,1,0,1,A young child is killed when Islamic fundamentalists toss a grenade into a crowd watching a soccer match on TV.
9082,17/2/2008,Iran,Zahedan,1,0,1,A man and a friend stone his 14-year-old daughter to death over an unauthorized relationship.
9083,18/2/2008,Sudan,Jebel Moon,11,0,11,Seven women and four children are killed in an attack by government troops on their village.
9084,18/2/2008,Somalia,Dhobley,3,5,8,Fundamentalists cut down three youth with gunfire for refusing demands to turn off their music.
9085,18/2/2008,Iraq,Sheikh,4,0,4,al-Qaeda gunmen murder a couple and their teenage son in their home along with a neighbor.
9086,18/2/2008,Iraq,Baghdad,5,14,19,"Jihadis mortar an airport, killing five Iraqi civilians."
9087,18/2/2008,Iraq,Mosul,3,4,7,Three civilians are killed in a roadside bombing.
9088,18/2/2008,Iraq,Hit,2,1,3,"Fundamentalists bomb a video store, killing the owner and a customer."
9089,18/2/2008,Afghanistan,Spin Boldak,38,36,74,Thirty-eight Afghans are blown apart by suicide bomber in an explosives packed car.
9090,19/2/2008,Thailand,Pattani,1,1,2,A 46-year-old Buddhist man is shot from his motorcycle and then set ablaze by militant Muslims.
9091,19/2/2008,Afghanistan,Kandahar,1,1,2,A civilian is killed by a suicide bomber.
9092,19/2/2008,Somalia,Mogadishu,6,0,6,"Islamic militia ambush a patrol along a city street, killing four soldiers and two civilians."
9093,19/2/2008,Pal. Auth.,Khan Yunis,1,2,3,A 10-year-old boy is killed while being used by Hamas as a human shield to ambush Israeli soldiers.
9094,19/2/2008,Iraq,Baquba,4,0,4,Two children and their parents are shot to death by Islamic terrorists.  The family had been displaced.
9095,19/2/2008,Iraq,Baghdad,6,3,9,Six civilians are killed in two Mujahideen bombing attacks.
9096,20/2/2008,Iraq,Tal Afar,2,8,10,A woman and a 6-year-old child are taken out by a suicide bomber at municipal office.
9097,20/2/2008,Iraq,Balad,3,7,10,Jihadis kill three children playing soccer near a US base.
9098,20/2/2008,Iraq,Muqdadiyah,7,20,27,Seven civilians are killed when a suicide bomber detonates in a marketplace.
9099,20/2/2008,Iraq,Mosul,5,4,9,"Sunni gunmen murder five Iraqis, including one woman."
9100,20/2/2008,Somalia,Baidoa,2,0,2,Two Ethiopian soldiers standing guard at a market are murdered by Islamic gunmen.
9101,21/2/2008,Iraq,Baquba,24,0,24,Three women are among twenty-four victims of al-Qaeda found in two mass graves.
9102,21/2/2008,Somalia,Afgoi,1,0,1,Islamic militias assassinate a government official.
9103,21/2/2008,Afghanistan,Helmand,1,4,5,Religious extremists kill a local policeman in a roadside bombing attack.
9104,22/2/2008,Iraq,Fallujah,6,9,15,Six people at a mosque are blown to bits by a suicide bomber.
9105,22/2/2008,Iraq,Baghdad,8,15,23,"Various Jihad attacks leave at least eight Iraqis dead, including three children."
9106,22/2/2008,Iraq,Tikrit,3,8,11,Three people are killed when a suicide bomber rams his vehicle into a police station.
9107,22/2/2008,Iraq,Garma,2,3,5,A Fedayeen suicide bomber murders two Iraqis at a checkpoint.
9108,22/2/2008,Thailand,Narathiwat,0,22,22,Twenty-two migrant workers are injured when Islamists set off a bomb at a garbage dump.
9109,22/2/2008,Pakistan,Swat,13,14,27,Bombers kill thirteen members of a wedding party traveling in a minibus.
9110,22/2/2008,Afghanistan,Khost,3,0,3,A suicide attack kills three Afghans.
9111,23/2/2008,Iraq,Baiji,1,1,2,Jihadis kill a woman in a roadside attack that leaves her son badly injured.
9112,23/2/2008,Iraq,al-Saqlawiyah,6,2,8,"Sunni radicals attack a police station, killing six Iraqis."
9113,23/2/2008,Somalia,Mogadishu,3,5,8,Two young sisters are among three civilians killed in a roadside bombing attack by Islamic militia.
9114,23/2/2008,Afghanistan,Zabul,1,0,1,A civilian truck driver is killed and his vehicle set ablaze by religious extremists.
9115,23/2/2008,Afghanistan,Kunar,7,0,7,Seven Afghans are killed in a landmine attack by the Taliban.
9116,23/2/2008,Somalia,Mogadishu,4,0,4,Four Ethiopians driving a water truck are gunned down by radicals screaming 'Allah Akbar.'
9117,24/2/2008,Somalia,Dinsoor,18,8,26,"Islamic militias attack a small town, killing eighteen local defenders."
9118,24/2/2008,Iraq,Mosul,2,3,5,Two electrical workers are blown apart in an IED attack on their vehicle.
9119,24/2/2008,Iraq,Baghdad,3,49,52,Three Shia pilgrims are killed when Sunni gunmen attack their procession.
9120,24/2/2008,Afghanistan,Garmabak,3,2,5,The Taliban are suspected in an assassination attempt on a local official that leaves three people dead.
9121,24/2/2008,Pakistan,Qadirabad,3,5,8,"Islamic militants attack a group of local police, killing three."
9122,24/2/2008,Iraq,Iskandariyah,63,68,131,A suicidal Sunni blasts more than sixty Shia pilgrims to death as they are resting from their journey in a tent.
9123,24/2/2008,Algeria,Tablat,1,2,3,A village guard is gunned down by Islamic fundamentalists.
9124,25/2/2008,Afghanistan,Helmand,5,1,6,Religious extremists kill five civilians with a rocket.
9125,25/2/2008,Iraq,Baghdad,4,15,19,Three women are among four Shia pilgrims killed by radical Sunni bombers.
9126,25/2/2008,Iraq,Samarra,3,8,11,A suicide bomber in a wheelchair murders three Iraqi policemen.
9127,25/2/2008,Iraq,Haruja,8,0,8,Eight women are kidnapped and executed by Islamic fundamentalists.
9128,25/2/2008,Iraq,Mosul,7,7,14,Three members of the same family are killed in their home by Jihads.  Four other Iraqis are killed in a separate attack.
9129,25/2/2008,Pakistan,Rawalpindi,8,35,43,Eight people are killed when a suicide bomber rams into another vehicle along a city road.
9130,25/2/2008,Pakistan,Mansehra,5,10,15,Two women are among five dead when Islamists attack and burn down a humanitarian agency office.
9131,25/2/2008,Somalia,Mogadishu,1,0,1,A young police officer is assassinated outside his home by Islamic militia members.
9132,25/2/2008,Pakistan,Mingora,1,0,1,A traffic cop is gunned down by Muslim militants.
9133,26/2/2008,Afghanistan,Kandahar,2,0,2,An 50-year-old American humanitarian worker and her driver are kidnapped and executed by the Taliban
9134,26/2/2008,Pakistan,Peshawar,1,0,1,A Shia leader is shot to death by Sunni radicals.
9135,26/2/2008,Afghanistan,Khost,6,0,6,A 9-year-old child and five Afghan adults are murdered by Islamic bombers.
9136,26/2/2008,Iraq,Mosul,8,8,16,"A suicide bomber detonates inside a passenger bus, killing eight Iraqis."
9137,26/2/2008,Somalia,Dusamareb,1,0,1,A former government official is assassinated by Islamic terrorists.
9138,27/2/2008,Israel,Sderot,1,1,2,Hamas kills an Israeli student with a rocket barrage on a college campus.
9139,27/2/2008,Thailand,Narathiwat,1,0,1,Muslim gunmen murder a 60-year-old man sitting in this truck.
9140,27/2/2008,Thailand,Yala,1,4,5,A local soldier is killed in a bombing ambush by Islamic militants.
9141,27/2/2008,Afghanistan,Kandahar,2,6,8,Two local soldiers are gunned down in an ambush by religious extremists.
9142,27/2/2008,India,Pulwama,2,1,3,"Two local cops are massacred in a Mujahideen ambush.  Elsewhere, an 11-year-old boy is severely injured in a bomb attack."
9143,27/2/2008,Iraq,Mosul,2,1,3,Two civilians are killed in a Jihad bomb blast.
9144,27/2/2008,Iraq,Hamdaniyah,1,0,1,A university student is shot to death by suspected fundamentalists.
9145,28/2/2008,Germany,Odenwald,3,0,3,"Muslims ask three innocent Christians to identify their religion, then brutally execute them."
9146,28/2/2008,Iraq,Mosul,2,0,2,A traffic officer and his young son are shot to death by radical Sunnis.
9147,29/2/2008,Iraq,Mosul,3,0,3,Three Christians are killed trying to unsuccessfully protect their archbishop from an abduction.
9148,29/2/2008,Iraq,Mosul,2,0,2,An 11-year-old child and his father are murdered in a roadside bombing by Sunni radicals.
9149,29/2/2008,Pakistan,Swat,42,50,92,Over forty people attending a funeral are murdered by a Fedayeen bomber who wandered into the crowd before detonating.
9150,29/2/2008,Thailand,Narathiwat,2,0,2,Two local soldiers are killed in an ambush by Islamic militants.
9151,29/2/2008,Pakistan,Lakky Marwat,4,2,6,Four local cops are blown to bits by Islamic bombers.
9152,29/2/2008,Somalia,Mogadishu,13,40,53,Thirteen civilians are killed when Islamic terrorists attack government troops near a marketplace.
9153,29/2/2008,Pakistan,Lahore,1,0,1,A 15-year-old girl is strangled by her uncle over an illicit affair.
9154,1/3/2008,Somalia,Mogadishu,2,0,2,Two local police manning a checkpoint near a market are shot to death by Islamic militia members.
9155,1/3/2008,Pakistan,Langnar,1,0,1,A 22-year-old man is beheaded by the Taliban.
9156,1/3/2008,Iraq,Baghdad,5,12,17,Five people are killed when Sunni extremists attack two buses carrying Shia pilgrims.
9157,1/3/2008,Afghanistan,Khost,3,4,7,"Three members of the same family, including two women, are blown to bits by the Taliban while traveling to a cemetery."
9158,1/3/2008,Pakistan,Khar,2,21,23,A suicide bomber kills two people in a car bomb attack.
9159,2/3/2008,Jordan,al-Azraq,2,0,2,A young woman and her lover are shot to death by members of her family to restore their honor.
9160,2/3/2008,India,Warpora,1,0,1,A civilian is shot to death by the Mujahideen.
9161,2/3/2008,Iraq,Baquba,6,4,10,A bus full of Shia pilgrims is attacked Sunni bombers.  At least six are killed.
9162,2/3/2008,Iraq,Samarra,8,30,38,A policeman and his family are murdered by Islamic radicals in a bombing attack that also kills others.
9163,2/3/2008,Pakistan,Peshawar,42,58,100,A teenaged suicide bomber murders over forty people gathered for a peace council.
9164,2/3/2008,Afghanistan,Zhob,4,11,15,Two children are among four killed when a bomb rips through an Afghan refugee camp.
9165,2/3/2008,Thailand,Yala,1,0,1,Islamist shoot a 41-year-old man to death as he is watching television in his home.
9166,2/3/2008,Algeria,Tizi Ouzou,1,0,1,Islamic fundamentalists kill a bank guard.
9167,3/3/2008,Iraq,Baghdad,22,43,65,Twenty-two Iraqis are blown to bits by a suicide car bomber along a city street.
9168,3/3/2008,Iraq,Samarra,7,9,16,Jihadis manage to kill seven women and children with a truck bomb.
9169,3/3/2008,Iraq,Ghadeer,4,10,14,A suicide car bomber kills four people near a police checkpoint.
9170,3/3/2008,Iraq,Sammara,14,0,14,"Fourteen Iraqis are found in a mass grave, believed to have been abducted and executed by Sunni extremists."
9171,3/3/2008,Pakistan,Bara,13,15,28,Thirteen people are killed when Lashkar Islami try to dismantle a rival Sunni shrine.
9172,3/3/2008,Afghanistan,Khost,4,4,8,Two Afghan laborers are among four killed by a Fedayeen suicide bomber.
9173,4/3/2008,Pakistan,Lahore,6,24,30,Two suicide bombers take out six other people in the parking lot of a naval college.
9174,4/3/2008,Pakistan,Khankhel,1,0,1,A villager is killed in a botched kidnapping attempt by Uzbek Mujahideen.
9175,4/3/2008,Iraq,Huwaish,6,10,16,Four Iraqi children and two women are killed in a bombing attack by Sunni extremists.
9176,4/3/2008,Afghanistan,Tani,1,5,6,A local cop is killed trying to prevent a suicide car bomber from plowing into a building.
9177,4/3/2008,India,Shopian,2,5,7,Two civilians are killed when Mujahid toss a grenade into their home.
9178,5/3/2008,Iraq,Kirkuk,1,0,1,A 74-year-old professor is gunned down in a suspected al-Qaeda attack.
9179,5/3/2008,Thailand,Pattani,1,4,5,Islamic bomber murder a 47-year-old policeman at a market.
9180,5/3/2008,Algeria,Jijel,3,0,3,Islamic fundamentalists murder three volunteer guards at a remote village.
9181,6/3/2008,Israel,Garara,2,2,4,Two Israeli soldiers are killed in a bombing attack by Islamic Jihad.
9182,6/3/2008,Somalia,Mogadishu,5,5,10,At least five Somalis are killed when Islamists attack a checkpoint with machine-guns and rockets.
9183,6/3/2008,Iraq,Baghdad,68,131,199,Sixty-eight Iraqis at a crowded marketplace are murdered in a twin-suicide bombing attack by al-Qaeda.  Over a hundred more are injured.
9184,6/3/2008,Israel,Jerusalem,8,10,18,Eight defenseless students are brutally gunned down at a Jewish seminary by a Muslim gunman.  Seven of the victims are between the ages of 15 and 19.
9185,6/3/2008,India,Reasi,3,8,11,"Two girls, ages 9 and 13, are murdered along with their grandfather when Islamists toss a hand grenade into their home."
9186,6/3/2008,Somalia,Gobale,4,3,7,Four civilians are killed when Islamic insurgents ambush a group of Ethiopians in a commercial area.
9187,6/3/2008,Iraq,Iskandariya,2,0,2,Jihadis kill two women with a roadside bomb.
9188,6/3/2008,Iraq,Mosul,4,0,4,Four civilians are gunned down by Sunni extremists.
9189,7/3/2008,Thailand,Yala,2,0,2,A 55-year-old man and his wife are murdered by Muslim gunmen inside their home.
9190,7/3/2008,Iraq,Mosul,4,19,23,A suicide bomber takes out four Iraqis at a police station.
9191,8/3/2008,Iraq,Wajihiya,3,2,5,Jihadis kill three family members with a roadside bomb.
9192,8/3/2008,Afghanistan,Helmand,3,1,4,Two children and an old man are blown to bits by a Taliban bomb.
9193,9/3/2008,Somalia,Hiiraan,10,8,18,A woman is among ten people shot to death by Islamic militants.
9194,9/3/2008,Chechnya,Troitskaya,1,0,1,"An Islamic sniper fires on a convoy, killing a Russian soldier."
9195,10/3/2008,England,Liverpool,1,0,1,A 17-year-old is beaten to death by other Muslims who accused him of violating Islamic law by drinking alcohol.
9196,10/3/2008,Iraq,Kanaan,3,2,5,A 5-year-old child is among three people murdered by a female suicide bomber.
9197,10/3/2008,Iraq,Suleimaniyah,3,30,33,Three civilians are killed by a suicide bomber outside a hotel.
9198,10/3/2008,Iraq,Baghdad,6,9,15,Five US soldiers and one Iraqi are killed when a Fedayeen suicide bomber walks up to a foot patrol on a city street and detonates.
9199,10/3/2008,Afghanistan,Badghis,1,0,1,Religious extremists ambush and kill a local policeman.
9200,11/3/2008,Afghanistan,Kandahar,4,11,15,Two children and two women are killed in the crossfire when Taliban militants attack a military convoy.
9201,11/3/2008,Pakistan,Bajaur,11,13,24,Two women are among eleven civilians killed during a firefight following an ambush on government troops by Muslim militants.
9202,11/3/2008,Iraq,Nasariya,16,13,29,"Sixteen men, women and children are blown to bits in a Jihad roadside attack on their bus."
9203,11/3/2008,Iraq,Duluiya,7,33,40,Two al-Qaeda car bombings leave seven Iraqis dead.
9204,11/3/2008,Pakistan,Lahore,35,150,185,Children are among the thirty-five innocents murdered when twin Fedayeen suicide bombers detonate in two different parts of the city.
9205,11/3/2008,Thailand,Pattani,1,1,2,A man is shot to death by Islamists while riding in a truck with his wife.
9206,11/3/2008,Somalia,Mogadishu,2,0,2,Two local cops are killed in a roadside attack by Islamic militants.
9207,11/3/2008,Thailand,Yala,1,0,1,A 36-year-old man is shot to death by Muslim terrorists.
9208,12/3/2008,Pakistan,Swat,2,2,4,Two security personnel are killed by Islamic bombers.
9209,12/3/2008,Iraq,Baghdad,2,10,12,"Islamic militants detonate a bomb in a residential neighborhood, killing two people."
9210,12/3/2008,Iraq,Benazid,5,0,5,Five Sunnis are shot and beheaded by al-Qaeda.
9211,12/3/2008,Afghanistan,Kandahar,1,4,5,A passing truck driver is killed by a suicide car bomber along a city street.
9212,13/3/2008,Somalia,Mogadishu,2,2,4,"Jihad Warriors fire into a Medecins Sans Frontieres transport vehicle, killing two guards and injuring medical volunteers."
9213,13/3/2008,Somalia,Bur Haqaba,3,0,3,Three police are killed at point-blank range in a brutal Mujahid attack.
9214,13/3/2008,Iraq,Mosul,1,0,1,A Christian archbishop is killed while in the captivity of Muslim militants.
9215,13/3/2008,Afghanistan,Kabul,6,20,26,A Fedayeen suicide bomber murders six civilians along a city street.
9216,13/3/2008,Afghanistan,Saydabad,1,4,5,Taliban bombers kill a local cop.
9217,13/3/2008,Somalia,Bossaso,1,0,1,Suspected Islamists assassinate a government official.
9218,13/3/2008,Iraq,Baghdad,11,57,68,Eleven innocents are blown to bits by Jihad car bombs in the heart of a commercial district.
9219,13/3/2008,Iraq,Zab,3,9,12,A suicide bomber kills three Iraqis.
9220,13/3/2008,Pakistan,Terak,1,0,1,A civilian is killed by a Taliban bomb blast.
9221,14/3/2008,Iraq,Baghdad,8,24,32,A soccer coach is one of at least eight Iraqis killed by Jihadis in various attacks.
9222,14/3/2008,Somalia,Mogadishu,2,5,7,A child is among two killed when Jihadis lob a mortar into their home.
9223,14/3/2008,Pakistan,Sham,1,0,1,Mujahid slash the throat of a 30-year-old tribesman.
9224,14/3/2008,Somalia,Mogadishu,3,4,7,Three local police are murdered in two separate attacks by Muslim extremists at a market.
9225,14/3/2008,Pakistan,Swat,1,0,1,A Taliban bomb kills a 12-year-old child.
9226,15/3/2008,Thailand,Pattani,1,4,5,"Islamists set fire to a school to draw firefighters, then detonate a bomb, killing one."
9227,15/3/2008,Pakistan,Islamabad,1,15,16,"Islamists bomb an Italian restaurant, killing a Turkish woman."
9228,15/3/2008,Iraq,Hilla,1,8,9,Jihadis kill an Iraqi woman with a mortar attack on a neighborhood.
9229,15/3/2008,Thailand,Pattani,2,14,16,Two people are killed when Islamic terrorists bomb a hotel.
9230,15/3/2008,Afghanistan,Khost,2,3,5,A child and an elderly man are blown to bits by a Shahid bomber.
9231,16/3/2008,Iraq,Basra,1,0,1,A 17-year-old girl is stomped and stabbed to death by her father for falling in love with a British soldier.  (The father is not charged with a crime).
9232,16/3/2008,Philippines,Jolo,1,0,1,A gay man is stabbed and clubbed to death by suspected fundamentalists.
9233,16/3/2008,Algeria,al-Wadi,2,0,2,Two moderate Muslims are gunned down by al-Qaeda at a mosque.
9234,16/3/2008,Algeria,Kadiria,1,2,3,Fundamentalists kill a 19-year-old student with a bomb that also injures two other teens.
9235,16/3/2008,Pakistan,Mardan,1,8,9,Jihadis kill a local police officer with a roadside bomb.
9236,16/3/2008,Algeria,Jijel,3,17,20,Three local soldiers are killed when armed Islamic fundamentalists open fire on their patrol.
9237,17/3/2008,Thailand,Yala,0,8,8,Eight children are injured when Mujahid set off a bomb at a playground.
9238,17/3/2008,Thailand,Yala,2,0,2,Two men are shot to death by Muslim militants.
9239,17/3/2008,Iraq,Karbala,43,73,116,A female suicide bomber murders over forty Shiites near a shrine.
9240,17/3/2008,Pakistan,Swat,2,3,5,Two young cadets are killed when a Shahid detonates himself at a police training center.
9241,17/3/2008,Iraq,Baghdad,5,11,16,Five children are killed when Jihadis lob mortars onto a soccer field.
9242,17/3/2008,Iraq,Baghdad,3,11,14,"Mujahideen bomb a minibus, killing three civilian passengers."
9243,17/3/2008,Afghanistan,Girishk,7,11,18,"A Shahid blows himself up near a security convoy, killing three civilians and three multinational troops."
9244,17/3/2008,Kosovo,Mitrovica,2,130,132,"A suspected Muslim radical tosses a hand grenade into a crowd of protesting Serbs, killing two people."
9245,18/3/2008,Canada,"Toronto, ON",1,0,1,A man slits his wife's throat for disobeying him by allowing their children to be raised 'too Westernized.'
9246,18/3/2008,Iraq,Baghdad,10,74,84,Ten Iraqis are killed by Islamic militants in three separate bombing attacks.
9247,18/3/2008,Israel,Jerusalem,0,1,1,A rabbi is stabbed in the neck by a Palestinian.
9248,18/3/2008,Yemen,Sanaa,2,19,21,A schoolgirl is among two killed in a bomb attack on the US Embassy.
9249,19/3/2008,Iraq,Balad Ruz,5,16,21,A female suicide bomber kills five innocent people at a market.
9250,19/3/2008,Thailand,Yala,1,0,1,A 70-year-old Buddhist is murdered by Mujahideen gunmen at a grocery store.
9251,19/3/2008,Thailand,Yala,1,0,1,A Buddhist village guard is shot to death by Islamic terrorists.
9252,19/3/2008,Thailand,Yala,2,0,2,Two people are killed when Muslim radicals throw a grenade into a moderate mosque.
9253,19/3/2008,India,Srinagar,1,16,17,"One person is killed, and sixteen others injured when Jihadis plant a bomb along a city street."
9254,20/3/2008,Somalia,Mogadishu,7,20,27,A 7-year-old child is among seven people killed when Islamic terrorists attack a government base.
9255,20/3/2008,Pakistan,Wana,5,9,14,"A Shahid detonates himself in a car bomb attack, killing five local soldiers."
9256,20/3/2008,India,Gawari,2,0,2,Two children are killed when Lashkar-e-Toiba lob a grenade into the yard of a house.
9257,20/3/2008,Thailand,Pattani,1,0,1,Muslim radicals gun down a local Imam.
9258,20/3/2008,Iraq,Mosul,2,7,9,Two civilians are killed in a Mujahideen bombing attack in a neighborhood.
9259,21/3/2008,Afghanistan,Kanduz,1,0,1,A local cop is gunned down by the Taliban.
9260,21/3/2008,Iraq,Mosul,1,0,1,Holy warriors kidnap and decapitate a civilian.
9261,21/3/2008,Afghanistan,Kabul,2,4,6,Two people are killed by a Fedayeen suicide bomber.
9262,21/3/2008,India,Kupwara,1,0,1,"A 40-year-old man is dragged out of his home by Mujahideen, who then slash his throat."
9263,22/3/2008,Pakistan,Hangu,4,25,29,Sectarian strife between rival mosques leaves four dead.
9264,22/3/2008,Afghanistan,Kunar,1,0,1,A civilian is brutally murdered by Sunni extremists.
9265,22/3/2008,Afghanistan,Jawzjan,1,0,1,A district chief is stabbed to death by religious extremists.
9266,22/3/2008,India,Bakhna,1,0,1,A young man is abducted from his home and brutally killed in captivity by Hizb-ul-Mujahideen.
9267,22/3/2008,Iraq,Latifiya,1,0,1,A civilian is kidnapped and beheaded by the Mujahideen.
9268,23/3/2008,Afghanistan,Jawzjan,5,7,12,Religious extremists calmly shoot five Afghans to death.  The workers were trying to clear landmines at the time.
9269,23/3/2008,Iraq,Baghdad,22,34,56,Women and children are among the casualties as Islamic terrorists stage at least three separate attacks on civilians.
9270,23/3/2008,Iraq,Mosul,15,45,60,Fifteen Iraqi security personnel are murdered by a suicidal Sunni bomber.
9271,23/3/2008,Iraq,Samarra,5,11,16,A Fedayeen suicide bomber kills five Iraqis.
9272,23/3/2008,Somalia,Mogadishu,1,0,1,A doctor is reported killed in an attack by Islamic terrorists.
9273,23/3/2008,Pakistan,Torkham,2,50,52,"al-Qaeda terrorists bomb a restaurant and an oil facility, killing two people."
9274,23/3/2008,India,Srinagar,4,3,7,Lashker-e-Toiba militants ambush and kill four policemen.
9275,23/3/2008,Iraq,Baqubah,2,2,4,Two children are killed by a Jihad roadside attack.
9276,24/3/2008,Afghanistan,Kunduz,2,0,2,Two more mine-clearing workers are murdered by the Taliban.
9277,24/3/2008,Pakistan,North Waziristan,1,0,1,A young man is executed by al-Qaeda with a gunshot to the head.
9278,24/3/2008,Chechnya,Alleroi,2,0,2,Mujahideen murder two policemen with a homemade bomb.
9279,24/3/2008,Afghanistan,Herat,6,0,6,Religious extremists kill two farmers and four local police in an ambush.
9280,24/3/2008,Iraq,Baghdad,2,0,2,The bodies of two American civilians are found mutilated following their kidnapping.
9281,24/3/2008,Thailand,Yala,1,0,1,A 48-year-old man is murdered by Muslim gunmen after dropping his wife off at work.
9282,24/3/2008,Somalia,Mogadishu,4,0,4,A civilian is among four people killed when Islamic terrorists attack a police station.
9283,25/3/2008,Iraq,Basra,31,88,119,Thirty-three people are killed when a Shiite militia attacks government troops.
9284,25/3/2008,Pakistan,Swat,2,1,3,Islamic militants gun down a married couple as they are standing outside their home.
9285,25/3/2008,Pakistan,Swat,2,0,2,Two people are murdered by suspected al-Qaeda.
9286,25/3/2008,Pakistan,Bajaur,1,0,1,A man is killed in a landmine attack by suspected Islamic militants.
9287,26/3/2008,Afghanistan,Helmand,1,2,3,A local police officer is killed in a landmine attack by religious extremists.
9288,26/3/2008,Afghanistan,Helmand,8,17,25,Eight shoppers at an outdoor market are blown to bits by a Taliban car bomb.
9289,26/3/2008,Somalia,Jowhar,7,0,7,Mujahideen kill at least seven Somalis in an attack on an agricultural town.
9290,27/3/2008,Iran,Ahwazi,7,0,7,"Sa'ad Ibn Abi Waqqas Brigade terrorists open fire on a bus, killing seven Iranians."
9291,27/3/2008,Iraq,Samarra,2,2,4,A man and his son are brutally murdered by al-Qaeda.  A child and woman are injured in the attack.
9292,27/3/2008,Iraq,Diyala,37,0,37,A mass grave is discovered containing the tortured remains of thirty-seven victims of sectarian violence.
9293,27/3/2008,Iraq,Baiji,1,5,6,A woman is killed when Islamic terrorists lob a mortar into a neighborhood.
9294,27/3/2008,Iraq,Baghdad,5,21,26,Jihadis kill at least five people in a series of mortar attacks.
9295,27/3/2008,Pakistan,Kurram,7,1,8,Two women are among seven killed when Islamic terrorists fire a rocket into an ambulance.
9296,27/3/2008,Thailand,Yala,0,8,8,Seven children are among eight people injured when Islamists detonate a bomb attached to a motorcycle.
9297,27/3/2008,Pakistan,Kohat,50,0,50,"Four days of violent attacks between Sunni and Shia leave over fifty dead, including women and children."
9298,27/3/2008,Pakistan,Karachi,2,0,2,Two local intelligence agents are shot to death by al-Qaeda militants.
9299,28/3/2008,Iraq,Basra,1,0,1,A woman with a baby in her arms is murdered by fundamentalists for 'unIslamic' activity.
9300,28/3/2008,Afghanistan,Nimroz,2,2,4,Two local cops are murdered when the Taliban attack a counter-narcotics unit.
9301,28/3/2008,Thailand,Pattani,1,0,1,A young man is shot to death in his truck by Muslim radicals.
9302,28/3/2008,Iraq,Baghdad,2,6,8,Two US civilians are killed in a mortar attack by Islamic terrorists.
9303,29/3/2008,Iraq,Bani Saad,3,0,3,Three members of a family are wiped out by a Jihadi mortar.
9304,29/3/2008,Afghanistan,Girishk,2,8,10,"Sunni extremists attack a power station with a bomb, killing two employees."
9305,30/3/2008,Iraq,Baiji,7,8,15,Eight people are killed when Islamists detonate a car bomb.
9306,30/3/2008,Iraq,Baghdad,6,21,27,Jihadis kill six Iraqis with a mortar strike.
9307,30/3/2008,Iraq,Muqdadiyah,14,0,14,An al-Qaeda mass grave is discovered containing fourteen torture victims.
9308,30/3/2008,Thailand,Yala,2,0,2,Islamists murder two civilians in separate attacks.
9309,30/3/2008,Iraq,Baghdad,1,0,1,"The remains of an American soldier, kidnapped and executed in captivity three years earlier, are identified."
9310,31/3/2008,Iraq,Latifiya,6,0,6,"Six Iraqis are kidnapped, blindfolded and shot to death by Islamic terrorists."
9311,31/3/2008,Somalia,Bule Burte,12,0,12,Twelve Somalis are killed when Islamists attack a small village.
9312,31/3/2008,Somalia,Mogadishu,1,0,1,Islamic extremists sneak up to a local guard and shoot him in the head.
9313,31/3/2008,Pakistan,Nowshera,2,0,2,A man and a woman are stoned to death for adultery.
9314,1/4/2008,Afghanistan,Nimroz,2,5,7,Two Afghan police are blown up by a suicide car bomber.
9315,1/4/2008,Iraq,Sammara,12,0,12,A dozen moderate Sunnis are murdered by al-Qaeda gunmen in two attacks.
9316,1/4/2008,Pakistan,Matta,2,6,8,Two members of a tribal peace committee are blown to bits in a bombing attack on their vehicle by Muslim militants.
9317,2/4/2008,India,Kupwara,1,0,1,A man is shot to death in his home by Islamic militants.
9318,2/4/2008,Somalia,Qansah Dhere,3,8,11,"Islamists attack a government residence, killing at least three people."
9319,2/4/2008,Iraq,Baghdad,6,24,30,Two women are among six killed in Jihad bombings.
9320,2/4/2008,Iraq,Mahmudiya,1,1,2,Gunmen shoot a teacher to death and injure his son.
9321,2/4/2008,Iraq,Muqdadiyah,11,5,16,Eleven Iraqis are murdered in Mujahideen bombings.
9322,3/4/2008,Iraq,Mosul,5,17,22,"A Fedayeen bomber kills five civilians, including a woman and a 5-year-old child."
9323,3/4/2008,Iraq,Samarra,5,0,5,Jihadis kill five Iraqis with a roadside bombing.
9324,3/4/2008,Thailand,Songkhla,1,0,1,An older man is murdered by Muslim gunmen while sitting in his truck.
9325,3/4/2008,Afghanistan,Kunar,1,0,1,"Religious extremists target a fuel truck, killing the local driver."
9326,4/4/2008,Iraq,Hamrin,9,30,39,"A suicide bomber detonates at a funeral, killing at least nine mourners."
9327,4/4/2008,Iraq,Hilla,7,3,10,Two Jihadi bombings leave seven local cops dead.
9328,4/4/2008,Afghanistan,Lashkar Gah,4,8,12,Four Afghans are murdered by a suicide bomber.
9329,4/4/2008,Somalia,Mogadishu,5,4,9,Islamists kill five local soldiers with a planted bomb.
9330,4/4/2008,India,Kupwara,2,0,2,Two policemen are kidnapped and brutally tortured to death by the al-Badr Mujahideen.
9331,5/4/2008,Algeria,Djebel Sbaa,1,1,2,al-Qaeda bombers kill one Algerian and seriously wound another.
9332,5/4/2008,Pal. Auth.,Gaza,1,1,2,"A Hamas rocket falls short, killing a Palestinian farmer."
9333,5/4/2008,Iraq,Khaneqin,8,1,9,Four oil workers are kidnapped and beheaded.  Four other innocents are killed elsewhere by Jihadis.
9334,5/4/2008,Iraq,Baghdad,3,16,19,"Sunni extremists bomb a bus, killing three people."
9335,5/4/2008,Yemen,Sanaa,1,7,8,An al-Qaeda gunmen attacks a checkpoint killing one person.
9336,5/4/2008,Iraq,Karradah,1,0,1,A Christian priest is shot to death by Muslim fanatics.
9337,5/4/2008,Pakistan,Kurrum,2,26,28,Sectarian violence between Sunni and Shia leaves two dead.
9338,5/4/2008,Somalia,Mogadishu,3,3,6,Three local soldiers are ambushed and killed by Islamic militia.
9339,6/4/2008,Iraq,Kirkuk,1,0,1,A woman is shot to death by suspected fundamentalists.
9340,6/4/2008,Iraq,Samarra,7,0,7,al-Qaeda gunmen assassinate seven Sunnis.
9341,6/4/2008,Pakistan,Peshawar,3,18,21,"Islamic militants ambush vehicles along a highway, killing at least three locals."
9342,6/4/2008,Somalia,Afgoye,2,3,5,A 9-year-old boy is among two people murdered when Islamists stage a shooting attack.
9343,6/4/2008,Somalia,Mogadishu,7,14,21,Seven people are shot to death by Muslim radicals in two attacks at a market.
9344,6/4/2008,Thailand,Narathiwat,1,0,1,A civilian is killed by radical Muslim gunmen.
9345,7/4/2008,Afghanistan,Kandahar,7,2,9,Seven local members of an anti-drug task force are murdered by religious extremists.
9346,7/4/2008,Somalia,Baidoa,13,12,25,Thirteen people are killed in three separate Islamist bomb attacks.
9347,7/4/2008,Afghanistan,Herat,2,1,3,"Sunni extremists attack a checkpoint, killing two local officers."
9348,7/4/2008,Afghanistan,Helmand,2,6,8,Two local policemen are killed in a Taliban bombing attack.
9349,7/4/2008,Sudan,Darfur,14,38,52,"Janjaweed militias attack three villages, murdering at least fourteen civilians."
9350,8/4/2008,Afghanistan,Zabul,17,16,33,Seventeen civilian road workers are murdered by Taliban gunmen.
9351,8/4/2008,Pakistan,Hangu,2,4,6,Two people are killed over a religious dispute.
9352,8/4/2008,Afghanistan,Helmand,1,2,3,"Taliban terrorists ambush a group of local cops, killing one."
9353,8/4/2008,Iraq,Baquba,4,0,4,A family of four is wiped out by Jihadi gunmen.
9354,8/4/2008,Iraq,Balad Ruz,7,10,17,"Sunni bombers target a minibus, killing seven innocents."
9355,8/4/2008,Pakistan,Karachi,1,0,1,A Hindu man is beaten to death by his Muslim co-workers over allegedly insulting Islam.
9356,8/4/2008,Somalia,Mogadishu,2,9,11,Two people are killed in a Fedayeen car-bomb attack.
9357,9/4/2008,Iraq,Dhuluiya,5,0,5,A mother and her four children are taken out in a Sunni mortar attack.
9358,9/4/2008,Iraq,Mosul,4,18,22,Four people are killed in a pair of Jihad car bombings.
9359,9/4/2008,Iraq,Baghdad,7,27,34,"The Mujahideen lob mortars into a funeral, killing seven mourners, including children."
9360,9/4/2008,Israel,Nahal Oz,2,2,4,Two Israeli civilians are shot to death by Palestinian militants at a fuel depot.
9361,9/4/2008,Thailand,Pattani,1,0,1,A man is gunned down by Islamic terrorists while driving home.
9362,9/4/2008,Pakistan,Kurram,1,6,7,A sectarian clash leaves one person dead.
9363,9/4/2008,Turkey,Ankara,3,0,3,Video is released showing the execution of three Chinese hostages by a Turkish Islamic group.
9364,9/4/2008,Somalia,Mogadishu,5,4,9,Islamists target a military convoy with a landmine.  Civilians are among the casualties.
9365,10/4/2008,Iraq,Mosul,4,25,29,Jihadis kill four Iraqis with a pair of bombs.
9366,10/4/2008,Iraq,Mahmoudiya,33,0,33,Thirty victims of sectarian violence within the Religion of Peace are found in a mass grave.
9367,10/4/2008,Afghanistan,Kandahar,8,20,28,Eight civilians are murdered by a Taliban suicide bomber.
9368,11/4/2008,Pakistan,Kurram,2,2,4,A 13-year-old boy is among two people killed in separate attacks by sectarian militants.
9369,11/4/2008,Pakistan,Chinar Chowk,2,3,5,"Religious radicals shell a market, killing two people."
9370,11/4/2008,Iraq,Baiji,2,13,15,"Children are among the casualties of two Jihad terror attacks, including a suicide bombing."
9371,11/4/2008,Iraq,Ramadi,3,5,8,A suicide bomber takes out three Iraqis.
9372,11/4/2008,Pakistan,Charsadda,1,0,1,A government official is shot to death by pro-Taliban militants.
9373,12/4/2008,Afghanistan,Nimroz,4,3,7,Three Indian road workers and a local Afghan are killed by a Fedayeen suicide bomber.
9374,12/4/2008,Afghanistan,Maiwand,4,0,4,Sunni extremists murder four anti-drug workers in a field.
9375,12/4/2008,Afghanistan,Helmand,4,7,11,Four local cops are ambushed and killed by the Taliban.
9376,12/4/2008,Pakistan,Kurram,8,10,18,Eight people are killed in violence between rival religious groups.
9377,13/4/2008,Afghanistan,Khost,3,4,7,Three civilians are blown to bits by a bomb planted by Islamic militants.
9378,13/4/2008,Ingushetia,Karabulak,1,0,1,A judge is assassinated by suspected Islamic gunmen.
9379,13/4/2008,Iraq,Mosul,3,10,13,An Islamist bombing and beheading leave three Iraqis dead.
9380,14/4/2008,Iraq,Tal Afar,4,14,18,A suicide bomber takes out four mourners at a funeral.
9381,14/4/2008,Iraq,Baghdad,7,17,24,Jihadis kill seven civilians with two bomb blasts.
9382,14/4/2008,Iraq,Sinjar,12,15,27,A dozen Iraqi soldiers are murdered by a suicide bomber while traveling home from a security posting.
9383,14/4/2008,Somalia,Belet Weyne,4,0,4,A 70-year-old man is among four teachers shot in the head by Islamists.
9384,14/4/2008,Somalia,Merka,4,12,16,"Fundamentalists toss a grenade into a cinema showing Western films, killing at least four patrons."
9385,14/4/2008,Afghanistan,Arghandab,11,1,12,"Islamic hardliners storm a police checkpoint, killing eleven locals."
9386,14/4/2008,Pakistan,Parachinar,7,68,75,Seven more people are killed in sectarian violence within the Religion of Peace.
9387,15/4/2008,Afghanistan,Spin Boldak,2,3,5,Two local cops are murdered by Sunni bombers.
9388,15/4/2008,Iraq,Ramadi,13,20,33,"Islamic terrorists send a suicide bomber into a restaurant, killing at least thirteen patrons."
9389,15/4/2008,Iraq,Baqubah,40,80,120,At least forty civilians are killed when Sunni extremists plant a bomb near a courthouse.
9390,15/4/2008,Iraq,Mosul,9,20,29,"Six women, including a schoolgirl, are among nine Iraqis murdered by Jihadis."
9391,15/4/2008,Iraq,Baghdad,11,19,30,"Jihads rack up eleven civilians, including women, in at least two attacks."
9392,15/4/2008,Iraq,Al-Doum,5,6,11,Shiite radicals kill five Iraqis and kidnap six more.
9393,15/4/2008,Iraq,Karbala,5,2,7,Five people are murdered by Sunni extremists in an armed attack on their village.
9394,15/4/2008,Pakistan,Parachinar,1,6,7,One person is killed in a Sunni-Shia sectarian clash.
9395,15/4/2008,India,Ramban,1,0,1,Lashkar-e-Toiba militants kill a local soldier.
9396,16/4/2008,Iraq,Muqdadiyah,2,5,7,"Sunni extremists open fire on a minibus, killing two occupants."
9397,16/4/2008,Afghanistan,Zabul,1,0,1,A local police officer is gunned down in a Taliban ambush.
9398,16/4/2008,Yemen,Marib,4,3,7,Four local cops are killed in an al-Qaeda bombing.
9399,16/4/2008,Thailand,Pattani,1,0,1,The manger of a shrimp farm is kidnapped and beheaded by Muslim extremists.
9400,16/4/2008,Pakistan,Khyber,20,15,35,Lashkar-e-Islam and fellow Sunnis clash over a religious dispute.  Twenty people are killed.
9401,17/4/2008,Pakistan,Baytha,1,0,1,Fundamentalists kill a female health worker at her clinic.
9402,17/4/2008,Iraq,Tuz Khormato,51,55,106,Fifty-one mourners at a funeral are blown to bits by a Fedayeen suicide bomber.
9403,17/4/2008,Iraq,Mahmudiya,51,0,51,A mass grave containing the tortured remains of 51 Iraqis is discovered.
9404,17/4/2008,Thailand,Pattani,1,0,1,A villager on his way to work is shot to death by Muslim terrorists.
9405,17/4/2008,Thailand,Yala,1,0,1,Islamic radicals kill a local soldier in a bomb attack.
9406,17/4/2008,Somalia,Mogadishu,3,0,3,"Islamists attack three foreigners collecting water, killing them with a rocket."
9407,17/4/2008,Thailand,Yala,1,0,1,A 55-year-old man is shot and killed by Muslim radicals while running errands.
9408,17/4/2008,Afghanistan,Zarang,23,31,54,"A Fedayeen suicide bomber strikes a crowd of civilians leaving a mosque, killing two dozen."
9409,17/4/2008,India,Doda,1,0,1,A civilian is murdered by Mujahideen gunmen.
9410,18/4/2008,Yemen,Saada,3,6,9,A government official and two others are shot to death by suspected Islamic militants.
9411,18/4/2008,Afghanistan,Logar,3,1,4,Three civilians are killed by a Taliban roadside blast.
9412,18/4/2008,Pakistan,Parachinar,4,0,4,Four young men are murdered by suspected Mujahideen in two separate attacks.
9413,18/4/2008,Afghanistan,Uruzgan,2,2,4,"Islamic radicals kill two Dutch soldiers, saying that it is in retaliation for Fitna, a Dutch movie alleging a violence problem within Islam."
9414,19/4/2008,Thailand,Narathiwat,1,1,2,A 45-year-old man is shot and killed by Islamists while riding with his wife on a motorcycle.
9415,19/4/2008,Somalia,Mogadishu,8,12,20,Eight civilians are killed in an ambush by Islamic militants.
9416,19/4/2008,Afghanistan,Zabul,3,1,4,Three civilians are blown to bits by a Taliban bomb.
9417,19/4/2008,Iraq,Baqubah,1,3,4,A child is killed in a Jihad roadside bombing.
9418,19/4/2008,Iraq,Diwaniyah,16,0,16,A mass grave is found containing sixteen decapitated bodies.
9419,20/4/2008,Thailand,Narathiwat,1,5,6,"Islamists detonate a bomb and then open fire on a group of local soldiers, killing one."
9420,20/4/2008,Lebanon,Zahle,2,0,2,Two political figures are shot to death by suspected Islamists.
9421,20/4/2008,Pakistan,Hub,3,1,4,Three local soldiers are machine-gunned to death by religious radicals.
9422,20/4/2008,Iraq,Sinjar,2,0,2,A government official and his brother are kidnapped from their home and murdered by Islamic terrorists.
9423,20/4/2008,Iraq,Rashad,2,0,2,Two contractors are shot to death by Sunni militants.
9424,20/4/2008,Iraq,Diyala,47,0,47,Forty-seven bodies of kidnap victims are found in a mass grave.
9425,20/4/2008,Thailand,Narathiwat,2,1,3,Two policemen guarding a polling station are gunned down by Muslim militants.
9426,20/4/2008,Somalia,Mogadishu,1,4,5,A man is killed in a mortar attack that also leaves his wife and children injured.
9427,20/4/2008,Afghanistan,Kunar,1,5,6,The Taliban kill a 15-year-old boy collecting livestock food with other children.
9428,21/4/2008,Afghanistan,Kandahar,6,0,6,Six local policemen are murdered in an attack on their checkpoint by religious extremists.
9429,21/4/2008,Iraq,Mosul,3,0,3,A teenager is among three civilians cut down by militant Sunnis.
9430,21/4/2008,Iraq,Baqubah,4,5,9,A female suicide bomber kills four Iraqis.
9431,21/4/2008,Pakistan,Jamrud,2,5,7,Two local security personnel are gunned down in a brutal ambush by dozens of Islamic fighters.
9432,21/4/2008,Somalia,Guda,4,7,11,"Islamic militias attack a small town, killing four local defenders."
9433,21/4/2008,Somalia,Baidoa,1,0,1,A government official is assassinated by Islamic terrorists.
9434,22/4/2008,Thailand,Yala,1,0,1,A villager is shot three times in the head by Islamists.
9435,22/4/2008,Iraq,Jalawla,8,17,25,A female suicide bomber murders eight Iraqis.
9436,22/4/2008,Iraq,Baghdad,6,10,16,"Jihadis rain down rockets on a residential neighborhood, leaving six dead."
9437,22/4/2008,Iraq,Ramadi,2,29,31,Iraqi children are among the casualties when a suicide bomber targets a group of Marines.
9438,23/4/2008,Iraq,Tikrit,2,0,2,Two oil workers are murdered by Sunni terrorists.
9439,23/4/2008,Iraq,Mosul,4,9,13,"Four people are killed by a suicide bomber and responders, who were then gunned down."
9440,23/4/2008,Thailand,Pattani,1,0,1,A man is shot to death by Muslim militants while riding home on a motorcycle.
9441,23/4/2008,Afghanistan,Spin Boldak,3,14,17,Children are among the casualties of a suicide bombing that kills three civilians.
9442,23/4/2008,Afghanistan,Helmand,2,3,5,Two Afghans are murdered by a suicide bomber.
9443,23/4/2008,Afghanistan,Kunar,5,7,12,"Religious extremists attack a police post, killing five officers."
9444,24/4/2008,Iraq,Kirkuk,3,0,3,Jihadis manage to murder three people with a roadside bomb.
9445,24/4/2008,Iraq,Baghdad,3,15,18,"Freedom fighters bomb a marketplace, killing three Iraqis."
9446,24/4/2008,Thailand,Pattani,5,1,6,Five construction workers are brutally gunned down by Islamic separatists.
9447,24/4/2008,Pakistan,Miranshah,1,0,1,"A young shopkeeper is abducted, tortured and murdered by religious extremists."
9448,25/4/2008,Pakistan,Hub,3,8,11,Suspected Islamists machine-gun three cement factory workers to death on their way to work.
9449,25/4/2008,Afghanistan,Kabul,3,4,7,Three local cops are murdered by the Taliban in two attacks.
9450,25/4/2008,Iraq,Basra,12,31,43,A child killed when Jihadis throw a grenade into a wedding is among a dozen civilians taken out in various attacks around the country.
9451,25/4/2008,Pakistan,Mardan,5,30,35,Five people are blown to bits by a Taliban bomb.
9452,25/4/2008,Israel,Nitzanei Oz,2,0,2,Two Israelis in their 50's are executed by a Palestinian gunman.
9453,26/4/2008,Iraq,Mosul,9,11,20,Nine people are murdered in two Fedayeen suicide bombing attacks.
9454,26/4/2008,Iraq,Baghdad,3,18,21,Jihadis gun down a shop owner.  Two other Iraqis are blown up by a suicide bomber.
9455,26/4/2008,Pakistan,Dadukhel,4,10,14,Woman and children are among the casualties when the Taliban attack a residence.
9456,27/4/2008,Somalia,Mogadishu,3,0,3,"Islamic militias fire a mortar into a home, killing a mother and her two children."
9457,27/4/2008,Somalia,Mogadishu,7,2,9,Seven civilians are killed when Islamists attack a government target.
9458,27/4/2008,Afghanistan,Kabul,3,10,13,"Sunni extremists rocket a parade, killing three people."
9459,27/4/2008,Iraq,Samarra,1,4,5,Jihadis murder a woman in a roadside attack.
9460,27/4/2008,Iraq,Baghdad,3,9,12,A suicidal Sunni bomber takes out three Iraqis.
9461,27/4/2008,Iraq,al-Guba,50,0,50,"A mass grave is discovered containing the bodies of at least fifty people, rounded up by Sunni radicals, bound and executed."
9462,27/4/2008,Thailand,Narathiwat,2,0,2,Two men in their 30's are shot to death in separate Mujahideen attacks.
9463,28/4/2008,Pakistan,Waziristan,1,0,1,A 35-year-old policeman is abducted and beheaded by the Taliban.
9464,28/4/2008,Iraq,Baghdad,2,4,6,A woman and child are killed when Islamic terrorists fire mortars into the city.
9465,28/4/2008,Somalia,Baidoa,6,2,8,An attack by Islamic militia leaves six people dead.
9466,29/4/2008,Sudan,Helf,1,1,2,"A woman is killed, and a child gravely injured, when the Islamic Republic bombs a village."
9467,29/4/2008,Somalia,Hiraan,1,0,1,"A local army officer is kidnapped, tortured and murdered by the Mujahideen."
9468,29/4/2008,Afghanistan,Khogyani,18,14,32,"The Taliban use a young boy as a suicide bomber, killing eighteen innocent people."
9469,29/4/2008,Iraq,Baquba,3,16,19,Two female suicide bomber kill three Iraqis in separate attacks.
9470,29/4/2008,Iraq,Diyala,6,0,6,Six academics are kidnapped and murdered by suspected Sunni extremists.
9471,29/4/2008,Iraq,Kirkuk,4,15,19,Four Iraqis are taken out by Jihadis in a roadside attack.
9472,29/4/2008,Pakistan,Kohat,3,3,6,Militant Muslims gun down three local police officers.
9473,30/4/2008,Thailand,Pattani,3,5,8,Islamic bombers kill three policemen after luring them to their deaths.
9474,30/4/2008,Thailand,Pattani,1,1,2,"A middle-aged man is shot, then burned to death by the Religion of Peace."
9475,30/4/2008,Iraq,Tikrit,2,0,2,A man and woman are kidnapped and tortured to death by suspected Islamic militants.
9476,30/4/2008,Somalia,Mogadishu,17,9,26,Seventeen civilians are killed in a bombing by Islamic terrorists.
9477,1/5/2008,Pakistan,Bara,0,31,31,Thirty-one people are injured when a suicide bomber attacks a rival seminary.
9478,1/5/2008,Iraq,Baghdad,9,23,32,Jihadis murder nine people in a car-bomb attack along a city street.
9479,1/5/2008,Afghanistan,Spin Boldak,8,6,14,Two children are among eight people killed by the Taliban in separate bombing attacks.
9480,1/5/2008,Iraq,Balad Ruz,35,76,111,Two female al-Qaeda suicide bombers take out three dozen Shiites in a brutal attack on a wedding.
9481,2/5/2008,Thailand,Pattani,1,1,2,"Islamists open fire on a group of Buddhists, killing at least one."
9482,2/5/2008,Yemen,Saada,3,0,3,Three local cops are gunned down at a checkpoint by suspected Shia militia.
9483,2/5/2008,Yemen,Saada,9,38,47,A woman and child are among nine people killed when sectarian Jihadis bomb a rival mosque.
9484,2/5/2008,Indonesia,Horale,3,0,3,"A Muslim mob rampages through a Christian village, killing three people and setting fire to churches and homes."
9485,3/5/2008,Iraq,Baghdad,2,7,9,Two Iraqis are killed when Islamic terrorists hit an apartment building with a rocket.
9486,3/5/2008,Iraq,Shirqat,1,2,3,A child is killed by Jihadis during a mortar attack.  Two others are injured.
9487,3/5/2008,Thailand,Yala,1,0,1,Islamists shoot a 47-year-old man to death as he is buying milk.
9488,4/5/2008,Pakistan,Hafizabad,1,0,1,A 19-year-old Christian is tortured and killed for having a relationship with a Muslim woman.
9489,4/5/2008,Sudan,Al-Ain,3,0,3,Three children are killed when the Islamic Republic bombs a village.
9490,4/5/2008,Sudan,Shugag Karo,11,5,16,Eleven civilians are killed when the Islamic Republic bombs a busy market.
9491,4/5/2008,Chechnya,Grozny,6,2,8,Six local cops are killed by Mujahideen bombers in two separate attacks.
9492,4/5/2008,Iraq,Mosul,5,4,9,A female journalist pulled from her car and shot in the head is among five people killed by Islamic terrorists.
9493,4/5/2008,Iraq,Balad,2,0,2,Two women are taken out by Jihadis bombers.
9494,4/5/2008,India,Kishtwar,2,0,2,Two civilians are kidnapped an brutally murdered by Hizb-ul-Mujahideen.
9495,5/5/2008,Thailand,Narathiwat,0,12,12,Three young girls are among a dozen injured when Islamists plant a bomb in front of a house.
9496,5/5/2008,Pakistan,Matta,2,0,2,Two bank guards are murdered by followers of a local cleric.
9497,5/5/2008,Iraq,Mosul,3,2,5,Three prostitutes are shot to death in their apartment by Islamic fundamentalists.
9498,5/5/2008,Iraq,Balad Ruz,10,13,23,Sunni radicals assassinate ten local policemen.
9499,6/5/2008,Iraq,Tikrit,4,27,31,"Sunni radicals detonate a car bomb outside a restaurant, killing four and injuring dozens of others."
9500,6/5/2008,Pakistan,Bannu,3,4,7,Three people are killed by a suicide bomber pulling a rickshaw.
9501,7/5/2008,Philippines,Midsayap,3,10,13,"Suspected Islamists detonate a crude bomb, killing three people waiting for a bus."
9502,7/5/2008,Somalia,Mogadishu,13,0,13,Thirteen civilians are killed when Islamic terrorists ambush an Ethiopian convoy.
9503,7/5/2008,Iraq,Yusufiya,1,0,1,A local teacher is gunned down by religious militants.
9504,7/5/2008,Somalia,Mogadishu,5,1,6,A young girl is among five people killed when Islamic militias detonate a roadside bomb.
9505,7/5/2008,Thailand,Yala,1,0,1,A wood factory worker is brutally murdered by Muslim gunmen.
9506,7/5/2008,Afghanistan,Khost,4,2,6,A child and a scientist are among four killed in two attacks by Islamic terrorists.
9507,7/5/2008,Jordan,Amman,1,0,1,A man shoots his 20-year-old sister three times in the head after learning that she is pregnant outside of marriage.
9508,8/5/2008,Iraq,Baghdad,10,25,35,Mujahideen murder ten Iraqi civilians with a car bombing and rocket attack.
9509,8/5/2008,Pakistan,Swat,1,1,2,"Fundamentalists blow up a music shop and attack a local security base, killing one soldier."
9510,8/5/2008,Iraq,Ramadi,4,8,12,al-Qaeda gunmen kill four Iraqis in a terror attack.
9511,9/5/2008,Israel,Kfar Aza,1,1,2,An Israeli father of four is murdered in a Hamas mortar attack.
9512,9/5/2008,Somalia,Mogadishu,2,13,15,At least two civilians are killed during an ambush by Islamic militia.
9513,9/5/2008,Pakistan,Kabbal,1,2,3,Islamic militants kill a local police officer with a hail of rockets.
9514,10/5/2008,Iraq,Basra,2,5,7,Two civilians are taken out in a roadside bombing.
9515,10/5/2008,Lebanon,Beirut,2,0,2,Two funeral mourners are gunned down by suspected Shia snipers.
9516,10/5/2008,Pakistan,Dera Ismail Khan,3,0,3,Three young Shia men are brutally shot to death by radical Sunnis while sitting in a shop.
9517,11/5/2008,India,Samba,6,5,11,A man and his wife are shot to death in their home by Islamic militants.  A photographer and three other civilians are later killed by the same group.
9518,11/5/2008,Algeria,Medea,6,0,6,Six Algerian soldiers on patrol are ambushed and killed by the Salafist Group for Preaching and Combat.
9519,11/5/2008,Dagestan,Makhachkala,1,0,1,Islamic gunmen open up on a local cop with automatic weapons at point blank range.
9520,12/5/2008,Algeria,Bouira,3,0,3,"Islamic fundamentalists stop a patrol truck with a bomb, then machine-gun three soldiers to death."
9521,12/5/2008,Thailand,Pattani,3,0,3,Three men are murdered in separate attacks by Islamic gunmen.
9522,12/5/2008,Thailand,Narathiwat,2,0,2,Two locals are shot to death by militant Muslims.
9523,12/5/2008,Israel,Moshav Yesha,1,0,1,A 70-year-old woman is killed in her home by a rocket fired by Islamic Jihad in Gaza.
9524,13/5/2008,Thailand,Pattani,2,0,2,Islamists ambush and kill a middle-aged married couple as they are traveling from their job at a rubber plantation.
9525,13/5/2008,Pakistan,Bajur,1,1,2,"Islamic militants attack a military post, killing a local soldier."
9526,13/5/2008,Afghanistan,Kunduz,1,0,1,A teacher is shot to death for saying that suicide bombings are un-Islamic.
9527,13/5/2008,Afghanistan,Helmand,2,6,8,Taliban militants kill two local cops in an ambush.
9528,13/5/2008,Iraq,Nassiriya,1,3,4,Jihadis manage to kill one woman and injure three others with a mortar round.
9529,13/5/2008,Iraq,Mosul,5,4,9,Five Iraqi security personnel are murdered by Sunni bombers.
9530,13/5/2008,India,Jaipur,63,216,279,"A Hindu temple is among several targets of Islamic bombers.  Over sixty innocents, including children, lose their lives in the carnage."
9531,14/5/2008,Iraq,Abu Minasir,25,48,73,"An al-Qaeda suicide bomber detonates at a funeral, killing over twenty innocent people."
9532,14/5/2008,Iraq,Yusufiya,1,7,8,al-Qaeda uses a teenage girl as a suicide bomber to kill another Iraqi.
9533,14/5/2008,Pakistan,Naurak,1,0,1,A man is kidnapped and beheaded by religious extremists.
9534,14/5/2008,Pakistan,Khar,1,0,1,Islamic militants shoot a village guard to death.
9535,14/5/2008,Thailand,Narathiwat,1,0,1,An ice cream vendor is shot to death by Muslim terrorists.
9536,14/5/2008,Israel,Ashkelon,0,15,15,A baby is among fifteen injured when Palestinians send an Iranian-supplied rocket into an Israeli shopping mall.
9537,14/5/2008,Pakistan,Peshawar,1,1,2,Islamic militants ambush and kill a local tribal elder.
9538,15/5/2008,Pakistan,Kohat Cantt,2,1,3,Local Taliban kill two Pakistani soldiers on routine patrol.
9539,15/5/2008,Iraq,al-Anbar,11,0,11,"al-Qaeda operatives invade the home of eleven Iraqi policemen, killing each one."
9540,15/5/2008,Afghanistan,Farah,16,28,44,Sunni extremists use a burqa-clad suicide bomber to blow sixteen people to bits at a marketplace.
9541,15/5/2008,Afghanistan,Kandahar,1,3,4,Sunni extremists kill a local soldier with a remote-controlled bomb.
9542,15/5/2008,Iraq,Jalawla,2,4,6,Jihadis kill two Iraqis with a roadside bomb.
9543,15/5/2008,Pakistan,Spinka Raghda,1,1,2,Taliban militants kill a local soldier with a bomb.
9544,15/5/2008,Germany,Hamburg,1,0,1,A 16-year-old girl is stabbed to death by her brother in an honor killing prompted by her 'Western lifestyle.'
9545,15/5/2008,Dagestan,Gubden,2,1,3,Local Islamists gun down two cops.
9546,16/5/2008,Somalia,Mogadishu,20,25,45,"Mujahideen stage a rocket attack in a commercial district, killing at least twenty people."
9547,16/5/2008,Pakistan,Khar,1,0,1,Tehreek-e-Taliban terrorists kidnap a Pakistani man and cut off his head.
9548,16/5/2008,Iraq,Fallujah,4,9,13,Sunni bomber take down four Iraqis with a bombing attack.
9549,17/5/2008,Iraq,Baqubah,3,15,18,A female suicide bomber blasts at least three Iraqis to Allah.
9550,17/5/2008,Afghanistan,Ghazni,2,4,6,Two local cops are gunned down by Sunni extremists.
9551,17/5/2008,Iraq,Baghdad,7,19,26,"Suspected Shia militia kill seven civilians, including a mother of three."
9552,17/5/2008,Afghanistan,Helmand,2,4,6,Taliban bombers kill two Afghan security personnel.
9553,17/5/2008,Afghanistan,Kandahar,1,4,5,A child is killed when Sunni extremists attach a bomb to a bicycle.
9554,17/5/2008,Afghanistan,Paktia,3,0,3,The Taliban murders three Afghan civilians with a roadside bomb.
9555,18/5/2008,Iraq,Baghdad,2,6,8,Jihadis set a car bomb that kills two Iraqis.
9556,18/5/2008,Afghanistan,Zabul,1,0,1,A Taliban bombing leaves one civilian dead.
9557,18/5/2008,Afghanistan,Helmand,4,8,12,A religious extremist detonates himself and ends the lives of four Afghan civilians.
9558,18/5/2008,Pakistan,Mardan,14,22,36,Fourteen people are blown to bits by a suicide bomber outside a bakery.
9559,18/5/2008,Thailand,Pattani,1,13,14,"Islamists set off two bombs, killing one person."
9560,18/5/2008,Pakistan,Mamirogha,1,1,2,Islamists kill a civilian with a remote-controlled bomb.
9561,19/5/2008,Afghanistan,Wardak,7,0,7,Seven civilians are killed in a Taliban landmine attack.
9562,19/5/2008,Afghanistan,Kabul,1,0,1,A driver for a humanitarian agency is shot to death by Islamic militants.
9563,19/5/2008,Afghanistan,Farah,1,0,1,Taliban extremists kidnap a local policeman and cut off his head.
9564,19/5/2008,Iraq,al-Baaj,11,0,11,Eleven young police recruits are brutally machine-gunned to death by Sunni terrorists.
9565,19/5/2008,Iraq,Suwayra,2,0,2,Two people are kidnapped and tortured.  One is beheaded.  The other shot.
9566,20/5/2008,Thailand,Narathiwat,1,0,1,Islamists gun down a 46-year-old father as he is gassing up his car.
9567,20/5/2008,Afghanistan,Ghazni,1,0,1,An Afghan civilian is killed by a Taliban bomb.
9568,20/5/2008,Iraq,Mandali,1,9,10,A 5-year-old girl is murdered by an al-Qaeda suicide bomber.
9569,20/5/2008,Iraq,Baghdad,2,5,7,"Muslim terrorists bomb a minibus, killing two occupants"
9570,20/5/2008,Iraq,Balad Ruz,3,9,12,"Jihadis fire mortars into a residential district, killing three people."
9571,20/5/2008,Philippines,Patikul,1,4,5,"Abu Sayyaf terrorists ambush a patrol, killing a local soldier."
9572,21/5/2008,China,Shanghai,3,12,15,Responsibility for a bus bombing that kills three people is claimed by the Turkistan Islamic Party.
9573,21/5/2008,Pakistan,Swat,1,0,1,Islamic fundamentalists set fire to two girls' schools and gun down a local cop.
9574,21/5/2008,Afghanistan,Kunar,1,3,4,The Taliban kill a small child in a rocket attack.
9575,21/5/2008,Afghanistan,Paktika,1,4,5,A suicide bomber takes out a civilian.
9576,21/5/2008,Pakistan,Khyber,4,0,4,Islamic militants are thought responsible for the shooting attack that leaves four family members dead.
9577,21/5/2008,Iraq,Rutba,4,3,7,A female suicide bomber murders four Iraqis.
9578,21/5/2008,Iraq,Baghdad,11,3,14,Eleven civilians are killed in a Mujahideen attack.
9579,21/5/2008,Afghanistan,Kunar,1,0,1,The Mujahideen slit the throat of a 32-year-old woman.
9580,22/5/2008,Afghanistan,Kandahar,1,1,2,An Afghan is killed by a bicycle bomb set by religious extremists.
9581,22/5/2008,Afghanistan,Ghazni,3,0,3,Three local guards are kidnapped and murdered by the Taliban with a bullet to the head.
9582,22/5/2008,India,Meerut,3,0,3,Three Hindu youth are brutally tortured and beheaded by a Muslim gang.
9583,23/5/2008,India,Doda,1,0,1,A civilian is murdered by Mujahideen gunmen while collecting flour.
9584,23/5/2008,Somalia,Mogadishu,4,6,10,Four African Union Peacekeepers are killed in a bombing attack by Islamic militia.
9585,23/5/2008,Afghanistan,Khost,5,6,11,"Five Afghans, including a child, are taken out by a suicidal Sunni bomber."
9586,23/5/2008,Pakistan,Tall-Mirali,1,0,1,An Afghan civilian is murdered by Taliban sympathizers.
9587,24/5/2008,Somalia,Mogadishu,5,1,6,A child is among five people killed in an ambush by Islamic militia.
9588,24/5/2008,Iraq,Baghdad,3,6,9,Jihadis place a bomb on a minibus that kills three Iraqis.
9589,24/5/2008,Iraq,Shohada,3,0,3,Three members of the same family are shot to death by Islamic terrorists.
9590,24/5/2008,Pakistan,Peshawar,1,3,4,A civilian is killed by a Taliban roadside blast.
9591,25/5/2008,Pakistan,Peshawar,2,0,2,A police chief and his driver are killed when Islamic militants bomb their car.
9592,25/5/2008,Thailand,Pattani,1,0,1,A 54-year-old policeman is shot to death outside his home by militant Muslims.
9593,26/5/2008,Iraq,Khan Bani Saad,2,0,2,A 6-year-old boy is shot to death along with his father by Islamic fanatics.
9594,26/5/2008,Iraq,Tarmiyah,6,16,22,Six Iraqis are killed by an al-Qaeda suicide bomber.
9595,26/5/2008,Pakistan,Dera Ismail Khan,2,0,2,A policeman and a Sunni civilian are killed in separate sectarian attacks.
9596,26/5/2008,Somalia,Mogadishu,13,8,21,"Thirteen civilians, including children, are killed during an ambush by Islamic militia."
9597,26/5/2008,Thailand,Pattani,1,0,1,Islamic gunmen murder a man inside his home.
9598,26/5/2008,Pakistan,Dera Ismail Khan,4,2,6,Four Shia are shot to death by radical Sunnis.
9599,26/5/2008,Iraq,Baghdad,3,12,15,"An al-Qaeda suicide bomber on a bicycle pedals to paradise, taking three innocents with him."
9600,26/5/2008,India,Kupwara,1,0,1,Islamic militants ambush and kill a local soldier.
9601,27/5/2008,Afghanistan,Farah,8,1,9,Eight civilians are blown to bits by a Taliban bombing attack against their minibus.
9602,27/5/2008,Afghanistan,Logar,4,0,4,Religious extremists murder four local cops with a roadside bomb.
9603,27/5/2008,Somalia,Mogadishu,9,11,20,Nine civilians are killed when Islamic militia attack government troops along a city street.
9604,27/5/2008,Lebanon,Aramoun,1,0,1,A local soldier is killed by Hezbollah supporters.
9605,27/5/2008,Iraq,Tal Afar,4,41,45,A Religion of Peace car bomb takes out four Iraqis.
9606,27/5/2008,Iraq,Baiji,3,0,3,Three pipeline workers are shot to death by Sunni radicals.
9607,27/5/2008,Afghanistan,Kandahar,3,0,3,Three young children playing near by are murdered by a bomb planted under a bridge.
9608,27/5/2008,Afghanistan,Shorabak,9,3,12,Sunni extremists kill nine local police in two bombing attacks.
9609,27/5/2008,Pakistan,Khyber,8,13,21,Islamists clash with each other over religious dispute.  Eight are killed.
9610,28/5/2008,Thailand,Yala,3,11,14,Guests at a wedding party are among the casualties of a series of Jihad attacks that leave 3 people dead.
9611,28/5/2008,Iraq,Qara Tara,2,1,3,"Jihadis bomb a family vehicle, killing a father and son."
9612,29/5/2008,Afghanistan,Ghazni,9,0,9,"Taliban terrorists overrun a small town, killing nine people."
9613,29/5/2008,Iraq,Sinjar,16,14,30,"A suicide bomber targets young police recruits, sending at least sixteen to their death."
9614,29/5/2008,Iraq,Mosul,3,9,12,Three Iraqis are murdered by a suicide bomber.
9615,29/5/2008,Philippines,Zamboanga,3,17,20,Three civilians are murdered in a bomb attack by Islamic terrorists.
9616,29/5/2008,Thailand,Pattani,1,0,1,A 36-year-old man is shot to death by Muslim radicals while sitting in a teashop.
9617,29/5/2008,Afghanistan,Kabul,3,2,5,Two children and a truck driver are blown away by a Religion of Peace car bomb.
9618,29/5/2008,Ethiopia,Nagele,3,5,8,An Islamic group claims responsibility for a bomb blast at a hotel that kills three people and leaves five others maimed.
9619,30/5/2008,Iraq,Diyala,6,8,14,Three women and a child are among six Iraqis killed by Freedom Fighters.
9620,30/5/2008,Pakistan,Kurram,2,0,2,Two people are murdered by suspected Islamists.
9621,30/5/2008,Yemen,Amran,10,26,36,Ten people are killed when a gunman opens fire inside a mosque in an apparent honor attack.
9622,30/5/2008,Afghanistan,Kandahar,1,2,3,A small child is killed by a bicycle bomb planted by Sunni extremists.
9623,31/5/2008,Iraq,Hit,13,18,31,Thirteen Iraqis are blown apart by a religious extremist with a suicide vest.
9624,31/5/2008,Thailand,Narathiwat,1,0,1,A 40-year-old motorcycle dealer is murdered by Islamic gunmen while walking home.
9625,31/5/2008,Lebanon,al-Abedeh,1,0,1,"The Islamic terrorist group, Fatah, kills a local soldier with a bomb blast."
9626,31/5/2008,Afghanistan,Zabul,2,0,2,Taliban gunmen shoot two Afghanis to death.
9627,31/5/2008,Somalia,Mogadishu,1,5,6,A young girl is killed during an ambush by Islamic militia.
9628,31/5/2008,Pakistan,Mamad Ghat,1,0,1,An innocent bystander is killed when a Taliban bomb explodes prematurely.
9629,1/6/2008,Iraq,Jalula,2,4,6,Islamic terrorists murder a 3-year-old boy and his mother with a roadside bomb.
9630,1/6/2008,Iraq,Baghdad,2,5,7,A Jihad car bomb kills two people.
9631,1/6/2008,Thailand,Narathiwat,1,0,1,A Chinese carpet salesman is murdered by Muslim gunmen while sitting in a tea shop.
9632,1/6/2008,Afghanistan,Kabul,1,5,6,The Taliban kill a woman with a remote-controlled bomb.
9633,2/6/2008,Iraq,Mosul,11,45,56,A suicide bomber takes out eleven Iraqis in a brutal attack.
9634,2/6/2008,Pakistan,Islamabad,8,17,25,"Islamists bomb the Danish embassy, presumably over cartoons, killing eight people."
9635,3/6/2008,Afghanistan,Helmand,1,23,24,A suicide bomber kills a young child and injures two dozen others.
9636,3/6/2008,Iraq,al-Katoun,1,0,1,A 5-year-old boy is kidnapped and hung by sectarian Jihadis.
9637,3/6/2008,Iraq,Baquba,1,0,1,An 11-year-old boy is shot to death by Freedom Fighters.
9638,3/6/2008,Thailand,Yala,1,1,2,"Muslim gunmen fire into a home, killing a 15-year-old boy and injuring his 4-year-old sister."
9639,3/6/2008,Thailand,Pattani,1,0,1,A 45-year-old Buddhist is shot to death by Islamic radicals.
9640,3/6/2008,Thailand,Narathiwat,3,0,3,A teenager is among three civilians killed in separate attacks by Muslim militants.
9641,3/6/2008,Somalia,Kismayo,1,1,2,"Islamic militia ambush a government official, killing one of his guards."
9642,3/6/2008,Thailand,Yala,1,4,5,Islamic bombers kill a woman in an attack on a commercial district.
9643,3/6/2008,Pakistan,Kurram,4,7,11,"Two children, ages 11 and 9, are among four killed in a landmine attack by religious extremists."
9644,3/6/2008,Indonesia,Jakarta,0,12,12,"Radical Muslims with machetes attack a group of Christians at a religious tolerance rally, shouting 'Repent or die!'"
9645,4/6/2008,Algeria,Bordj El Kiffan,2,0,2,Two civilians are taken out by a blast from a bomb planted by Islamic fundamentalists.
9646,4/6/2008,Thailand,Narathiwat,2,0,2,"Mujahideen open fire at the half-time of a soccer match, killing the referee and a player."
9647,4/6/2008,Thailand,Yala,1,0,1,A 30-year-old man is killed by Muslim gunmen while out with friends.
9648,4/6/2008,Pakistan,Kohat,3,3,6,Three people are killed in a wave of bombings against video stores by Islamic fundamentalists.
9649,4/6/2008,Afghanistan,Khost,1,19,20,A civilian is killed by a suicide bomber.
9650,4/6/2008,Iraq,Baghdad,25,86,111,"Twenty-five Iraqis are killed in two explosions, one caused by a truck carrying weapons for Shia militia in a residential area."
9651,4/6/2008,Iraq,Fallujah,8,12,20,Freedom Fighters murder eight Iraqis in two attacks.
9652,4/6/2008,Afghanistan,Qarabagh,2,3,5,"The Taliban attack a convoy of fuel tankers, killing two guards."
9653,4/6/2008,Afghanistan,Ghanzi,2,0,2,Two policemen are killed in a bombing by religious extremists.
9654,5/6/2008,Pakistan,Bajaur,1,0,1,A Pakistani soldier is kidnapped and tortured to death by Islamic fundamentalists.
9655,5/6/2008,Afghanistan,Ghazni,2,0,2,Sunni extremists murder two local police with a roadside bomb.
9656,5/6/2008,Israel,Nir-Oz,1,3,4,A father of three is murdered by Palestinians firing rockets into an Israeli residential area.
9657,5/6/2008,Algeria,Bordj El Kiffan,6,4,10,Two al-Qaeda suicide bombers leave six Algerians dead at a cafe and military post.
9658,6/6/2008,Pakistan,Dera Ismail Khan,5,7,12,Five people are killed in a bombing by suspected Islamists.
9659,6/6/2008,Thailand,Songkhla,2,0,2,Two construction workers are murdered by Muslim militants.
9660,6/6/2008,Thailand,Yala,1,0,1,A Buddhist woman is murdered by Islamic gunmen.
9661,6/6/2008,Somalia,Huriwa,5,5,10,Five civilians are killed during an ambush by Islamic militia.
9662,6/6/2008,Thailand,Narathiwat,1,0,1,A middle-aged man is shot to death by Muslim radicals while returning from work.
9663,6/6/2008,Iraq,Ramadi,4,6,10,A female suicide bomber is used in one of two attacks that leave four dead.
9664,6/6/2008,Afghanistan,Nimroz,1,5,6,"A suicide bomber targets Indian engineers working on a road, killing one of them."
9665,7/6/2008,Afghanistan,Helmand,1,0,1,Holy warriors kidnap and murder a journalist.
9666,7/6/2008,Iraq,Kanaan,1,3,4,A small child is killed by Sunni radicals in a roadside attack.
9667,7/6/2008,Iraq,Wihda,8,0,8,"Eight victims of suspected al-Qaeda are found in a mass grave, tortured and executed."
9668,7/6/2008,Iraq,Baghdad,2,7,9,A suicide bomber murders two innocents.
9669,7/6/2008,Iraq,Baghdad,4,18,22,Jihadis take out four Iraqis with a roadside bomb blast.
9670,7/6/2008,Thailand,Narathiwat,1,0,1,Islamists gun down a 23-year-old civilian.
9671,7/6/2008,Somalia,Kismayo,1,0,1,A journalist is shot to death by Muslim militants.
9672,8/6/2008,Algeria,Lakhdaria,13,8,21,"Fundamentalists stage a double bomb attack, killing those who rushed to help victims of the first blast."
9673,8/6/2008,Afghanistan,Khost,4,0,4,Four Afghans are shot to death at point-blank range by Talibanis while sitting in their car.
9674,8/6/2008,Somalia,Mogadishu,20,44,64,"Islamists ambush a military convoy in a civilian district, leaving some twenty people dead."
9675,8/6/2008,Pakistan,Chitral,4,0,4,Four children are killed in an explosion triggered by Holy Warriors.
9676,8/6/2008,Pakistan,Matani,4,1,5,Four police are ambushed and killed by Jihadis while sitting in their van.
9677,8/6/2008,Iraq,Aziziya,6,0,6,Six shepherds are brutally murdered by Mujahideen.
9678,8/6/2008,Iraq,Khanaqin,5,0,5,Five people at a market are gunned down by Sunni militants.
9679,8/6/2008,Iraq,Baghdad,8,38,46,Jihadis take out eight innocents in two bombing attacks.
9680,8/6/2008,Afghanistan,Ghazni,8,0,8,Eight Afghan are murdered in a Mujahideen ambush.
9681,8/6/2008,Ingushetia,Nazran,1,0,1,A local cop is gunned down by suspected Islamists.
9682,8/6/2008,Somalia,Baidoa,1,0,1,A government official is assassinated by religious radicals.
9683,9/6/2008,Algeria,Bouira,20,0,20,"Islamic fundamentalists bomb a bus stop, killing twenty ordinary people."
9684,9/6/2008,Afghanistan,Ghazni,5,0,5,The Taliban murder five local police in two shootings.
9685,9/6/2008,Iraq,Baghdad,4,12,16,"Militant Sunnis detonate a bomb along a city street, killing four passers-by."
9686,9/6/2008,Thailand,Yala,1,0,1,"Thai Islamists ambush a local police chief, then set his body on fire in front of his wife."
9687,9/6/2008,Pakistan,Kurram,1,6,7,al-Qaeda-backed militants kill a civilian in his home with a mortar attack.
9688,10/6/2008,India,Kangan,1,0,1,Hizb-ul-Mujahideen abduct a 42-year-old civilian from his home and then murder him in captivity.
9689,10/6/2008,Thailand,Narathiwat,2,0,2,Mujahideen shoot and kill two young men riding a motorcycle.
9690,10/6/2008,Somalia,Baidoa,2,0,2,A taxi driver and another civilian are shot to death by Islamists.
9691,10/6/2008,Somalia,Mogadishu,1,0,1,A government official is murdered by Islamic gunmen.
9692,10/6/2008,Somalia,Mogadishu,6,2,8,Islamic hardliners kill six Somalis in a savage ambush.
9693,11/6/2008,Somalia,Mogadishu,2,0,2,The head of a humanitarian agency and his driver are shot to death by Muslim militia.
9694,11/6/2008,Pakistan,Bajaur,1,0,1,A prostitute is murdered by religious fundamentalists.
9695,11/6/2008,Iraq,Baghdad,5,10,15,Jihads successfully kill five people with a bombing attack on a minibus.
9696,11/6/2008,Iraq,Fallujah,5,0,5,Five Iraqis are kidnapped and tortured to death by Sunni terrorists.
9697,11/6/2008,Pakistan,Bajaur,1,0,1,A civilian is shot to death by Muslim radicals.
9698,11/6/2008,Thailand,Pattani,1,2,3,Islamist gunmen kill a father in an attack that leaves his two daughters injured as well.
9699,12/6/2008,Bangladesh,West Bengal,0,15,15,"Fifteen Hindu pilgrims, including women and children, are burned by Molotov cocktails thrown by a Muslim mob."
9700,12/6/2008,England,Forest Gate,0,1,1,A Hindu man is set on fire for dating a Muslim girl.
9701,12/6/2008,Pakistan,Dattakhel,5,0,5,Five local family members are pulled out of a house and murdered by Islamic fundamentalists.
9702,12/6/2008,Pal. Auth.,Beit Lahiya,4,0,4,"Four civilians, including a 4-month-old baby, are among seven killed in a Hamas explosion."
9703,12/6/2008,Somalia,Mogadishu,5,5,10,A child is among five civilians murdered by the Mujahideen in a mortar attack.
9704,12/6/2008,Somalia,Leego,1,0,1,A UN food convoy driver is shot by suspected Islamic militia gunmen.
9705,13/6/2008,Ingushetia,Naran,4,4,8,"Islamic fundamentalists detonate a bomb at a building storing alcohol, killing at least four innocents."
9706,13/6/2008,India,Watsar,5,0,5,Five local soldiers are ambushed and killed by Lashkar-e-Toiba terrorists.
9707,13/6/2008,Iraq,Tuz Khormato,3,0,3,A father and son are among three people shot to death by Mujahideen.
9708,13/6/2008,Afghanistan,Kandahar,15,0,15,At least fifteen local prison guards are killed when Taliban militants storm the facility with two suicide bombers.
9709,13/6/2008,Dagestan,Makhchkala,1,0,1,A bomb planted by suspected Islamists kills a jogger.
9710,13/6/2008,Chechnya,Benoi-Vedeno,3,0,3,Mujahideen kill three locals in a sustained attack on their village.
9711,14/6/2008,Iraq,Mosul,2,0,2,Two brothers are shot to death outside their home by Holy Warriors.
9712,14/6/2008,Iraq,Baghdad,2,7,9,Jihadis kill two people with a bomb on a minibus.
9713,14/6/2008,Afghanistan,Helmand,4,1,5,Religious extremists kill four US Marines training local security forces.
9714,14/6/2008,Somalia,Mogadishu,4,0,4,Two women are among four civilians abducted and murdered by suspected Islamic militia.
9715,14/6/2008,Pakistan,Sanghar,1,16,17,Sunni extremists are thought responsible for a bomb at a tea shop that kills a young boy.
9716,15/6/2008,Iraq,Mosul,2,1,3,A college professor is among two people shot to death by Freedom Fighters.
9717,15/6/2008,Iraq,Baghdad,3,1,4,"Three members of a family, including two women, are murdered by Sunni militants in a home invasion."
9718,15/6/2008,Afghanistan,Helmand,1,1,2,The Taliban kill a local police chief with a remote-controlled bomb.
9719,15/6/2008,Afghanistan,Khost,1,0,1,A 12-year-old boy is killed by Taliban bombers as he is walking to school.
9720,15/6/2008,Iraq,Baghdad,0,34,34,A female suicide bomber targets soccer fans celebrating a victory.
9721,15/6/2008,Pakistan,FATA,5,7,12,Islamic militants kill five people in two landmine attacks.
9722,16/6/2008,Pakistan,Dera Ismail Khan,4,5,9,Four Shiites praying at a mosque are blown to bits by radical Sunnis.
9723,16/6/2008,Chechnya,Grozny,3,5,8,Three border guards are murdered in a Jihad ambush on their vehicle.
9724,16/6/2008,Iraq,Baghdad,4,31,35,A double suicide bombing is one of two attacks that leaves four civilians dead.
9725,16/6/2008,Lebanon,Bekaa,3,4,7,Three people are killed in a sectarian clash.
9726,16/6/2008,Pakistan,Torchapar,1,0,1,Local Islamists kidnap and murder a village elder.
9727,17/6/2008,Thailand,Narathiwat,1,0,1,A 45-year-old widow and mother of five is chased down and shot by Holy Warriors.
9728,17/6/2008,Pakistan,Hangu,4,0,4,Four members of a Shia family are murdered in their car by Sunni gunmen.
9729,17/6/2008,Iraq,Mosul,1,0,1,Religious extremists gun down a journalist who had presented segments on Islam and culture.
9730,17/6/2008,Iraq,Baghdad,63,78,141,"Shiite radicals bomb an open-air market, slaughtering over sixty shoppers and vendors."
9731,17/6/2008,Somalia,Mogadishu,3,17,20,Three civilians are killed when Islamic militia open fire on government troops.
9732,17/6/2008,Iraq,al-Saba Abkar,4,2,6,"A suicide bicycle bomber pedals to paradise, taking four Iraqis with him."
9733,17/6/2008,Somalia,Mogadishu,3,2,5,"Islamic militants fire a mortar into a home, killing three civilians."
9734,18/6/2008,Iraq,Nineveh,12,0,12,A report surfaces of a dozen Christian children kidnapped and crucified by Muslim extremists over the course of five years.
9735,18/6/2008,Thailand,Pattani,2,5,7,Two members of a security patrol die from shrapnel injuries following a roadside blast set off by Mujahideen.
9736,18/6/2008,Afghanistan,Khost,4,3,7,Four local cops are killed in a Taliban bombing.
9737,18/6/2008,Somalia,Mogadishu,4,3,7,Four local police are killed by a roadside bomb detonated by Islamists.
9738,19/6/2008,Pakistan,Kharian,1,0,1,A man shoots his sister-in-law to death on suspicion of 'bad character.'
9739,19/6/2008,Thailand,Yala,2,0,2,A 3-year-old boy and his father are gunned down by the Religion of Peace.
9740,19/6/2008,Pakistan,Kurram,7,10,17,Clashes between Sunni and Shia leave at least seven dead.
9741,19/6/2008,Pakistan,Kurram,4,0,4,"Muslim radicals ambush a food relief convoy, killing the driver and three others, and then setting fire to the goods."
9742,19/6/2008,Iraq,Tuz Khormato,1,0,1,A man is kidnapped and tortured to death by Mujahid.
9743,19/6/2008,Pakistan,Hajira,4,3,7,Four local soldiers are killed by Islamic terrorists.
9744,20/6/2008,Thailand,Yala,1,4,5,"Islamic gunmen open up on a truck, killing an occupant."
9745,20/6/2008,Somalia,Mogadishu,13,30,43,At least two children are among thirteen civilians killed in attacks by Islamic militia.
9746,20/6/2008,Israel,Neveh Tzuf,0,2,2,Masked Palestinians shoot two Israelis in a brutal drive-by attack.
9747,20/6/2008,Afghanistan,Helmand,7,10,17,Children are among the casualties when a suicide bomber detonates in a crowded market.
9748,20/6/2008,France,Paris,0,1,1,A 17-year-old Hassidic Jew is beaten into a coma by Muslim immigrants.
9749,20/6/2008,Iraq,Baghdad,3,8,11,A Jihad car bombing kills eight Iraqis.
9750,20/6/2008,Afghanistan,Zabul,2,3,5,Two local soldiers are killed in a bomb attack by religious extremists.
9751,21/6/2008,Pakistan,Khyber,29,50,79,"Feuding religious sects clash, leaving about thirty people dead."
9752,21/6/2008,Afghanistan,Kunar,1,2,3,"Extremists send a rocket into a hospital, killing at least one person."
9753,21/6/2008,Iraq,Baquba,2,0,2,Two brothers are kidnapped and killed.
9754,21/6/2008,Thailand,Narathiwat,4,0,4,Four railway workers are gunned down in cold blood by radical Muslims.
9755,21/6/2008,Afghanistan,Khost,4,8,12,A woman and three children are taken out by a Mujahid rocket attack.
9756,22/6/2008,Lebanon,Tripoli,9,35,44,Nine people are killed in sectarian clashes within the Religion of Peace.
9757,22/6/2008,Iraq,Kirkuk,3,2,5,Two women are among three killed in a Mujahideen bombing.
9758,22/6/2008,Iraq,Khalis,7,12,19,Jihadis murder seven Iraqis in a mortar attack on a residential neighborhood.
9759,22/6/2008,India,Srinagar,1,0,1,Lashkar-e-Taiba members ambush and kill an Indian soldier.
9760,22/6/2008,Iraq,Baqubah,17,42,59,A female suicide bomber massacres seventeen Iraqis.
9761,22/6/2008,Somalia,Dharkenley,3,4,7,Three local soldiers are killed in an Islamic militia bombing.
9762,23/6/2008,Dagestan,Buinaksk,1,0,1,A police chief succumbs after being sprayed with automatic weapons fire.
9763,23/6/2008,Pakistan,Jandola,16,10,26,"Islamic militants attack pro-government tribesmen, killing at least sixteen."
9764,23/6/2008,Iraq,Mosul,4,2,6,A woman and a university student are among four murdered by Islamic gunmen.
9765,23/6/2008,Lebanon,Tripoli,2,0,2,Two more people are killed in sectarian violence.
9766,23/6/2008,Pakistan,Kurram,11,0,11,Eleven kidnapped Shias are brutally beheaded by Sunni radicals.
9767,23/6/2008,Afghanistan,Shindand,5,19,24,A suicide car bomber takes out five Afghan civilians.
9768,23/6/2008,Afghanistan,Kandahar,3,0,3,Taliban militants kill three local police in a brutal ambush.
9769,24/6/2008,Iraq,Mosul,2,75,77,A baby is among two people killed by a Fedayeen suicide bomber.
9770,24/6/2008,Iraq,Baghdad,11,11,22,Eleven people are killed when Islamic militants set off a bomb at a government building.
9771,24/6/2008,Afghanistan,Herat,1,0,1,A policewoman is murdered by fundamentalists as she is walking home from work.
9772,24/6/2008,Lebanon,Tripoli,1,0,1,Another person is killed in a sectarian clash.
9773,24/6/2008,Somalia,Kismayo,1,2,3,A local official is assassinated by suspected Islamists.
9774,25/6/2008,Iraq,Baghdad,5,25,30,Two Jihad bombings leave five Iraqis dead.
9775,25/6/2008,Pakistan,Jandola,28,0,28,Twenty-eight members of a local peace council are murdered by the Taliban.
9776,25/6/2008,Somalia,Deynile,9,0,9,Nine local police are ambushed and killed by Islamic militia.
9777,26/6/2008,Pakistan,Barikot,7,0,7,Islamists burn down a girls school and kill a family of seven.
9778,26/6/2008,Iraq,Karma,20,24,44,A Fedayeen suicide bomber murders twenty innocents.
9779,26/6/2008,Iraq,Mosul,17,62,79,Jihadis successfully take out seventeen Iraqis with a well-placed car bomb.
9780,27/6/2008,Algeria,Jijel,6,14,20,Six security personnel are taken out by al-Qaeda gunmen.
9781,27/6/2008,Chechnya,Vedeno,4,0,4,Four police are ambushed and killed by Jihad fighters.
9782,27/6/2008,Iraq,Khanaqin,1,2,3,Islamic militants kill a shepherd with a well-placed bomb.
9783,27/6/2008,Iraq,Shurqat,2,3,5,al-Qaeda takes out two Iraqis with a roadside blast.
9784,27/6/2008,Pakistan,Damadola,2,0,2,"A mob screaming ""Allah Akbar"" slits the throats of two Afghans, then beheads them."
9785,27/6/2008,Thailand,Pattani,1,0,1,A 64-year-old man is murdered by Islamic gunmen.
9786,27/6/2008,Thailand,Narathiwat,1,1,2,A 36-year-old civilian is shot to death by Mujahid after dropping his children off at school.
9787,28/6/2008,Iraq,Samarrah,7,0,7,"Seven dead torture victims, including a woman, are found in an al-Qaeda hideout."
9788,28/6/2008,Lebanon,Tripoli,2,25,27,"Shia terrorists detonate a bomb in an apartment building, killing two residents."
9789,28/6/2008,Iraq,Samarrah,50,0,50,A mass grave is discovered containing women and children among fifty people rounded up by Sunni militants and executed.
9790,28/6/2008,Pakistan,Khyber,8,5,13,A sectarian disagreement leaves eight dead.
9791,28/6/2008,Afghanistan,Faryab,8,0,8,Eight local cops are ambushed and killed by Talibanis.
9792,29/6/2008,Afghanistan,Farah,4,5,9,"Religious extremists attack a local police post, killing four officers."
9793,29/6/2008,Pakistan,Swat,6,5,11,Islamic militants kill six people in at least two separate bombings.
9794,29/6/2008,Iraq,Udhaim,3,0,3,Mujahid kill two women and a child with a mortar attack on their home.
9795,29/6/2008,Iraq,Duluiya,7,3,10,A Fedayeen suicide bomber murders seven Iraqis.
9796,29/6/2008,Pakistan,Swat,1,0,1,A civilian is beheaded by Sunni radicals.
9797,30/6/2008,Thailand,Yala,1,0,1,A 46-year-old man is shot to death by Islamic terrorists.
9798,30/6/2008,Somalia,Mogadishu,1,0,1,Muslim radicals kidnap and kill a humanitarian aid worker.
9799,1/7/2008,Philippines,Aleosan,1,0,1,A Christian man is shot to death after refusing to give up his property to Moro Islamic Front raiders.
9800,1/7/2008,Pakistan,Swat,5,3,8,An elderly woman is among five people shot to death by Islamists in four separate attacks.
9801,1/7/2008,Somalia,Mataban,53,40,93,Fifty-three people are killed in a series of ambushes by Islamic militants.
9802,1/7/2008,Iraq,Buhriz,3,1,4,Three members of the same family are murdered by Mujahideen bombers.
9803,1/7/2008,Iraq,Mandali,4,16,20,A Fedayeen suicide bomber sends four Iraqis to Allah.
9804,1/7/2008,Iraq,Mosul,2,32,34,Two Jihad bombs leave two dead and about forty wounded.
9805,1/7/2008,Afghanistan,Lashkar Gah,2,7,9,Taliban bombers kill two local policemen.
9806,2/7/2008,Iraq,Baghdad,3,6,9,A street sweeper is among three people killed in a Mujahideen roadside bombing.
9807,2/7/2008,Israel,Jerusalem,3,57,60,"Two teachers, including a mother, are among three people are killed when a Palestinian goes on a violent rampage with a bulldozer."
9808,2/7/2008,Thailand,Narathiwat,1,0,1,Islamic gunmen murder a woman shortly after she drops her daughter off at school.
9809,2/7/2008,Afghanistan,Logar,5,0,5,The Taliban murder five local soldiers with a roadside blast.
9810,2/7/2008,India,Bhaderwah,1,20,21,A man later dies of injuries suffered when Islamists toss a grenade into the street.
9811,2/7/2008,Afghanistan,Nimroz,5,2,7,Five people are murdered by a Fedayeen suicide bomber.
9812,3/7/2008,Iraq,Samarra,14,0,14,Fourteen victims of Sunni terrorists are discovered in a mass grave.
9813,3/7/2008,Pakistan,Khyber,5,4,9,Five people are killed when rival Islamist groups clash.
9814,3/7/2008,Iraq,Baghdad,4,8,12,Four Iraqis are blown apart by an Islamist bomb.
9815,3/7/2008,Afghanistan,Kandahar,8,3,11,Eight local police are killed in a brutal ambush by Sunni militants.
9816,3/7/2008,Thailand,Yala,1,0,1,A school principal is shot to death by Muslim radicals.
9817,3/7/2008,Somalia,Hiiran,10,0,10,Ten civilians are killed in an ambush by Islamic militia.
9818,4/7/2008,Thailand,Yala,1,1,2,"Islamists shoot a Buddhist, hammer nails through his hands, behead him and then set his body on fire.  The man's son is seriously injured as well."
9819,4/7/2008,Thailand,Pattani,1,0,1,A retired schoolteacher is gunned down by Islamic militants.
9820,4/7/2008,Thailand,Yala,1,0,1,Muslim radicals shoot a 42-year-old man to death.
9821,4/7/2008,India,Kupwara,5,0,5,Five Indian army personnel are massacred in a Mujahideen ambush.
9822,4/7/2008,Afghanistan,Maidan-Wardak,2,5,7,Two Afghan security personnel are taken out in a Taliban bombing.
9823,4/7/2008,Afghanistan,Kandahar,1,0,1,Islamic hardliners are suspected in the assassination of a local official walking home from work.
9824,5/7/2008,Somalia,Mogadishu,6,0,6,A married couple is blown up with four others by a bomb planted by Islamic fundamentalists.
9825,5/7/2008,Iraq,Mosul,3,6,9,Islamic militants manage to kill three Iraqis in two bombing and shooting attacks.
9826,5/7/2008,Thailand,Yala,4,4,8,"Muslim gunmen open up on a crowd eating breakfast at a tea shop, killing four."
9827,6/7/2008,Philippines,Kauswagan,5,0,5,Five people are killed in a shooting attack on a bus by suspected Moro Islamic terrorists.
9828,6/7/2008,Iraq,Mussayab,1,0,1,Suspected fundamentalists kidnap and torture a woman to death.
9829,6/7/2008,Iraq,Jalawla,7,12,19,Seven members of the same family are murdered by a well-placed roadside bomb.
9830,6/7/2008,Iraq,Baghdad,6,14,20,Jihadis kill six Iraqis with a car bomb.
9831,6/7/2008,Pakistan,Islamabad,19,23,42,A brutal suicide attack by a teenager near a market and a police station leaves about two dozen dead and many more maimed and bloodied.
9832,6/7/2008,Somalia,Mogadishu,1,0,1,Islamists gun down a UN official in charge of development.
9833,6/7/2008,USA,"Atlanta, Georgia",1,0,1,A devout Muslim strangles his 25-year-old daughter in an honor killing.
9834,6/7/2008,Pakistan,Quetta,1,1,2,A prominent Shia is killed in a sectarian killing that also leaves a young boy injured.
9835,7/7/2008,Thailand,Pattani,2,3,5,"Islamists open fire on a bus full of Buddhist teenagers, killing two guards."
9836,7/7/2008,Afghanistan,Kabul,65,147,212,"Sunni hardliners bomb an Indian embassy, killing over sixty people, including seventeen children."
9837,7/7/2008,Somalia,Baidoa,2,7,9,"al-Shabaab terrorists attack a government facility, killing two people."
9838,7/7/2008,Iraq,Baghdad,17,40,57,"Various attacks by the Mujahideen leave about seventeen innocent people dead, including women."
9839,7/7/2008,Pakistan,Swat,1,0,1,A religious leader is killed by rival Muslims.
9840,7/7/2008,Pakistan,Quetta,1,0,1,A Shia lawyer is shot to death by sectarian rivals.
9841,8/7/2008,India,Joynagar,1,0,1,A Hindu monk is tied to a tree and severely beaten by a Muslim mob.
9842,8/7/2008,Iraq,Ramadi,22,0,22,Twenty-two victims of sectarian violence are discovered buried at an elementary school.
9843,8/7/2008,Iraq,Mosul,4,8,12,Sunni bombers kill four contractors traveling in a vehicle.
9844,8/7/2008,Thailand,Pattani,2,0,2,"A husband and wife team of laborers is shot, showered with gas and then burned by radical Muslims."
9845,8/7/2008,Pakistan,Karachi,1,37,38,"Religious hardliners set off a series of bombs, killing at least one person."
9846,8/7/2008,Pakistan,Bara,5,3,8,"Hardliners ambush a security vehicle, killing five local cops."
9847,8/7/2008,Philippines,Pagangan,1,0,1,A farmer is killed following an ambush by Moro Islamists.
9848,9/7/2008,Turkey,Istanbul,3,0,3,al-Qaeda gunmen stage a brutal attack on the US consulate that leaves three guards dead.
9849,9/7/2008,Jordan,Mafraq,1,0,1,A 16-year-old girl is stabbed to death by her brother on suspicion of pre-marital sex.
9850,9/7/2008,Sudan,Umm Hakibah,7,22,29,"Janjaweed militants attack a group of Africans working as UN peacekeepers, killing seven."
9851,9/7/2008,Ingushetia,Muzhichi,3,0,3,Islamic rebels kill three local policemen in a shooting attack.
9852,9/7/2008,Pakistan,Mardan,2,1,3,"Islamic militants fire on a police van, killing two officers."
9853,9/7/2008,Iraq,Mosul,8,41,49,Eight Iraqis are murdered by Mujahideen bombers.
9854,9/7/2008,Iraq,Fallujah,6,18,24,Six elderly people are blown apart by a double bombing at a mosque.
9855,9/7/2008,Iraq,Baghdad,6,8,14,"Muslim gunmen fire inside a rival mosque, murdering four attendees."
9856,9/7/2008,Iraq,Baqubah,4,11,15,"Jihadis bomb a funeral procession, killing four mourners."
9857,9/7/2008,Lebanon,Tripoli,4,54,58,Four people are killed in a Religion of Peace sectarian clash.
9858,9/7/2008,Pakistan,Kurram,1,1,2,One man is killed and another loses his leg after an encounter with the handiwork of Taliban bombers.
9859,10/7/2008,Somalia,Afgyoye,1,0,1,Islamists with automatic weapons shoot a Christian man to death for not praying toward Mecca.
9860,10/7/2008,India,Kupwara,1,1,2,"Islamic militants ambush two local police, killing one."
9861,10/7/2008,Pakistan,Kurram,7,12,19,The Taliban kill seven civilians in two landmine attacks.
9862,10/7/2008,Pakistan,Dosli,1,0,1,A doctor is shot four times in the chest.  A note pinned to the body accuses him of 'opposing Islam and Jihad.'
9863,10/7/2008,Pakistan,Khyber,8,0,8,Two women are among eight killed when militants fire mortars into two homes.
9864,10/7/2008,Pakistan,Tirah,5,15,20,"Rival Islamist groups clash, leaving five people dead."
9865,10/7/2008,Iraq,Baghdad,2,13,15,Two civilians are murdered when Jihadis detonate a car bomb in a residential neighborhood.
9866,10/7/2008,Somalia,Baidoa,2,4,6,Two local soldiers are beheaded by the Al-Shabaab Islamist group.
9867,10/7/2008,Pakistan,Bajaur,1,2,3,Islamic militants kill a 15-year-old girl in a targeted rocket attack on a home.
9868,11/7/2008,Somalia,Taredishe,1,0,1,Suspected Islamic militia gun down two aid workers in separate attacks as they are handing out food.
9869,11/7/2008,Pakistan,Karachi,1,0,1,The head of a Shia mosque is murdered by Sunni gunmen.
9870,12/7/2008,Chechnya,Grozny,1,2,3,"Mujahideen detonate a bomb hidden in a trash can, killing one person."
9871,12/7/2008,Afghanistan,Bargi Matal,1,0,1,A youth is killed defending his village from a Taliban attack.
9872,12/7/2008,Pakistan,Hangu,16,0,16,"Sixteen pro-government tribesmen are killed by the Taliban, eight by execution."
9873,12/7/2008,Iraq,Tal Afar,7,0,7,The bodies of seven people kidnapped by Islamic terrorists are discovered.
9874,12/7/2008,Iraq,Mosul,3,4,7,A woman and two local cops are murdered by Sunni radicals in separate attacks.
9875,12/7/2008,Afghanistan,Helmand,4,5,9,A Fedayeen bomber in a suicide vest kills four local soldiers on routine patrol.
9876,12/7/2008,Pakistan,Tirah,7,5,12,Two women are among seven people killed in clashes between rival Islamist groups.
9877,12/7/2008,Afghanistan,Ghazi,2,0,2,"The Taliban force two female prostitutes to their knees, then shoot them."
9878,12/7/2008,Algeria,Beni Djemaa,1,0,1,Fundamentalists behead a 66-year-old farmer.
9879,13/7/2008,Iraq,Baghdad,11,18,29,Eleven Iraqis are killed in at least three Mujahid attacks around the country.
9880,13/7/2008,Pakistan,Kharqamar,1,0,1,A civilian is abducted and beheaded by devoted members of the Religion of Peace.
9881,13/7/2008,Pakistan,Khyber,6,10,16,Lashkar-e-Islam and Ansar-ul-Islam continue to work out their differences (six more dead).
9882,13/7/2008,Afghanistan,Oruzgan,25,30,55,A suicide attack near a busy market leaves over two dozen people dead.
9883,14/7/2008,Pakistan,Balochistan,5,0,5,Five women are tortured and buried alive for wanting to marry by choice.
9884,14/7/2008,Somalia,Mogadishu,2,2,4,Two woman are murdered in a shooting attack by Mujahideen.
9885,14/7/2008,Somalia,Mogadishu,1,0,1,Islamic militia gun down a man sitting in a tea shop.
9886,14/7/2008,Iraq,Baghdad,3,14,17,Three people are killed when a Muslim terrorist tosses a grenade into a gathering.
9887,14/7/2008,Thailand,Songkhla,1,1,2,"A local security patrol is ambushed by Islamic militants, leaving one member dead."
9888,14/7/2008,India,Doda,1,2,3,"Islamists toss a grenade into a police station, killing at least one local officer."
9889,14/7/2008,Afghanistan,Paktika,7,2,9,"Sunni extremists take out a car with a roadside bomb, killing seven civilians."
9890,14/7/2008,Somalia,Mogadishu,4,4,8,Islamic militia kill four local soldiers in two ambushes.
9891,15/7/2008,Iraq,Baqubah,35,69,104,"Fedayeen bombers massacre nearly forty Iraqis, including first responders."
9892,15/7/2008,Chechnya,Grozny,1,3,4,A local cop is murdered in a staged Mujahideen ambush.
9893,15/7/2008,Pakistan,Khyber,7,5,12,Rival Islamic groups continue to work out their differences by shooting at each other (seven more dead).
9894,15/7/2008,Iraq,Mosul,12,6,18,Two suicide bombers take out a dozen Iraqis in separate attacks.
9895,16/7/2008,Somalia,Anjel,1,0,1,A Muslim gang murders a Christian man.
9896,16/7/2008,Pakistan,Lahore,1,0,1,"A teenaged Christian boy is kidnapped, tortured for two days, then killed by Muslims for dating a Muslim girl."
9897,16/7/2008,India,Doda,1,0,1,Islamic militants abduct and murder a civilian.
9898,16/7/2008,Iraq,Baghdad,3,7,10,"A female al-Qaeda suicide bomber detonates in the house a Sunni family, killing three people."
9899,16/7/2008,Iraq,Mosul,2,9,11,Jihadis kill two Iraqis with a car bomb.
9900,16/7/2008,Iraq,Tal Afar,18,90,108,"Mujahideen detonate a car bomb along a city street, slaughtering at least eighteen Iraqis, including seven children."
9901,17/7/2008,Somalia,Huriwa,5,3,8,A mother and her two children are among five killed when Holy Warriors stage an ambush.
9902,17/7/2008,India,Murshidabad,1,0,1,"A Hindu man is beheaded by Muslims, angry that he married a Muslim woman."
9903,17/7/2008,Afghanistan,Zabul,1,5,6,"Taliban militants attack a convoy, killing an Afghan."
9904,17/7/2008,Pakistan,Mohmand,3,0,3,Three people are killed when rival Islamist groups clash.
9905,18/7/2008,India,Udhampur,1,0,1,A civilian is abducted and murdered by the Hizb-ul-Mujahideen.
9906,18/7/2008,Afghanistan,Helmand,3,4,7,Three Afghan guards are killed when religious hardliners bomb their convoy.
9907,18/7/2008,Iraq,Mosul,4,7,11,A Fedayeen suicide bomber takes out four Iraqis.
9908,18/7/2008,Somalia,Mogadishu,3,0,3,Muslim gunmen shoot three elders to death for helping humanitarian efforts.
9909,18/7/2008,India,Banihal,0,36,36,"Three dozen people, mostly women and children, are injured when Islamic terrorists toss a grenade into a crowded market."
9910,18/7/2008,Pakistan,South Waziristan,3,0,3,Three civilians are brutally executed by al-Qaeda backed militants.
9911,18/7/2008,Pakistan,North Waziristan,1,0,1,The head of a local madrassa is gunned down by sectarian rivals.
9912,19/7/2008,Ethiopia,Jijiga,0,2,2,Two former Muslims who converted to Christianity are attacked by a stone-throwing mob of Muslims.
9913,19/7/2008,Turkey,Bosphorus,1,0,1,A gay man is shot to death in a suspected 'honor' killing.
9914,19/7/2008,Pal. Auth.,Jabaliya,1,0,1,Suspected Hamas militants shoot a Fatah activist in his home.
9915,19/7/2008,Pakistan,Tirah,9,10,19,"Lashkar-e-Islam and Ansar-ul-Islam clash over sectarian differences, leaving nine people dead."
9916,19/7/2008,Afghanistan,Kandahar,4,1,5,Sunni extremists murder four local cops with a roadside bomb.
9917,19/7/2008,Lebanon,Ain el-Helweh,1,0,1,Jund al-Sham gunmen take out a member of a reconciliation committee.
9918,19/7/2008,Iraq,Tikrit,3,0,3,Freedom Fighters kill three Iraqis with automatic weapons.
9919,19/7/2008,India,Srinagar,10,16,26,Hizb-ul-Mujahedeen kill ten Indian soldiers in transport with a horrific bomb attack on their convoy.
9920,19/7/2008,Pakistan,Mohmand,4,0,4,The Taliban murder four hostages in cold blood.
9921,20/7/2008,Afghanistan,Laghman,6,0,6,Six civilians are killed when Sunni hardliners blow up a fuel truck and a nearby minibus with a rocket.
9922,20/7/2008,India,Gulmarg,2,5,7,An 8-year-old boy is among two people killed when Islamic terrorists toss a grenade into a resort.
9923,20/7/2008,India,Reasi,1,0,1,A civilian is shot to death outside his home by Mujahideen.
9924,20/7/2008,Iraq,Basra,1,0,1,A suspected prostitute is shot to death by fundamentalists.
9925,20/7/2008,Chechnya,Grozny,3,0,3,Suspect Islamic rebels kill three policemen in cold blood.
9926,20/7/2008,Somalia,Mogadishu,6,11,17,Six people are killed when Islamic hardliners attack a government patrol along a city street.
9927,20/7/2008,Thailand,Pattani,3,0,3,Islamic terrorists shoot three villagers to death.
9928,21/7/2008,Pakistan,Bajur,1,2,3,Islamic militants gun down an elderly man riding in a car.
9929,21/7/2008,Afghanistan,Paktika,1,3,4,"Sunni extremists attack the home of a former governor, killing him and injuring members of his family."
9930,21/7/2008,Iraq,Saidiya,7,8,15,al-Qaeda kill seven Iraqis by planting a bomb on a tractor.
9931,21/7/2008,Iraq,Mosul,6,8,14,Freedom Fighters murder six Iraqis in various attacks.
9932,21/7/2008,Somalia,Mogadishu,7,12,19,Three children are among seven killed in an Islamic militia mortar attack.
9933,21/7/2008,Afghanistan,North Waziristan,2,0,2,Two civilians are abducted and murdered by Talibanis.
9934,21/7/2008,China,Kunming,2,10,12,The Turkistan Islamic Party takes credit for a bus bombing that leaves two dead.
9935,22/7/2008,Israel,Jerusalem,0,11,11,A Palestinian attempts to run Israelis down with a bulldozer.
9936,22/7/2008,Thailand,Narathiwat,1,5,6,A local soldier is killed in an Islamist bomb blast.
9937,22/7/2008,Thailand,Narathiwat,1,0,1,A 41-year-old rubber worker is shot to death by Muslim militants.
9938,22/7/2008,Afghanistan,Khost,4,3,7,A woman and child are among four civilians blown up by Sunni bombers.
9939,22/7/2008,Afghanistan,Ghazni,4,1,5,The Taliban kidnaps a man after invading his home and killing his four sons.
9940,22/7/2008,Philippines,Aleosan,1,1,2,Moro Islamists shoot a 62-year-old woman to death as she is farming her field.
9941,23/7/2008,Afghanistan,Nangarhar,1,2,3,Religious extremists murder a local cop with a bomb.
9942,23/7/2008,Algeria,Lakhdaria,0,13,13,A suicide bomber on a motorbike injures thirteen Algerians.
9943,23/7/2008,Somalia,Jowhar,1,0,1,Islamic militia assassinate a local official.
9944,23/7/2008,Iraq,Muqdadiyah,1,0,1,A young woman is killed in a Jihad roadside bombing.
9945,23/7/2008,Thailand,Pattani,1,0,1,Islamists gun down a school bus driver in a drive-by shooting.
9946,24/7/2008,Thailand,Pattani,1,0,1,Islamists shoot a 63-year-old villager to death.
9947,24/7/2008,Thailand,Pattani,1,0,1,A 30-year-old schoolteacher is murdered by Islamic gunmen on his way to work.
9948,24/7/2008,India,Doda,4,0,4,A woman and a 13-year-old girl are among four civilians shot to death during a Hizb-ul-Mujahideen home invasion.
9949,24/7/2008,Iraq,Baqubah,8,25,33,A female suicide bomber kills eight Sunni Iraqis.
9950,24/7/2008,India,Srinagar,5,28,33,"Four children, ages 4 to 12, are killed along with a woman from the same family of migrant workers when Islamic terrorists throw a grenade into a bus stop."
9951,24/7/2008,Philippines,Digos,2,10,12,A group tied to the Moro Islamic Front is suspected in the bombing of a bus in which two people died.
9952,24/7/2008,Afghanistan,Paktia,3,4,7,Talibanis murder three local police with a bomb.
9953,24/7/2008,Yemen,Sayoun,4,12,16,al-Qaeda is suspected in the car bombing of a ministry building that leaves four dead.
9954,25/7/2008,Pal. Auth.,Gaza,1,3,4,A bomb set outside a Christian cafe kills one person.
9955,25/7/2008,India,Bangalore,2,10,12,"Islamists set off a series of bombs, leaving two innocents dead, including a woman."
9956,25/7/2008,Bangladesh,Sadar,1,0,1,"Suspected Jama'atul Mujahideen strangle a woman, then hang her from a tree."
9957,25/7/2008,Pal. Auth.,Gaza,1,15,16,A bomb kills a young girl.
9958,26/7/2008,India,Ahmedabad,57,161,218,"Islamic bombers rock India for a second day, setting seventeen bombs and killing over fifty innocent people."
9959,26/7/2008,Lebanon,Tripoli,9,50,59,A 10-year-old boy and a woman are among nine people killed in a sectarian conflict between Sunni and Alawite.
9960,26/7/2008,Iraq,Hilla,1,0,1,Islamic gunmen take down a 4-year-old girl.
9961,26/7/2008,Somalia,Gedo,3,0,3,Islamic militia shoot three people to death at a roadblock.
9962,26/7/2008,Pakistan,Dera Bugti,3,0,3,Three local cops are murdered by Islamists in separate attacks.
9963,26/7/2008,Indonesia,Jakarata,0,265,265,Over two-hundred people are injured when a Muslim mob storms a Christian school.
9964,27/7/2008,Iraq,Fallujah,2,2,4,"Radical Sunnis bomb a house, killing two occupants."
9965,27/7/2008,Iraq,Buhriz,2,0,2,Two oil workers are murdered by Jihadi bombers.
9966,27/7/2008,Pakistan,Charbagh,1,5,6,A child is killed when fundamentalists bomb a shopping center.
9967,27/7/2008,Iraq,Baghdad,7,0,7,Seven young Shia pilgrims on foot are shot at point-blank range by Sunni gunmen.
9968,28/7/2008,Pakistan,Kohat,2,12,14,A teenager is among two people blown apart when Islamic militants detonate a bomb attached to a bicycle.
9969,28/7/2008,Afghanistan,Nuristan,3,0,3,A Taliban rocket attack on a residential area leaves three dead.
9970,28/7/2008,Pakistan,Mohmand,1,0,1,A 60-year-old man is abducted and murdered by the Mujahideen.
9971,28/7/2008,Pakistan,Matta,3,2,5,Three Pakistanis in a truck are shot to death by Tehrik-e-Taliban terrorists.
9972,28/7/2008,Iraq,Baghdad,32,102,134,Three female suicide bombers run into crowds of Shia pilgrims before detonating.  Some thirty-two innocents are killed.
9973,28/7/2008,Iraq,Kirkuk,38,178,216,"A Fedayeen suicide bomber attacks a political rally, slaughtering nearly forty people."
9974,28/7/2008,Iraq,Mussayab,1,0,1,"A woman is abducted, tied up and then murdered by suspected fundamentalists."
9975,29/7/2008,Pakistan,Degan,1,0,1,"A young woman is abducted and shot three times in the chest by Sunni extremists, who then dump the body in a sewer."
9976,29/7/2008,Philippines,Mindanao,4,1,5,Four Christian passengers are pulled from a bus and murdered by Islamic terrorists.
9977,29/7/2008,Pakistan,Akhun Killay,2,0,2,Two people are shot to death by Mujahideen.
9978,30/7/2008,Pakistan,Rabanpur,3,0,3,Three young sisters (two of whom were teens) are beheaded by their brothers over suspicion of 'illicit' activity.
9979,30/7/2008,Pakistan,Dera Ismail Khan,1,3,4,"Islamic extremists ambush a vehicle, shooting one occupant to death."
9980,30/7/2008,Ingushetia,Nazran,5,5,10,Islamic hardliners are suspected in a car bomb attack that leaves five people dead.
9981,31/7/2008,Somalia,Hodan,2,0,2,A civilian and a police officer are gunned down in an ambush by Mujahid.
9982,31/7/2008,Thailand,Pattani,1,0,1,A 57-year-old schoolteacher is shot to death by Muslim militants at close-range.
9983,31/7/2008,Jordan,Nqeira,1,0,1,A man shoots his 23-year-old sister to death on suspicion that she had unmarried sex.
9984,31/7/2008,Iraq,Mosul,2,0,2,Fundamentalists kill two women over suspected immorality.  One is beheaded.
9985,31/7/2008,Iraq,Shaheed,3,4,7,A Fedayeen suicide bomber takes out three Iraqi police.
9986,31/7/2008,Iraq,Mosul,3,0,3,A judge and two bodyguards are taken out by Islamic terrorists.
9987,31/7/2008,Pakistan,Deolai,7,0,7,Five children and their parents are killed when a shell hits their house following an ambush by Muslim militants.
9988,1/8/2008,Iraq,Rashad,3,1,4,Jihadis kill three Iraqis with a roadside bomb.
9989,1/8/2008,India,Reasi,1,0,1,"A boy is abducted by Mujahid, who then slit his throat."
9990,1/8/2008,Afghanistan,Kunar,1,0,1,Radical Sunnis take out a civilian in a roadside blast.
9991,1/8/2008,Somalia,Mogadishu,1,0,1,Islamic militia blast a Ugandan peacekeeper to death with a bomb planted at an airport.
9992,1/8/2008,Afghanistan,Nimroz,3,5,8,Two children and a woman are murdered by a Fedayeen suicide bomber.
9993,2/8/2008,Pakistan,Kabal,8,5,13,Islamic hard-liners bomb a police van killing eight people.
9994,2/8/2008,Afghanistan,Kandahar,13,6,19,The bride and groom are among thirteen people blown to bits when Islamists target a wedding party with a bomb.
9995,2/8/2008,Thailand,Yala,1,0,1,A 29-year-old civilian is shot to death while riding a motorcycle.
9996,2/8/2008,Pal. Auth.,Gaza,1,16,17,"A young boy is killed in fighting between the Muslim terror groups, Hamas and Fatah."
9997,2/8/2008,Ingushetia,Nazran,1,1,2,Suspected Islamists open up on two policemen with automatic weapons.
9998,2/8/2008,India,Ramban,1,0,1,A youth is shot to death by Islamic militants.
9999,2/8/2008,Iraq,Baqubah,5,3,8,Sunni radicals murder five Iraqis with a roadside bomb.
10000,3/8/2008,Pakistan,Temargara,2,2,4,Two government tax collectors are shot to death by Sharia-minded militants.
10001,3/8/2008,Afghanistan,Paktika,0,0,0,Two clerics are killed while trying to assemble a suicide vest in their mosque.
10002,3/8/2008,Afghanistan,Gardiz,3,0,3,Three civilians are murdered by Taliban militants.
10003,3/8/2008,Afghanistan,Ghazni,4,0,4,"Religious extremists storm a police post, killing four officers."
10004,3/8/2008,Iraq,Baghdad,12,22,34,Islamic terrorists manage to kill a dozen Iraqis with a truck bomb.
10005,3/8/2008,Iraq,Latifiyah,6,13,19,Six civilians are killed by a Jihad roadside blast.
10006,3/8/2008,Afghanistan,Helmand,1,0,1,Islamic extremists gun down a local judge.
10007,3/8/2008,Algeria,Kabylie,0,25,25,Twenty-five people are injured in a suicide blast.
10008,3/8/2008,Somalia,Mogadishu,20,47,67,"Twenty civilians, mostly women street sweepers, are blown to bits by a massive bomb planted by Islamists."
10009,3/8/2008,Sudan,Nyala,6,28,34,"Janjaweed militia ambush a civilian convoy, killing six people."
10010,3/8/2008,Pakistan,Bajaur,1,0,1,A civilian is shot to death by Sunni extremists.
10011,4/8/2008,China,Xinjiang,16,16,32,"Islamists stage a brutal grenade attack on a group of police, killing sixteen."
10012,4/8/2008,Iraq,Baghdad,2,15,17,Jihadis manage to kill two civilians with a roadside bomb.
10013,5/8/2008,Pakistan,Mughli,1,0,1,A mother of two is hacked to death with an axe by her cousin who objected to a suspected affair.
10014,5/8/2008,Ingushetia,Nazran,2,4,6,Muslim hardliners take down two local cops in separate Kalashnikov attacks.
10015,5/8/2008,Iraq,Basra,1,0,1,Fundamentalists shoot a barber to death for shaving beards.
10016,5/8/2008,Iraq,Kirkuk,3,0,3,al-Qaeda militants slit the throats of three Iraqis.
10017,5/8/2008,Philippines,Aleosan,1,0,1,One person is killed when Moro Islamic terrorists storm a sugar plantation.
10018,6/8/2008,Iraq,Mosul,1,11,12,A suicide bomber kills a civilian and injures eleven more.
10019,6/8/2008,Iraq,Baquba,16,0,16,Sixteen men kidnapped by Sunni extremists are found bound and executed.
10020,6/8/2008,Thailand,Yala,0,1,1,A school principal is shot multiple times by Shahid while on his way home.
10021,6/8/2008,Somalia,Lafoole,1,0,1,Islamic radicals gun down the head of an orphanage.
10022,6/8/2008,Afghanistan,Lashkar Gah,7,2,9,"Religious extremists attack a police post, killing seven local officers."
10023,6/8/2008,Pakistan,Tirah,4,12,16,"Fighting breaks out between Islamic fundamentalist groups, leaving four dead."
10024,6/8/2008,Pakistan,Swat,2,15,17,"Islamic militants burn down several girls schools and kill two people, including a child, in separate attacks."
10025,7/8/2008,Pakistan,Shahdara,2,0,2,Two sisters in their 20s are murdered by their brother over suspicions of 'illicit' relations with local men.
10026,7/8/2008,Iraq,Mosul,4,6,10,"Terrorists plant a bomb on a corpse, luring four investigators to their deaths."
10027,7/8/2008,Philippines,Zamboanga,2,1,3,A 16-year-old and his father are shot to death by suspected Abu Sayyaf militants.
10028,7/8/2008,Pakistan,Swat,4,0,4,Fundamentalists burn down a girls school then shoot three people to death and behead another.
10029,8/8/2008,Pakistan,Bajaur,3,0,3,Three civilians are murdered by the Taliban - two by beheading.
10030,8/8/2008,Afghanistan,Kunar,1,2,3,A child is killed in a Taliban ambush.
10031,8/8/2008,Afghanistan,Paktika,5,0,5,Five local cops are murdered by Islamic bombers.
10032,8/8/2008,Iraq,Tal Afar,25,74,99,"Jihadis bomb a marketplace, slaughtering over twenty Iraqis."
10033,8/8/2008,Pakistan,Sadeeqabad,22,0,22,"Twenty-two soldiers, some wounded, are riddled with bullets after being captured by Mujahideen."
10034,8/8/2008,Thailand,Pattani,1,0,1,A 60-year-old Buddhist is beheaded by Islam's Holy Warriors.
10035,8/8/2008,Thailand,Yala,2,0,2,A fruit trader having dinner with his wife is among two people shot to death by Muslim terrorists in separate attacks.
10036,9/8/2008,Nigeria,Kano,1,0,1,A 50-year-old man is beaten to death by a Muslim mob for alleged blasphemy.
10037,9/8/2008,Somalia,Alamada,4,2,6,Three civilians and a local cop are murdered in a grenade attack by Islamic militia.
10038,9/8/2008,Iraq,Baghdad,1,2,3,"Fundamentalists shoot at a swimming pool manager, injuring him but killing one of his sons."
10039,9/8/2008,Iraq,Baqubah,16,0,16,An al-Qaeda mass grave is discovered.  Five women are among the sixteen victims tortured and murdered.
10040,9/8/2008,Pakistan,Swat,8,15,23,Eight local cops are shot to death inside their station by Islamic radicals.
10041,9/8/2008,Algeria,Zemmouri,8,8,16,A suicide bomber takes out eight Algerians along a city street.
10042,9/8/2008,Pakistan,Kurram,16,25,41,"Sunnis and Shia settle their sectarian differences with gunfire, leaving sixteen dead."
10043,10/8/2008,Afghanistan,Kandahar,5,3,8,A group of migrant laborers is blown up by Taliban bombers.  Five are killed.
10044,10/8/2008,Philippines,Midsayap,3,0,3,Moro Islamist snipers take out three local soldiers.
10045,10/8/2008,China,Xinjiang,8,4,12,Eight people are killed in a series of suicide bomb attacks by Muslim militants.
10046,10/8/2008,Saudi Arabia,Riyadh,1,0,1,"A 26-year-old woman has her tongue cut out, then is set on fire by her father (a moral policeman) for converting to Christianity."
10047,10/8/2008,Algeria,Zemmouri,8,19,27,Eight Algerians are killed by a suicide bomber.
10048,10/8/2008,Algeria,Tigzirt,3,0,3,"Islamic fundamentalists blow up a police station, killing three officers."
10049,10/8/2008,Pakistan,Hangu,1,0,1,Taliban hardliners are suspected in the shooting death of a local cop.
10050,10/8/2008,Pakistan,Kurram,10,24,34,A second day of Sunni-Shia sectarian violence leaves ten people dead.
10051,10/8/2008,Pakistan,South Waziristan,1,0,1,An elderly man is shot to death by Islamic terrorists.
10052,10/8/2008,Iraq,Khanaqin,3,25,28,"Fedayeen bombers blow themselves up in a minibus along a city street, killing three innocent bystanders."
10053,10/8/2008,Iraq,Tarmiyah,4,21,25,Four locals are taken out in a suicide bombing.
10054,10/8/2008,Iraq,Baghdad,9,46,55,Jihad bombers murder nine Iraqis in three attacks.
10055,11/8/2008,Somalia,Mogadishu,8,0,8,Holy Warriors kill eight soldiers in a brutal ambush.
10056,11/8/2008,Philippines,Basilan,2,12,14,Two civilians are killed when Moro Islamists storm a village.
10057,11/8/2008,Afghanistan,Kabul,3,12,15,Three Afghan civilians are blown apart by a suicide car bomber.
10058,11/8/2008,Afghanistan,Uruzgan,6,3,9,A child is among a half dozen civilians killed while being used as human shields by Holy Warriors.
10059,11/8/2008,Pakistan,Bajaur,2,0,2,Islamists capture and then cut the heads off of two civilians.
10060,11/8/2008,Iran,Saravan,2,0,2,A Sunni group called 'soldiers of Allah' kidnaps and executes two security guards.
10061,11/8/2008,Iraq,Wajihiya,5,3,8,Five women field laborers are slain by Jihad bombers while walking to work.
10062,11/8/2008,Iraq,Baqubah,4,16,20,A female suicide bomber takes out four Iraqis.
10063,12/8/2008,Iraq,Ramadi,6,0,6,A woman and three children are among six family members shot to death by the Religion of Peace.
10064,12/8/2008,Iraq,Baqubah,2,10,12,A female suicide bomber takes out two Iraqis.
10065,12/8/2008,Philippines,Basilan,4,0,4,At least four Catholic civilians are killed when Moro Islamists strafe their homes with gunfire.
10066,12/8/2008,China,Xinjiang,3,0,3,Three security guards are stabbed to death by Muslim militants.
10067,12/8/2008,Thailand,Narathiwat,3,1,4,Two small children and their father are brutally gunned down by radical Muslims while out on a family trip.
10068,12/8/2008,Pakistan,Peshawar,13,11,24,A child is among thirteen people killed when Sunni bombers target a minibus.
10069,12/8/2008,Germany,Ruesselsheim,1,0,1,A 55-year-old woman is shot to death in an honor attack involving two Muslim groups.
10070,13/8/2008,Saudi Arabia,Riyadh,1,0,1,A Christian girl has her tongue cut out and is then burned alive by her father for leaving Islam.
10071,13/8/2008,Algeria,Bouira,1,0,1,A local guard is killed by a bomb planted by Islamic fundamentalists.
10072,13/8/2008,India,Kishtwar,1,0,1,A civilian is shot to death by Muslim militants outside his home.
10073,13/8/2008,Pakistan,Bajaur,1,0,1,A doctor is killed while being held as a human shield by Mujahideen.
10074,13/8/2008,Pakistan,Kirri,1,5,6,"Baitullah Mehsud terrorists ambush a group of local soldiers, killing one."
10075,13/8/2008,Pakistan,Lahore,9,35,44,"Islamists bomb an independence day celebration, killing at least nine innocents."
10076,13/8/2008,Iraq,Khan Bani Saad,1,2,3,A local woman is taken out by Mujahideen bombers.
10077,13/8/2008,Iraq,Qayara,2,10,12,Two patrons are killed when Jihadis set off a car bomb at a market.
10078,13/8/2008,Iraq,Mosul,3,15,18,Islamic bombers kill three Iraqis at an intersection.
10079,13/8/2008,Lebanon,Tripoli,18,45,63,Eighteen people at a bus stop are blown to bits by Islamic bombers.
10080,13/8/2008,Afghanistan,Logar,4,0,4,Three female humanitarian workers and their driver are brutally shot to death at point blank range by Holy Warriors.
10081,13/8/2008,Thailand,Yala,1,2,3,"A 57-year-old man is killed, and his family injured, when Mujahideen toss a grenade into his home."
10082,13/8/2008,Thailand,Pattani,1,19,20,"Islamists gun down a 26-year-old man, then plant a bomb to catch first responders."
10083,13/8/2008,Afghanistan,Helmand,5,4,9,Taliban bombers murder five local police.
10084,14/8/2008,Pakistan,Swat,2,0,2,A woman and a boy are killed when Islamists fire on security forces in a populated area.
10085,14/8/2008,Iraq,Baqubah,1,2,3,"An 8-year-old girl is killed by Islamic bomber, who also wound her mother and sister."
10086,14/8/2008,Pakistan,Swat,1,0,1,A civilian is abducted and riddled with bullets by Sunni militants.
10087,14/8/2008,Iraq,Karbala,18,75,93,"An al-Qaeda female suicide bomber strikes a group of Shiite pilgrims, slaughtering at least eighteen."
10088,14/8/2008,Pakistan,Umari,1,0,1,A pro-government tribesman is shot to death by the Taliban
10089,14/8/2008,Algeria,Jijel,2,0,2,An army officer and his driver are killed by Islamic fundamentalists in their car.  A separate bombing kills one other person.
10090,15/8/2008,Iraq,Balad,9,48,57,"Sunnis detonate a bomb on a bus carrying Shiite pilgrims, killing nine."
10091,15/8/2008,Somalia,Mogadishu,5,0,5,Islamic militia kill five people with a roadside bomb along a city street.
10092,16/8/2008,Afghanistan,Logar,1,0,1,A drum player is shot to death by Islamic hardliners.
10093,16/8/2008,Pakistan,Shawaal,1,0,1,A 40-year-old man is beheaded by religious radicals.
10094,16/8/2008,Iraq,Baghdad,6,11,17,Six more Shia pilgrims are murdered by Sunni bombers in an attack on their minibus.
10095,16/8/2008,Philippines,Panamao,2,0,2,Two off-duty soldiers are brutally murdered by Abu Sayyaf after being stranded by a broken motorcycle.
10096,16/8/2008,Pakistan,Hayatabad,1,0,1,A prominent Shia leader is shot to death outside his home by Sunni militants.
10097,16/8/2008,India,Kishtwar,1,0,1,Mujahideen abduct and murder a civilian.
10098,16/8/2008,Afghanistan,Kandahar,10,0,10,Ten Afghans are blown up by religious extremists in a roadside attack.
10099,17/8/2008,Philippines,Lanao del Sur,7,11,18,"Moro Islamists ambush a logistics transport, killing seven riders."
10100,17/8/2008,Afghanistan,Helmand,3,4,7,A woman and two small children are killed when Mujahideen use them as human shields.
10101,17/8/2008,Iraq,Baghdad,15,29,44,"An al-Qaeda suicide bomber on a motorcycle attacks a crowd outside a Sunni mosque, killing at least fifteen innocents."
10102,17/8/2008,Somalia,Dinsoor,2,0,2,Two humanitarian workers are murdered by hardline Islamists.
10103,17/8/2008,Azerbaijan,Baku,2,8,10,Islamic extremists are thought responsible for hurling a grenade into a mosque.
10104,18/8/2008,Pakistan,Kari Wala,1,0,1,A young woman is murdered by her cousins for having sex with a man she loved.
10105,18/8/2008,Afghanistan,Khost,10,13,23,"Ten civilians are murdered by a suicide bomber along a city street.  The victims are described as ""poor laborers."""
10106,18/8/2008,Iraq,Baghdad,1,1,2,Radicals gun down a cleric.  His wife is also shot in the attack.
10107,18/8/2008,Iraq,Ramadi,5,7,12,Five Iraqis are taken down by a Fedayeen car bomber.
10108,18/8/2008,Philippines,Mindanao,49,50,99,Forty-nine Christian villagers are shot or hacked to death by Moro Islamists rampaging through three towns.
10109,18/8/2008,Somalia,Doblai,2,2,4,"Fundamentalists hurl a grenade into a meeting place used by a sect, killing two people."
10110,18/8/2008,Pakistan,Swat,1,0,1,A civilian is shot to death by Mujahideen.
10111,19/8/2008,Iraq,Baqubah,35,0,35,Thirty-five victims of Sunni terrorists are found bound and executed in two mass graves.
10112,19/8/2008,Algeria,Issers,43,38,81,An Islamic fundamentalist drives a car packed with explosives into a police school.  Over forty are killed in the carnage.
10113,19/8/2008,Pakistan,Dera Ismail Khan,30,32,62,"A man walks into a hospital, yells ""Allah Akbar,"" then detonates, slaughtering over thirty innocents."
10114,19/8/2008,Afghanistan,Khost,2,0,2,Two civilians are killed in attacks by Sunni suicide bombers.
10115,19/8/2008,Afghanistan,Surobi,10,21,31,Ten French soldiers are brutally ambushed and killed.  Four were murdered in captivity.
10116,20/8/2008,Pakistan,Sargodha,1,0,1,Two brothers kill their grown sister with knives over suspicions that she is engaging in unauthorized sex.
10117,20/8/2008,Pakistan,Peshawar,2,0,2,"Jaish-i-Islami shoot two accused prostitutes to death, then mutilate their faces with knives."
10118,20/8/2008,Somalia,Mogadishu,4,7,11,Four civilians are killed during an ambush by Islamic hardliners.
10119,20/8/2008,Algeria,Bouira,12,38,50,"Islamic fundamentalists murder a dozen civilians with two bomb attacks, one on a hotel."
10120,20/8/2008,Somalia,Kismayo,9,22,31,"Al Shabaab Islamists attack a town, killing at least nine civilians."
10121,20/8/2008,Iraq,Baghdad,7,6,13,"Seven civilians are murdered by Islamic terrorists in various attacks, including a woman and a player on a soccer field."
10122,21/8/2008,Pakistan,Swat,5,1,6,Five civilians are brutally gunned down in two Taliban drive-bys.
10123,21/8/2008,Somalia,Mogadishu,6,11,17,Six civilians are killed during two separate attacks by Islamic militia.
10124,21/8/2008,Iraq,Mosul,1,0,1,A civilian is abducted and beheaded by suspected fundamentalists.
10125,21/8/2008,Pakistan,Wah,78,67,145,Over seventy innocents are slaughtered by twin Fedayeen suicide bombers outside a factory.
10126,21/8/2008,Thailand,Narathiwat,2,17,19,A journalist is among two people murdered by Muslim car bombers.
10127,21/8/2008,Pakistan,Kohat,1,0,1,Muslim radicals on motorcycles gun down a young soldier.
10128,22/8/2008,Pakistan,NWFP,2,14,16,Two security force personnel are killed when Mujahideen attack their vehicle with a grenade.
10129,22/8/2008,India,Ganderbal,1,1,2,A local soldier is shot to death by Islamic militants while standing guard.
10130,22/8/2008,Pakistan,Peshawar,1,2,3,"Taliban militants fire rockets into a police station, killing one officer."
10131,23/8/2008,Pakistan,Kurram,4,7,11,Four people are killed in a sectarian clash.
10132,23/8/2008,Pakistan,North Waziristan,2,0,2,Two civilians are kidnapped and shot to death by Sunni radicals.
10133,23/8/2008,Chechnya,Agishty,2,2,4,Jihad warriors take out two Russians with a roadside bomb.
10134,23/8/2008,Iraq,Kirkuk,5,8,13,Five people are killed when Fedayeen suicide bombers strike an auto dealership.
10135,23/8/2008,Pakistan,Swat,15,23,38,A Holy Warrior sends over a dozen innocents to Allah with a car bomb.
10136,23/8/2008,Pakistan,Abuha,2,4,6,Two people are killed when Islamists detonate a bomb at an intersection.
10137,24/8/2008,Iraq,Baghdad,30,42,72,Thirty people attending a celebration are blown apart by a Fedayeen suicide bomber.
10138,24/8/2008,Iraq,Baghdad,9,32,41,Nine civilians are murdered in three separate Jihad bombings.
10139,24/8/2008,Pakistan,Matta,4,0,4,"Islamists kidnap and bind four civilians, then shoot them to death."
10140,25/8/2008,Philippines,Maguindanao,1,0,1,"A soldier is kidnapped, bound, tortured and brutally executed."
10141,25/8/2008,Iraq,Mussayab,1,2,3,Jihadis kill a soldier's daughter and injure his two sons with a bomb near his home.
10142,25/8/2008,Sudan,Darfur,32,135,167,Women and children are among the thirty-two bodies counted following a government attack on a civilian refugee camp.
10143,25/8/2008,Pakistan,Swat,10,2,12,Ten occupants of a home are killed when Talibanis fire rockets into it.
10144,25/8/2008,Pakistan,Shakardara,2,0,2,Two tribesmen are killed and several girls schools are blown up during a rampage by Islamic hardliners.
10145,26/8/2008,Iraq,Mandali,5,0,5,A family of five is taken out by Jihadi roadside bombers as they are traveling to a religious shrine.
10146,26/8/2008,Iraq,Jalawla,28,45,73,A suicide bomber calmly walks up and murders over twenty-five police recruits waiting outside a station.
10147,26/8/2008,Pakistan,Islamabad,8,20,28,Sunni radicals manage to kill eight patrons at a cafe with a planted bomb.
10148,26/8/2008,Somalia,Baidoa,2,1,3,Two people are killed in a Mujahideen grenade attack on their home.
10149,26/8/2008,India,Kupwara,1,1,2,A local soldier is shot to death in an ambush by Islamic militants.
10150,27/8/2008,Afghanistan,Nangarhar,1,0,1,A Japanese humanitarian worker on an irrigation project is kidnapped and murdered by the Taliban.
10151,27/8/2008,Thailand,Pattani,2,0,2,A young man and woman are shot to death in separate attacks by radical Islamists.
10152,27/8/2008,Thailand,Narathiwat,1,0,1,Muslim gunmen murder a government social worker.
10153,27/8/2008,India,Jammu,6,0,6,"Lashkar-e-Toiba shoot six civilians to death, including a cab driver and his passengers."
10154,27/8/2008,Somalia,Mogadishu,2,0,2,Two civilians are killed in a sudden attack by Islamic militia.
10155,27/8/2008,Pakistan,Wana,2,11,13,A Taliban ambush leaves two local soldiers dead.
10156,27/8/2008,Thailand,Yala,1,0,1,A 51-year-old electrical worker is shot to death by Mujahid.
10157,28/8/2008,Iraq,Baghdad,2,0,2,A man and his wife are gunned down by Islamic terrorists.
10158,28/8/2008,China,Xinjiang,2,7,9,"Knife-wielding Muslims set upon a group of police, stabbing at least two to death."
10159,28/8/2008,Pakistan,Bannu,10,16,26,"Islamic bombers target a bus carrying prisoners, leaving at least ten dead."
10160,28/8/2008,Lebanon,Sejoud,1,0,1,"Hezbollah gunmen fire on a helicopter, killing a Lebanese officer."
10161,28/8/2008,Pakistan,Swat,2,0,2,Two civilians are beheaded by religious radicals.
10162,28/8/2008,Pakistan,Koza Bandai,1,0,1,The Taliban abduct and murder a civilian.
10163,29/8/2008,Algeria,Batna,7,14,21,Islamic fundamentalists kill seven Algerians in a highway attack.
10164,29/8/2008,Pakistan,Kohat Tunnel,5,37,42,Fedayeen suicide car bombers murder five innocents.
10165,29/8/2008,Dagestan,Makhachkala,1,0,1,A local cop is gunned down by Islamic militants.
10166,29/8/2008,Somalia,Kismayo,2,1,3,Two brothers are gunned down by armed Islamists.
10167,29/8/2008,Somalia,Mogadishu,1,0,1,A civilian is killed during an attack by Islamic militia.
10168,30/8/2008,Pakistan,Kurram,19,70,89,Nineteen tribesman are killed in a series of Taliban suicide attacks and ambushes.
10169,30/8/2008,Iraq,Iskandariya,2,0,2,"Two civilians are murdered by Jihadis, one of whom is decapitated."
10170,30/8/2008,Philippines,Sulu,4,10,14,Four local soldiers are killed in a brutal ambush by Islamic extremists.
10171,30/8/2008,Chechnya,Vedeno,2,11,13,A Fedayeen suicide attack is one of two bombings that leave two people dead.
10172,30/8/2008,Iraq,al-Ahbash,4,0,4,"A husband, wife and their two children are slaughtered in their home by al-Qaeda militants."
10173,30/8/2008,Pakistan,Swat,2,0,2,A civilian and a cop are murdered by Mujahideen in separate attacks.
10174,30/8/2008,Angola,Andulo,1,40,41,A young girl is decapitated by Muslims rampaging through a Christian community on a church-burning spree. (Reported)
10175,31/8/2008,Iraq,Mosul,1,0,1,A Christian man is kidnapped and murdered by Islamic fundamentalists.
10176,31/8/2008,Thailand,Pattani,2,0,2,"Muslim extremists gun down a 43-year-old man, and a 50-year-old in separate attacks."
10177,1/9/2008,Thailand,Pattani,2,0,2,A Buddhist woman is among two people murdered in separate shooting attacks by Muslim radicals.
10178,1/9/2008,Thailand,Yala,1,0,1,A 61-year-old man is shot to death by militant Muslims while driving home.
10179,1/9/2008,Pakistan,Kohat,7,0,7,Religious extremists take out seven security personnel in a surprise ambush.
10180,1/9/2008,Philippines,Digos,6,32,38,"Islamic bombers are suspected in a blast that rips nails through a passenger bus, leaving six dead."
10181,1/9/2008,Afghanistan,Kunduz,1,0,1,A civilian is blown to bits by a suicide bomber.
10182,1/9/2008,Thailand,Yala,1,0,1,A teacher is brutally gunned down in front of his wife by Religion of Peace warriors.
10183,1/9/2008,Somalia,Mogadishu,1,0,1,A civilian is killed during a Mujahideen ambush along a city street.
10184,1/9/2008,Iraq,Kirkuk,1,2,3,An Iraqi child is taken down by Islamic bombers.
10185,1/9/2008,Iraq,Othmaniyah,3,0,3,Sunni bombers kill three farmers with a device hidden in a water pump.
10186,1/9/2008,Afghanistan,Wardak,3,0,3,Three security guards are killed by religious radicals in an ambush.
10187,1/9/2008,Afghanistan,Kandahar,1,0,1,A taxi driver is murdered by Sunni extremists.
10188,1/9/2008,Afghanistan,Khost,2,2,4,The Taliban take down two local cops with a roadside bomb.
10189,2/9/2008,Iraq,Kirkuk,1,2,3,A 9-year-old boy is murdered by Islamic bombers.
10190,2/9/2008,Iraq,Mosul,7,7,14,Children are among the victims of a Fedayeen suicide car bombing.
10191,2/9/2008,Iraq,Baghdad,4,23,27,Four Iraqis are killed in a couple of Jihad roadside attacks.
10192,2/9/2008,India,Pulwama,1,2,3,An off-duty soldier is brutally cut down by Islamists while shopping at a vegetable market.
10193,2/9/2008,Iraq,Mosul,1,0,1,Islamic fundamentalists abduct and murder a 65-year-old Christian doctor.
10194,2/9/2008,Pakistan,Swat,2,0,2,A retired schoolteacher is among two people murdered by the Mujahideen.
10195,2/9/2008,Dagestan,Makhachkala,1,0,1,An anti-Islamist journalist is assassinated by suspected extremists.
10196,3/9/2008,Pakistan,Sahiwal,1,0,1,A 17-year-old girl is shot to death by her father and brother for seeking a divorce after being forcibly married at 9.
10197,3/9/2008,Somalia,Mogadishu,2,4,6,Two civilians are killed during an ambush by Islamic militia.
10198,4/9/2008,Iraq,Mosul,4,0,4,A 12-year-old child and a woman are among four Iraqis murdered by Sunni terrorists.
10199,4/9/2008,Thailand,Narathiwat,1,0,1,Islamists gun down an orchard worker.
10200,5/9/2008,Iraq,Baghdad,6,17,23,Six people are killed by Jihadi bombers.
10201,5/9/2008,Thailand,Pattani,2,0,2,Two Buddhists are shot to death by militant Muslims in separate drive-by attacks.
10202,5/9/2008,Thailand,Yala,1,0,1,A man mourning beside his brother's grave at a cemetery is murdered by Muslim extremists.
10203,6/9/2008,Iraq,Tal Afar,6,54,60,"Fedayeen suicide bombers take out six innocents, and injure nearly sixty more, with an attack on an outdoor market."
10204,6/9/2008,Iraq,Buhriz,2,3,5,Two people are blown apart by Sunni bombers.
10205,6/9/2008,Pakistan,Peshawar,35,91,126,Over thirty people are massacred by Fedayeen suicide bombers in a brutal attack along a city street.
10206,6/9/2008,Pakistan,Peshawar,16,80,96,Sixteen people are blown up by suicide car bombers.
10207,6/9/2008,Afghanistan,Nimroz,6,1,7,A suicide bomber pretending to be a beggar murders six office workers.
10208,6/9/2008,Afghanistan,Nimruz,2,7,9,"Religious extremists attack a police post, killing two officers."
10209,6/9/2008,Somalia,Mogadishu,1,0,1,Mujahideen gun down a businessman in his store.
10210,7/9/2008,Pakistan,Waris Khan,2,0,2,A man shoots his daughter and her lover to death over their relationship.
10211,7/9/2008,Pakistan,Zila Mir Pur Khas,1,0,1,Islamic extremists gun down a Ahmadiyya doctor for worshipping the wrong god.
10212,7/9/2008,Afghanistan,Kandahar,8,23,31,Eight Afghans are blown to bits by a pair of Fedayeen suicide bombers.
10213,7/9/2008,Pakistan,Kurram,3,12,15,Three children are killed when Sunnis and Shia clash settle sectarian differences by targeting homes with heavy weapons.
10214,7/9/2008,India,Ramban,1,2,3,Muslim militants attack and kill a member of a search party.
10215,7/9/2008,Pakistan,Swat,2,0,2,Mujahideen shoot two civilians to death.
10216,7/9/2008,Somalia,Beletwein,5,5,10,Five civilians are taken down during an ambush by Islamic militia.
10217,8/9/2008,Pakistan,Sindh,1,0,1,The local leader of a minority sect is murdered by Islamic hardliners.
10218,8/9/2008,Somalia,Mogadishu,4,2,6,Children are among those killed when Islamic militia stage a terror attack along a public street.
10219,8/9/2008,Afghanistan,Zabul,6,2,8,The Taliban take out six civilians with a landmine.
10220,8/9/2008,India,Doda,1,0,1,A civilian is shot to death by Hizb-ul-Mujahideen.
10221,8/9/2008,Iraq,Mosul,3,0,3,Mujahideen kill a woman and two children by bombing their home.
10222,8/9/2008,Iraq,Bani Saad,2,1,3,Jihad gunmen murder a married couple and injure their young son.
10223,8/9/2008,Iraq,Baiji,2,4,6,Car bombers take out two Iraqis.
10224,9/9/2008,Sudan,Bere,6,0,6,Six villagers are killed during an attack by Janjiweed militia.
10225,9/9/2008,Pakistan,Swat,5,1,6,Five civilians are murdered by the Taliban in two targeted attacks.
10226,9/9/2008,Thailand,Pattani,1,0,1,A Buddhist is shot and beheaded by Religion of Peace militants.
10227,9/9/2008,Thailand,Yala,1,1,2,A local soldier is killed when Islamists fire rockets into their base.
10228,9/9/2008,Pakistan,Sindh,4,0,4,"Religious radicals gun down a man, his two wives and young grandson in their home."
10229,9/9/2008,Iraq,Mosul,1,0,1,A humanitarian agency worker is gunned down by Muslim terrorists.
10230,10/9/2008,Somalia,Mogadishu,4,0,4,At least four civilians are killed when dozens of militants screaming 'Allah Akbar' attack an Ethiopian patrol.
10231,10/9/2008,Iraq,Mosul,1,0,1,A Christian man is shot to death by Muslim fundamentalists.
10232,10/9/2008,Pakistan,Dir,25,50,75,Twenty-five people are killed when rival Islamists hurl grenades into a mosque.
10233,10/9/2008,Sudan,Zamzam,5,24,29,"Janjiweed militia attack a displaced persons camp, killing five refugees."
10234,10/9/2008,Pakistan,Bajaur,3,0,3,"Sunni fundamentalists kidnap three civilians, then shoot them in the neck."
10235,11/9/2008,Afghanistan,Nimroz,2,0,2,Two civilians are murdered by a Fedayeen suicide bomber.
10236,11/9/2008,Pakistan,Orakzai,2,0,2,"Talibanis abduct and slit the throats of two local soldiers, then cut off their heads."
10237,11/9/2008,Afghanistan,Kandahar,2,4,6,"A suicide bomber takes out two Afghan civilians, including a young boy on his way to school."
10238,11/9/2008,India,Doda,0,1,1,"A farmer is pulled from his home by the Mujahideen, who then hack off his ears."
10239,11/9/2008,Iraq,Saidiya,5,2,7,Five members of the same family are murdered in their home by Mujahideen.
10240,11/9/2008,Iraq,Mosul,5,7,12,A family of three is among five civilians taken down by Islamic terrorists.
10241,11/9/2008,Iraq,Khalis,2,0,2,A man and his son are shot to death inside their home by Sunni militants.
10242,11/9/2008,Iraq,Baghdad,3,3,6,"Jihadis bomb a minibus carrying civil servants, killing at least three."
10243,11/9/2008,Pakistan,Swat,8,0,8,"A 9-year-old girl, brutally gunned down by Jihadis, is among eight people murdered in two attacks."
10244,11/9/2008,Thailand,Pattani,2,0,2,A young Buddhist man is among two civilians killed in separate attacks by Muslim militants.
10245,11/9/2008,Thailand,Narathiwat,1,0,1,Islamists gun down a 45-year-old man in a drive-by shooting.
10246,12/9/2008,Turkey,Diyarbakir,1,0,1,A family slits their 19-year-old daughter's throat over her 'interactions with men.'
10247,12/9/2008,Afghanistan,Farah,8,0,8,Eight people are blasted to death at point-blank range with automatic weapons during a Taliban ambush.
10248,12/9/2008,Iraq,Dujail,31,60,91,Over thirty Shias are blown to Allah by bombs detonated by radical Sunnis at a marketplace.
10249,12/9/2008,Iraq,Sinjar,3,15,18,"Sunnis bomb a Shia mosque, killing three attendees."
10250,13/9/2008,Iraq,Mosul,2,0,2,Fundamentalists storm a home and kill a man and woman who may have been co-habitating.
10251,13/9/2008,Iraq,Mosul,4,0,4,Four members of a charity-TV crew are kidnapped and senselessly executed by Islamic terrorists.
10252,13/9/2008,Iraq,Baghdad,4,9,13,Four Iraqis are killed in a roadside bombing attack by Jihadis.
10253,13/9/2008,Pakistan,Kurram,2,8,10,At least two people are killed when Sunnis and Shias work out their differences.
10254,13/9/2008,Pakistan,Zabul,0,1,1,Talibanis drag a teacher out of a mosque and cut off his ears.
10255,13/9/2008,India,New Delhi,30,90,120,"Islamists detonate bombs at five marketplaces within a 30-minute span, massacring dozens of innocent people explicitly in the name of Allah."
10256,13/9/2008,Israel,Yitzhar,0,1,1,"A Palestinian terrorist stabs a 9-year-old Israeli boy five times, then throws him from a balcony."
10257,13/9/2008,Afghanistan,Logar,4,0,4,The Taliban murder a local governor with a bomb attack on his vehicle.
10258,13/9/2008,Pakistan,Lahore,1,0,1,A man shoots his teenage daughter to death over a relationship with a non-Muslim boy.
10259,14/9/2008,Somalia,Afgoye,1,0,1,A 22-year-old Christian is casually shot to death at a wedding after being accused of apostasy.
10260,14/9/2008,Kenya,Garissa,0,10,10,"A Muslim mob storms a church during a service, pelting worshippers with stones and injuring ten."
10261,14/9/2008,Thailand,Pattani,1,0,1,A 41-year-old laborer is shot by Islamists while riding his motorcycle home.
10262,14/9/2008,Somalia,Mogadishu,3,0,3,Islamic hardliners celebrate Ramadan by killing a Ugandan peacekeeper and two others.
10263,14/9/2008,Afghanistan,Kandahar,3,16,19,Two doctors and their drivers are murdered by fundamentalist bombers while delivering vaccine to children.
10264,14/9/2008,Afghanistan,Ghazni,7,0,7,Religious extremists murder seven Afghan security patrol members riding in a pickup truck.
10265,14/9/2008,Iraq,Mosul,2,0,2,Two brothers are shot to death by sectarian rivals.
10266,14/9/2008,Iraq,Saidiya,7,6,13,Jihadi bombers take down seven Iraqis with a series of blasts.
10267,14/9/2008,India,Poonch,4,0,4,Four local security personnel are killed in a Mujahideen ambush.
10268,14/9/2008,Afghanistan,Ghazni,6,12,18,Six children are blown to bits by Taliban bombers.
10269,14/9/2008,Pakistan,North Waziristan,1,0,1,A 70-year-old man is stabbed to death in the neck by Sunni extremists.
10270,14/9/2008,Pakistan,Esha,1,0,1,A 55-year-old refugee is kidnapped and severely tortured before being shot to death by Religion of Peace militants.
10271,14/9/2008,Pakistan,Lahore,1,0,1,"A pregnant woman is burned alive by her husband, allegedly because she wanted to leave him."
10272,14/9/2008,Russia,Karachayevo-Cherk.,1,2,3,A local cop is gunned down outside his home by Muslim terrorists.
10273,15/9/2008,Somalia,Mogadishu,4,0,4,Four African Union soldiers are murdered by Islamic militia bombers.
10274,15/9/2008,Mauritania,Tourine,12,4,16,"al-Qaeda militants rake a security patrol with machine-gun fire, killing a dozen local men."
10275,15/9/2008,Thailand,Pattani,1,0,1,An 80-year-old man is murdered by Islamic gunmen.
10276,15/9/2008,Iraq,Balad Ruz,22,33,55,A female suicide bomber sends twenty-two others to Allah with a blast in a residential area.
10277,15/9/2008,Iraq,Baghdad,13,35,48,Jihadis successfully kill thirteen Iraqis with a pair of strategically placed bombs.
10278,15/9/2008,Thailand,Narathiwat,1,0,1,A young hospital worker is murdered by Religion of Peace gunmen.
10279,16/9/2008,Iraq,Taji,2,16,18,Mujahideen manage to kill two civilians with a bicycle bomb placed in a marketplace.
10280,16/9/2008,Iraq,Khanaqin,4,3,7,Four local police are murdered by Jihadi bombers.
10281,16/9/2008,Thailand,Pattani,1,0,1,Muslim radicals murder a 50-year-old civilian outside his home.
10282,16/9/2008,Pal. Auth.,Gaza,1,0,1,"Hamas gunmen attack a family home, killing a baby girl."
10283,16/9/2008,Lebanon,Ain el-Helweh,4,0,4,Four people are killed when Sunnis and Shia clash over their differences.
10284,16/9/2008,Pakistan,Swat,3,6,9,"Talibanis attack a schoolhouse, killing three guards."
10285,16/9/2008,Thailand,Narathiwat,3,0,3,A man sweeping the curb outside his home is among two people shot to death by Islamists.
10286,17/9/2008,Thailand,Yala,2,0,2,A father and son are brutally gunned down by Religion of Peace militants.
10287,17/9/2008,Philippines,Mindanao,1,7,8,"Moro Islamists attack a group of local soldiers, killing one."
10288,17/9/2008,Ingushetia,Magas,4,0,4,Four local security personnel are ambushed and killed by Muslim radicals.
10289,17/9/2008,India,Srinagar,0,15,15,Fifteen pedestrians are injured when Islamic terrorists toss a grenade into the street outside a shopping center.
10290,17/9/2008,Pakistan,Khyber,1,0,1,The Taliban abduct and murder an Afghan refugee.
10291,17/9/2008,Pakistan,Dera Ismail Khan,1,7,8,A woman is murdered by Islamic bombers in a residential area.
10292,17/9/2008,Iraq,Baghdad,18,79,97,Eighteen Iraqis are killed in a series of Mujahideen bombing and shooting attacks.
10293,17/9/2008,Yemen,Sanaa,10,13,23,Women and children are among the casualties when al-Qaeda militants stage a coordinated attack on the US embassy.
10294,18/9/2008,England,Crawley,0,1,1,A man shouts about the Qur'an as he stabs a non-Muslim woman in the head.
10295,18/9/2008,Iraq,Mosul,2,0,2,Two family members are killed when sectarian gunmen storm their home.
10296,18/9/2008,Afghanistan,Khost,3,0,3,Three Afghans are taken down by a Taliban ambush.
10297,19/9/2008,Pakistan,Swat,2,0,2,"Islamic militants attack a bank vehicle, killing two occupants."
10298,19/9/2008,Iraq,Tuz Khormato,1,0,1,A woman is shot to death by Muslim terrorists.
10299,19/9/2008,Somalia,Mogadishu,12,35,47,"al-Shabaab Islamists rain down mortars on a city airport, killing a dozen civilians."
10300,19/9/2008,Pakistan,Quetta,8,9,17,Eight students at a religious school are blown to bits by a suicide bomber.
10301,19/9/2008,Afghanistan,Paktika,4,2,6,A child is among four civilians working in a field killed by a Jihadi rocket attack.
10302,19/9/2008,Thailand,Narathiwat,1,0,1,A teenager is taken down in a drive-by shooting by Islamic radicals.
10303,19/9/2008,Iraq,Basra,1,0,1,A Shia cleric is assassinated by Sunni extremists.
10304,20/9/2008,Ethiopia,Addis Ababa,0,1,1,A 35-year-old Christian leaders is nearly beaten to death by Religion of Peace advocates.
10305,20/9/2008,Pakistan,North Waziristan,6,5,11,Six locals are blown to bits by a Fedayeen suicide bomber.
10306,20/9/2008,Mauritania,Tourine,12,0,12,Twelve local soldiers are kidnapped and beheaded by al-Qaeda.
10307,20/9/2008,Pakistan,Jamrud,1,1,2,A truck driver is shot to death by religious militants.
10308,20/9/2008,Iraq,Tal Afar,6,23,29,Three women are among six Iraqis murdered by Muslim terrorists in separate attacks.
10309,20/9/2008,Pakistan,Islamabad,53,257,310,Over fifty people are burned or blasted to death when Mujahideen attack a Marriott hotel.
10310,20/9/2008,Philippines,Maguindanao,1,4,5,Moro Islamists ambush and kill a pro-government tribesman.
10311,21/9/2008,Iraq,Mosul,6,48,54,"A Fedayeen suicide bomber is among several Mujahideen attackers who kill six Iraqis, including a woman and two brothers"
10312,21/9/2008,Iraq,Jalawla,3,6,9,Three people riding a minibus are murdered by Sunni roadside bombers.
10313,21/9/2008,Iraq,Kirkuk,3,23,26,Jihadis take down three Iraqis with a truck bomb.
10314,21/9/2008,Thailand,Pattani,1,0,1,A 60-year-old rubber worker is shot off his motorcycle by Mujahideen.
10315,21/9/2008,Thailand,Pattani,1,0,1,A Buddhist market vendor is murdered by Islamic gunmen.
10316,21/9/2008,Thailand,Yala,2,0,2,Two civilians are shot to death by Muslim radicals in separate attacks.
10317,22/9/2008,Afghanistan,Kandahar,2,0,2,Two Afghans are murdered by Taliban bombers while driving home.
10318,22/9/2008,Iraq,Baghdad,3,5,8,Sunni militants kill three Iraqis with a bomb.
10319,22/9/2008,Thailand,Narathiwat,2,0,2,A Buddhist man and his teenage son are shot and beheaded by Religion of Peace militants.
10320,22/9/2008,Israel,Jerusalem,0,15,15,Fifteen Israelis are injured when an Arab driver goes on a rampage.
10321,22/9/2008,Pakistan,Swat,9,2,11,Nine local soldiers are killed by a Fedayeen suicide bomber.
10322,22/9/2008,Iraq,Mosul,5,3,8,Five Iraqi children at play are murdered by a bomb planted by Freedom Fighters.
10323,22/9/2008,Somalia,Mogadishu,42,60,102,"Over forty people, including a woman and her five children, are killed by mortar fire during two al-Shabaab terrorist attacks."
10324,22/9/2008,Pakistan,Peshawar,1,1,2,"Suspected Islamists shoot a driver to death, then kidnap a passenger."
10325,23/9/2008,Somalia,Manyafulka,1,0,1,A Christian is beheaded for leaving Islam by men who read the Qur'an aloud before decapitating him.
10326,23/9/2008,Afghanistan,Uruzgan,6,0,6,A woman and a 12-year-old are among six civilians blown to bits by Taliban bombers.
10327,23/9/2008,Iraq,Baquba,1,8,9,"Sectarian rivals blow up the home of a recently returned family, killing one of the women."
10328,24/9/2008,Pakistan,Kot,2,10,12,Islamic militants blow up a girls school and kill two local soldiers in a separate incident.
10329,24/9/2008,Iraq,Diyala,35,0,35,"al-Qaeda gunmen ambush an Iraqi security patrol, wiping out thirty-five souls."
10330,24/9/2008,Thailand,Yala,1,0,1,A 30-year-old hospital gardener is murdered in cold blood by Islamic gunmen.
10331,24/9/2008,Thailand,Pattani,1,1,2,A local soldier is killed by Muslim radicals while resting under a tree.
10332,24/9/2008,Somalia,Baidoa,4,0,4,Mujahideen kill four people at a market with a bomb hidden in a donkey cart.
10333,24/9/2008,Somalia,Mogadishu,11,40,51,Eleven civilians are killed during an attack by Islamic militia.
10334,24/9/2008,Pakistan,Quetta,4,10,14,A young girl is among four people killed by a Fedayeen suicide bomber.
10335,24/9/2008,Afghanistan,Kabul,6,4,10,Six Afghan policemen are murdered in two attacks by religious extremists.
10336,25/9/2008,Thailand,Pattani,3,1,4,Three civilians in their early 30's are murdered by Islamic gunmen in separate attacks.
10337,25/9/2008,Pakistan,Khyber,1,1,2,The Taliban shoot a man to death outside a mosque.
10338,25/9/2008,Pakistan,Charbagh,1,0,1,A flour dealer is murdered near his shop by Muslim militants.
10339,25/9/2008,Pakistan,Swat,2,1,3,Religious extremists gun down two local cops.
10340,25/9/2008,Somalia,Wardegley,10,14,24,"Ten civilians, including a woman and several children are killed following attacks by Islamic militia."
10341,25/9/2008,India,Baramulla,1,0,1,A pro-India politician is gunned down by Mujahideen.
10342,25/9/2008,Afghanistan,Herat,11,5,16,Eleven guards at a construction site are murdered by religious radicals.
10343,25/9/2008,Afghanistan,Kandahar,4,3,7,Talibanis take down four locals with two bombs.
10344,25/9/2008,Iraq,Baghdad,1,0,1,Fundamentalists gun down a local homosexual rights leader inside a barber shop.
10345,26/9/2008,Pakistan,Karachi,1,0,1,Religious extremists murder a man after handcuffing him.
10346,26/9/2008,Pakistan,South Waziristan,1,0,1,A local tribesman is killed by the Taliban.
10347,26/9/2008,Thailand,Narathiwat,1,0,1,Islamists shoot a 27-year-old plantation worker to death.
10348,26/9/2008,Pakistan,Punjab,9,15,24,A woman and three children are among nine killed when suspected Islamists derail a train with an explosive device.
10349,26/9/2008,Afghanistan,Khost,5,7,12,A Fedayeen suicide bomber murders five Afghans at a marketplace.
10350,26/9/2008,Philippines,Maguindanao,1,7,8,A civilian is killed when Moro Islamists attack an army patrol.
10351,26/9/2008,Pakistan,Karachi,1,0,1,The body of a kidnapped truck driver is found tortured and murdered by Islamists.
10352,26/9/2008,Iraq,Baghdad,3,2,5,Jihadis use an IED to kill three children.
10353,27/9/2008,Somalia,Mogadishu,9,10,19,"Islamic militia fire mortars into an airport, killing at least nine."
10354,27/9/2008,Syria,Damascus,17,14,31,"A suicidal Sunni bombs a Shia shrine, slaughtering seventeen innocents."
10355,27/9/2008,India,Delhi,2,25,27,A young boy and an old man die following a bombing by Muslim radicals at an outdoor market.
10356,27/9/2008,Pakistan,Matta,3,0,3,Sunni extremists kill three house servants when they blow up several homes.
10357,27/9/2008,Iraq,Mosul,1,0,1,Fundamentalists gun down a table tennis coach.
10358,28/9/2008,Afghanistan,Kandahar,1,1,2,"A top policewoman is gunned down by the Taliban, who also put her young son in a coma during the attack."
10359,28/9/2008,Algeria,Tizi Wazu,2,0,2,Two security guards are brutally slain by Muslim fundamentalists at a fake checkpoint.
10360,28/9/2008,Algeria,Dellys,4,9,13,al-Qaeda bombers murder four in a commercial district.
10361,28/9/2008,Somalia,Tayeglow,0,2,2,Two Christians are seriously injured when a Muslim mob invades their church with spears and machetes.
10362,28/9/2008,Pakistan,Attock,3,1,4,Suspected Taliban abduct an engineer after murdering his three companions.
10363,28/9/2008,Thailand,Pattani,1,0,1,A 47-year-old man is murdered by Muslim terrorists.
10364,28/9/2008,Afghanistan,Kandahar,4,0,4,Taliban assassins take down four Afghan bodyguards.
10365,28/9/2008,Iraq,Baghdad,32,97,129,Three separate Jihad car bombings leave nearly three dozen Iraqi civilians dead.
10366,28/9/2008,Somalia,Mogadishu,2,0,2,Two civilians are killed during a Mujahideen attack in a residential area.
10367,28/9/2008,Thailand,Narathiwat,1,0,1,A 33-year-old man is shot to death by Muslim extremists.
10368,29/9/2008,Thailand,Narathiwat,1,0,1,Islamists shoot a 47-year-old man to death while he is shopping for groceries.
10369,29/9/2008,Algeria,Bomerdas,3,4,7,Suicide car bombers take down three innocent people.
10370,29/9/2008,Lebanon,Tripoli,6,30,36,"Six people are burned to a crisp, and thirty others injured by Islamic bombers targeting local soldiers."
10371,29/9/2008,Iraq,Mosul,2,0,2,Two brothers are gunned down by Sunni radicals.
10372,29/9/2008,Pakistan,Chatto Chowk,1,0,1,"Fundamentalists bomb a music shop, killing a patron."
10373,30/9/2008,Pakistan,Sadar,1,0,1,A woman is sprayed with acid and then set on fire by her in-laws in an 'honor' attack.
10374,30/9/2008,Somalia,Baidoa,1,4,5,A child standing along a city street is killed by Mujahideen bombers.
10375,30/9/2008,Ingushetia,Nazran,1,3,4,A Fedayeen suicide bomber takes out a local civilian.
10376,30/9/2008,Thailand,Yala,2,0,2,Two young men in their 20's are gunned down in separate Muslim drive-by attacks.
10377,30/9/2008,Iraq,Mosul,2,0,2,A coffee shop employee and a woman are taken down by Mujahideen.
10378,30/9/2008,Iraq,Baghdad,4,9,13,"Islamists bomb a movie theater, killing four Iraqis."
10379,1/10/2008,India,Doda,1,0,1,"A shepherd is abducted by Mujahideen, who then slit his throat."
10380,1/10/2008,Iraq,Balad,4,29,33,Four Iraqis are taken out by a Jihad car bomb.
10381,1/10/2008,India,Agartala,4,76,80,Harkat ul-Jihad-e-Islami is suspected in serial bomb blasts at civilian bus stops that leave at least four dead.
10382,1/10/2008,Somalia,Baidoa,2,4,6,"A child blown apart by an Islamist grenade, one of two people killed in separate attacks."
10383,1/10/2008,Philippines,Mindanao,3,12,15,"Moro Islamists ambush a security patrol, killing three members."
10384,2/10/2008,Pakistan,Charsadda,5,12,17,"A suicide bomber invades a home, killing five people."
10385,2/10/2008,Iraq,Wajihiya,6,3,9,Women and children on a mini-bus are machine-gunned to death by Freedom Fighters.
10386,2/10/2008,Iraq,Baghdad,26,50,76,"Sunni suicide bombers target two Shia mosques, slaughtering at least twenty worshippers."
10387,3/10/2008,Afghanistan,Kunar,1,4,5,Islamic militants gun down a civilian.
10388,3/10/2008,Algeria,Theniet el-Had,6,0,6,Six local security forces are killed when armed fundamentalists open up with machine-guns on their vehicle at point-blank range.
10389,4/10/2008,Thailand,Pattani,2,0,2,Two local soldiers are brutally executed by Muslim radicals.
10390,4/10/2008,Somalia,Baidoa,1,0,1,A man strolling through a market is shot five times in the chest by Islamic militia men.
10391,4/10/2008,Ingushetia,Rostov-on-don,1,0,1,A cop is gunned down by religious extremists.
10392,4/10/2008,Iraq,Tahrir,1,0,1,A 15-year-old Christian boy is shot to death by Mujahideen while standing outside his home.
10393,4/10/2008,Somalia,Mogadishu,5,7,12,Five people are killed when Islamic militia lob mortars into the city airport.
10394,4/10/2008,Iraq,Mosul,4,0,4,Islamists enter a Christian store and murder the owner.  Three tortured and executed kidnap victims are found elsewhere.
10395,5/10/2008,Egypt,al-Tayeba,1,3,4,A 19-year-old Christian is shot to death by a Muslim mob.
10396,5/10/2008,Iraq,Zanjili,4,6,10,"Terrorists attack a funeral with automatic weapons, killing four innocents."
10397,5/10/2008,Iraq,Mosul,1,1,2,Fundamentalists gun down a butcher in his shop.
10398,6/10/2008,Iraq,Mosul,1,0,1,A disabled Christian is abducted from his shop by Islamists and then shot to death.
10399,6/10/2008,Somalia,Mogadishu,17,35,52,Children are among the seventeen civilians killed at a marketplace following an al-Shabaab mortar attack.
10400,6/10/2008,Somalia,Merka,1,2,3,"Islamic militia attack a humanitarian vehicle, leaving one worker dead."
10401,6/10/2008,Pakistan,Punjab,17,60,77,Holy Warriors strike a party held at a home.  Seventeen people are blown to bits.
10402,7/10/2008,Iraq,Mosul,2,0,2,A Christian man and his elderly father are shot to death at their workplace by Religion of Peace radicals.
10403,7/10/2008,Iraq,Mosul,1,0,1,Islamic extremists enter a Christian pharmacy and kill the owner.
10404,7/10/2008,Algeria,M'sila,2,0,2,An army major is killed when fundamentalists booby-trap the dead body of another man kidnapped and murdered earlier.
10405,7/10/2008,Thailand,Narathiwat,1,1,2,Militant Muslims murder a man sitting in his pickup truck.  The victim's teenage son is severely injured.
10406,7/10/2008,Somalia,Beledweyne,1,0,1,Islamic militia are suspected of shooting a peaceful negotiator in the head at a marketplace.
10407,8/10/2008,Iraq,Baquba,10,19,29,A female Fedayeen murders ten Iraqis outside a courthouse.
10408,8/10/2008,Iraq,Mosul,2,0,2,Two more Christians are murdered by Muslim extremists in separate attacks.
10409,8/10/2008,Lebanon,Ain al-Helweh,1,0,1,Suspected fundamentalists gun down a Fatah activist.
10410,9/10/2008,Afghanistan,Uruzgan,6,9,15,Women and children are among the casualties during a shooting attack by religious extremists.
10411,9/10/2008,Iraq,Udhaim,4,5,9,Two children are among four family members wiped out by Jihadi bombers.
10412,9/10/2008,Iraq,Tal Afar,2,3,5,"Mujahideen bomb a restaurant, killing two patrons."
10413,9/10/2008,Iraq,Habaniya,3,8,11,A suicide bomber successfully takes out three Iraqis.
10414,9/10/2008,Pakistan,Islamabad,10,21,31,Four schoolgirls are among ten people killed in a Mujahideen bombing.
10415,9/10/2008,Pakistan,Bajaur,4,0,4,Four tribal elders are abducted and beheaded in the name of Allah.
10416,10/10/2008,Iraq,Mosul,39,53,92,Mujahideen successfully kill about forty Iraqis with two marketplace car bombings.
10417,10/10/2008,Iraq,Baghdad,12,26,38,Twelve Iraqis are murdered by Jihadi bombers at a commercial center.
10418,10/10/2008,Pakistan,Orakzai,82,160,242,A Fedayeen bomber sends over eighty souls to Allah at a tribal meeting.
10419,10/10/2008,Afghanistan,Khost,2,3,5,Two people are blown up by a Taliban suicide bomber.
10420,10/10/2008,Iraq,Mosul,2,0,2,Two Christians are shot to death by Islamists at a roadblock after being forced to identify themselves.
10421,10/10/2008,Pakistan,Charbagh,1,0,1,Sunni hardliners burn down two girls schools and shoot a citizen to death.
10422,11/10/2008,Pakistan,Mailsi,1,0,1,A man is tortured and murdered by his girlfriend's son over illicit relations.
10423,11/10/2008,Iraq,Mosul,3,0,3,The bodies of three Christians are discovered following their abduction by Islamic radicals.
10424,11/10/2008,Philippines,Sultan Kudarat,5,5,10,"Moro Islamists attack a Christian village, killing five innocents and kidnapping two others for use as human shields."
10425,12/10/2008,Afghanistan,Khost,2,3,5,A woman and child are killed when the Taliban fire a rocket into their home.
10426,12/10/2008,Iraq,Baghdad,9,11,20,Nine people are blown apart by a Jihad car bomb.
10427,12/10/2008,Iraq,Mosul,5,11,16,Mujahideen bombers kill five Iraqis.
10428,12/10/2008,Thailand,Pattani,1,0,1,Islamists shoot a man to death in front of his 8-year-old daughter.
10429,12/10/2008,Somalia,Kismayo,1,0,1,Islamists brutally machine gun a man to death as he is being released from prison.
10430,12/10/2008,Pakistan,Khyber,3,0,3,Three men are shot to death by suspected Islamic radicals.
10431,12/10/2008,Iraq,Mosul,1,1,2,A Christian business owner is gunned down in his music store by Islamic fundamentalists.
10432,13/10/2008,Pakistan,Murid Wal,1,0,1,A young man is forced by honor to kill his mother when she refuses to break off an 'illicit' relationship.
10433,13/10/2008,Pakistan,Darra Adam Khel,1,4,5,A sudden Sunni rocket attack leaves a local security staff member dead.
10434,13/10/2008,Somalia,Mogadishu,2,23,25,Two African Union mission members are killed when Muslim militia attack their vehicles.
10435,13/10/2008,Afghanistan,Ghazni,6,2,8,Religious extremists take out six civilians with a roadside blast.
10436,14/10/2008,Philippines,North Cotabato,1,0,1,"Moro Islamists attack a Christian village, killing one civilian and driving many families from their homes."
10437,14/10/2008,Afghanistan,Uruzgan,9,6,15,Two children are among nine civilians murdered when Taliban bombers target a minibus.
10438,14/10/2008,Afghanistan,Kandahar,1,0,1,Religious extremists assassinate a government official who aids war widows.
10439,14/10/2008,Somalia,Mogadishu,1,0,1,Islamists murder the driver of an aid agency.
10440,14/10/2008,Pakistan,Kabal,1,0,1,"Sunni extremists abduct, torture and behead a local soldier."
10441,14/10/2008,India,Poonch,2,0,2,Mujahideen kill two local soldiers in separate ambushes.
10442,15/10/2008,Afghanistan,Lashkar Gah,6,0,6,Six local police are taken out in a brutal Taliban ambush on their checkpoint.
10443,15/10/2008,Pakistan,Swat,2,0,2,The Taliban enter a home and murder a husband and wife.
10444,15/10/2008,Pakistan,Swat,3,0,3,"Three people, including two brothers, are killed in two Jihad shooting attacks."
10445,15/10/2008,Iraq,Karbala,22,0,22,A mass grave is discovered containing the bodies of twenty-two abducted shepherds
10446,15/10/2008,Iraq,Baghdad,7,18,25,A Mujahideen bomb blast and separate mortar attack on a mosque leave seven civilians dead.
10447,15/10/2008,Algeria,Setif,3,2,5,Fundamentalists murder three local guards with a bomb attack.
10448,15/10/2008,Jordan,Amman,1,0,1,A Muslim man shoots his 16-year-old daughter to death over concerns that she has had sex.
10449,16/10/2008,Iraq,Buhriz,1,1,2,A 6-year-old shepherd boy is murdered by Mujahideen bombers.  Another child is injured.
10450,16/10/2008,Pakistan,Miranshah,1,0,1,An Afghan refugee is brutally beheaded by the Taliban.
10451,16/10/2008,Algeria,Algiers,1,0,1,A young boy is kidnapped and beheaded by Islamic extremists.
10452,16/10/2008,Afghanistan,Paktika,1,0,1,"A radicalized policeman stages a surprise suicide ambush on a group of US soldiers, killing one."
10453,16/10/2008,Pakistan,Swat,5,15,20,"A Fedayeen suicide car bomber rams into a police station, killing five Pakistanis."
10454,16/10/2008,Afghanistan,Maiwand,31,0,31,Thirty-one passengers on a bus are stopped by the Taliban and calmly machine-gunned and beheaded.
10455,17/10/2008,Somalia,Merka,1,0,1,A humanitarian worker is shot to death by suspected fundamentalists.
10456,17/10/2008,India,Jaipur,0,1,1,A 'conservative Muslim' sets an 11-year-old girl on fire for wearing lipstick and being inappropriately dressed.
10457,17/10/2008,Iraq,Kut,1,0,1,Suspected fundamentalists shoot an unmarried pregnant woman to death.
10458,17/10/2008,Iraq,Baghdad,3,7,10,"Jihadis set off a bomb near a mosque, killing three civilians."
10459,18/10/2008,Iraq,Baquba,1,4,5,A woman is taken out by Mujahideen bombers.  Four family members are badly injured.
10460,18/10/2008,Iraq,Samarra,11,0,11,Eleven Iraqis kidnapped a year earlier by sectarian Jihadis are found in a mass grave.
10461,18/10/2008,Thailand,Narathiwat,1,0,1,A young laborer is gunned down by Mujahideen.
10462,18/10/2008,Thailand,Pattani,1,2,3,"Radical Muslims shoot at a family, killing the father and seriously injuring his wife and 5-year-old child."
10463,18/10/2008,Ingushetia,Muzhichi,2,5,7,Islamic militants ambush and kill two local soldiers.
10464,18/10/2008,Afghanistan,Kandahar,2,0,2,A father and son are shot to death by Sunni radicals outside a mosque.
10465,18/10/2008,Jordan,Aqaba,1,0,1,A man is forced to kill his sister for leaving the house without his permission.
10466,19/10/2008,Somalia,Hudur,1,0,1,Islamic militia shoot a UNICIF worker twice in the head as he is drinking tea with relatives.
10467,19/10/2008,Pakistan,Khyber,1,1,2,A woman is killed when Islamic militants bomb a marketplace.
10468,19/10/2008,Pakistan,Swat,1,0,1,A roadside ambush by the Taliban leaves one local soldier dead.
10469,19/10/2008,Iraq,Baghdad,2,15,17,Mujahideen bombers take out two civilians.
10470,19/10/2008,Iraq,Balad,5,3,8,"al-Qaeda gunmen attack a family home, killing five people."
10471,19/10/2008,Thailand,Yala,1,0,1,A 60-year-old rubber tapper is shot to death by Muslim militants while returning from work.
10472,19/10/2008,Thailand,Pattani,1,1,2,Islamists murder a 1-year-old baby when they fire into his home.
10473,20/10/2008,Somalia,Hudur,1,0,1,An aid worker for UNICEF is gunned down by fundamentalists.
10474,20/10/2008,Thailand,Narathiwat,2,6,8,"Islamists pepper a truck returning from a sporting event with machine-gun fire, killing two occupants."
10475,20/10/2008,Thailand,Pattani,3,0,3,"Three men sitting in a house are murdered by Muslim radicals, who shoot through the walls to kill them."
10476,20/10/2008,Thailand,Narathiwat,1,0,1,A civilian is shot to death by Islamists.
10477,20/10/2008,Iraq,Baghdad,4,8,12,"Mujahideen kill four civilians with two bombs, one an attack on a bus."
10478,20/10/2008,Afghanistan,Kabul,1,0,1,A female aid worker is shot to death by Sunni extremists over fears that she was sharing her Christian faith.
10479,20/10/2008,Afghanistan,Kunduz,7,0,7,Five children are among seven people blown to death by a Fedayeen suicide bomber.
10480,20/10/2008,Dagestan,Makhachkala,5,10,15,Muslim militants ambush and kill five police officers in two attacks.
10481,21/10/2008,Iraq,Latifiya,9,0,9,The bodies of nine people abducted and murdered by Jihadis are found in a grave.
10482,21/10/2008,Pakistan,Sersenai,2,6,8,Two people are murdered by Mujahideen bombers along a highway.
10483,22/10/2008,Thailand,Yala,1,0,1,A 40-year-old garbage truck driver is shot to death by Muslim extremists while riding to work.
10484,22/10/2008,Pakistan,Swat,15,20,35,Sunni radicals take out fifteen local troops with a bombing on their convoy.
10485,22/10/2008,Iraq,Mosul,2,0,2,"Two Christians, a father and son, are shot to death by Islamic radicals."
10486,22/10/2008,Pakistan,Khyber,2,0,2,Two children are killed when Lashkar-e-Islam open fire at a checkpoint.
10487,22/10/2008,Iraq,Mosul,4,3,7,Four people are taken down by Mujahideen bombers.
10488,22/10/2008,Iraq,Qaim,34,0,34,Two women are among thirty-four al-Qaeda kidnap victims found executed in a mass grave.
10489,23/10/2008,Afghanistan,Helmand,0,1,1,The Taliban rip out a farmer's eyes in front of his family.
10490,23/10/2008,Israel,Mingora,1,1,2,An 86-year-old Jewish man is stabbed to death at random by a Palestinian attacker.
10491,23/10/2008,Pakistan,Mingora,1,0,1,Sunnis abduct and behead a policeman.
10492,23/10/2008,Pakistan,Orakzai,8,0,8,"Religious extremists force a car off the road, then shoot the eight occupants to death one by one."
10493,23/10/2008,Iraq,Baghdad,10,22,32,"A Fedayeen suicide bomber detonates in the middle of rush hour, killing ten commuters."
10494,23/10/2008,Iraq,Kut,3,2,5,Three children bleed to death after their house is hit by a Jihadi mortar.
10495,23/10/2008,Philippines,Cotabato,2,0,2,Two game hunters are shot to death by Moro Islamists.
10496,24/10/2008,Chechnya,Serzhen-Yurt,1,10,11,Mujahideen use a landmine to murder a local security officer.
10497,25/10/2008,Somalia,Gurilel,1,0,1,A female activist for women's rights is murdered by suspected fundamentalists as she is walking home.
10498,25/10/2008,Afghanistan,Kabul,2,2,4,Two civilians are shot to death in their office by a Sunni radical.
10499,25/10/2008,Thailand,Pattani,1,4,5,Muslim militants gun down a police officer.
10500,25/10/2008,Pakistan,Wah,1,0,1,An 18-year-old girl is shot to death by her older brother on suspicion that she was having sex.
10501,26/10/2008,Pakistan,North Waziristan,5,0,5,Five civilians are brutally beheaded on video by al-Qaeda members.
10502,26/10/2008,Pakistan,Sambat,3,0,3,"Fundamentalists target a barbershop, killing three civilians."
10503,26/10/2008,Somalia,Mogadishu,6,3,9,Three civilians are among six people killed in a Mujahideen landmine attack.
10504,26/10/2008,Somalia,Saydheelow,5,15,20,Five local soldiers are killed in an ambush by Islamic militia.
10505,26/10/2008,Pakistan,Khyber,1,0,1,A tribal elder is shot to death by religious extremists.
10506,26/10/2008,Pakistan,Mohmand,11,5,16,A Fedayeen suicide car bomber murders eleven people at a check point.
10507,26/10/2008,Pakistan,Matta,11,62,73,Eleven innocent people are killed during a botched kidnapping attempt by the Taliban.
10508,26/10/2008,Somalia,Mogadishu,2,2,4,Two people are killed in an Islamic militia bombing.
10509,27/10/2008,Iraq,Baghdad,5,19,24,Jihad bombers take out five Iraqis in two separate blasts.
10510,27/10/2008,Afghanistan,Baghlan,3,6,9,An 8-year-old boy is among three people blasted to death by a suicide bomber posing as a policeman.
10511,27/10/2008,Somalia,Kismayu,2,0,2,Islamists quote from the Qur'an as they stone a 13-year-old rape victim to death and kill a young boy coming to her defense.
10512,27/10/2008,Pakistan,Karachi,4,0,4,Four locals are shot to death by sectarian rivals as they leave a mosque.
10513,27/10/2008,Thailand,Narathiwat,1,0,1,Islamists are suspected in the shooting death of a wood trader on his doorstep.
10514,28/10/2008,Iraq,Habaniya,2,3,5,A suicide bomber successfully takes out two Iraqis.
10515,28/10/2008,Iraq,Tal Afar,20,0,20,A mass grave containing twenty victims of al-Qaeda is discovered.
10516,28/10/2008,Sudan,Darfur,3,0,3,Three Chinese engineers are murdered in cold blood by their Janjiweed kidnappers.
10517,29/10/2008,Somalia,Hargeisa,28,26,54,Five separate suicide bombings leave over two dozen innocent people dead in commercial areas across the city.
10518,29/10/2008,Pakistan,Dera Ismail Khan,3,0,3,Three Shiite civilians standing at a bus stop are gunned down in cold blood by Sunni militants.
10519,29/10/2008,Pakistan,Bannu,2,11,13,Two local soldiers are blown to bits by a Fedayeen suicide bomber.
10520,29/10/2008,Iraq,Baghdad,5,17,22,"Mujahideen bomb a soda fountain, killing at least five patrons."
10521,29/10/2008,Iraq,Baqubah,1,16,17,A 4-year-old child is murdered by Islamic bombers.
10522,29/10/2008,Iraq,Balad Ruz,3,14,17,al-Qaeda gunmen murder three children in their home.
10523,29/10/2008,Thailand,Pattani,1,0,1,Islamists shoot a 52-year-old man to death.
10524,30/10/2008,India,Assam,81,300,381,Harkat-ul-Jehadi-e-Islami terrorists massacre over eighty people in six deadly blasts across several towns.
10525,30/10/2008,Afghanistan,Kabul,5,23,28,A woman is among five people killed when a Muslim terrorist throws a bomb into an office building.
10526,30/10/2008,Pakistan,Charbagh,1,0,1,The Taliban behead an abducted cop after holding him hostage for two days.
10527,30/10/2008,Iraq,Mosul,2,6,8,A random bombing along a traffic circle leaves two civilians dead.
10528,31/10/2008,Thailand,Pattani,1,1,2,A local man is shot to death by Muslim radicals.
10529,31/10/2008,Afghanistan,Helmand,4,4,8,Four local security forces are killed in two separate attacks by Sunni militants.
10530,31/10/2008,Somalia,Mogadishu,3,3,6,Islamists successfully kill three civilians in separate grenade attacks on two markets.
10531,31/10/2008,Pakistan,Mardan,8,25,33,"A suicide bomber walks into a home and detonates himself, killing at least eight other people."
10532,31/10/2008,Pakistan,Orakzai,4,3,7,Four people are killed in a sustained Taliban attack on their village.
10533,1/11/2008,Iraq,Basra,1,1,2,Jihadis take out a young child with a landmine.
10534,1/11/2008,Pakistan,Peshawar,2,0,2,Two residents are gunned down by Islamic militants.
10535,2/11/2008,Thailand,Narathiwat,1,1,2,"A Buddhist family is attacked by Muslim terrorists, who shoot the 72-year-old matriarch to death."
10536,2/11/2008,Pakistan,Zalai,8,3,11,A suicide bomber murders eight local soldiers at a checkpoint.
10537,2/11/2008,Iraq,Kirkuk,2,1,3,Two children are taken out by Jihadi roadside bombers.
10538,2/11/2008,Somalia,Baidoa,5,6,11,Fundamentalists kill five Somalis with a roadside blast.
10539,3/11/2008,Thailand,Narathiwat,1,0,1,A 66-year-old tea shop owner is shot to death by Islamic separatists.
10540,3/11/2008,Afghanistan,Kandahar,1,0,1,Taliban gunmen murder a government official as he is riding a motorbike.
10541,3/11/2008,Pakistan,Kabal Khas,4,0,4,"A father and son are among four people detained, then shot to death by Islamic radicals."
10542,3/11/2008,Iraq,Saadiya,2,0,2,Two women are kidnapped and murdered by suspected Sunni extremists.
10543,3/11/2008,Iraq,Baghdad,6,20,26,Jihadis manage to kill six Iraqis with a double bombing.
10544,3/11/2008,Iraq,Buhriz,6,0,6,Four children are among six members of a family taken out in a brutal al-Qaeda bomb attack.
10545,3/11/2008,Somalia,Baidoa,1,0,1,A women's rights activist is shot twice in the head and chest in front of her business by Islamic hardliners.
10546,4/11/2008,Afghanistan,Kandahar,1,0,1,A female anthropologist trying to learn local customs is doused with gas and burned to death (succumbs 1/7/09).
10547,4/11/2008,Pakistan,Swat,1,0,1,The Taliban tie a policeman to a pole and shoot him to death.
10548,4/11/2008,Pakistan,Orakzai,1,0,1,An elderly man is gunned down by Sunni extremists.
10549,4/11/2008,Iraq,Madaen,3,0,3,A woman and two children are killed when terrorists lob a mortar into their home.
10550,4/11/2008,Iraq,Baghdad,18,47,65,Eighteen Iraqis are killed in at least four Jihad bombings.
10551,4/11/2008,Pakistan,Mardan,2,2,4,Two policemen are shot at point blank range by Muslim militants.
10552,4/11/2008,Thailand,Narathiwat,1,72,73,"Islamists bomb a marketplace and a tea shop, killing at least one innocent and injuring over seventy."
10553,4/11/2008,Pakistan,Hangu,7,6,13,Seven people are killed by a Fedayeen suicide bomber.
10554,4/11/2008,Thailand,Yala,3,0,3,A 16-year-old boy is among three people ambushed and murdered by Muslim terrorists in separate attacks.
10555,5/11/2008,Somalia,Mogadishu,1,3,4,Islamic militia kill a local guard with a hand grenade.
10556,5/11/2008,Iraq,Baghdad,6,12,18,Six people are blown to bits by a suicide bomber at an airport.
10557,5/11/2008,Thailand,Yala,1,0,1,A school janitor on his way to work is shot to death by Islamic extremists.
10558,5/11/2008,Pakistan,Waziristan,5,0,5,Five civilians are hanged by religious fundamentalists.
10559,5/11/2008,Pakistan,FATA,1,0,1,Mujahideen abduct and murder a local official.
10560,6/11/2008,Iraq,Mosul,1,0,1,A young woman is shot to death by suspected fundamentalists over immoral activity.
10561,6/11/2008,Russia,Vladikavkaz,11,40,51,"A female suicide bomber strikes at a marketplace bus stop, murdering at least eleven passengers."
10562,6/11/2008,Algeria,Cabilia,1,0,1,"A popular mayor is kidnapped, executed and then burned by Islamic fundamentalists."
10563,6/11/2008,Pakistan,Khar,22,45,67,Fedayeen suicide bombers take out over twenty people at a gathering of tribal elders.
10564,6/11/2008,Thailand,Yala,1,0,1,The 47-year-old widow of a murdered man is herself gunned down by Muslim militants.
10565,7/11/2008,Pakistan,Changa Manga,1,0,1,A 15-year-old girl is stabbed to death by her brother on suspicion of sexual relations.
10566,7/11/2008,Iraq,Baghdad,6,12,18,Two Jihad bombings leave six civilians dead.
10567,7/11/2008,Pakistan,Mingora,2,11,13,Two local security personnel are dismembered by a suicide bomber.
10568,7/11/2008,Afghanistan,Ghor,1,1,2,Talibanis assassinate a local official.
10569,8/11/2008,Iraq,Ramadi,8,12,20,A double suicide bombing by Fedayeen leave eight Iraqis dead.
10570,8/11/2008,Somalia,Jamame,1,0,1,"A aid worker, whose agency helps construct roads, is murdered by Islamic militia."
10571,8/11/2008,Somalia,Lego,3,0,3,Al-Shabaab terrorists kidnap and behead three local soldiers.
10572,8/11/2008,Pakistan,North Waziristan,2,0,2,"Two civilians are abducted, then riddled with bullets by religious extremists."
10573,8/11/2008,Algeria,Naciria,1,0,1,A young man delivering bread is shot and beheaded by Islamic fundamentalists.
10574,9/11/2008,Iraq,Fallujah,3,5,8,Two woman and a 10-year-old girl are blown to bits by a Fedayeen suicide bomber.
10575,9/11/2008,Philippines,Pikit,2,3,5,A 12-year-old boy and 10-year-old girl are brutally gunned down by Islamic extremists.
10576,9/11/2008,Philippines,Maguindanao,2,0,2,Two locals are abducted and shot to death by Moro Islamists.
10577,9/11/2008,Afghanistan,Herat,2,4,6,"A suicide bomber yells 'Allah Akbar' then detonates along a highway, killing two Spanish soldiers."
10578,9/11/2008,Pakistan,Matta,1,0,1,A woman is pumped full of bullets after being found guilty of adultery by a Sharia court.
10579,9/11/2008,Algeria,Jijel,1,0,1,Islamic fundamentalists murder a 52-year-old civilian.
10580,10/11/2008,Iraq,Baghdad,30,68,98,Two Sunni suicide bombers massacre thirty Shia civilians outside a fine arts school.
10581,10/11/2008,Thailand,Narathiwat,1,5,6,Islamists kill a local soldier with a roadside bomb.
10582,10/11/2008,Pakistan,Orakzai,1,9,10,"Sunni extremists fire on a passenger bus, killing one person."
10583,10/11/2008,Dubai,Umm Suqeim,1,1,2,"A brother stabs his sister's lover to death in an honor killing.  (The woman is also stabbed, but survives)."
10584,10/11/2008,Iraq,Baqubah,7,12,19,al-Qaeda sends a 13-year-old female suicide bomber to a gathering where seven people are killed.
10585,11/11/2008,Thailand,Pattani,2,0,2,A 79-year-old woman is murdered along with her son by Muslim terrorists as she is walking home.
10586,11/11/2008,Thailand,Yala,2,0,2,Two laborers are shot to death by Islamic militants in separate attacks.
10587,11/11/2008,Iraq,Baghdad,3,15,18,"Mujahideen target newspaper vendors with bombs, killing at least three."
10588,11/11/2008,Thailand,Pattani,1,0,1,A Buddhist civilian is shot to death at close range by Islamists.
10589,11/11/2008,Pakistan,Peshawar,4,13,17,A suicide bomber murders four people outside a sports stadium.
10590,12/11/2008,Pakistan,Peshawar,2,0,2,An American humanitarian worker and his driver are murdered by Islamic radicals.
10591,12/11/2008,Iraq,Mosul,2,0,2,Two Christian sisters are shot to death inside their home by Muslim militants.
10592,12/11/2008,Afghanistan,Kandahar,6,42,48,Six people are killed when a suicide bomber flattens a commercial district.
10593,12/11/2008,Afghanistan,Kandahar,0,3,3,Religious extremists spray three teenage schoolgirls with acid while they are walking to school.
10594,12/11/2008,Afghanistan,Farah,1,0,1,A religious cleric who condemned suicide bombings is kidnapped and executed in captivity by the Taliban.
10595,12/11/2008,Iraq,Baghdad,21,87,108,Nearly two dozen Iraqis are successfully killed by Mujahideen bombers in three attacks.
10596,12/11/2008,Pakistan,Charsadda,6,15,21,A half dozen people are murdered by a Fedayeen suicide car bomber.
10597,13/11/2008,Dagestan,Urguba,1,1,2,Suspected Islamists gun down a local cop at point-blank range.
10598,13/11/2008,Afghanistan,Nangarhar,9,74,83,"Islamic suicide bombers hit a livestock market, sending nine innocents to Allah."
10599,13/11/2008,Iraq,Ramadi,4,3,7,A Fedayeen suicide bomber murders four people.
10600,13/11/2008,Philippines,Mindanao,3,0,3,A 5-year-old boy is among three civilians killed by Moro Islamists during an assault.
10601,14/11/2008,Pakistan,Ramora,2,0,2,A young man is forced by honor to kill his sister and her lover after finding them in a compromising position.
10602,14/11/2008,Afghanistan,Khost,3,0,3,Three construction workers are shot to death by Sunni extremists.
10603,15/11/2008,Iraq,Tal Afar,9,40,49,"Mujahideen plant a car bomb at a car dealership, killing nine employees and customers."
10604,15/11/2008,Iraq,Baghdad,3,25,28,Three people are killed when terrorists detonate a bomb near a theatre.
10605,15/11/2008,Philippines,Sarangani,2,0,2,Moro Islamists murder two local soldiers with a landmine.
10606,15/11/2008,Somalia,Yaqshid,2,0,2,Two civilians are killed during an ambush by Islamic extremists.
10607,16/11/2008,Iraq,Jalawla,15,20,35,"A Fedayeen detonates himself in a crowd, sending fifteen innocent souls to Allah."
10608,16/11/2008,Iraq,Baghdad,3,6,9,Jihadis manage to kill three Iraqis with a roadside bomb.
10609,16/11/2008,Somalia,Baidoa,3,10,13,A child and two women are blown to bits by Muslim bombers at a marketplace.
10610,16/11/2008,Somalia,Mogadishu,2,2,4,"Islamists open fire on a car, killing two businessmen."
10611,16/11/2008,Thailand,Yala,1,0,1,A young man is murdered outside his home by Muslim gunmen.
10612,16/11/2008,Thailand,Pattani,1,0,1,Islamists shoot a man to death outside a mosque.
10613,16/11/2008,Pakistan,Anayat Kalley,1,0,1,A tribal elder is killed in a brutal ambush by a group of Taliban.
10614,17/11/2008,Thailand,Pattani,3,0,3,A 73-year-old woman is among three civilians murdered by Religion of Peace gunmen in separate attacks.
10615,17/11/2008,Thailand,Narathiwat,1,1,2,"A civilian is killed, and his 8-year-old daughter badly injured, when Islamic gunmen fire on their pickup truck."
10616,17/11/2008,Afghanistan,Farah,6,4,10,"Talibanis ambush a group of local soldiers, shooting some and beheading others."
10617,17/11/2008,Afghanistan,Dand,3,2,5,Three Afghans are murdered by a suicide bomber.
10618,17/11/2008,Ingushetia,Nazran,1,1,2,"Islamic separatists shoot a married couple in their car, killing the man and putting his wife in the hospital."
10619,17/11/2008,Afghanistan,Kandahar,4,8,12,Religious extremists murder four civilians with a roadside bomb.
10620,17/11/2008,Pakistan,Swat,4,3,7,Four Pakistanis are blown apart by a suicide car bomber.
10621,17/11/2008,Thailand,Pattani,1,0,1,A 44-year-old security guard is shot three times by Islamic terrorists while riding his motorbike.
10622,18/11/2008,Iraq,Baghdad,15,0,15,Fifteen bodies are found beneath a house controlled by the militia of a Shiite cleric.
10623,18/11/2008,Thailand,Pattani,2,0,2,"Two Buddhists are shot to death by Muslim militants, who then mutilate the bodies and take amputated arms."
10624,18/11/2008,Thailand,Pattani,1,1,2,Mujahideen gun down a woman and her son on their way to work at a plantation.
10625,18/11/2008,Thailand,Yala,1,1,2,"Islamists gun down a soldier shopping at a local market as well as his wife, who came to his defense."
10626,19/11/2008,England,Woolwich,1,0,1,A failed asylum seeker from Algeria beats a gay man to death who took him in.
10627,19/11/2008,Yemen,Joaar,5,0,5,al-Qaeda terrorists gun down four local cops and a civilian.
10628,19/11/2008,Pakistan,Islamabad,2,0,2,Two men are shot to death by Mujahideen along a city street.
10629,19/11/2008,Dagestan,Buynaksk,1,0,1,A local cop is gunned down by suspected Muslim militants.
10630,20/11/2008,Afghanistan,Khost,8,13,21,"A Fedayeen suicide bomber detonates outside an office building, sending eight Afghans to Allah."
10631,20/11/2008,Iraq,Kut,5,0,5,"Sunni extremists invade a home and kill five residents, including children."
10632,20/11/2008,Iraq,Mosul,5,0,5,Two women are among five people murdered by terrorists while sitting in their vehicle.
10633,20/11/2008,Pakistan,Bajaur,9,6,15,A suicide bomber enters a rival mosque and takes out nine innocents.
10634,20/11/2008,Pakistan,Swat,1,0,1,A local man is murdered by the Taliban for helping a Chinese engineer escape abduction.
10635,21/11/2008,Iran,Tehran,1,0,1,"A 43-year-old businessman is tortured by police into a ""confession"" then executed as a spy."
10636,21/11/2008,Pakistan,Hangu,1,0,1,"Religious extremists fire a rocket at a checkpoint, killing a policeman."
10637,21/11/2008,Iraq,Baghdad,3,15,18,Mujahideen take out three Iraqis with a roadside bomb.
10638,21/11/2008,Pakistan,Dera Ismail Khan,11,40,51,"Radical Sunnis gun down a Shia cleric, then bomb his funeral, murdering eight others."
10639,21/11/2008,Somalia,Mogadishu,9,20,29,Five children are among nine civilians killed in a rolling series of attacks by Islamic militia in residential areas.
10640,21/11/2008,Afghanistan,Zabul,3,4,7,Three civilians are blown to bits by a suicide car bomber.
10641,22/11/2008,Pakistan,Mingora,1,0,1,Religious extremists burn down a video store and shoot a civilian to death.
10642,22/11/2008,Pakistan,Bannu,3,0,3,A Taliban rocket attack on a police post leaves three dead.
10643,22/11/2008,Somalia,Mogadishu,15,75,90,At least fifteen civilians are killed in attacks by Islamic militias on security forces.
10644,22/11/2008,Iraq,Iskandariya,10,0,10,Two women are among ten people found executed in a mass grave in a Sunni stronghold.
10645,22/11/2008,Afghanistan,Khost,2,15,17,A 15-year-old boy and a man are blown to bits when Holy Warriors bomb a vegetable market.
10646,22/11/2008,Afghanistan,Kunar,0,0,0,"After being held in captivity for three months, the Taliban execute a local official when their demands are not met."
10647,22/11/2008,Afghanistan,Ghazni,1,0,1,A local civilian is captured and shot to death by Sunni radicals.
10648,22/11/2008,Ingushetia,Nazran,1,0,1,A cafe worker is gunned down by Muslim rebels.
10649,22/11/2008,Afghanistan,Kabul,1,1,2,Sunni extremists kill a French de-miner with a landmine.
10650,22/11/2008,Pakistan,Hangu,5,8,13,Two children are among five killed when Islamists set a bomb off inside a rival mosque.
10651,23/11/2008,Chechnya,Sadovyi,5,4,9,Mujahideen murder five security personnel and a civilian in two attacks.
10652,23/11/2008,Ingushetia,Nazran,1,0,1,Islamic militants kill an off-duty cop at a grocery store.
10653,23/11/2008,Iraq,Muwaylaha,9,0,9,Nine kidnap victims of an Islamic militia are found in a mass grave.
10654,24/11/2008,India,Doda,1,0,1,A civilian is murdered in his home by Muslim terrorists.
10655,24/11/2008,Pakistan,Kabal,1,0,1,Mujahid assassinate a local political activist.
10656,24/11/2008,Thailand,Yala,3,1,4,Islamists gun down three civilians and severely injure a teacher in separate attacks.
10657,24/11/2008,Pakistan,Mingora,1,0,1,Religious extremists execute a woman in her home for immoral behavior.
10658,24/11/2008,Iraq,Baghdad,13,6,19,Women and children are heavily represented in the thirteen bus passengers massacred by Mujahideen bombers.
10659,24/11/2008,Iraq,Baghdad,5,24,29,A female suicide bomber takes out five Iraqis.
10660,24/11/2008,Dagestan,Karabudakhent,2,3,5,"Muslim rebels open fire on a group of policemen, killing two."
10661,25/11/2008,Pakistan,Bara,1,0,1,A Sikh father is brutally murdered two days after being abducted by Muslim radicals.
10662,25/11/2008,Pakistan,Shahdra,1,0,1,A Muslim lad hacks his stepmother to death with an axe over 'illicit relations.'
10663,25/11/2008,Pakistan,Kohat,0,0,0,"Four persons, including a mother and child, are killed when sectarian Jihadis fire into a vehicle."
10664,25/11/2008,Pakistan,Hangu,4,9,13,"Shia militants open fire in a hotel, murdering eight Sunni rivals."
10665,25/11/2008,India,Baramulla,1,2,3,A 14-year-old boy is killed when Islamists throw a grenade into a road show.
10666,25/11/2008,Pakistan,Matta,3,5,8,A butcher is among three people gunned down by the Taliban in separate attacks.
10667,25/11/2008,Iraq,Mosul,2,5,7,Two Americans are shot to death while handing out humanitarian aid.
10668,25/11/2008,Somalia,Baidoa,1,0,1,A local officer is shot several times in the chest by Islamists at a market.
10669,25/11/2008,India,Mumbai,4,0,4,Islamic terrorists hijack a boat in Pakistan and kill the four man crew.
10670,26/11/2008,Chechnya,Grozny,6,0,6,Six women are shot in the head and chest over suspected immorality in separate attacks.
10671,26/11/2008,Dagestan,Khasavyurt,1,2,3,A police officer is gunned down outside a mosque by Jihad terrorists.
10672,26/11/2008,Dagestan,Makhachkala,1,0,1,A border guard is shot and killed by Muslim militants.
10673,26/11/2008,Pakistan,Peshawar,2,6,8,Two residents are killed when the Taliban fire rockets into their home.
10674,26/11/2008,Iraq,Samarrah,6,0,6,Six people are murdered by local Jihadists.
10675,26/11/2008,Iraq,Diyala,23,0,23,Twenty-three victims of sectarian terrorists are found in a mass grave.
10676,26/11/2008,Philippines,Makir,1,3,4,"Moro Islamists ambush a group of local soldiers guarding a highway, killing one."
10677,26/11/2008,India,Mumbai,178,370,548,"Mujahideen throw grenades and machine-gun over one-hundred and fifty civilians and tourists to death as they attack several sites, including a hotel, cafe, market and train station."
10678,26/11/2008,Russia,Vladikavkaz,1,0,1,"A mayor is assassinated by local terrorists, who call him an ""enemy of Allah."""
10679,27/11/2008,Afghanistan,Kabul,4,18,22,A suicide car bomber takes out four local civilians outside the US embassy.
10680,27/11/2008,Afghanistan,Badghis,13,11,24,Thirteen local security personnel are killed in an ambush by religious extremists.
10681,27/11/2008,Pakistan,Swat,6,0,6,"Six people are shot to death by Sunni extremists in separate attacks, including a brutal abduction."
10682,27/11/2008,Iraq,Mosul,2,28,30,Suicide bombers successfully take out two Iraqi civilians.
10683,28/11/2008,Nigeria,Jos,6,0,6,Six Christian pastors are among hundreds killed when Muslim rioter stage a deadly church-burning rampage.
10684,28/11/2008,Pakistan,Bannu,7,16,23,Six civilians and a cop are murdered by a suicide bomber along a city street.
10685,28/11/2008,Iraq,Baghdad,2,10,12,A Fedayeen suicide car bomber kills two civilians.
10686,28/11/2008,India,Mumbai,5,0,5,"Five Jewish hostages, including a rabbi and his wife, are murdered by Islamists."
10687,28/11/2008,Pakistan,Gharibabad,6,0,6,Three women and a child are among six member of a family murdered in their home by the Mujahideen.
10688,28/11/2008,Iraq,Kut,1,2,3,A child is killed when Muslim militants fire a rocket into a home.
10689,28/11/2008,Iraq,Mussayab,12,18,30,Twelve people at a mosque are blown to bits by rival sectarian bombers.
10690,28/11/2008,Nigeria,Jos,2,0,2,"Two Christians are hacked to death after a cleric inspires his followers to 'kill unbelievers."""
10691,29/11/2008,Iraq,Baghdad,3,12,15,Three people are murdered by an Iranian-made rocket fired by Mujahideen.
10692,29/11/2008,Iraq,Mosul,3,18,21,Two brothers are among three killed in an attack on a jewelry shop by Sunni terrorists.
10693,29/11/2008,Iraq,Albu Toma,38,0,38,Thirty-eight victims of sectarian violence within the Religion of Peace are found in a mass grave.
10694,29/11/2008,Chechnya,Enginoy,1,0,1,A woman is shot to death over suspected immoral behavior.
10695,29/11/2008,Somalia,Baidoa,2,10,12,Two people are killed in blasts by suspected Islamic militia.
10696,30/11/2008,Afghanistan,Kabul,2,3,5,A street sweeper is among two civilians blown up by a suicide bomber.
10697,30/11/2008,Pakistan,Bannu,6,5,11,Six local police are killed in two Taliban ambushes.
10698,30/11/2008,Pakistan,North Waziristan,1,0,1,The Taliban abduct and murder an Afghan civilian.
10699,30/11/2008,Pakistan,Peshawar,1,1,2,A local driver is killed when Sunni militants lob rockets into a terminal.
10700,30/11/2008,Dagestan,Makhachkala,4,0,4,Muslim gunmen shoot four people to death.
10701,1/12/2008,Afghanistan,Musa Qala,10,25,35,Ten shoppers are blown up by a suicide bomber at a market.
10702,1/12/2008,Pakistan,Swat,11,66,77,Women are among the casualties of a horrific suicide attack on a traffic checkpoint.  Eleven are killed.
10703,1/12/2008,Afghanistan,Ghazni,1,0,1,A local official is assassinated by religious extremists.
10704,1/12/2008,Iraq,Mosul,15,25,40,A Fedayeen suicide bomber takes out fifteen civilians along a city street.
10705,1/12/2008,Iraq,Baghdad,16,35,51,Sixteen police recruits are murdered by two Jihad bombers at their academy.
10706,1/12/2008,Thailand,Yala,1,0,1,Muslim terrorists gun down a rubber tapper in his orchard.
10707,1/12/2008,Pakistan,Peshawar,2,0,2,"Taliban militants attack a supply convoy, killing two drivers."
10708,2/12/2008,Pakistan,Sunpag,1,0,1,"Religious extremists abduct a local official, keep him for a few days, then slaughter him and stuff his body in a bag."
10709,2/12/2008,Pakistan,Kabal,1,0,1,A civilian is shot to death by Islamic terrorists.
10710,2/12/2008,Iraq,Tal Afar,5,30,35,Jihadis successfully kill five Iraqis with a car bomb.
10711,2/12/2008,Iraq,Mosul,4,12,16,Two young children are among four killed when Mujahideen place a bomb outside a school.
10712,2/12/2008,Dagestan,Makhachkala,1,4,5,Suspected Muslim militants gun down a cop.
10713,3/12/2008,Pakistan,Shabqadar,5,6,11,Five locals are killed by a Fedayeen car bomber.
10714,3/12/2008,Chechnya,Grozny,3,0,3,Three people are shot inside their home by suspected Mujahideen.
10715,3/12/2008,Iraq,Albu Toma,13,0,13,Thirteen victims of al-Qaeda kidnappings are found in a mass grave.
10716,4/12/2008,Pakistan,Bahawalpur,1,0,1,A young girl is clubbed to death by her uncle on suspicion of 'illicit relations.'
10717,4/12/2008,Thailand,Pattani,2,0,2,A 60-year-old man is among two people gunned down by Muslim separatists.
10718,4/12/2008,Iraq,Albu Toma,25,0,25,Twenty-five al-Qaeda victims are found in mass graves.
10719,4/12/2008,Iran,Bluchistan,16,0,16,Jundullah terrorists kidnap and execute sixteen Iranian nationals.
10720,4/12/2008,Afghanistan,Khost,5,10,15,Five people are killed in two suicide attacks by Sunni extremists.
10721,4/12/2008,Iraq,Fallujah,15,147,162,Women and children are among fifteen Iraqis blasted to death by Jihadi car bombers.
10722,4/12/2008,Dagestan,Khasavyurt,1,0,1,A woman is killed by Islamic car bombers outside an apartment building.
10723,5/12/2008,Pakistan,Mir Ali,1,0,1,Sunni extremists abduct and murder an 30-year-old man.
10724,5/12/2008,Thailand,Narathiwat,5,12,17,Five people are killed at a grocery by Islamic bombers.
10725,5/12/2008,Iraq,Baghdad,2,2,4,Mujahideen bombers take out two Iraqis.
10726,5/12/2008,Pakistan,Bannu,2,3,5,Taliban militants kill two policemen with a rocket attack.
10727,5/12/2008,Pakistan,Orakzai,10,5,15,Religious extremists take out ten shoppers at a bazaar with a suicide blast.
10728,5/12/2008,Pakistan,Peshawar,34,131,165,Twenty-nine people at a marketplace are blown to bits by sectarian car bombers.
10729,6/12/2008,Afghanistan,Kunar,4,2,6,Four local soldiers are killed when religious extremists attack their vehicle with a roadside bomb.
10730,6/12/2008,Pakistan,Swat,3,0,3,Three civilians are gunned down by suspected Taliban.
10731,6/12/2008,Iraq,Babel,4,0,4,Four children are killed by a landmine planted near a soccer field by suspected Sunnis.
10732,6/12/2008,Iraq,Kirkuk,1,15,16,A Fedayeen suicide bomber kills only one other person.
10733,6/12/2008,Iraq,Wajihiya,3,4,7,"al-Qaeda gunmen attack a Sunni village, killing three people."
10734,6/12/2008,Somalia,Baidoa,3,0,3,"An Islamic militia member tosses a grenade into a market, killing three civilians."
10735,7/12/2008,Pakistan,Peshawar,1,0,1,The Taliban murder a local security guard at a depot.
10736,7/12/2008,Iraq,Baquba,3,39,42,Jihadis kill three Iraqis with a bomb hidden in a shop.
10737,8/12/2008,India,Bharatpur,2,0,2,A man reclaims his honor by shooting his daughter and her boyfriend after learning of their sexual relationship.
10738,9/12/2008,Philippines,Maguindanao,1,8,9,A local soldier is killed when Moro Islamists open fire on them with automatic weapons.
10739,9/12/2008,Pakistan,Buner,1,4,5,A 10-year-old child is murdered by a Fedayeen suicide bomber.
10740,10/12/2008,Iraq,Jalawla,1,2,3,A civilian is taken out in a Jihad bomb blast.
10741,11/12/2008,Pakistan,Matta,3,4,7,Tehrik-e-Taliban terrorists gun down three locals.
10742,11/12/2008,Iraq,Kirkuk,55,120,175,Fifty-five Iraqis are blown to bits at a restaurant by Shahid suicide bombers.
10743,11/12/2008,Somalia,Mogadishu,10,11,21,Children are among ten people killed during an attack by Islamic militia.
10744,11/12/2008,Yemen,Reida,1,0,1,"A Jewish leader is gunned down by a Muslim shouting, 'Jew, receive the message of Islam.'"
10745,12/12/2008,Thailand,Yala,3,3,6,Three border guards are killed when Islamic militants open up on them with automatic weapons.
10746,12/12/2008,Thailand,Pattani,1,2,3,Jihadis kill a man and seriously injure two others with a planted bomb in a karaoke bar.
10747,12/12/2008,Afghanistan,Helmand,4,1,5,"Religious extremists trick a 13-year-old boy into carrying explosives to British troops, which were then detonated remotely."
10748,13/12/2008,Pakistan,Miranshah,2,0,2,Islamists slit one man's throat and shoot another to death.
10749,13/12/2008,Philippines,Basilan,3,3,6,A woman is among three people murdered in their home by Moro Islamists.
10750,13/12/2008,India,Doda,1,2,3,Mujahideen gun down a woman in her home.
10751,13/12/2008,Pakistan,Matta,4,0,4,Four tribesmen are shot to death by the Taliban.
10752,13/12/2008,Pakistan,Swat,5,0,5,Five civilians are killed in a terrorist landmine attack.
10753,14/12/2008,England,West Yorkshire,0,1,1,A Muslim youth brutally stabs a 51-year-old at random after telling him that he is walking through an area of Britain that 'Muslims rule.'
10754,14/12/2008,Afghanistan,Paktika,1,0,1,A musician is kidnapped and killed by Taliban fundamentalists for defying a ban on music.
10755,14/12/2008,Pakistan,Mandal Daag,9,3,12,Sunni extremists murder a rival cleric and eight of his followers.
10756,14/12/2008,Afghanistan,Kandahar,3,11,14,Three Afghans are murdered by a Taliban bomb hidden in a street vendor cart.
10757,14/12/2008,Pakistan,Jamrud,2,1,3,Mujahideen shoot two tribal elders to death along a road.
10758,15/12/2008,Iraq,Khan Dhari,9,31,40,Nine Iraqi police are blown apart by a Fedayeen car bomber at a checkpoint.
10759,15/12/2008,Thailand,Narathiwat,2,1,3,A 4-year-old child is among three people shot by Islamists in two attacks.
10760,15/12/2008,Pakistan,Swat,6,3,9,Six locals are murdered - two beheaded - by Taliban fundamentalists in three attacks.
10761,15/12/2008,Iraq,Tarmiya,1,1,2,A female suicide bomber takes out an Iraqi man and seriously injures his son.
10762,15/12/2008,Thailand,Yala,1,0,1,A 53-year-old man is gunned down in front of a food shop by Islamic terrorists.
10763,15/12/2008,Iraq,Sinjar,7,3,10,Women and children are among seven members of a religious minority sect slaughtered in their home by suspected Sunnis.
10764,16/12/2008,Thailand,Pattani,2,0,2,Two young guards escorting a teacher are gunned down by Muslim radicals.
10765,16/12/2008,Pakistan,Swat,2,0,2,Islamic terrorists gun down two people in separate attacks.
10766,16/12/2008,Iraq,Baghdad,1,3,4,A 13-year-old child is taken out by Islamic bombers.
10767,16/12/2008,Iraq,Mosul,8,16,24,Two suicide bombings leave eight Iraqis dead.
10768,16/12/2008,Iraq,Baghdad,3,15,18,"Jihadis place a bomb near a college campus, killing three people."
10769,16/12/2008,Thailand,Yala,3,1,4,"Muslim terrorists shoot three people to death at a market, including a woman"
10770,17/12/2008,Pakistan,Jamrud,1,1,2,"A woman is killed, and a child injured, in a Taliban rocket attack on a vehicle."
10771,17/12/2008,Pakistan,Wana,1,0,1,A civilian is shot to death by religious extremists.
10772,17/12/2008,Pakistan,Matta,2,0,2,Taliban militants abduct and kill two locals.
10773,17/12/2008,Iraq,Baghdad,18,53,71,Eighteen innocent souls are snuffed out by Jihadi bombers along a city street.
10774,17/12/2008,Thailand,Yala,1,0,1,A 16-year-old boy is shot to death outside of a 7-Eleven by Mujahideen.
10775,17/12/2008,Pakistan,Kanju,2,0,2,A couple is murdered for having unmarried sex.
10776,18/12/2008,Philippines,Iligan,3,47,50,"Islamists detonate nail-packed bombs at two shopping malls in Christian areas, killing at least three people."
10777,18/12/2008,Iraq,Kirkuk,1,0,1,A female women's rights activist is beheaded in her home by Islamic terrorists.
10778,18/12/2008,Pakistan,Hangu,4,1,5,A child is among four people shot to death by Islamists in three attacks.
10779,18/12/2008,Iraq,Diyala,2,17,19,Two Iraqis are taken out by roadside bombers.
10780,19/12/2008,Somalia,Mogadishu,1,10,11,A civilian is shot to death during an attack by Jabalu Islamiya terrorists.
10781,19/12/2008,Pakistan,Khyber,3,0,3,Three civilians are killed when Sunni militants open fire on an empty fuel tanker.
10782,19/12/2008,Iraq,Baghdad,7,0,7,Islamists behead seven Iraqis.
10783,20/12/2008,Thailand,Pattani,1,7,8,A woman standing outside a convenience store is murdered by Islamic bombers.  Children are injured as well.
10784,20/12/2008,Thailand,Yala,1,0,1,A 49-year-old security guard is shot to death by Muslim radicals as he leaves his home.
10785,21/12/2008,Pakistan,North Waziristan,2,0,2,Two brothers are brutally kidnapped and murdered by Sunni extremists.
10786,21/12/2008,Pakistan,Swat,3,0,3,Mujahideen drag three people out of their home and shoot them in cold blood.  The victims include a man and his son.
10787,21/12/2008,Pakistan,Bannu,2,0,2,"Islamic militants rocket a government building, killing two people."
10788,21/12/2008,Thailand,Pattani,1,0,1,A 50-year-old civilian is murdered by Muslim gunmen on his way home.
10789,22/12/2008,Somalia,Mogadishu,7,22,29,Seven civilians are killed during an attack by Islamic guerrillas
10790,22/12/2008,Pakistan,Swat,6,8,14,Two women are among six civilians killed by Mujahideen in three incidents.
10791,22/12/2008,Afghanistan,Ghazni,3,4,7,A suicide bomber takes out three civilians.
10792,22/12/2008,India,Baramulla,2,0,2,Two local soldiers are shot to death at close range by Muslim assassins at a market.
10793,23/12/2008,Iraq,Tarmiyah,5,4,9,A man and his wife are among two people blasted to death by Jihad bombers.
10794,23/12/2008,Iraq,Mosul,2,6,8,A child and doctor are murdered by Islamic terrorists.
10795,23/12/2008,Iraq,Kifl,1,0,1,A man is kidnapped and tortured to death by Religion of Peace militants.
10796,23/12/2008,Thailand,Pattani,1,7,8,An Islamist shooting and bombing leave one dead and seven injured.
10797,23/12/2008,Pakistan,Mingora,2,0,2,A beggar woman and her daughter are gunned down at point-blank range by Holy Warriors.
10798,23/12/2008,Pakistan,Swat,4,0,4,A man and his wife are among four people murdered by Mujahideen in three attacks.
10799,23/12/2008,Philippines,Isabela,0,26,26,Abu Sayyaf members toss two grenades into a group of people enjoying a musical performance.
10800,23/12/2008,Philippines,Sultan Kudarat,9,8,17,Moro Islamists storm two villages and shoot nine civilians to death.
10801,24/12/2008,Pakistan,Lahore,1,4,5,Muslim bombers take out a woman along a city street.
10802,24/12/2008,Philippines,Kalamansig,1,0,1,"Moro Islamists fire at a motorboat, killing a passenger."
10803,24/12/2008,Iraq,Fallujah,3,4,7,Three children are killed in a suspected al-Qaeda roadside attack.
10804,25/12/2008,Iraq,Bishkan,1,1,2,A 13-year-old is murdered in her home by Jihadi invaders.
10805,25/12/2008,Iraq,Baghdad,4,24,28,"Sunni extremists bomb a restaurant, killing four patrons."
10806,25/12/2008,Iraq,Muqdadiyah,3,12,15,A Fedayeen suicide bomber takes out three other people.
10807,26/12/2008,Pal. Auth.,Beit Lahiya,2,0,2,Two young girls are killed when a Palestinian rocket hits their home.
10808,26/12/2008,Iran,Mashhad,2,0,2,Two men are buried up to their waists and stoned to death for adultery.
10809,26/12/2008,Pakistan,Bajaur,1,9,10,A child is killed during a Taliban rocket attack.
10810,26/12/2008,India,Kishtwar,1,0,1,"Mujahideen abduct a man, then murder him in a wooded area."
10811,26/12/2008,Pakistan,Gilgit,5,0,5,A child is among five people shot dead in a sectarian ambush.
10812,27/12/2008,Israel,Netivot,1,4,5,Hamas rockets kill an Israeli man and injure four others.
10813,27/12/2008,Afghanistan,Kandahar,5,5,10,Five Afghans are blown up by a Fedayeen suicide bomber.
10814,27/12/2008,Afghanistan,Kabul,3,0,3,Three teenage sisters are crushed to death by a Taliban rocket barrage.
10815,27/12/2008,Iraq,Baghdad,24,45,69,Women and children are among two dozen people blasted to death by Jihadi car bombers.
10816,28/12/2008,Pakistan,Miranshah,3,0,3,"Three young civilians, including an 18-year-old, are kidnapped and hung by Taliban militants."
10817,28/12/2008,Iraq,Mosul,4,20,24,A 12-year-old boy is among four civilians taken out by a suicide bomber on a bicycle.
10818,28/12/2008,Iraq,Fallujah,4,10,14,Four Iraqis are murdered in two Jihad bombings.
10819,28/12/2008,Afghanistan,Khost,16,58,74,Fourteen children on their way to school are deliberately murdered along with two adults by a suicidal Sunni bomber.
10820,28/12/2008,Pakistan,Buner,43,16,59,Religious extremists take out over forty people at a polling station with car bombs. Five children are among the dead.
10821,28/12/2008,Thailand,Yala,1,0,1,Islamic gunmen murder a man in a tea shop.
10822,29/12/2008,Thailand,Pattani,1,1,2,A woman is shot to death on her way to work by Muslim terrorists.  Three others are killed elsewhere.
10823,29/12/2008,Somalia,Mogadishu,5,10,15,"At least five civilians are killed, including a young child, when Islamists bomb a market."
10824,29/12/2008,Pakistan,Gwalirai,2,0,2,"Two men, abducted days earlier, are murdered in captivity by the Taliban."
10825,29/12/2008,Iraq,Mahaweel,3,0,3,A mother and daughter are among three people killed by Sunni bombers.
10826,29/12/2008,Iraq,Mosul,1,0,1,A Shahid suicide bomber takes out a shopper at a grocery.
10827,29/12/2008,Israel,Ashdod,1,1,2,A mother of four is killed by a Palestinian rocket.
10828,29/12/2008,Afghanistan,Kabul,2,17,19,Two Afghan civilians are blown to bits by a Fedayeen suicide bomber.
10829,29/12/2008,Israel,Ashkelon,1,7,8,"Hamas rockets hit an Israeli home, killing a resident."
10830,29/12/2008,Iran,Saravan,2,10,12,Two police officers are killed by a Sunni suicide bomber.
10831,30/12/2008,Egypt,Cairo,0,1,1,"A woman who embraced Christianity is arrested, raped and tortured by police, who promise to release her if she will return to Islam."
10832,30/12/2008,Pakistan,Mingora,1,0,1,A local official is assassinated by Muslim militants.
10833,30/12/2008,Iraq,Jalawla,1,0,1,Suspected al-Qaeda gun down a tribal leader.
10834,30/12/2008,Philippines,Esperanza,1,0,1,A 17-year-old Christian taxi driver is killed by a bomb planted by Muslim radicals.
10835,31/12/2008,Somalia,Baidoa,1,0,1,A woman is shot to death by Islamic fundamentalists over an 'illicit' relationship.
10836,31/12/2008,Denmark,Odense,0,2,2,A Muslim shoots two Jewish vendors at a shopping mall.
10837,31/12/2008,Philippines,General Santos,0,22,22,"Moro Islamists toss a grenade into a New Years Eve celebration, injuring over twenty."
10838,31/12/2008,Philippines,Bagong,1,0,1,Moro Islamists gun down a civilian.
10839,31/12/2008,Afghanistan,Helmand,21,0,21,A mother pleading for her son's life is among twenty-one persons shot in cold blood by the Taliban.
10840,31/12/2008,Pakistan,Darra Adamkhel,4,6,10,Three women and a child are killed when Muslim terrorists fire a rocket into their home.
10841,31/12/2008,Pakistan,Mir Ali,1,0,1,A 28-year-old man is kidnapped and murdered by the Taliban.
10842,31/12/2008,Iraq,Baghdad,14,66,80,Four members of a religious minority are among fourteen killed by Islamists in four attacks.
10843,1/1/2009,Pakistan,Bajaur,6,0,6,Six locals are blown to bits by a Taliban roadside bomb.
10844,1/1/2009,Pakistan,Ghania,2,0,2,A young man chops his mother and daughter into pieces after they ignore his warning to end an illicit affair with a local man.
10845,1/1/2009,Pakistan,Swat,1,0,1,Militants drag a man out of his home and cut off his head in a public square.
10846,1/1/2009,Pakistan,Peshawar,3,6,9,Three policemen are killed by two Religion of Peace bombs.
10847,1/1/2009,Pakistan,Swat,3,0,3,Three people are shot to death by Islamic terrorists in separate attacks.
10848,1/1/2009,Pakistan,Bajaur,4,16,20,Four civilians are killed when Mujahideen fire rockets into an office complex.
10849,1/1/2009,Iraq,Mosul,3,5,8,A Shahid takes out three Iraqis.
10850,1/1/2009,Somalia,Afgoye,1,0,1,A journalist is killed during an attack by Islamic militia.
10851,1/1/2009,Somalia,Mogadishu,2,0,2,Two local officials are assassinated by Mujahideen.
10852,1/1/2009,Somalia,Baidoa,1,0,1,A member of a reconciliation committee is murdered by Islamic militia.
10853,2/1/2009,Pakistan,Bajaur,1,0,1,Muslim terrorists shoot a tribal elder to death.
10854,2/1/2009,Pakistan,Balogram,2,0,2,Two policemen are abducted by Islamists and gruesomely tortured to death.
10855,2/1/2009,Pakistan,Swat,3,0,3,Three civilians are shot to death in two attacks.
10856,2/1/2009,Pakistan,Mingora,1,0,1,A local dancing girl is quickly gunned down by Islamists after her husband kicks her out of the house.
10857,2/1/2009,Somalia,Mogadishu,1,0,1,A local cleric is shot to death by al-Shabaab radicals in his home in front of his blind mother.
10858,2/1/2009,Somalia,Mogadishu,9,0,9,Two soldiers and seven civilians are killed in an Mujahid bombing and the ensuing fire fight.
10859,2/1/2009,Iraq,al-Yusufiyah,23,110,133,"A Fedayeen suicide bomber wades into a lunch crowd at a reconciliation meeting between Sunni and Shia leaders, killing twenty-three."
10860,3/1/2009,Iraq,Baghdad,4,16,20,Shia pilgrims are among the victims of two Sunni bombing attacks.
10861,4/1/2009,Iraq,Baghdad,36,72,108,Dozens of women and children are blown to bits by a Shahid suicide bomber targeting a crowd of Shiite pilgrims near a shrine.
10862,4/1/2009,Pakistan,Di Khan,10,25,35,Islamic bombers blast at least ten people to death in an attack at a college campus.
10863,4/1/2009,Thailand,Pattani,1,1,2,Muslim gunmen murder a Buddhist man and injure his wife as they are riding in their vehicle.
10864,4/1/2009,Pal. Auth.,Gaza,35,75,110,"The Islamic terror group, Hamas, 'executes' thirty-five rivals and maims over seventy others over the course of several days."
10865,4/1/2009,Pakistan,Swat,2,0,2,"Muslim fundamentalists abduct and brutally execute two police officers, beheading one and hanging his head from a pole."
10866,4/1/2009,Pakistan,Matta,3,0,3,Three persons are murdered by suspected Taliban gunmen.
10867,5/1/2009,Eritrea,Mitire,1,0,1,A 37-year-old man dies from torture after refusing to recant his Christian faith.
10868,5/1/2009,Thailand,Narathiwat,1,1,2,"Islamists shoot at a married couple with automatic weapons, killing the husband and injuring his wife."
10869,5/1/2009,Thailand,Yala,1,2,3,A villager is shot to death by Mujahid while standing with his neighbors.
10870,5/1/2009,Thailand,Narathiwat,1,1,2,Religious radicals gun down a 51-year-old cop.
10871,5/1/2009,Afghanistan,Kandahar,1,0,1,A pro-government mosque leader is taken out by Islamic gunmen
10872,5/1/2009,Pakistan,Swat,2,0,2,"Two persons are murdered by Mujahideen in separate attacks, including a woman in her home."
10873,5/1/2009,Afghanistan,Kandahar,3,1,4,"Religious extremists attack a police post, killing three local officers."
10874,5/1/2009,Pakistan,Quetta,2,0,2,Two Shia civilians are shot to death by Sunni militants.
10875,5/1/2009,Pakistan,Bannu,3,0,3,Three family men are abducted and executed by the Taliban.
10876,5/1/2009,Iraq,Baghdad,3,6,9,"Jihadis plant a bomb outside a soccer stadium, killing three Iraqis."
10877,6/1/2009,Iraq,Baghdad,4,6,10,Four Iraqis are taken out by roadside bombers.
10878,6/1/2009,Thailand,Pattani,1,0,1,An Islamic terror attack leaves a 47-year-old security man dead.
10879,6/1/2009,Pakistan,Mingora,6,0,6,Six local cops are kidnapped and brutally executed by Sunni radicals.
10880,6/1/2009,Iraq,Mosul,2,6,8,A Shahid successfully kills two civilians with a suicide bomb.
10881,7/1/2009,Pakistan,North Waziristan,2,0,2,Two Afghan civilians are kidnapped and brutally executed by religious radicals.
10882,7/1/2009,Pakistan,Swat,2,0,2,Two civilians are shot to death by terrorists in separate incidents.
10883,7/1/2009,Somalia,Yaqshid,4,2,6,"Four local soldiers are killed when Islamists stop their vehicle with a roadside bomb, then toss a grenade at the survivors."
10884,7/1/2009,Somalia,Yubsan,1,0,1,A humanitarian worker and father of five is shot to death in cold blood by Islamic terrorists.
10885,7/1/2009,Pakistan,Hungu,4,1,5,Four policemen die from burns and shrapnel during a Taliban rocket attack.
10886,7/1/2009,Pal. Auth.,Gaza,6,0,6,Three brothers are among six people shot to death by Hamas militants.
10887,8/1/2009,Iraq,Jalawla,6,7,13,Six Iraqis are blown up in a Jihad bomb attack.
10888,8/1/2009,Afghanistan,Kandahar,3,21,24,A Holy Warrior takes out three civilians with an explosives belt.
10889,9/1/2009,Pakistan,Lahore,0,5,5,Fundamentalists bomb movie theaters accused of showing 'anti-Islamic' films.
10890,9/1/2009,Pakistan,Swat,2,0,2,Two locals are abducted and butchered by Islamic militants.
10891,9/1/2009,Iraq,Baghdad,9,15,24,A child is among nine Iraqis taken out be Jihadi bomber in three attacks.
10892,9/1/2009,Somalia,Gedo,1,5,6,Islamic militants assassinate a local mayor with a rocket.
10893,9/1/2009,Afghanistan,Nimroz,10,3,13,"A Shahid blows himself up in a fruit shop, taking out ten patrons and employees."
10894,9/1/2009,Israel,Rehovot,0,1,1,A Muslim yells 'Allah Akbar' and strikes a Jewish teen with an axe.
10895,10/1/2009,Pakistan,Chak,0,1,1,Six Muslim men gang-rape a 14-year-old girl in front of her parents because they are Christian.
10896,10/1/2009,Pakistan,Hangu,47,60,107,"A Muslim group attacks a rival funeral, setting off Sunni-Shia violence that leaves nearly fifty dead over the next four days."
10897,10/1/2009,Pakistan,Sibi,2,0,2,Two Shias are assassinated by Sunni terrorists.
10898,10/1/2009,Thailand,Pattani,1,0,1,A 54-year-old civilian is gunned down by Mujahideen.
10899,11/1/2009,Pakistan,Mohmand,6,7,13,"Taliban militants overrun a military base, killing at least six local soldiers."
10900,11/1/2009,Somalia,Guriel,30,50,80,"al-Shabaab hardline fundamentalists attack a rival group, leaving about thirty people dead."
10901,11/1/2009,Pakistan,Bajaur,0,4,4,Religious extremists abduct and then chop the ears off of four private security guards.
10902,11/1/2009,Pakistan,Swat,4,0,4,A father and son are among four civilians shot to death by Taliban militants in three attacks.
10903,11/1/2009,Iraq,Mosul,5,4,9,Five Iraqis are murdered by Islamic militants in two attacks.
10904,11/1/2009,Thailand,Yala,3,2,5,Two Buddhists are among three farmers shot to death by Islamic terrorists.
10905,11/1/2009,Algeria,Merine,2,2,4,A mother and child are gunned down by armed Islamists at a fake roadblock.
10906,12/1/2009,Pakistan,Hangu,5,21,26,Five more people are killed in sectarian violence between Sunni and Shia.
10907,12/1/2009,Ingushetia,Nazran,1,1,2,Islamic snipers pick off a local soldier.
10908,12/1/2009,Iraq,Baghdad,8,31,39,Eight Iraqis are burned or blasted to death in three Jihad bombings.
10909,12/1/2009,Pakistan,North Waziristan,2,0,2,Two brothers are abducted and brutally murdered by Mujahideen.
10910,12/1/2009,Somalia,Mogadishu,13,30,43,At least thirteen people are killed in a brutal mortar attack by Islamic militia.
10911,13/1/2009,Pakistan,Miranshah,1,0,1,A civilian is abducted and brutally beheaded by religious radicals.
10912,13/1/2009,Pakistan,Matta,3,4,7,A beheaded rickshaw driver is among three people killed in separate terror attacks.
10913,13/1/2009,Thailand,Pattani,2,0,2,Two village chiefs are shot to death in Muslim drive-by attacks.
10914,13/1/2009,Thailand,Pattani,2,0,2,Two civilians are shot to death by Mujahideen.
10915,13/1/2009,Thailand,Narathiwat,1,4,5,A local soldier succumbs to shrapnel injuries following a Religion of Peace bombing attack.
10916,14/1/2009,Pakistan,Quetta,4,0,4,Four Shia are ambushed and killed by Sunni militants with automatic weapons.
10917,14/1/2009,Iraq,Mosul,2,4,6,A Holy Warrior takes out two Iraqis with a suicide belt.
10918,14/1/2009,Somalia,Mogadishu,6,18,24,A half-dozen civilians are killed due to an Islamist mortar attack on the presidential palace.
10919,15/1/2009,Somalia,Kismayo,1,0,1,Islamists assassinate a former statesman after 'sentencing' him to death.
10920,15/1/2009,Pakistan,Miranshah,1,0,1,A 30-year-old civilian is abducted and murdered by Islamic radicals.
10921,16/1/2009,Eritrea,Mitire,1,0,1,A 42-year-old man dies after being tortured in prison for his Christian faith.
10922,16/1/2009,Iraq,Mosul,1,2,3,Mujahideen storm a home and murder a woman inside.
10923,16/1/2009,Iraq,Mosul,1,0,1,The local Christian owner of a car repair shop is brutally murdered by Islamic terrorists.
10924,17/1/2009,Algeria,Miliana,1,0,1,A man has his throat slit by Islamic fundamentalists at a fake roadblock.
10925,17/1/2009,Pakistan,Matani,1,0,1,A faith healer is abducted and beheaded by Islamists.
10926,17/1/2009,Pakistan,Miranshah,1,0,1,An Afghan civilian is murdered by the Taliban.
10927,17/1/2009,Iraq,Mosul,2,0,2,Two innocent guards at a cell phone tower are gunned down by Sunni extremists.
10928,17/1/2009,Iraq,Baghdad,1,1,2,Jihad bombers kill the driver of a municipal vehicle.
10929,17/1/2009,Afghanistan,Kabul,4,23,27,A woman and child are among four civilians killed outside the German embassy when a Holy Warrior detonates beside them.
10930,17/1/2009,Afghanistan,Nangarhar,1,2,3,A civilian is taken down by a Fedayeen suicide bomber in a minivan.
10931,17/1/2009,Somalia,Mogadishu,2,9,11,al-Shabaab militants take out two civilians during an attack on African peacekeepers.
10932,18/1/2009,Pakistan,Swat,4,2,6,Two brothers murdered in their home are among four people taken out by Mujahideen.
10933,19/1/2009,Iraq,Tikrit,2,0,2,Two young civilians are taken out in a roadside bombing.
10934,20/1/2009,Pakistan,Sindh,1,0,1,A 55-year-old member of the Ahmadiyya is killed merely on account of his faith.
10935,20/1/2009,Pakistan,Miranshah,6,0,6,Six civilians are rounded up and shot to death by Islamic extremists.
10936,20/1/2009,Iraq,Mosul,2,1,3,A real estate agent brutally gunned down in his office is among two civilians murdered by the Mujahideen.
10937,20/1/2009,Iraq,Baghdad,3,5,8,Three civilians are taken down by Jihadi bombers.
10938,20/1/2009,Afghanistan,Bala Mughab,3,7,10,"Talibanis ambush a police post, killing three local officers and kidnapping seven others."
10939,20/1/2009,Afghanistan,Kandahar,2,3,5,Religious extremists murder two Afghans with a bicycle bomb.
10940,21/1/2009,Jordan,Amman,1,0,1,A 17-year-old stomps and stabs his 13-year-old sister to death in an honor killing.
10941,21/1/2009,Thailand,Pattani,1,0,1,An older man walking home with his cattle is shot to death by Muslim militants.
10942,21/1/2009,Afghanistan,Baghlan,0,5,5,A suicide bomber injures five children at a wedding.
10943,21/1/2009,Iraq,Baghdad,4,8,12,Islamic bombers take out four students near a university.
10944,21/1/2009,Iraq,Khalis,18,0,18,Eighteen al-Qaeda victims are found in a mass grave.
10945,21/1/2009,Afghanistan,Herat,2,1,3,Two local soldiers are killed by a suicide bomber.
10946,22/1/2009,Iraq,Kut,4,0,4,Parents and their two children are wiped out inside their home by Jihadi gunmen.
10947,22/1/2009,Thailand,Pattani,1,0,1,A shop owner is murdered in his store by Mujahideen gunmen.
10948,22/1/2009,Pakistan,Swat,5,8,13,Two people beheaded are among five civilians taken out by Mujahideen in three attacks.
10949,22/1/2009,Pakistan,Derpakhel,1,0,1,A civilian is kidnapped and brutally murdered by Sunni radicals.
10950,22/1/2009,Jordan,Amman,1,0,1,"A man kills his 19-year-old divorced sister for ""having a bad reputation."""
10951,23/1/2009,Afghanistan,Kabul,6,0,6,"Six people, including an Indian husband and wife are shot dead when the Taliban fire into a home."
10952,23/1/2009,Pakistan,Mingora,2,22,24,A Fedayeen suicide bomber kills two local soldiers.
10953,23/1/2009,Pakistan,Mingora,3,1,4,A woman is among three civilians murdered in a Jihad roadside attack.
10954,23/1/2009,Iraq,Baghdad,1,1,2,"A 7-year-old boy is killed, and his mother injured, by a hidden bomb."
10955,23/1/2009,Iraq,Baghdad,8,0,8,Five women and a 12-year-old girl are among eight Sunni family members murdered in their home by sectarian rivals.
10956,23/1/2009,Pakistan,Swat,2,0,2,"Fundamentalists stab a man to death over his 'un-Islamic' style of dress, then travel to his house where they murder his father."
10957,23/1/2009,Thailand,Yala,3,0,3,A 65-year-old woman is among three civilians gunned down in separate Mujahideen drive-by attacks.
10958,24/1/2009,Thailand,Narathiwat,1,0,1,A 28-year-old lesbian is stabbed and suffocated.
10959,24/1/2009,Pal. Auth.,Gaza,1,0,1,Hamas executes a 46-year-old human rights activist.
10960,24/1/2009,Israel,Ashkelon,1,0,1,A young Arab mother is stabbed to death over suspected immorality
10961,24/1/2009,Pakistan,Bannu,1,0,1,Suspected Islamists kidnap and murder a local civilian.
10962,24/1/2009,Pakistan,Khairabad,1,0,1,A night cleaner at a police station is killed by a Sunni rocket.
10963,24/1/2009,Iraq,Fallujah,5,14,19,Five Iraqis are taken out in a vicious Fedayeen truck bombing.
10964,24/1/2009,Thailand,Yala,4,0,4,Four construction workers are murdered by Islamist gunmen at a building site.
10965,24/1/2009,Somalia,Mogadishu,15,24,39,Fifteen bus passengers on a public bus are blown to bits by a Shahid suicide bomber.
10966,25/1/2009,Iran,Saravan,12,0,12,"A dozen policemen are killed by a Sunni terror group, 'Soldiers of Allah.'"
10967,25/1/2009,Thailand,Narathiwat,1,1,2,A factory worker is shot to death by Mujahideen while driving with his wife.
10968,26/1/2009,Somalia,Baidoa,4,10,14,Four people are killed when al-Shabaab terrorists hurl a grenade into a bus stop.
10969,26/1/2009,Pakistan,North Waziristan,1,0,1,"Religious militants kidnap a man, chop off his hand and then execute him."
10970,26/1/2009,Pakistan,Quetta,1,0,1,A Shia leader is assassinated by Sunni gunmen.
10971,26/1/2009,Pakistan,Dera Ismail Khan,6,22,28,"Sunni radicals detonate a bicycle bomb in a public area, killing six civilians."
10972,26/1/2009,Pakistan,Lahore,1,0,1,A 45-year-old woman is stabbed to death by her son on suspicion of an illicit relationship.
10973,26/1/2009,Thailand,Narathiwat,1,1,2,Islamists gun down a 26-year-old civilian.
10974,27/1/2009,Thailand,Pattani,2,0,2,A Buddhist married couple is brutally murdered by Muslim gunmen in a drive-by attack.
10975,27/1/2009,Israel,Kissufim,1,2,3,Palestinian bombers murder an Israelis border guard.
10976,27/1/2009,Afghanistan,Kandahar,4,10,14,Taliban bombers blow up a minibus killing four civilians.
10977,27/1/2009,Pakistan,Dera Ismail Khan,1,0,1,A second Shia civilian is gunned down in as many days by sectarian extremists.
10978,27/1/2009,Iraq,Mosul,3,3,6,Three Iraqis are killed in a car bomb attack on Kurds by suspected Sunnis terrorists.
10979,28/1/2009,Pakistan,Mingora,8,0,8,Eight bullet-ridden victims of Taliban justice are found.
10980,28/1/2009,Iraq,Kirkuk,2,0,2,"Sunni extremists attack a polling station, killing two guards."
10981,29/1/2009,Pakistan,Tal,1,4,5,Religious extremists slit the throat of a policeman.
10982,29/1/2009,Pakistan,Miranshah,1,0,1,Sunni radicals kidnap and shoot a 30-year-old local man.
10983,30/1/2009,Iraq,Baiji,1,1,2,"Sunni terrorists open fire on a polling station, killing an American guard."
10984,31/1/2009,Pakistan,Swat,3,1,4,Taliban militants ambush and kill three local security personnel.
10985,1/2/2009,Dagestan,Makhachkala,4,0,4,"Suspected Islamists open fire on a cafe, killing four patrons."
10986,1/2/2009,Philippines,Siocon,4,1,5,"Moro Islamists capture four gold prospectors, hog-tie them and then hack them to death with machetes."
10987,1/2/2009,Pakistan,Shajwal Chak,1,0,1,A Christian man begging for wages owed is murdered by Muslim employers as they deride his faith.
10988,2/2/2009,Pakistan,Punjab,1,0,1,A local leader is gunned down is a sectarian incident.
10989,2/2/2009,Pakistan,Swat,8,0,8,Eight people are shot to death by Taliban militants in various attacks.
10990,2/2/2009,Iraq,Mosul,3,9,12,Three Iraqis are murdered by Mujahideen roadside bombers.
10991,2/2/2009,Thailand,Pattani,2,0,2,"Two security personnel are beheaded by Muslim militants, who also burn the bodies."
10992,2/2/2009,Pakistan,Quetta,1,0,1,A Shia businessman is shot to death by Sunni extremists.
10993,2/2/2009,Afghanistan,Uruzgan,21,8,29,A Fedayeen suicide bomber murders over twenty local police trainees at their facility.
10994,3/2/2009,Algeria,Ait Chaafa,1,9,10,Fundamentalists kill a security officer with a bombing attack.
10995,3/2/2009,Pakistan,Swat,3,5,8,"Islamic militants assault a police post, killing three local officers."
10996,3/2/2009,Pakistan,Orakzai,1,0,1,Fundamentalists behead a local civilian.
10997,3/2/2009,Pakistan,Dera Ismail Khan,1,18,19,One person is killed when an Islamic radical tosses a grenade into a rival mosque.
10998,3/2/2009,Thailand,Pattani,2,0,2,Two civilians are shot inside their homes by Mujahideen.
10999,3/2/2009,Thailand,Narathiwat,1,0,1,Islamic gunmen chase down a man with a pickup truck then shoot him to death.
11000,4/2/2009,Iraq,Baqubah,8,0,8,Eight decapitated al-Qaeda victims are found in a mass grave.
11001,4/2/2009,Afghanistan,Helmand,6,0,6,A brutal Taliban roadside bombing leaves six Afghanis dead.
11002,4/2/2009,Somalia,Mogadishu,1,0,1,The head of a radio station is gunned down by suspected Islamists.
11003,4/2/2009,Somalia,Mogadishu,1,0,1,A journalist is assassinated by al-Shabaab gunmen.
11004,5/2/2009,Pakistan,Orakzai,1,0,1,Islamists kidnap and murder the head of a teachers association.
11005,5/2/2009,Pakistan,Swat,3,3,6,"Religious extremists barge into a home, kill three women and kidnap three survivors."
11006,5/2/2009,Pakistan,Punjab,32,48,80,A suicide bomber at a rival religious procession sends more than 30 innocent souls to Allah.
11007,5/2/2009,Iraq,Khanaqin,16,12,28,A horrific suicide bombing at a restaurant leaves sixteen Iraqi patrons dead.
11008,6/2/2009,Pakistan,Kohat,1,2,3,"Sunni radicals open fire on a passing bus, killing a passenger."
11009,6/2/2009,Pakistan,Miranshah,2,0,2,"The Taliban abduct two civilians, kill them, then dump their bodies at a bus stop."
11010,6/2/2009,Afghanistan,Laghman,2,0,2,Taliban gunmen ambush and kill two local security men.
11011,7/2/2009,Thailand,Narathiwat,1,0,1,Mujahideen gun down a 48-year-old rubber plantation worker.
11012,7/2/2009,Pakistan,Punjab,7,0,7,Seven local cops are murdered by Islamist attackers.
11013,7/2/2009,Afghanistan,Nangarhar,2,1,3,Two people are killed in two attacks by Islamic terrorists.
11014,8/2/2009,Iraq,Baghdad,2,12,14,Two Shia pilgrims are murdered by Sunni bombers while walking along the side of a road.
11015,8/2/2009,Pakistan,Swat,1,0,1,Jihadis kidnap and decapitate a civilian.
11016,8/2/2009,Pakistan,Swat,3,0,3,Mujahideen ambush and kill three local soldiers.
11017,8/2/2009,Pakistan,Lakorain,1,1,2,A truck driver is shot to death by Taliban while on the job.
11018,8/2/2009,Afghanistan,Kabul,1,0,1,The Taliban release a video showing the beheading of a kidnapped Polish Christian who declined the offer to save his life by converting to Islam.
11019,8/2/2009,Somalia,Mogadishu,3,7,10,A child is among three people killed in two attacks following calls for holy war.
11020,8/2/2009,Thailand,Yala,1,0,1,Islamic rebels shoot a 29-year-old civilian in the head along the side of a road.
11021,9/2/2009,Pakistan,Darra Adamkhel,13,38,51,Eleven children are among thirteen killed when Islamic militants shell a girl's school.
11022,9/2/2009,Afghanistan,Kabul,1,0,1,"An Indian Christian, who worked for a food chain, is reported dead four months after being abducted by Sunni extremists."
11023,9/2/2009,Pakistan,Khyber Agency,10,10,20,"Rival Islamist groups clash, leaving ten people dead."
11024,9/2/2009,Thailand,Narathiwat,1,0,1,A 26-year-old woman is shot to death by Islamic terrorists.
11025,9/2/2009,Iraq,Mosul,3,7,10,Mujahideen murder three Iraqis with a mortar strike.
11026,9/2/2009,Iraq,Mosul,5,3,8,Four US soldiers and a local interpreter are killed by a Shahid suicide bomber.
11027,9/2/2009,Pakistan,Baran Pul,5,17,22,"A religious extremist detonates himself in a crowd, killing five other people."
11028,9/2/2009,Afghanistan,Nimroz,3,0,3,Three Afghans are taken out by a Fedayeen suicide bomber.
11029,9/2/2009,Afghanistan,Khogyani,2,3,5,"Islamic extremists detonate a bomb near a police vehicle, killing two local cops."
11030,9/2/2009,Pakistan,North Waziristan,2,0,2,Holy Warriors shoot two civilians to death in separate attacks.
11031,10/2/2009,Iraq,Mosul,2,0,2,Sunni extremists gun down two policemen at a checkpoint.
11032,10/2/2009,Thailand,Pattani,2,1,3,Muslim extremists murder two people is separate drive-by attacks.
11033,10/2/2009,Pakistan,Hangu,17,30,47,Seventeen people are killed when Shia and Sunni rivals clash.
11034,11/2/2009,Iraq,Baghdad,16,44,60,"Jihadis explode a pair of bombs at a bus station, slaughtering sixteen Iraqis."
11035,11/2/2009,Jordan,Amman,1,0,1,"A 24-year-old woman is stabbed to death in bed by her brother, who suspects her of having an affair."
11036,11/2/2009,Iraq,Baghdad,2,18,20,Two Shia pilgrims are murdered by Sunni bombers in separate attacks.
11037,11/2/2009,Afghanistan,Kabul,28,57,85,"Suicidal Sunnis attack two government buildings, randomly shooting nearly thirty office workers to death."
11038,11/2/2009,Pakistan,Peshawar,1,8,9,A local lawmaker is murdered by a bomb planted by suspected Islamists.
11039,11/2/2009,Afghanistan,Logar,4,0,4,Four local soldiers are killed in a Taliban roadside bombing on their vehicle.
11040,11/2/2009,Thailand,Pattani,2,0,2,Religion of Peace terrorists shoot two men to death as they are standing in front of a school.
11041,11/2/2009,Thailand,Pattani,1,0,1,A 40-year-old man is gunned down in a Muslim drive-by attack.
11042,12/2/2009,USA,"Buffalo, NY",1,0,1,The founder of a Muslim TV station beheads his wife in the hallway for seeking a divorce.
11043,12/2/2009,Thailand,Pattani,3,1,4,Islamic bombers kill three policemen guarding teachers from attacks.
11044,12/2/2009,Pakistan,North Waziristan,1,1,2,Taliban militants murder a police officer in an unprovoked rocket attack.  A second policeman is killed elsewhere.
11045,12/2/2009,Ingushetia,Nazran,4,2,6,Four Russians are killed when Islamic militants detonate a bomb during a raid.
11046,12/2/2009,Iraq,Mosul,4,5,9,Jihadis take out four local cops with a roadside bomb.
11047,12/2/2009,Somalia,Mogadishu,2,6,8,Two laborers die from shrapnel injuries when Mujahideen mortar a seaport.
11048,12/2/2009,Afghanistan,Paktika,1,5,6,A suicide bomber murders a police officer who stops to help him.
11049,13/2/2009,Afghanistan,Kandahar,4,0,4,Four Afghan policemen are killed by the Taliban in a roadside bombing.
11050,13/2/2009,Iraq,Baghdad,2,0,2,A man and his son are murdered in their home by Sunni gunmen.
11051,13/2/2009,Algeria,Fum,7,0,7,An infant and two women are among seven people blown up by Islamic fundamentalists.
11052,13/2/2009,Iraq,Karbala,39,60,99,"A female suicide bomber detonates in a tent full of Shia pilgrims, sending nearly forty souls to Allah."
11053,13/2/2009,Afghanistan,Kohat,2,0,2,"The Taliban shoot dead two women for 'immoral' behavior, then dump their burka-clad bodies in a ditch."
11054,13/2/2009,Pakistan,Peshawar,2,3,5,Two more policemen are killed by religious extremists in separate attacks.
11055,14/2/2009,Afghanistan,Khost,1,2,3,Sunni radicals assassinate a local governor.
11056,14/2/2009,Iraq,Baghdad,40,0,40,Forty Shiite abductees are found in a mass grave in a Sunni stronghold.
11057,14/2/2009,Lebanon,Beirut,1,0,1,A minority Druse is stabbed to death by Hezbollah supporters at a memorial rally.
11058,15/2/2009,Iraq,al-Taji,10,0,10,Ten victims of al-Qaeda militia are found in a mass grave.
11059,15/2/2009,Algeria,Tebessa,5,4,9,"Religious radicals detonate a bomb under a passing truck, killing five occupants."
11060,15/2/2009,Algeria,Boumerdes,3,0,3,Three off-duty soldiers are stopped a roadblock and machine-gunned to death by fundamentalists.
11061,16/2/2009,Pakistan,Karamkot,1,0,1,A 35-year-old civilian is kidnapped and killed in captivity by Islamic extremists.
11062,16/2/2009,Iraq,Baghdad,8,24,32,Eight Shia pilgrims are blown apart by Sunni bombers in two attacks.
11063,17/2/2009,Iraq,Mosul,1,1,2,A Christian is gunned down by suspected Islamists.
11064,17/2/2009,Pakistan,Khar,4,4,8,A woman is among four civilians killed when the Taliban rocket homes and a school.
11065,17/2/2009,Iraq,Baqubah,2,10,12,Jihadi bombers manage to take out two Iraqi civilians.
11066,17/2/2009,Pakistan,Peshawar,4,16,20,Four people are murdered in a Mujahideen car bombing in a residential neighborhood.
11067,18/2/2009,Pakistan,Quetta,1,0,1,A local Sunni leader is gunned down by Shia militants.
11068,18/2/2009,Jordan,Petra,1,0,1,A 19-year-old man shoots his divorced sister to death over 'immoral' behavior.
11069,18/2/2009,Pakistan,Swat,1,0,1,Muslim radicals shoot a journalist thirty-two times following a peace rally.
11070,19/2/2009,Afghanistan,Khost,1,0,1,A member of a road construction crew is taken out by Islamic bombers.
11071,19/2/2009,Afghanistan,Khost,3,0,3,Three local guards are murdered by Sunni extremists.
11072,19/2/2009,Pakistan,Mohmand,1,0,1,Religious extremists assassinate a tribal elder.
11073,19/2/2009,Iraq,Mosul,1,0,1,A Christian businessman is gunned down in his shop.
11074,19/2/2009,Iraq,Mosul,1,7,8,A suicide bomber takes out an Iraqi policeman.
11075,19/2/2009,Pakistan,Dera Ismail Khan,1,0,1,A local Shia leader is shot to death by Sunni militants.
11076,20/2/2009,Pakistan,Dera Ismail Khan,32,145,177,"A suicidal Sunni detonates at a Shia funeral, massacring thirty-two mourners."
11077,20/2/2009,Somalia,Mogadishu,1,2,3,A civilian is killed in a terror attack by Islamic hardliners.
11078,20/2/2009,Iraq,Mosul,2,0,2,Jihadis kill a man and his son in a roadside bombing.
11079,20/2/2009,Thailand,Yala,2,0,2,Two soldiers guarding teachers are shot and beheaded by Religion of Peace radicals.
11080,20/2/2009,Pakistan,Karachi,1,2,3,A boy is gunned down in a sectarian dispute.
11081,21/2/2009,Somalia,Yonday,2,0,2,Two young Christian boys (ages 11 and 12) are beheaded by Religion of Peace extremists.
11082,21/2/2009,Iraq,Baaj,5,0,5,Five Iraqi security personnel are murdered when Islamists booby-trap a building.
11083,21/2/2009,Pakistan,Dera Ismail Khan,2,5,7,"Sunnis open fire on a Shia funeral procession, killing at least two mourners."
11084,21/2/2009,Iraq,Tikrit,2,0,2,Two policemen are killed in separate Jihad attacks.
11085,21/2/2009,Pakistan,Dera Ismail Khan,4,0,4,Suicide bombers murder four more innocents.
11086,21/2/2009,Nigeria,Bauchi,11,38,49,"A Muslim mob goes on a rampage, burning churches and killing Christians."
11087,21/2/2009,Afghanistan,Torkham,1,2,3,A passerby is blown up when Sunni bombers target an oil tanker.
11088,21/2/2009,Pakistan,Multan,2,0,2,Two adults are beheaded when it is discovered that they are having 'illegitimate' sex.
11089,22/2/2009,Thailand,Yala,2,0,2,A married couple are beheaded by Muslim militants on their way home from work at a rubber plantation.
11090,22/2/2009,Egypt,Cairo,1,21,22,"Islamists bomb a market, killing a 17-year-old French girl."
11091,22/2/2009,Somalia,Mogadishu,11,15,26,al-Shabaab suicide bombers take out eleven Burundi peacekeepers on their base.
11092,22/2/2009,Algeria,Spas,9,3,12,Islamic fundamentalists machine-gun nine local guards to death in an ambush.
11093,22/2/2009,Afghanistan,Zaranj,1,3,4,A local guard is taken down by suicide bombers.
11094,22/2/2009,Pakistan,Karachi,1,0,1,A man chops his 60-year-old sister into pieces on suspicion that she was having unmarried sex.
11095,23/2/2009,Afghanistan,Helmand,8,17,25,Eight civilians are killed when Taliban gunmen attack an ISAF patrol.
11096,23/2/2009,Afghanistan,Kandahar,3,0,3,Three children are blasted to death by a Taliban IED.
11097,23/2/2009,Pakistan,Bannu,1,2,3,A policeman is murdered by a Shahid suicide bomber.
11098,23/2/2009,Iraq,Baghdad,5,15,20,Jihadis take down five Iraqis in two terror attacks.
11099,23/2/2009,Thailand,Narathiwat,1,1,2,"A rubber tapper is brutally shot to death by Muslim radicals, who also shoot his wife."
11100,23/2/2009,Sudan,Darfur,2,4,6,Two Doctors without Borders humanitarian workers are shot to death by suspected Janjaweed militia.
11101,24/2/2009,Thailand,Yala,1,3,4,Muslim militants storm a food shop and murder the owner.
11102,24/2/2009,Thailand,Yala,1,0,1,A 41-year-old woman is shot to death by Islamic terrorists.
11103,24/2/2009,Pakistan,Landikotal,2,0,2,Two women who may have been prostitutes are tortured to death after having their faces disfigured.
11104,24/2/2009,Pakistan,Quetta,4,0,4,A Shia trader and his three sons are brutally shot to death by Sunni extremists while on their way home.
11105,24/2/2009,Somalia,Mogadishu,18,78,96,"Eighteen people, including woman and children, are killed when Islamic hardliners attack peacekeepers."
11106,24/2/2009,Afghanistan,Helmand,5,0,5,Religious extremists kill four US soldiers and a civilian with a roadside bomb.
11107,24/2/2009,Pakistan,Kohat,2,0,2,Two civilians on a motorcycle are taken out by Sunni bombers.
11108,25/2/2009,Somalia,Mogadishu,2,4,6,Two schoolchildren under the age of ten are taken out by an Islamic mortar shell on a school.
11109,25/2/2009,Afghanistan,Kandahar,2,8,10,Two civilians are killed in a Taliban bombing along a city street.
11110,25/2/2009,Ingushetia,Karabulak,1,0,1,Fundamentalists gun down the owner of a local bowling alley.
11111,25/2/2009,Thailand,Narathiwat,3,0,3,Three people are beheaded by Muslim radicals.
11112,26/2/2009,Jordan,Ajlun,1,0,1,A teenager strangles his 30-year-old sister to death on suspicion that she is in a sexual relationship.
11113,26/2/2009,Pakistan,Mohmand,2,0,2,Islamic militants kill two tribesmen and blow up a girl's school.
11114,26/2/2009,Pakistan,Razmak,1,0,1,The Taliban behead a 35-year-old Afghan civilian as a 'gift' to the new American President.
11115,26/2/2009,Iraq,Baghdad,2,10,12,Two Iraqis are killed when Islamists explode a bomb near a university.
11116,27/2/2009,Pakistan,Hangu,4,5,9,"Mujahideen open fire on a school van, killing three students and their driver."
11117,27/2/2009,Iraq,Hawija,2,2,4,Two Iraqis are taken down by al-Qaeda gunmen.
11118,27/2/2009,Somalia,Mogadishu,42,125,167,Forty-two civilians are killed in three days of Islamic militia violence.
11119,28/2/2009,Iraq,Baghdad,2,7,9,Jihadis murder two Iraqis in a restaurant bombing.
11120,28/2/2009,Afghanistan,Uruzgan,1,0,1,A civilian contractor is killed by Taliban bombers.
11121,1/3/2009,Pakistan,Quetta,2,0,2,Sunni radicals shoot a Shia man and his son to death in their shop.
11122,1/3/2009,India,Doda,1,0,1,"A local police officer is abducted, tortured and murdered by Lashkar-e-Toiba."
11123,1/3/2009,Iraq,Fallujah,1,0,1,A civilian is killed in his home by an intruding suicide bomber.
11124,2/3/2009,Germany,Rees,1,0,1,A 20-year-old girl is clubbed to death by her brother for having sex.
11125,2/3/2009,Pakistan,Kili Karbala,6,6,12,A 15-year-old suicide bomber takes out a half dozen people at a girl's school.
11126,2/3/2009,Iraq,Khalis,3,16,19,"Sectarian Jihadis plant a bomb near a mosque, killing five rivals."
11127,2/3/2009,Philippines,Mindanao,2,0,2,Two local security personnel are murdered in an ambush by Moro Islamists.
11128,2/3/2009,Pakistan,Songo,1,28,29,"Muslim radicals open fire on a Presbyterian church, then enter the building and beat a 45 woman to death."
11129,3/3/2009,Thailand,Yala,2,0,2,Two civilians are murdered by Mujahideen gunmen while riding home from work.
11130,3/3/2009,Pakistan,Swat,2,0,2,Taliban militants kill two local soldiers in an ambush along a highway.
11131,3/3/2009,Pakistan,Quetta,5,0,5,Five members of a Shia family are shot to death by Sunni radicals in a sectarian drive-by attack.
11132,3/3/2009,Pakistan,Lahore,8,6,14,Eight people are gunned down when Mujahideen stage a brutal attack on a visiting cricket team.
11133,4/3/2009,Thailand,Pattani,3,0,3,Two truck drivers are among three people shot to death by Islamic terrorists.
11134,4/3/2009,Somalia,Galkacyo,1,0,1,A cleric is gunned down by Islamist rivals.
11135,4/3/2009,Iraq,Samarrah,4,0,4,Four members of a family are eliminated by al-Qaeda gunmen.
11136,4/3/2009,Iraq,Baghdad,5,24,29,Two Shahid suicide bombers leave five Iraqis dead.
11137,5/3/2009,Philippines,Basilan,3,2,5,Three fisherman are killed when suspected Islamists storm their boat.
11138,5/3/2009,Thailand,Yala,1,0,1,Muslim terrorists murder a 33-year-old civilian in a drive-by attack.
11139,5/3/2009,Ingushetia,Nazran,6,2,8,Six policemen are killed trying to defuse an Islamist bomb.
11140,5/3/2009,Iraq,Hillah,12,40,52,Holy Warriors send a dozen souls to Allah with a car bombing at a livestock market.
11141,5/3/2009,Pakistan,Dera Ismail Khan,1,19,20,"Radicals throw a hand grenade into a rival mosque, killing at least one."
11142,5/3/2009,Egypt,Qalubiya,2,0,2,Muslims set a young Christian on fire and also stab his 60-year-old father to death.
11143,6/3/2009,Pakistan,North Waziristan,2,0,2,Religious extremists abduct and murder two civilians.
11144,6/3/2009,Pakistan,Bannu,1,1,2,Sunni militants take out a local official with a bomb blast.
11145,6/3/2009,Thailand,Yala,1,0,1,The 52-year-old owner of a tea shop is shot to death at his business by Mujahideen.
11146,6/3/2009,Somalia,Mogadishu,3,0,3,Three civilian bystanders are killed when Islamic militia attack African peacekeepers.
11147,6/3/2009,Iraq,Tikrit,2,0,2,Mujahideen bombers take out two civilians.
11148,7/3/2009,Iraq,Mosul,3,8,11,Three local security personnel are killed in two Sunni militant attacks.
11149,7/3/2009,Thailand,Pattani,2,0,2,Two Buddhist brothers riding a motorcycle are shot and then burned by Religion of Peace militants.
11150,7/3/2009,Algeria,Kabylie,2,8,10,An elderly woman is among two people killed by a Shahid bomber.
11151,7/3/2009,Afghanistan,Nimroz,2,3,5,Two Afghans are take out by a Fedayeen suicide bomber.
11152,7/3/2009,Pakistan,Darra Adam Khel,2,7,9,Two civilians are murdered by Jihadi car bombers.
11153,7/3/2009,Pakistan,Peshawar,8,5,13,"Islamists kill an elderly man, then booby-trap the body, killing seven investigating police."
11154,7/3/2009,Pakistan,Khyber,5,8,13,"Lashkar-e-Islam terrorists bomb a shop, killing five people."
11155,7/3/2009,Pakistan,Mohmand,14,0,14,Fourteen Pakistani soldiers are killed in an ambush by Sunni fundamentalists.  Some are executed in captivity.
11156,8/3/2009,Russia,St. Petersburg,1,0,1,A Muslim man has his 21-year-old woman shot to death for wearing miniskirts.
11157,8/3/2009,Iraq,Khalis,25,0,25,Twenty-five victims of al-Qaeda abductions are found in several mass graves.
11158,8/3/2009,Iraq,Mosul,3,3,6,Jihadi bombers take down three local soldiers at a traffic stop.
11159,8/3/2009,Iraq,Baghdad,28,57,85,"An al-Qaeda suicide bomber attacks new police recruits, leaving nearly thirty innocent people dead."
11160,8/3/2009,Algeria,Tizi Ouzou,1,0,1,A policeman is shot and then set on fire by Islamic fundamentalists.
11161,8/3/2009,Thailand,Yala,1,1,2,"Islamists fire on a pair of teachers, killing one."
11162,9/3/2009,Thailand,Pattani,1,0,1,A 25-year-old man is murdered by Muslim gunmen.
11163,9/3/2009,Pakistan,Quetta,2,0,2,Two Shias are shot to death by Sunni rivals.
11164,9/3/2009,Pakistan,Kohat,1,4,5,"Islamists fire a rocket at a passenger bus traveling through the Kohat Friendship Tunnel, killing one rider."
11165,9/3/2009,Iraq,Baghdad,2,0,2,Two moderate Sunnis are gunned down by al-Qaeda militants.
11166,9/3/2009,Iraq,Mosul,2,0,2,Two policemen are shot to death at their post by Islamic terrorists.
11167,9/3/2009,Pakistan,South Waziristan,3,0,3,Two brothers are among three civilians abducted and murdered by religious extremists.
11168,10/3/2009,Pakistan,Dera Ismail Khan,1,0,1,A policeman is gunned down in revenge for preventing a suicide bombing.
11169,10/3/2009,Iraq,Mosul,3,6,9,A woman is killed inside her home by Mujahideen.  Two other civilians are killed elsewhere.
11170,10/3/2009,Iraq,Abu Ghraib,33,34,67,"A Shahid detonates an explosive belt in the midst of Sunni and Shia tribal leaders, murdering over thirty people."
11171,10/3/2009,Afghanistan,Helmand,4,6,10,Four civilians are killed when fundamentalists detonate a roadside bomb.
11172,10/3/2009,Afghanistan,Khost,7,2,9,Seven local soldiers are killed by Taliban roadside bombers.
11173,11/3/2009,India,Reasi,1,0,1,A man is murdered in his home by Islamic gunmen.
11174,11/3/2009,Iraq,Mosul,4,10,14,Mujahideen car bombers take out four civilians along a city street.
11175,11/3/2009,Iraq,Kirkuk,2,8,10,Two Iraqis are killed in a Jihad car bombing.
11176,11/3/2009,Somalia,Mogadishu,4,0,4,"Islamists trigger a roadside bomb, killing four people."
11177,11/3/2009,Pakistan,Peshawar,4,2,6,Two women are among four killed by a Fedayeen suicide bomber.
11178,11/3/2009,Algeria,Barika,1,1,2,Islamic fundamentalists attack an approaching group of policemen with machine guns.
11179,12/3/2009,Iraq,Basra,1,0,1,Shia gunmen take down a Sunni official.
11180,12/3/2009,Ingushetia,Nazran,1,0,1,A Russian policeman is murdered by suspected Mujahid.
11181,13/3/2009,Iraq,Orakzai,2,0,2,Two civilians are murdered by the Taliban.
11182,13/3/2009,Iraq,Baghdad,1,1,2,Islamic radicals kill a woman and wound a boy with a planted bomb.
11183,13/3/2009,Pakistan,Bajaur,3,0,3,Three tribesmen are abducted and beheaded by Sunni hardliners.
11184,13/3/2009,Thailand,Narathiwat,3,1,4,Three local soldiers are killed in an ambush by Muslim militants.
11185,13/3/2009,Thailand,Yala,1,0,1,A woman dies from injuries a day after being shot by Muslim extremists.
11186,14/3/2009,Pakistan,Dera Ismail Khan,2,0,2,"Sunnis spray a Shiite couple on a motorcycle with automatic weapons, killing both the husband and wife."
11187,14/3/2009,Afghanistan,Helmand,2,0,2,"Sunni hardliners attack a police post, killing two officers."
11188,15/3/2009,Israel,Masua,2,0,2,Two Israelis are shot to death by Palestinian gunmen while riding in a car.
11189,15/3/2009,Afghanistan,Kabul,2,9,11,A suicide bomber kills two civilians outside a high school.
11190,15/3/2009,Afghanistan,Kandahar,1,6,7,A bystander is killed by a Taliban wheelbarrow bomb.
11191,15/3/2009,England,London,0,1,1,A Christian minister critical of Islam is brutally beaten by local Muslims.
11192,15/3/2009,Pakistan,Multan,2,0,2,"A young husband and his pregnant wife, both doctors, are brutally murdered by Islamists for being minority Ahmadiyya."
11193,15/3/2009,Pakistan,Dera Ismail Khan,2,0,2,Two Sunnis are shot to death outside a mosque by Shia gunmen.
11194,15/3/2009,Iraq,Baghdad,1,0,1,Mujahideen bombers murder an oil engineer.
11195,15/3/2009,Yemen,Shibam,5,4,9,Four Korean tourists and a local are murdered by fundamentalist bombers.
11196,16/3/2009,Philippines,Jolo,2,4,6,"Abu Sayyaf militants toss a grenade into a karaoke bar, killing two patrons."
11197,16/3/2009,Algeria,Tebessa,5,0,5,"Fundamentalists slit the throat of a shepherd, then kill his family with a bomb."
11198,16/3/2009,Algeria,Tadmait,4,5,9,Four local soldiers are taken out in an Islamist bombing.
11199,16/3/2009,Algeria,Oued Essania,2,0,2,Two people are killed in a bomb blast.
11200,16/3/2009,Iraq,Kirkuk,1,0,1,Sunni militants murder a doctor with a grenade.
11201,16/3/2009,Iraq,al-Mukhifa,5,0,5,Five al-Qaeda kidnap victims are found executed.
11202,16/3/2009,Afghanistan,Lashkar Gah,11,28,39,Eleven Afghans are blown to bits by a Shahid suicide bomber.
11203,17/3/2009,Pakistan,Pirwadhai,14,25,39,At least fourteen people are killed when a suicide bomber detonates at a crowded bus stop.
11204,17/3/2009,Pakistan,NWFP,5,3,8,"Islamic extremists fire rockets at a university, killing five people."
11205,17/3/2009,Philippines,Mindanao,2,0,2,"Moro Islamists attack a government patrol, killing two local troops."
11206,17/3/2009,Iraq,Mosul,1,0,1,A university student is gunned down by Mujahideen.
11207,18/3/2009,Iraq,Mosul,2,0,2,An older married couple is killed within their home by Mujahideen.
11208,18/3/2009,Iraq,Mosul,1,4,5,A Fedayeen suicide bomber kills a local policeman.
11209,18/3/2009,Somalia,Mogadishu,1,2,3,al-Shabaab terrorists murder an AU peacekeeper in a roadside ambush.
11210,19/3/2009,Somalia,Balad,2,0,2,Two men are beheaded by al Shabaab terrorists.
11211,19/3/2009,Somalia,Mogadishu,1,0,1,An aid worker is gunned down in his car by Islamic militia assassins.
11212,19/3/2009,Pakistan,Landi Kotal,8,30,38,"Islamic militants lob mortars into a town's commercial district, murdering at least eight innocents"
11213,19/3/2009,Iraq,Mosul,1,1,2,"A woman is killed, and her daughter injured, by Sunni gunmen along a city street."
11214,19/3/2009,Thailand,Pattani,4,0,4,Islamic bombers murder four local soldiers riding in a pickup truck.
11215,19/3/2009,Afghanistan,Helmand,5,0,5,A lawmaker who stood up to the Taliban is assassinated in a targeted bombing along with four others.
11216,20/3/2009,Iraq,Rasht,1,0,1,A man is stoned to death for adultery.
11217,20/3/2009,Afghanistan,Kandahar,1,1,2,Sunnis murder a carpenter with a mortar.
11218,20/3/2009,India,Kupwara,8,15,23,"Lashkar-e-Toiba terrorists Indian troops, killing eight."
11219,20/3/2009,Afghanistan,Kandahar,1,6,7,A civilian is killed when Sunni hardliners rocket an airport.
11220,20/3/2009,Iraq,Fallujah,1,2,3,An Iraqi is blown to bits by a suicide bomber.
11221,20/3/2009,Pakistan,Lahore,1,0,1,A mother of three is shot to death by her brothers on suspicion of having an affair with a neighbor.
11222,20/3/2009,Thailand,Pattani,1,0,1,Muslim terrorists gun down a man riding his motorcycle home.
11223,21/3/2009,Thailand,Yala,1,0,1,An older man is murdered by Mujahid gunmen while working outside his home.
11224,21/3/2009,Afghanistan,Nauroz,2,4,6,A second attack on people celebrating the Persian new year leaves two dead.
11225,21/3/2009,Bahrain,Ma'ameer,1,0,1,An innocent foreigner dies from injuries suffered in a 3/8 petrol bomb attack by Islamic terrorists.
11226,21/3/2009,Iraq,Hilla,1,0,1,An Iraqi is killed in a suspected al-Qaeda bombing.
11227,21/3/2009,Jordan,Amman,1,0,1,A man and his two sons beat his 19-year-old daughter to death for talking to a strange man.
11228,21/3/2009,Afghanistan,Khost,5,5,10,Islamists murder five civilians when they bomb a celebration for the Persian new year.
11229,21/3/2009,Afghanistan,Nangarhar,6,5,11,Six Afghans are murdered by a Shahid suicide bomber while waiting in line at a checkpoint.
11230,22/3/2009,Iraq,Diyala,5,2,7,Five Iraqis are killed in two Jihad bombings.
11231,23/3/2009,Thailand,Saida,1,1,2,A young man is murdered by Muslim gunmen while talking to a friend in front of his home.
11232,23/3/2009,Lebanon,Saida,1,3,4,Iranian agents are suspected in the assassination of a Palestinian official at a refugee camp.
11233,23/3/2009,Pakistan,Dera Ismail Khan,1,1,2,A Sunni is gunned down by Shia militants.
11234,23/3/2009,India,Bandipora,1,0,1,A civilian is shot to death inside his home by Mujahideen.
11235,23/3/2009,Iraq,Fallujah,8,9,17,Two children are among eight killed when Islamists bomb a residence.
11236,23/3/2009,Iraq,Abu Ghraib,9,19,28,Jihad bombers kill nine Iraqis in a commercial district.
11237,23/3/2009,Iraq,Jalula,24,28,52,"A suicide bomber strikes a Kurdish funeral, killing at least twenty-four mourners."
11238,23/3/2009,Pakistan,Markez,1,4,5,A Shahid suicide bomber takes out a local policeman.
11239,23/3/2009,Pakistan,Miranshah,2,0,2,Religious extremists kidnap and kill two civilians in separate attacks.
11240,23/3/2009,Afghanistan,Spin Boldak,8,1,9,Eight local police are killed in a brutal ambush by Sunni hardliners.
11241,24/3/2009,Somalia,Mogadishu,4,1,5,al-Shabaab terrorists shoot four local policemen to death in a drive-by.
11242,24/3/2009,India,Ghaziabad,1,0,1,A 16-year-old girl is burned alive by Muslim moral police over a suspected affair.
11243,24/3/2009,Pal. Auth.,Gaza,1,0,1,A Palestinian is tortured and beaten to death in the hospital by Hamas.
11244,24/3/2009,Iraq,Mosul,1,0,1,Mujahid murder a woman inside her home.
11245,25/3/2009,Iraq,Mosul,4,7,11,Four schoolgirls are murdered by Islamic bombers.  Seven other children are injured.
11246,25/3/2009,Chechnya,Vedeno,1,0,1,A policeman is abducted and killed by Jihad warriors.
11247,25/3/2009,Afghanistan,Khost,10,6,16,"Ten civilians, including women and children, are blown to bits when Islamic hardliners bomb their passenger bus."
11248,25/3/2009,Sudan,Abu Zor,2,2,4,"Suspected Janjiweed militia torch a refugee camp, killing two people."
11249,25/3/2009,Thailand,Pattani,1,0,1,Mujahideen gun down a Buddhist man.
11250,26/3/2009,Iraq,Baghdad,4,0,4,Four homosexual men are shot to death following a call by clerics for a crackdown.
11251,26/3/2009,Pakistan,Tank,11,25,36,"A Shahid suicide bomber detonates at a restaurant, killing a dozen patrons."
11252,26/3/2009,Pakistan,Dera Ismail Khan,3,3,6,Three Sunnis are shot to death in a sectarian drive-by attack.
11253,26/3/2009,Afghanistan,Helmand,9,6,15,Nine local police are gunned down when armed religious extremists attack a checkpoint.
11254,26/3/2009,Thailand,Yala,1,0,1,"Muslims shoot a 46-year-old Buddhist woman, then set her on fire."
11255,26/3/2009,Thailand,Pattani,1,1,2,"Mujahideen storm a school, injure the principal and shoot a teacher to death."
11256,26/3/2009,Thailand,Narathiwat,1,1,2,Militant Muslims shoot a female grocery owner to death and injure her 70-year-old husband.
11257,26/3/2009,Iraq,Baghdad,26,37,63,"Sunni car bombers massacre over two dozen Shiites, including women and children, at an outdoor market."
11258,26/3/2009,Algeria,Kabylie,2,3,5,Separate al-Qaeda ambushes leave two people dead.
11259,26/3/2009,Iraq,Mosul,7,2,9,Three children are among seven Iraqis killed in two Muslim terror bombings.
11260,27/3/2009,Thailand,Pattani,3,0,3,Mujahideen gunmen murder three civilians in two attacks.
11261,27/3/2009,Pakistan,North Waziristan,3,0,3,Three civilians are shot to death by armed fundamentalists.
11262,27/3/2009,Iraq,Jalawla,1,1,2,A cleric is gunned down by al-Qaeda assassins.
11263,27/3/2009,Thailand,Narathiwat,1,16,17,A local farmer is shot to death as he returns from work and sixteen others injured in a separate bombing.
11264,27/3/2009,Pakistan,Jamrud,71,115,186,Over seventy people are slaughtered by a horrific Taliban suicide attack on a rival mosque.
11265,27/3/2009,Philippines,Maguindanao,7,2,9,"Moro Islamists ambush a security patrol, killing seven members."
11266,28/3/2009,Yemen,Jaar,4,3,7,Islamists ambush and kill four local policemen.
11267,28/3/2009,Iraq,Fallujah,2,0,2,Two farmers are murdered by Muslim extremists while working in their fields.
11268,28/3/2009,Thailand,Yala,1,0,1,A 51-year-old man is gunned down in his home by Muslim radicals.
11269,28/3/2009,Afghanistan,Paktia,7,5,12,Seven local security personnel are killed by Sunni hardliners in two separate attacks.
11270,29/3/2009,Iraq,Basra,5,6,11,Five Iraqis are blown apart by a Jihad roadside bomb.
11271,30/3/2009,Somalia,Saydhelow,3,10,13,A woman is among three people killed in an al-Shabaab ambush.
11272,30/3/2009,Iraq,Baqubah,3,9,12,Mujahid bombers murder three people outside a real estate office.
11273,30/3/2009,Iraq,Hillah,3,0,3,Three al-Qaeda victims are found dead in a car.
11274,30/3/2009,Thailand,Pattani,1,1,2,A vendor is murdered by Muslim gunmen while riding on his cart with his 14-year-old son.
11275,30/3/2009,Pakistan,Lahore,9,93,102,Civilians are among at least nine innocents slain in a Fedayeen attack on a police academy.
11276,30/3/2009,Thailand,Pattani,2,0,2,A married couple is brutally shot to death by Islamic extremists.
11277,30/3/2009,Afghanistan,Kandahar,9,8,17,"A Fedayeen bomber calmly walks into a government office and detonate, leaving at least nine dead."
11278,30/3/2009,Afghanistan,Paktia,3,0,3,Three local cops are killed by a Taliban roadside bomb.
11279,30/3/2009,Pakistan,Bannu,5,3,8,"A Shahid rams an explosives-laden vehicle into a police checkpoint, killing five officers."
11280,30/3/2009,Thailand,Narathiwat,1,0,1,Muslim gunmen murder a civilian as he is walking home.
11281,31/3/2009,Iraq,Kirkuk,1,0,1,A 71-year-old Christian man is killed in his own home by Muslim intruders.
11282,31/3/2009,Pakistan,Samundri,1,0,1,A father of four young children is murdered by suspected Islamists.
11283,31/3/2009,Iraq,Mosul,7,40,47,A suicide truck bomber takes out seven Iraqis.
11284,31/3/2009,Iraq,Kirkuk,1,0,1,An elderly Christian is gunned down by Muslim radicals.
11285,31/3/2009,Philippines,Alamada,1,3,4,Moro Islamists gun down a local soldier guarding a town square.
11286,1/4/2009,Pakistan,Upper Dir,5,2,7,Five police are slaughtered in a brutal Taliban ambush.
11287,1/4/2009,Iraq,Mosul,4,0,4,"Two bombings and a shooting leave four dead, including a schoolteacher and a 7-year-old child."
11288,1/4/2009,Somalia,Mogadishu,1,1,2,A civilian is killed when al-Shabaab terrorists fire at a vehicle carrying a lawmaker.
11289,1/4/2009,Afghanistan,Kandahar,13,17,30,A Fedayeen attack on a government office leaves thirteen people dead.
11290,1/4/2009,Iraq,Mashtal,1,0,1,A Christian man is gunned down in front of his restaurant by Islamic terrorists.
11291,2/4/2009,Iraq,Baghdad,2,0,2,Two older Christian sisters are murdered by Mujahideen gunmen.
11292,2/4/2009,Iraq,Baghdad,2,0,2,"Two homosexuals are killed by their tribes in a bid to ""restore family honor."""
11293,2/4/2009,Israel,Bat Ayin,1,1,2,"A 45-year-old Muslim slips into a Jewish settlement, stabs a 7-year-old and axes a 13-year-old to death."
11294,2/4/2009,Afghanistan,Herat,4,0,4,Sunni fundamentalists kill three civilians and a local cop in an ambush.
11295,2/4/2009,Dagestan,Khasavyurt,3,0,3,A local cop and his two brothers are kidnapped and murdered by Islamic separatists.
11296,2/4/2009,Pakistan,Koral,1,0,1,A Muslim man stabs his sister to death for marrying without the family's permission.
11297,2/4/2009,Iraq,Baqubah,3,0,3,"Terrorists plant a bomb at a car dealership, killing three people."
11298,3/4/2009,Iraq,Baghdad,2,5,7,Jihadi bombers successfully kill two Iraqis.
11299,3/4/2009,Afghanistan,Ghazni,4,0,4,Four construction crew workers are killed in a Taliban bombing.
11300,3/4/2009,Philippines,Basilan,2,8,10,A woman is among two people killed when Islamic militants bomb a fast food shop near a Catholic cathedral.
11301,4/4/2009,Iraq,Mosul,1,0,1,A Christian repairman is shot to death by Muslim gunmen in front of his workshop.
11302,4/4/2009,Thailand,Pattani,2,0,2,A 60-year-old man and his teenage son are shot to death outside their home by Islamic terrorists.
11303,4/4/2009,Pakistan,Miranshah,7,30,37,Children are among seven people murdered by a Fedayeen bomber.
11304,4/4/2009,Pakistan,Islamabad,8,4,12,Eight embassy guards are blown to bits by a Shahid suicide bomber.
11305,5/4/2009,Iraq,Abu Ghraib,1,2,3,A civilian is taken out in an al-Qaeda bombing in a residential area.
11306,5/4/2009,Iraq,Mosul,2,1,3,A child and his mother are among three casualties of two terror attacks.
11307,5/4/2009,Somalia,Mogadishu,1,6,7,A child is killed in an Islamist mortar attack.
11308,5/4/2009,Pakistan,Chakwal,24,35,59,"Two dozen innocents, including four children, are blown to bits in a religious center by a Shahid suicide bomber."
11309,5/4/2009,Jordan,Sahab,1,0,1,A 22-year-old woman is stabbed to death by her brother for 'spending too much time out of the house.'
11310,6/4/2009,Pakistan,Manghopir,1,0,1,A 35-year-old Hindu faith healer is brutally murdered in suspected sectarian violence.
11311,6/4/2009,Pakistan,Mansehra,4,0,4,Three female aid workers and their driver are brutally murdered by suspected Muslim militants.
11312,6/4/2009,Pakistan,Mingora,1,1,2,A village guard is murdered by Islamic gunmen.
11313,6/4/2009,Afghanistan,Khost,2,1,3,Taliban bombers take out two local security personnel.
11314,6/4/2009,Iraq,Jalawla,3,0,3,Three civilians are gunned down in a Sunni drive-by.
11315,6/4/2009,Iraq,Baghdad,37,100,137,Six coordinated terror bombings leave thirty-seven Iraqis dead.
11316,6/4/2009,Philippines,Basilan,3,9,12,Three laborers are cut down by automatic weapons at point-blank range by Abu Sayyaf militants.
11317,7/4/2009,Iraq,Baghdad,7,14,21,Mujahideen blow seven people to bit with a car bomb.
11318,7/4/2009,Iraq,Fallujah,3,7,10,A suicide bomber takes out three Iraqis.
11319,8/4/2009,Pakistan,Buner,5,0,5,"Taliban fighters attack a local village, killing five people."
11320,8/4/2009,Iraq,Baghdad,7,19,26,"Jihadis bomb a marketplace, murdering seven patrons."
11321,8/4/2009,Algeria,Kabylie,1,0,1,A cop is killed in a Mujahideen bombing.
11322,8/4/2009,Pakistan,Lahore,1,0,1,A Muslim man guns down his niece to keep her from marrying against the family's permission.
11323,9/4/2009,Pal. Auth.,Gaza,3,0,3,A 5-year-old boy is among three family members gunned down over immoral behavior.
11324,9/4/2009,Algeria,Jijel,3,0,3,Three brothers are massacred by Islamic fundamentalists at a fake checkpoint.
11325,9/4/2009,Afghanistan,Lashkar Gah,5,17,22,Two children are among five Afghans blown apart by a Shahid suicide bomber.
11326,9/4/2009,Thailand,Pattani,1,0,1,A teenager is kidnapped and beheaded by Mujahideen.
11327,10/4/2009,Somalia,Mogadishu,2,9,11,The 'Mujahideen Youth Movement' take out two civilians in a mortar attack.
11328,10/4/2009,Pakistan,Bannu,1,2,3,"Islamists bomb a tribal elder meeting, killing one member."
11329,10/4/2009,Pakistan,North Waziristan,2,0,2,Two civilians are kidnapped and beheaded by Taliban militants.
11330,10/4/2009,Thailand,Narathiwat,1,2,3,"Mujahideen gunmen fire into a passenger train, killing one railway worker."
11331,10/4/2009,Philippines,Basilan,1,8,9,"Muslim terrorists attack a Christian village, killing one and kidnapping several young children."
11332,10/4/2009,Iraq,Mosul,7,20,27,Five Americans are among seven murdered by a Fedayeen suicide bomber.
11333,10/4/2009,Afghanistan,Helmand,6,7,13,"Religious extremists attack a police post, killing six local officers."
11334,11/4/2009,Iraq,Iskandariya,12,32,44,A dozen innocents waiting in line for pay are blown apart by an al-Qaeda suicide bomber.
11335,12/4/2009,USA,"Phoenix, AZ",2,0,2,"A man shoots his brother-in-law and another man to death after finding out that they visited a strip club, in contradiction to Islamic values."
11336,12/4/2009,Iran,Shiraz,14,160,174,"The Sunni Jihadi Movement bombs a Shia prayer gathering, killing fourteen people."
11337,12/4/2009,Jordan,Basira,1,0,1,A 28-year-old pregnant woman is stabbed to death by her younger brother in an 'honor killing.'
11338,12/4/2009,Iraq,Yathrib,2,0,2,al-Qaeda terrorists murder two Iraqis with a roadside bomb.
11339,12/4/2009,Iraq,Mosul,3,2,5,Mujahideen gun down a civilian and two policemen.
11340,12/4/2009,Pakistan,Peshawar,1,7,8,"Islamic militants attack a trucking terminal, killing a security guard."
11341,12/4/2009,Afghanistan,Kandahar,1,0,1,A women's rights activist is murdered by four fundamentalist gunmen.
11342,13/4/2009,Pakistan,Jandola,2,0,2,Two people are kidnapped and shot to death by Mujahid.
11343,13/4/2009,Afghanistan,Nimruz,2,0,2,A man and woman are publicly executed by the Taliban for eloping.
11344,13/4/2009,Afghanistan,Khost,2,0,2,Two construction crew guards are murdered by Islamic militants.
11345,13/4/2009,Afghanistan,Herat,4,0,4,Four civilians are blown to bits when Sunni hardliners bomb a passenger bus.
11346,13/4/2009,Somalia,Mogadishu,1,3,4,A woman is among the casualties as Islamists set off a bomb along a city street.
11347,13/4/2009,Somalia,Mogadishu,1,5,6,"Terrorists send a rocket into a Red Cross building, killing one civilian."
11348,13/4/2009,Iraq,Baghdad,0,4,4,Fundamentalists toss a grenade into a liquor shop.
11349,13/4/2009,Philippines,Basilan,1,0,1,Abu Sayyaf terrorists behead a kidnapped Christian.
11350,14/4/2009,Thailand,Yala,1,0,1,A villager is murdered by Mujahid gunmen.
11351,14/4/2009,Pal. Auth.,Gaza,1,0,1,A 28-year-old woman is murdered by her family in an honor killing.
11352,15/4/2009,Pakistan,Jacobabad,1,0,1,A young girl is killed by her uncle on suspicion of sexual immorality.
11353,15/4/2009,Somalia,Mogadishu,1,0,1,A government official is assassinated by al-Shabaab terrorists.
11354,15/4/2009,Pakistan,Karachi,1,0,1,A lawyer is gunned down in a suspected sectarian attack.
11355,15/4/2009,Philippines,Elian,2,0,2,Moro Islamists ambush and kill two locals.
11356,15/4/2009,Iraq,Kirkuk,11,22,33,Eleven Iraqis are murdered by a Fedayeen suicide bomber near an oil facility.
11357,15/4/2009,Pakistan,Charsadda,18,5,23,"A suicide bomber drives an explosives-laden car into a police checkpoint, killing both officers and civilians."
11358,16/4/2009,India,Anantnag,1,1,2,"A woman is murdered, and her son wounded, when Mujahideen intrude into the home and open fire on the family."
11359,16/4/2009,Pakistan,Mardan,1,0,1,A woman is killed when Islamic militants bomb the offices of a humanitarian organization.
11360,16/4/2009,Iraq,Baquba,1,4,5,One person is killed in an al-Qaeda bombing.
11361,16/4/2009,Pakistan,Lahore,1,0,1,An 18-year-old woman is shot dead by her brother-in-law for trying to leave the marriage.
11362,17/4/2009,Afghanistan,Parwan,5,5,10,Five security guards are gunned down by suspected Sunni radicals.
11363,17/4/2009,Iraq,Baghdad,7,15,22,Seven people are killed when Jihadis lob mortars into a residential neighborhood.
11364,17/4/2009,Afghanistan,Nimroz,3,3,6,A suicide bomber takes out three civilians.
11365,18/4/2009,Pakistan,Khyber,4,0,4,Four men are killed in a remote-controlled bomb attack.
11366,18/4/2009,Pakistan,Hangu,27,55,82,"A Holy Warrior rams an explosives-laden truck into a local checkpoint, sending at least twenty-seven souls to Allah."
11367,18/4/2009,Afghanistan,Kandahar,2,4,6,A woman is among two people blown to bits by a planted bicycle bomb.
11368,19/4/2009,Iraq,Baghdad,3,0,3,Three Christian jewelers are brutally murdered in their shop by Muslim gunmen.
11369,19/4/2009,Ingushetia,Rostov-on-Don,2,0,2,A faith healer is one of two people murdered by suspected Islamic militants.
11370,19/4/2009,Pakistan,Hangu,2,0,2,A man and woman are executed by the Taliban for having relations outside of marriage.
11371,19/4/2009,Somalia,Merka,1,0,1,Islamic gunmen murder a humanitarian worker.
11372,19/4/2009,India,Pulwama,1,0,1,A former terrorist who renounced violence is shot to death by Islamists.
11373,19/4/2009,India,Doda,2,0,2,"Lashkar-e-Toiba militants open fire on local security forces, killing two."
11374,19/4/2009,Iraq,Mussayib,2,0,2,Two Sunnis are gunned down by suspected al-Qaeda.
11375,19/4/2009,Iraq,Baghdad,1,0,1,Terrorists assassinate a government official.
11376,19/4/2009,Ingushetia,Sunzhen,1,1,2,"Mujahideen stage a grenade attack on a home, killing a woman."
11377,19/4/2009,Afghanistan,Zabul,2,3,5,Three local police are murdered in a Taliban ambush.
11378,19/4/2009,Pakistan,Orakzai,2,0,2,Two women are killed when fundamentalists blow up a house on suspicion of sexual activity.
11379,20/4/2009,Pakistan,South Waziristan,3,0,3,A woman and child are among three people killed during a Taliban ambush.
11380,20/4/2009,Iraq,Baqubah,11,15,26,Eleven Iraqis are blasted to death by a Fedayeen suicide bomber.
11381,20/4/2009,Iraq,Fallujah,2,0,2,Jihadis manage to kill two young girls with an IED.
11382,20/4/2009,Somalia,Kismayo,7,15,22,Seven people are killed during an al-Shabaab assault.
11383,20/4/2009,Afghanistan,Uruzgan,1,2,3,Religious extremists kill a civilian with a roadside bomb.
11384,20/4/2009,Pakistan,Lahore,2,0,2,An 18-year-old girl is among two women shot to death by their family member on suspicion of illicit relations with men.
11385,20/4/2009,Afghanistan,Khost,2,8,10,"Islamists bomb a passenger bus, killing two civilians."
11386,21/4/2009,Pakistan,Taseer,3,0,3,A mob of Islamic hardliners invade a Christian neighborhood and terrorize the residents.  Two Christians are killed as they attempt to defend women from rape.  An 11-year-old boy dies a few days later.
11387,21/4/2009,India,Poonch,5,7,12,A young girl and mother are among two people blown to bits by a Lashkar-e-Toiba landmine.
11388,21/4/2009,Iraq,Mosul,2,0,2,A female professor and butcher are brutally murdered by Islamic extremists in separate attacks.
11389,22/4/2009,Iraq,Duluiya,5,12,17,A child suicide bomber takes out five people at a rival mosque.
11390,22/4/2009,Chechnya,Bamut,3,0,3,Three Russian soldiers are shot at point-blank range by Islamic ambushers.
11391,22/4/2009,Thailand,Yala,2,0,2,Two local police are killed in a combination shooting and bombing attack by Muslim militants.
11392,23/4/2009,Afghanistan,Farah,1,0,1,A local policeman is killed in a Taliban ambush.
11393,23/4/2009,Iraq,Udhaim,3,3,6,A planted al-Qaeda bomb kills three local Sunnis.
11394,23/4/2009,Iraq,Diyala,55,67,122,A Sunni murders fifty-three Shia pilgrims and two employees at a restaurant with a suicide vest.
11395,23/4/2009,Iraq,Baghdad,32,52,84,A female suicide bomber successfully blasts thirty-two Iraqis to death.  Her toddler is used as a disguise and dies in the blast.
11396,23/4/2009,Somalia,Jawle,3,0,3,al-Shabaab terrorists assassinate three rival clerics.
11397,23/4/2009,Pakistan,Buner,2,0,2,"Religious extremists open fire on a pair of local cops, killing both."
11398,24/4/2009,Iraq,Jalawla,7,24,31,A Fedayeen car bomber takes out seven Shiite pilgrims.
11399,24/4/2009,Pakistan,Kala Dhaka,2,0,2,A man and woman are killed for having an unauthorized sexual relationship.
11400,24/4/2009,Iraq,Baghdad,66,127,193,Two female Fedayeen massacre over 60 Shiite pilgrims at a mosque with explosives hidden in their purse.
11401,24/4/2009,India,Pulwama,1,0,1,A 55-year-old man is shot to death inside his home by suspected Mujahideen.
11402,25/4/2009,Afghanistan,Kabul,2,1,3,"A young American contractor, working on a septic system for impoverished locals, is killed along with another innocent in an ambush."
11403,25/4/2009,Somalia,Mogadishu,8,15,23,Islamic hardliners murder eight people in a mortar attack on a residential area.
11404,25/4/2009,Afghanistan,Kandahar,5,3,8,Three Shahid suicide bombers kill five local guards at a government building.
11405,25/4/2009,Iraq,Tal Keef,1,0,1,A Christian woman is abducted and beheaded by Islamic radicals.
11406,25/4/2009,Somalia,Mogadishu,3,8,11,Three civilians are shot to death in a sustained attack by a religious extremist group.
11407,26/4/2009,Afghanistan,Khost,3,3,6,Three local border guards are murdered by Taliban bombers.
11408,26/4/2009,Pakistan,Datta Khel,6,5,11,Six people are blown to bits by a Mujahideen roadside bomb.
11409,26/4/2009,Pakistan,Peshawar,1,0,1,A young woman is murdered by her family for choosing a singing career against their approval.
11410,26/4/2009,Iraq,Kirkuk,2,0,2,Islamists slit the throats of a Christian woman and her daughter-in-law.
11411,26/4/2009,Iraq,Kirkuk,1,2,3,A Christian man is gunned down by Mujahid.
11412,26/4/2009,Afghanistan,Kandahar,7,0,7,Civilians and local police are among seven killed in a Taliban landmine attack.
11413,26/4/2009,Iraq,Mosul,3,0,3,Two brothers are among three people gunned down by Sunni radicals.
11414,26/4/2009,Pakistan,Dir,12,0,12,A dozen children are blown apart by a bomb hidden in a football planted by Sunni hardliners to punish their families.
11415,26/4/2009,Philippines,Sultan Kudarat,1,3,4,"Moro Islamists plant a bomb near a beach, killing one passerby."
11416,27/4/2009,Thailand,Yala,5,0,5,A man watching a soccer game and Buddhist plantation worker are among five people murdered separately by Muslim gunmen.
11417,28/4/2009,Pakistan,Karachi,1,0,1,A 15-year-old kills his 19-year-old sister on his family's orders for eloping with a non-Muslim man.
11418,28/4/2009,Iraq,Mosul,1,0,1,An elderly man is murdered by Sunni gunmen.
11419,28/4/2009,Thailand,Yala,4,1,5,A 16-year-old girl is among four members of a family brutally shot to death in their home by Islamic terrorists.
11420,28/4/2009,Thailand,Pattani,1,0,1,A Buddhist man is gunned down by Mujahideen.
11421,29/4/2009,Iraq,Mosul,1,0,1,A girl is beheaded over a suspected moral issue.
11422,29/4/2009,Iraq,Baghdad,12,21,33,Twelve Iraqis are killed in three Mujahideen bombings in Shia neighborhoods.
11423,29/4/2009,Somalia,Galkayo,5,7,12,"Suspected Islamists hurl a grenade at a government car, killing five occupants."
11424,29/4/2009,Iraq,Baghdad,48,68,116,Sunni bombers massacre nearly fifty Shiites with three bombs planted in two crowded markets and a packed minibus.
11425,29/4/2009,Afghanistan,Baghlan,2,0,2,A man shoots his daughter and boyfriend to death after finding them in bed together.
11426,30/4/2009,England,Manchester,1,0,1,A Sikh dies from injuries suffered when a Muslim gang severely beats him in what police call an unprovoked 'racist' attack.
11427,30/4/2009,Iraq,Tal Afar,3,0,3,Islamic militants shoot three brothers to death inside their car.
11428,30/4/2009,Thailand,Yala,1,1,2,Muslim terrorists gun down a 51-year-old businessman.
11429,30/4/2009,Pakistan,Kohat,1,6,7,"Sunnis bomb a minivan carrying Shia pilgrims, murdering at least one passenger."
11430,30/4/2009,Afghanistan,Khost,2,0,2,Two car dealers are shot to death by Jihad terrorists.
11431,1/5/2009,Afghanistan,Kunar,10,8,18,Ten security force personnel are killed when Islamic militants attack a base.
11432,1/5/2009,Pakistan,Miranshah,1,0,1,A civilian is murdered by Sunni extremists on suspicion of spying.
11433,1/5/2009,Iraq,Mosul,5,6,11,A Shiite family of five is blown to bits by a Fedayeen suicide bomber in a cafe.
11434,2/5/2009,India,Baramulla,1,2,3,A 10-year-old boy is killed by a Jihadi bomb.
11435,2/5/2009,Iraq,Mosul,2,3,5,Two US soldiers are shot to death by a local imam wearing a Coalition uniform.
11436,2/5/2009,Pakistan,Bajaur,1,5,6,Sunni militants kill a man and injure five women in a rocket attack on their homes.
11437,2/5/2009,Iraq,Kirkuk,3,0,3,Three civilians are taken down in a Mujahideen roadside blast.
11438,2/5/2009,Pakistan,Mingora,2,0,2,Two government officials are kidnapped and beheaded by religious extremists.
11439,3/5/2009,Somalia,Mogadishu,11,15,26,Eleven African peacekeepers are murdered in a Mujahid suicide attack.
11440,3/5/2009,Pakistan,North Waziristan,2,0,2,The bodies of two Taliban kidnap victims are found riddled with bullets.
11441,3/5/2009,Iraq,Mosul,3,4,7,Terrorists take out three Iraqis with a car bomb.
11442,3/5/2009,Israel,Ramat Gan,0,1,1,An Israeli soldier riding a bus is stabbed in the neck by an Arab attacker.
11443,3/5/2009,Afghanistan,Helmand,4,7,11,An 8-year-old girl and 10-year-old boy are among four murdered in a Taliban bomb blast.
11444,3/5/2009,Thailand,Narathiwat,1,1,2,Islamic fundamentalists shoot a 59-year-old pork vendor to death and injure an accompanying minor.
11445,3/5/2009,Thailand,Narathiwat,2,1,3,A construction worker is among two people killed in separate Muslim attacks.
11446,3/5/2009,Pakistan,Swat,2,0,2,Two security officers are kidnapped and beheaded by Islamists.
11447,4/5/2009,Pakistan,Peshawar,5,12,17,"Five local cops are murdered in two attacks, including a Fedayeen bombing."
11448,4/5/2009,Iraq,Baghdad,4,6,10,Muslim bombers take out four Iraqis.
11449,4/5/2009,Afghanistan,Zabul,7,10,17,A mayor is among seven people blown to bits by a 14-year-old suicide bomber.
11450,4/5/2009,Philippines,Tulunan,3,6,9,"Moro Islamists attack a banana plantation, killing three civilians."
11451,4/5/2009,Afghanistan,Zabul,8,0,8,The Taliban murder eight people working a construction crew in a brutal ambush.
11452,4/5/2009,Thailand,Yala,1,0,1,Muslim insurgents shoot a 70-year-old man to death inside his home.
11453,4/5/2009,Afghanistan,Zabul,12,0,12,Women and children are represented among the twelve victims of Sunni fundamentalist bombers.
11454,5/5/2009,Pakistan,Peshawar,7,48,55,Two children are among seven people blown apart by a Holy Warrior car bomber.
11455,5/5/2009,Pakistan,Mohmand,2,6,8,"Sunni militants attack a check post, killing at least two defending officers."
11456,5/5/2009,Iraq,Kirkuk,1,0,1,A man is kidnapped and tortured to death by suspected al-Qaeda.
11457,6/5/2009,Pakistan,Dera Ismail Khan,0,14,14,"A Muslim militant throws a grenade into a rival mosque during prayer time, injuring fourteen."
11458,6/5/2009,Pakistan,Buner,4,0,4,A woman is among four civilians murdered by fundamentalists in two incidents.
11459,6/5/2009,Iraq,Mosul,1,2,3,An 11-year-old boy is taken out by Mujahideen bombers.
11460,6/5/2009,Iraq,Baghdad,15,46,61,Jihadis successfully kill fifteen patrons of an outdoor marketplace with a well-placed bomb.
11461,6/5/2009,Pakistan,Nazar Muhalla,1,0,1,A woman is shot to death in an honor killing when 'illicit' relations are suspected.
11462,7/5/2009,Philippines,Jolo,5,3,8,Abu Sayyaf terrorists ambush and murder five local police.
11463,7/5/2009,Pakistan,Hangu,5,7,12,"Islamic militants abduct three tribesmen, then shoot five others to death as they are searching for their peers."
11464,7/5/2009,Afghanistan,Helmand,16,32,48,Sixteen people at an outdoor market are blown to bits by a Shahid suicide bomber.
11465,8/5/2009,Pakistan,Darra Adam Khel,4,3,7,Two women and a child are among four killed when Taliban militants fire a rocket into a refugee camp.
11466,8/5/2009,Iraq,Kut,1,0,1,A boy is deliberately murdered by suspected Sunni gunmen.
11467,8/5/2009,India,Reasi,3,0,3,"Hizb-ul-Mujahideen terrorists abduct three civilians, including a woman, from their homes and then shoot them to death."
11468,9/5/2009,Pakistan,Machharkay,1,0,1,A Christian man is beaten to death with pipes by Muslims angry that he drank tea at a 'Muslim-only' establishment.
11469,9/5/2009,Pakistan,Shikarpur,2,0,2,Two women are tortured and then strangled by family members for having 'illicit' relations.
11470,9/5/2009,Jordan,Amman,1,0,1,A 30-year-old woman is stabbed to death by her brothers in an honor killing after she states her desire to live as she pleases.
11471,9/5/2009,Iraq,Mosul,1,3,4,Terrorists gun down an off-duty police officer at a market.
11472,9/5/2009,Afghanistan,Zabul,4,8,12,Religious extremists kill four local police in two roadside attacks.
11473,10/5/2009,Iraq,Taji,2,0,2,Suspected al-Qaeda kill two innocent Iraqis in a roadside attack.
11474,10/5/2009,Somalia,Mogadishu,39,60,99,"Islamists pour mortars and machine-gun fire into eliminating the 'enemies of Allah.'  At least thirty-nine people are killed, including civilians at a mosque."
11475,10/5/2009,Afghanistan,Helmand,7,20,27,Two suicide bombers take out seven civilians in an attack on a taxi stand.
11476,10/5/2009,Afghanistan,Zabul,3,0,3,Three civilians are blown apart in a Jihad bombing.
11477,10/5/2009,Afghanistan,Nangarhar,8,0,8,Eight construction crew workers are murdered in a Taliban bomb blast.
11478,11/5/2009,Iraq,Mosul,3,7,10,Three Iraqis are killed in two Mujahid bombings.
11479,11/5/2009,Pakistan,Peshawar,10,12,22,A 6-year-old girl is among ten locals massacred by a suicide car bomber.
11480,11/5/2009,Somalia,Mogadishu,2,3,5,"Islamists lob a mortar shell into a cafe, ending the lives of two patrons."
11481,11/5/2009,Dagestan,Kizilyurt,1,3,4,A policeman is gunned down in a marketplace by suspected Islamic separatists.
11482,11/5/2009,Iraq,Mosul,1,0,1,Muslim kidnappers murder a 5-year-old Christian boy.
11483,12/5/2009,Pal. Auth.,Ramallah,1,0,1,"A 30-year-old woman, and mother of seven, is stabbed to death by her nephew in an honor killing."
11484,12/5/2009,Pakistan,Swat,7,0,7,Seven civilians are shot to death by the Taliban on suspicion betraying Islam.
11485,12/5/2009,Iraq,Kirkuk,7,18,25,"A child suicide bomber, recruited by al-Qaeda, takes out seven Iraqis along a city street."
11486,12/5/2009,Afghanistan,Khost,7,13,20,"Four religious extremists blow themselves up, killing seven laborers."
11487,12/5/2009,Pakistan,Nishat Chowk,1,0,1,The Taliban murder a rival mosque leader.
11488,12/5/2009,Iraq,Baqubah,1,0,1,A 13-year-old girl is kidnapped and brutally murdered by al-Qaeda.
11489,12/5/2009,Pakistan,Suhrab Khan,6,0,6,Islamists behead six people.
11490,13/5/2009,Pakistan,Mingora,5,0,5,Five more people are beheaded by Sunni radicals.
11491,13/5/2009,Iraq,Baghdad,3,1,4,A young boy is among three Iraqis murdered by Mujahid gunmen.
11492,13/5/2009,Chechnya,Vedeno,3,0,3,Islamic bombers take out three people.
11493,14/5/2009,Iraq,Baqubah,3,0,3,al-Qaeda gunmen shoot two men and their mother to death inside their home.
11494,14/5/2009,Somalia,Mogadishu,26,98,124,Twenty-six civilians are killed in a series of street battles as al-Shabaab Islamists fight for Allah.
11495,14/5/2009,Afghanistan,Ghazni,1,1,2,A Taliban attack leaves a security guard dead.
11496,14/5/2009,Pakistan,Miranshah,3,4,7,Three local soldiers are murdered by Taliban roadside bombers.
11497,15/5/2009,Pakistan,Punjab,1,0,1,A Christian man is raped and murdered for refusing to convert to Islam.
11498,15/5/2009,Iraq,Mosul,1,0,1,A Christian is kidnapped and beheaded.
11499,15/5/2009,Iraq,Mandali,1,0,1,A young woman is the victim of a suspected honor killing.
11500,15/5/2009,Afghanistan,Khost,3,4,7,"Sunni terrorists strike a mosque with a rocket, killing three civilians."
11501,15/5/2009,India,Kupwara,2,0,2,Mujahideen shoot two civilians to death in their home.
11502,15/5/2009,India,Kupwara,1,0,1,A park ranger is kidnapped and beheaded by Islamic extremists.
11503,16/5/2009,Chechnya,Grozny,4,5,9,Four people are killed by a Shahid suicide bomber.
11504,16/5/2009,Pakistan,Peshawar,11,31,42,Women and children are among those murdered when Islamists bomb a commercial district near an Internet cafe.
11505,16/5/2009,Iraq,Baghdad,1,2,3,A child is killed when Muslim terrorists lob a mortar into a family home.
11506,16/5/2009,Iraq,Baghdad,4,12,16,Jihad bombers take our four Iraqis in two attacks.
11507,17/5/2009,Afghanistan,Helmand,6,0,6,Six local police are murdered in a Sunni bomb attack.
11508,17/5/2009,Iraq,Mosul,9,3,12,Nine Iraqis are taken down by Islamic terrorists.
11509,17/5/2009,Iraq,Baghdad,4,10,14,Four innocents are blown up at a coffee shop by Religion of Peace bombers.
11510,18/5/2009,India,Mumbai,1,0,1,A 14-year-old Hindu boy is strangled for dating a Muslim girl.  His face is subsequently smashed with rocks.
11511,18/5/2009,Afghanistan,Kandahar,1,0,1,A Taliban machine-gun attack leaves one person dead.
11512,18/5/2009,Pakistan,Mohmand,2,0,2,Two hostages held by the Tehrik-e-Taliban are executed and left by a roadside.
11513,18/5/2009,Philippines,Basilan,1,0,1,The beheaded body of a 61-year-old Christian farmer is found following his abduction by Islamic militants.
11514,18/5/2009,Thailand,Narathiwat,1,0,1,A 39-year-old civilian is gunned down by Muslim terrorists while on his way to play soccer.
11515,19/5/2009,Thailand,Pattani,2,0,2,Islamists ambush and kill two rangers.
11516,19/5/2009,Iraq,Taji,2,5,7,Terrorists kill two Iraqis with a roadside bomb.
11517,19/5/2009,Thailand,Yala,1,0,1,Three Mujahideen murder an elementary school teacher.
11518,20/5/2009,Thailand,Pattani,2,0,2,"Two elderly women are shot off their motorbike, then set on fire by Muslim militants."
11519,20/5/2009,Afghanistan,Kabul,2,0,2,Two Americans are murdered in a Mujahideen bombing.
11520,20/5/2009,Iraq,Baghdad,40,83,123,Sunni bomber take out at least forty Shias with a car bomb near a packed restaurant.
11521,20/5/2009,Somalia,Mogadishu,3,0,3,A 6-year-old child sleeping in his home is among three civilians murdered in an Islamic attack.
11522,20/5/2009,Algeria,Medea,5,1,6,Five local policemen are killed in an ambush by armed Islamic fundamentalists.
11523,21/5/2009,Iraq,Baghdad,12,25,37,A dozen people are blasted to death by a Fedayeen suicide bomber.
11524,21/5/2009,Iraq,Mosul,2,1,3,Suspected Sunni extremists storm a home and kill a woman and her daughter.
11525,21/5/2009,Iraq,Kirkuk,8,7,15,Eight Iraqis are blown to bits by a Shahid suicide bomber.
11526,21/5/2009,Pakistan,Jandola,9,25,34,"A Holy Warrior detonates himself near a bazaar, killing nine people."
11527,21/5/2009,Philippines,Zamboanga,3,5,8,Islamists are suspected in the brutal ambush of a civilian vehicle that leaves three dead.
11528,22/5/2009,Pakistan,Mingora,2,0,2,Two local cops are executed by Sunni fundamentalists.
11529,22/5/2009,Pakistan,Peshawar,10,75,85,Ten people are killed when religious fundamentalists detonate one of their own outside a cinema.
11530,22/5/2009,Israel,Qaryut,1,0,1,al-Aqsa Martyrs Brigade takes credit for shooting a Jewish settler in the back.
11531,23/5/2009,Iraq,Mosul,4,3,7,Mujahideen take out four Iraqi police with a roadside bomb.
11532,23/5/2009,Afghanistan,Ghazni,2,0,2,The Taliban are able to bag two civilians with a rocket attack on their vehicle.
11533,23/5/2009,Israel,Beit Jan,1,0,1,A 23-year-old girl is shot to death by her father for 'violating the tenets of Islam.'
11534,24/5/2009,Iraq,Mosul,2,0,2,A woman and her daughter are murdered in their home by Mujahideen.
11535,24/5/2009,Iraq,Fallujah,1,3,4,"Sunni insurgents toss a grenade into a home, killing a 2-month-old baby."
11536,24/5/2009,Pakistan,Karachi,1,0,1,A Sunni activist is shot to death in a sectarian attack.
11537,24/5/2009,Pakistan,South Waziristan,2,0,2,Two local security personnel are murdered in a Taliban ambush.
11538,24/5/2009,Iraq,Mosul,8,26,34,Eight lives are snuffed out by a suicide bomber at a restaurant.
11539,24/5/2009,Iraq,Mosul,1,0,1,Terrorists gun down a university professor.
11540,24/5/2009,Somalia,Mogadishu,7,7,14,Seven people are murdered by a suicide car bomber.
11541,25/5/2009,Dagestan,Makhachkala,1,0,1,A moderate cleric is murdered by Islamic radicals.
11542,25/5/2009,Pakistan,Dera Ismail Khan,3,0,3,Three Shia laborers are shot dead in a Sunni drive-by attack.
11543,25/5/2009,Ingushetia,Sunzha,4,0,4,Mujahid plant a landmine that kills four local police.
11544,26/5/2009,Uzbekistan,Andijan,1,1,2,A Fedayeen suicide attack leaves one other dead.
11545,26/5/2009,Pakistan,Dera Ismail Khan,1,2,3,"Sunnis roll a hand grenade into the home of a local Shia, killing him and injuring two family members."
11546,26/5/2009,Somalia,Mogadishu,9,10,19,Nine people die from shrapnel during an Islamists mortar attack.
11547,26/5/2009,Afghanistan,Kabul,6,3,9,Three civilians are among six people blown up a suicide car bomber.
11548,26/5/2009,Iraq,Anbar,7,0,7,Seven victims of sectarian violence are found in a mass grave.
11549,27/5/2009,Uzbekistan,Khanabad,4,0,4,Four border policemen are killed in a drive-by attack by Islamic militants.
11550,27/5/2009,Pakistan,Karachi,1,1,2,A man is gunned down in a suspected sectarian attack that also leaves his son injured.
11551,27/5/2009,Pakistan,Mingora,2,0,2,Two local security personnel are murdered in a Taliban landmine attack.
11552,27/5/2009,Iraq,Abu Ghraib,5,10,15,Five people are blown to bits by a Jihadi car bombing.
11553,27/5/2009,Afghanistan,Paktika,5,1,6,A man and his three sons are among five shot to death by religious extremists.
11554,27/5/2009,Pakistan,Lahore,27,326,353,A child is among two dozen people massacred in a coordinated shooting and bombing attack by Fedayeen.
11555,27/5/2009,Algeria,Biskra,9,7,16,Islamic fundamentalists ambush and kill nine Algerian soldiers.
11556,28/5/2009,Iraq,Mosul,2,0,2,A 15-year-old girl and her mother are brutally gunned down in their own home by Muslim terrorists.
11557,28/5/2009,Pakistan,Peshawar,8,68,76,"Islamists kill at least eight people, including a little girl, in a series of violent bomb blasts."
11558,28/5/2009,Pakistan,Barikot,4,0,4,Four members of a food convoy are shot to death in a Taliban ambush.
11559,28/5/2009,Pakistan,Peshawar,6,22,28,Six people are killed in two suicide attacks.
11560,28/5/2009,Iraq,Mosul,1,0,1,A woman is shot to death by Mujahideen.
11561,29/5/2009,Iraq,Khalis,7,13,20,Seven people are killed in two Jihad bombings.
11562,29/5/2009,Iran,Zahedan,25,125,150,A Shahid suicide bomber blows up twenty-five innocents at a mosque.
11563,30/5/2009,Pakistan,Pacha Killay,3,0,3,Three residents are beheaded by religious radicals.
11564,30/5/2009,Iraq,Mosul,4,0,4,Four local police are murdered by Islamic terrorists.
11565,30/5/2009,Afghanistan,Kandahar,4,0,4,Sunni extremists take out four civilians with a roadside bomb.
11566,30/5/2009,Somalia,Mogadishu,2,5,7,A child is among two civilians killed in an al-Shabaab attack along a city street.
11567,30/5/2009,Iraq,Baqubah,1,0,1,A 6-year-old boy is murdered by al-Qaeda gunmen.
11568,31/5/2009,Pakistan,Hangu,1,0,1,Fundamentalists barge into a school and kill a guard.
11569,31/5/2009,India,Kashmir,3,1,4,"Muslim terrorists shoot three people to death in separate attacks, including one at a bus stop."
11570,31/5/2009,Iraq,Kirkuk,1,0,1,A woman is gunned down by suspected Islamists.
11571,31/5/2009,Iraq,Mosul,1,2,3,A sports reporter is murdered in a terror bombing.
11572,31/5/2009,Iraq,Samarrah,4,2,6,Mujahideen take out four police with a roadside bomb.
11573,31/5/2009,Afghanistan,Nabi Popal,4,0,4,Four local security personnel are ambushed and machine-gunned to death by Talibanis.
11574,1/6/2009,Mali,Anderamboukane,1,0,1,A British man attending an African music festival is kidnapped and beheaded by al-Qaeda.
11575,1/6/2009,USA,"Little Rock, AR",1,1,2,A Muslim with 'religious motives' guns down a local soldier in a drive-by attack.
11576,1/6/2009,Somalia,Mogadishu,7,20,27,Holy warriors take down seven Somalis in two attacks.
11577,1/6/2009,Pakistan,Kohat,4,13,17,Four people are blown to bits by Jihadi bombers at a bus stand.
11578,1/6/2009,Iran,Zahedan,5,0,5,Five people are killed in an arson attack aimed at stirring up sectarian tensions.
11579,1/6/2009,Iraq,Mosul,1,12,13,A child is murdered when Sunni insurgents throw a grenade into the street.
11580,1/6/2009,Iraq,Baghdad,4,15,19,Four innocents are blown apart by bombing at a marketplace.
11581,2/6/2009,Afghanistan,Paktia,8,0,8,Eight local security guards are murdered by roadside bombers.
11582,2/6/2009,Somalia,Mogadishu,3,20,23,Three civilians are shot to death by al-Shabaab militants.
11583,2/6/2009,Pakistan,Dera Ismail Khan,2,0,2,Two men are murdered by sectarian Jihadis in a drive-by attack.
11584,2/6/2009,Pakistan,Chaman,2,0,2,A raid by suspected Islamists on a NATO depot leaves two local guards dead.
11585,2/6/2009,Afghanistan,Bagram,6,0,6,Two children are among six members of a family are annihilated by a Shahid suicide bomber.
11586,2/6/2009,Thailand,Narathiwat,1,0,1,A Buddhist scrap dealer is cut down by Mujahid gunmen.
11587,2/6/2009,Thailand,Narathiwat,1,0,1,A man is shot to death by Islamists while sitting in a tea shop.
11588,2/6/2009,Thailand,Narathiwat,2,3,5,Two Buddhist women are brutally murdered by Muslims while riding to work in a pickup truck.
11589,2/6/2009,Iran,Zahedan,1,2,3,"Sunni terrorists open fire on a passenger bus, killing one."
11590,3/6/2009,Philippines,Maguindanao,2,4,6,A woman is among two people killed in a Moro Islamist bomb blast.
11591,3/6/2009,Somalia,Mogadishu,2,7,9,Two African peacekeepers are murdered by Islamic radicals.
11592,3/6/2009,Algeria,Timezrit,10,0,10,Two teachers are among ten people butchered at point-blank range by armed fundamentalists.
11593,3/6/2009,Afghanistan,Spin Boldak,5,0,5,"A Shahid martyr blows himself up next to a convoy, killing five Afghans."
11594,3/6/2009,Ingushetia,Nazran,1,1,2,Suspected Islamic militants kill a police officer and injure his wife with a car bomb.
11595,3/6/2009,India,Shopian,1,0,1,A teenaged girl is shot to death inside her home by Islamic terrorists.
11596,3/6/2009,Iraq,Baghdad,9,31,40,Nine patrons of a cafe are blown to bits by Mujahid bombers while watching a televised soccer match.
11597,3/6/2009,Afghanistan,Wardak,1,0,1,A political candidate is kidnapped by Sunni fundamentalists and murdered.
11598,4/6/2009,Afghanistan,Kandahar,4,0,4,Four farmers are blown to bits when Talibanis attach a bomb to their vehicle.
11599,5/6/2009,Pakistan,Upper Dir,49,41,90,"A suicide bomber manages to infiltrate a rival mosque and massacre fifty worshippers, including a dozen children."
11600,5/6/2009,Dagestan,Dagestan,2,0,2,Two government officials are machine-gunned at point-blank range.
11601,5/6/2009,Thailand,Pattani,5,0,5,Three civilians and two rangers are murdered in four attacks by Islamic terrorists.
11602,5/6/2009,India,Pulwama,1,0,1,A 56-year-old man is shot to death inside his home by Mujahideen.
11603,5/6/2009,Pakistan,South Waziristan,5,4,9,Five security personnel are killed by Islamic fundamentalists in two IED attacks.
11604,5/6/2009,Iraq,Jalawla,1,0,1,A local policeman is kidnapped and murdered by Muslim militants.
11605,6/6/2009,Pakistan,Islamabad,2,4,6,Two local cops are taken down by a Shahid suicide bomber.
11606,6/6/2009,Iraq,Suwayra,9,15,24,A man and his wife are among nine people blown up in the name of Allah in various attacks.
11607,6/6/2009,Afghanistan,Spin Boldak,5,11,16,Five people are blown to bits by a Fedayeen bomber at a market.
11608,7/6/2009,Pakistan,Peshawar,3,5,8,Three people are killed when Taliban militants attack a convoy carrying prisoners.
11609,7/6/2009,Iraq,Mosul,2,0,2,Two hospital guards are kidnapped and murdered.
11610,7/6/2009,Somalia,Mogadishu,1,1,2,A radio station director is shot in the head by suspected fundamentalists.
11611,7/6/2009,Afghanistan,Kandahar,2,0,2,Mujahideen manage to kill a mother and son with a landmine.
11612,7/6/2009,Afghanistan,Faryab,4,0,4,Taliban ambush a police post and murder four local officers.
11613,7/6/2009,Thailand,Narathiwat,1,19,20,A storekeeper is blasted to death by Muslim truck bombers.
11614,7/6/2009,Thailand,Narathiwat,2,0,2,Islamic militants gun down two village defense volunteers in cold blood.
11615,7/6/2009,Somalia,Mogadishu,3,5,8,Islamists kill three civilians with a roadside bomb.
11616,7/6/2009,Algeria,Kabylia,3,1,4,Three security personnel are killed in two bombings by fundamentalists.
11617,7/6/2009,Pakistan,Dera Ismail Khan,3,9,12,Two Shias are killed in a Sunni drive-by.  A Sunni is killed in a Shia grenade attack.
11618,8/6/2009,Bangladesh,Boalia,0,3,3,"Three Christians, including a pastor, are pulled from their church and tortured for their faith with burning cigarettes and wooden clubs."
11619,8/6/2009,Pakistan,Tiasar,1,0,1,An 11-year-old boy is shot in the head when the Taliban attack his church.
11620,8/6/2009,Pakistan,Peshawar,1,2,3,Seminary students are suspected in the bombing of a police van that killed one officer.
11621,8/6/2009,Iraq,Baghdad,7,21,28,Seven passengers aboard a minibus are blown to Allah by a planted bomb.
11622,8/6/2009,Iraq,Mosul,2,0,2,Two students are gunned down in separate attacks.
11623,8/6/2009,Thailand,Narathiwat,1,0,1,Islamists gun down a rubber tapper.
11624,8/6/2009,Pakistan,Swat,2,2,4,"Religious extremists attack a home, kill a guard, then kidnap a man, whom they later murder."
11625,9/6/2009,Pakistan,Peshawar,17,52,69,"Shahid car bombers attack a hotel, killing seventeen people in the suicide blast."
11626,9/6/2009,Afghanistan,Asadabad,1,54,55,A child dies from shrapnel injuries when religious extremists toss a grenade into a crowd.
11627,10/6/2009,Ingushetia,Nazran,1,5,6,Muslim gunman stage a daring ambush outside a kindergarten that leaves a woman dead and a baby among the injured.
11628,10/6/2009,Pal. Auth.,Deir el-Balah,1,0,1,A girl is murdered by her father in an 'honor killing.'
11629,10/6/2009,Iraq,Bathaa,30,70,100,Thirty Shiites at an outdoor food market are massacred by Sunni car bombers.  Children are among the dead.
11630,10/6/2009,Thailand,Pattani,1,2,3,A 43-year-old Buddhist man is murdered by Muslim gunmen.
11631,11/6/2009,Turkey,Afyon,1,0,1,A 19-year-old woman is tortured and beaten to death by her suitor and his family for refusing a marriage proposal.
11632,11/6/2009,Thailand,Narathiwat,2,0,2,A Buddhist man and his pregnant wife are brutally shot to death by Islamic terrorists.
11633,11/6/2009,Thailand,Narathiwat,1,0,1,"Muslim gunmen open fire from a pickup truck, killing a civilian walking to work."
11634,11/6/2009,Iraq,Hamrin,1,2,3,A child is killed and two others injured by Mujahid bombers.
11635,11/6/2009,Mali,Timbuktu,1,0,1,An anti-terror official is assassinated in his home by al-Qaeda.
11636,11/6/2009,Pakistan,Peshawar,1,14,15,A civilian is murdered by a Fedayeen suicide bomber.
11637,11/6/2009,Iraq,Hawija,3,9,12,Sunni radicals kill three Iraqis with a planted bomb.
11638,12/6/2009,Pal. Auth.,Hajah,1,0,1,A 15-year-old boy is hung by his family on a (false) suspicion of being an Israeli informant.
11639,12/6/2009,Pakistan,Hangu,4,6,10,Islamists use a homemade bomb to kill four local police.
11640,12/6/2009,Iraq,Balad Ruz,1,1,2,A 17-year-old girl is shot to death in her home by Sunni terrorists.
11641,12/6/2009,Iraq,Baghdad,6,12,18,A lawmaker is among six people murdered by a teenage Fedayeen.
11642,12/6/2009,Pakistan,Nowshera,5,105,110,A Shahid suicide car bomber takes out five people at a mosque.
11643,12/6/2009,Thailand,Yala,1,1,2,A Buddhist monk is shot to death by Islamists while begging for alms.
11644,12/6/2009,Pakistan,Lahore,7,7,14,A moderate cleric is targeted by a suicide bomber outside his mosque.  Six others also die.
11645,12/6/2009,Thailand,Yala,2,0,2,A woman is among two people killed by Muslim militants in separate attacks.
11646,12/6/2009,Philippines,Kidapawan,1,2,3,"Moro Islamists attack a local jail, killing one of the guards."
11647,13/6/2009,Iraq,Baiji,1,7,8,Sunni bombers manage to kill a young girl traveling with her family.
11648,13/6/2009,Philippines,Parang,6,10,16,Six local troops are killed in an Abu Sayyaf ambush.
11649,13/6/2009,Thailand,Narathiwat,1,1,2,A female nursery teacher is shot to death by Islamic radicals.
11650,13/6/2009,Afghanistan,Helmand,8,21,29,Eight delivery drivers are killed when a Shahid suicide bomber detonates in a convoy.
11651,13/6/2009,Afghanistan,Paktia,4,2,6,Three construction workers and one other civilian are murdered in two Taliban attacks.
11652,13/6/2009,Thailand,Yala,2,0,2,"Two Buddhist villagers, a husband and wife, are gunned down by Mujahideen in cold blood."
11653,13/6/2009,Thailand,Yala,1,12,13,"Dedicated Muslims throw a grenade into a bus packed with Buddhists, killing at least one."
11654,13/6/2009,Ingushetia,Nazran,1,0,1,Islamic terrorists machine-gun a former government official to death.
11655,13/6/2009,Afghanistan,Farah,2,0,2,Religious extremists murder a woman and her husband as they are traveling to her hospital.
11656,13/6/2009,India,Poonch,2,2,4,Two boys are blown apart by a Mujahid landmine.
11657,13/6/2009,Pakistan,Kohat,2,6,8,Two people are killed by Islamic bombers.
11658,13/6/2009,Pakistan,Bahawalpur,0,10,10,Ten Christians are injured by a Muslim package bomb.
11659,14/6/2009,Belgium,Brussels,1,0,1,A 32-year-old woman is murdered by her brothers for refusing to wear the veil.
11660,14/6/2009,India,Srinagar,1,0,1,Hizb-ul-Mujahideen members shoot a man to death inside his home.
11661,14/6/2009,Pakistan,South Waziristan,3,2,5,Three people are blown to bits by Taliban bombers.
11662,14/6/2009,Iraq,Mandali,6,0,6,al-Qaeda militants machine-gun six Iraqis to death as they are sitting on a minibus.
11663,14/6/2009,Pakistan,Dera Ismail Khan,9,36,45,Nine people are incinerated by a Taliban bomb at a marketplace.
11664,15/6/2009,Pakistan,Mardan,2,3,5,Taliban militants gun down two local cops.
11665,15/6/2009,Pakistan,Swat,2,0,2,"The bodies of two men, kidnapped earlier by Sunni fundamentalists, are found."
11666,15/6/2009,Iraq,Baghdad,6,25,31,Six Iraqis are killed in various terror attacks.
11667,15/6/2009,Thailand,Yala,1,0,1,Islamists behead a Buddhist laborer outside a plantation.
11668,15/6/2009,Yemen,Sanaa,9,0,9,Women and children are among nine foreign missionaries kidnapped and executed by Shiite fundamentalists.
11669,15/6/2009,Thailand,Pattani,1,0,1,A Buddhist janitor is shot to death on his way to work by Muslim militants
11670,15/6/2009,Iran,Tehran,7,12,19,"Basij Islamic hardliners open fire on demonstrators, killing seven."
11671,15/6/2009,Philippines,Maguindanao,1,3,4,A civilian is murdered in a Moro Islamist ambush.
11672,16/6/2009,Pakistan,Peshawar,1,1,2,Islamic terrorists kill a police officer by tossing a grenade at his vehicle.
11673,16/6/2009,Iraq,Kirkuk,2,5,7,A storeowner stabbed inside his shop is among two people killed in separate attacks.
11674,16/6/2009,Pakistan,Shahdadkot,3,0,3,A woman and a 3-year-old child are among three people gunned down in an honor killing over illicit sex.  The killers were led by an imam.
11675,16/6/2009,Thailand,Yala,1,0,1,A 56-year-old female Buddhist teacher is gunned down by Muslim militants as she is riding to work.
11676,16/6/2009,Thailand,Pattani,2,2,4,Two policemen are blown up in a Mujahideen bombing.
11677,16/6/2009,Somalia,Galgalato,6,0,6,Six people are killed in an al-Shabaab attack.
11678,16/6/2009,Somalia,Mogadishu,1,0,1,An Islamist sniper nails the chief of police from a rooftop.
11679,16/6/2009,Pakistan,Kurram,3,0,3,Three people are killed in a Religion of Peace sectarian clash.
11680,17/6/2009,Somalia,Mogadishu,1,1,2,Islamists kill an African peacekeeper in an IED attack.
11681,17/6/2009,Pakistan,Mohmand,4,9,13,Three women are among four who die from shrapnel injuries following a mortar attack by hardliners.
11682,17/6/2009,India,Sopore,1,0,1,Mujahideen shoot a 50-year-old woman to death inside her home.
11683,17/6/2009,Somalia,Mogadishu,9,48,57,Five children are among nine civilians killed by mortar fire during an offensive by Muslim militants.
11684,17/6/2009,Algeria,El Mehir,23,5,28,"Holy Warriors stage a brutal ambush on a group of policemen escorting a road construction crew, machine-gunning about two dozen to death."
11685,17/6/2009,Afghanistan,Helmand,3,0,3,Islamic bombers murder three Danish peacekeepers in a roadside attack.
11686,17/6/2009,Afghanistan,Khost,2,2,4,Two Afghan soldiers are killed in a Taliban ambush.
11687,18/6/2009,Thailand,Yala,2,0,2,A teen is among two young men gunned down by Mujahideen while eating at a restaurant.
11688,18/6/2009,Pakistan,Lahore,1,0,1,A 22-year-old woman is strangled by her brother in front of her family on suspicion of unauthorized sex.
11689,18/6/2009,Thailand,Yala,1,0,1,Muslim separatists shoot a 29-year-old civilian to death by the side of the road.
11690,18/6/2009,Afghanistan,Kandahar,2,4,6,A child is among two civilians blown apart by a bomb planted on a motorcycle.
11691,18/6/2009,Pakistan,Mir Ali,2,0,2,Sunni hardliners abduct and murder two locals.
11692,18/6/2009,Somalia,Baladwayne,35,45,80,At least thirty-five people are murdered by a Shahid suicide bomber blast at a hotel.
11693,18/6/2009,Iraq,Mosul,1,0,1,A Christian is gunned down by Muslim gunmen in the process of kidnapping another Christian.
11694,19/6/2009,Pakistan,Ittanwali,0,3,3,"A Christian woman's family is beaten, including two young children, after she refuses to embrace Islam."
11695,19/6/2009,India,Srinagar,1,3,4,"Mujahideen toss a grenade at a tourist bus, killing at least one civilian."
11696,19/6/2009,Iraq,Mosul,3,0,3,The coach of the national karate team is among three Iraqis gunned down by Islamic terrorists.
11697,19/6/2009,India,Krimcha,1,0,1,A Muslim man beheads his daughter to keep her from marrying a man of her choosing.
11698,19/6/2009,Afghanistan,Kandahar,1,1,2,Religious extremists enter a school and behead one student.
11699,20/6/2009,Philippines,Mindanao,3,32,35,"Muslim militants hurl a grenade into a town festival, killing three celebrants."
11700,20/6/2009,India,Anantnag,1,0,1,Mujahideen invade a home and slit a woman's throat.
11701,20/6/2009,Iraq,Ramadi,1,6,7,A child is killed when Sunni militants rocket a home.
11702,20/6/2009,Iraq,Fallujah,4,0,4,A female Fedayeen bomber murders four Iraqis.
11703,20/6/2009,Iran,Tehran,13,50,63,"Islamic militias and police kill another thirteen Iranian demonstrators, including a young girl."
11704,20/6/2009,Iraq,Taza,80,211,291,"Women and children are abundant among the dead and dismembered as dedicated Sunni detonate a truck bomb outside a Shia mosque, killing at least eighty."
11705,20/6/2009,Chechnya,Grozny,1,0,1,Authorities arrest a young man for shooting his sister to death over 'immoral behavior'.
11706,21/6/2009,Egypt,El-Fashn,0,22,22,"A Muslim mob assaults a Christian church, smashing and slashing until at least twenty-two worshippers lay injured."
11707,21/6/2009,Afghanistan,Samangan,2,0,2,An 18-year-old girl and her lover are stabbed over fifty times apiece by her father in an honor attack.
11708,21/6/2009,Afghanistan,Bagram,2,6,8,"Hard-line fundamentalists fire on an air field, killing at least two Americans."
11709,21/6/2009,Iraq,Baghdad,2,0,2,"The bodies of two British hostages, held two years before being murdered, are recovered."
11710,21/6/2009,Iraq,Baghdad,2,13,15,Two civilians are killed when Muslim terrorists bomb a cafe.
11711,21/6/2009,Iraq,Baghdad,8,1,9,Jihadi gunmen are able to murder eight local cops in multiple attacks.
11712,22/6/2009,Pakistan,Bannu,3,1,4,Two women are among three killed when Islamic radicals fire a rocket into a home.
11713,22/6/2009,Pakistan,Quetta,3,0,3,Three Shias are gunned down in a sectarian drive-by shooting.
11714,22/6/2009,Iraq,Mosul,3,0,3,A woman shot to death in her home by Mujahideen is among three civilians killed.
11715,22/6/2009,Iraq,Husseiniyah,5,19,24,"Holy Warriors bomb a marketplace, killing five patrons."
11716,22/6/2009,Iraq,Baghdad,22,79,101,"Twenty-two people are blown to bits in four separate Jihad bombings, including an attack on a school bus."
11717,22/6/2009,Ingushetia,Magas,2,3,5,"Two people are killed during a Fedayeen car bomb assassination attempt on the president of the republic, who is seriously injured."
11718,22/6/2009,Thailand,Narathiwat,0,8,8,Eight people are injured when Islamists open fire on a Buddhist temple.
11719,22/6/2009,Pakistan,Battagram,2,7,9,A Shahid suicide bomber take out two local police.
11720,22/6/2009,Algeria,Khenchela,5,1,6,Armed fundamentalists machine-gun five police officers at point-blank range.
11721,22/6/2009,Philippines,Maguindanao,1,4,5,Moro Islamists storm a village and shoot a 15-year-old Christian boy dead.
11722,23/6/2009,Mauritania,Nouakchott,1,0,1,An young American aid worker is murdered by al-Qaeda gunmen.
11723,23/6/2009,Pakistan,Quetta,1,0,1,A college principal is gunned down in a sectarian drive-by attack as he is walking home.
11724,23/6/2009,Somalia,Jowhar,2,4,6,A mother traveling with her two young children is among those machine-gunned to death on a bus by al-Shabaab militants.
11725,23/6/2009,Afghanistan,Jowzjan,3,0,3,Sunni bombers take out three UN aid workers in a roadside attack.
11726,23/6/2009,Afghanistan,Ghazni,2,0,2,Two civilians are murdered by a Shahid suicide bomber.
11727,23/6/2009,Chechnya,Grozny,2,0,2,Islamic insurgents kill two people with a roadside blast.
11728,23/6/2009,Pakistan,Khyber,1,1,2,"Sunni hardliners open fire on a pair of village guards, killing one."
11729,23/6/2009,Pakistan,Dera Ismail Khan,1,0,1,A Taliban leader criticizes a recent attack on civilians and is quickly gunned down.
11730,23/6/2009,Afghanistan,Zabul,2,0,2,Two Afghan intelligence agents are murdered by Taliban terrorists.
11731,23/6/2009,Iraq,Ludhiana,1,0,1,A pregnant woman is stabbed to death by her uncle in an honor killing.
11732,24/6/2009,Algeria,Setif,1,0,1,A man stabs his daughter to death across the street from a mosque.  She was disobedient.
11733,24/6/2009,Pakistan,Bajaur,1,4,5,"Sunni militants fire a missile into a bazaar, killing one patron."
11734,24/6/2009,Pakistan,Peshawar,3,0,3,Three local police are blasted to death when radicals shoot a rocket into their post.
11735,24/6/2009,Iraq,Baghdad,1,10,11,A young man is killed in a sectarian bombing in a residential neighborhood.
11736,24/6/2009,Iraq,Mosul,2,9,11,Two people are killed in separate Jihad bombings.
11737,24/6/2009,Iraq,Baghdad,69,135,204,At least sixty people are blown to bits when Islamists bomb a packed outdoor pet market full of women and children.
11738,24/6/2009,Ingushetia,Karabulak,1,0,1,Muslim rebels machine-gun a local soldier to death in a drive-by.
11739,24/6/2009,Germany,Schweinfurt,1,0,1,A 15-year-old girl is stabbed to death by her father over her Western lifestyle.
11740,24/6/2009,Afghanistan,Helmand,7,4,11,Seven civilians die when Islamists bomb their minibus.
11741,25/6/2009,Pakistan,Buner,1,0,1,"Religious radicals kidnap a policeman, then riddle his body with bullets."
11742,25/6/2009,Iraq,Baghdad,7,31,38,Islamic bombers kill seven Iraqis at a bus station.
11743,25/6/2009,Iraq,Mosul,1,0,1,Terrorists murder a 16-year-old boy.
11744,25/6/2009,Somalia,Shabelle,5,13,18,Five people are killed during an al-Shabaab attack.
11745,26/6/2009,Pakistan,North Waziristan,4,24,28,Four Pakistanis are killed in a remote-controlled Taliban bomb attack.
11746,26/6/2009,Iraq,Baghdad,19,50,69,Holy Warriors detonate a bomb packed with nails to maximize casualties at a crowded bazaar.  Nineteen are killed.
11747,26/6/2009,Afghanistan,Khost,1,5,6,An English interpreter dies from shrapnel injuries suffered during a roadside blast.
11748,26/6/2009,Pakistan,Muzaffarabad,2,3,5,A Shahid suicide bomber takes down two local soldiers along a highway.
11749,27/6/2009,Bangladesh,Shariatpur,1,0,1,Muslims rape and kill a Hindu woman.
11750,27/6/2009,Afghanistan,Kunar,2,0,2,Two locals are blown apart by a well-placed Islamic bomb.
11751,27/6/2009,Afghanistan,Khost,1,0,1,Taliban bombers kill a civilian with a car bomb.
11752,27/6/2009,Iraq,Baghdad,1,4,5,A civilian is murdered when Islamists plant a bomb on a motorcycle.
11753,27/6/2009,Philippines,Tacurong,0,9,9,Nine people at a bus terminal suffer shrapnel injuries from an Islamic bomb.
11754,27/6/2009,Afghanistan,Helmand,8,0,8,Religious radicals storm a police post and shoot eight local officers to death.
11755,27/6/2009,India,Rajouri,2,0,2,Muslim terrorists gun down a young couple.
11756,27/6/2009,Sudan,Hashaba,8,20,28,"The Islamic Republic stages air strikes on a village, killing eight residents."
11757,27/6/2009,Philippines,Tipo Tipo,2,0,2,Two unarmed engineers are murdered by Moro Islamist gunmen.
11758,28/6/2009,Philippines,Sumisip,7,2,9,Abu Sayyaf militants ambush a police vehicle and shoot seven officers to death.
11759,28/6/2009,Somalia,Mogadisu,5,14,19,Five Somalis are killed during an attack on the presidential palace.
11760,28/6/2009,Pakistan,Charsadda,5,0,5,'Deeply conservative' Muslims shoot a young couple to death for eloping without permission - along with a few other family members.
11761,28/6/2009,Pakistan,Waziristan,22,35,57,Twenty-two local troops are killed in two brutal ambushes by Muslim extremists.
11762,28/6/2009,Iraq,Mosul,2,0,2,Two civilians are murdered by Sunni gunmen.
11763,28/6/2009,Iraq,Hamrin Dam,1,3,4,"Islamists bomb a family vehicle, killing one member and injuring three."
11764,28/6/2009,Thailand,Narathiwat,1,0,1,A female Buddhist teacher is murdered by two Muslim gunmen on a motorcycle.
11765,29/6/2009,Belgium,Brussels,1,0,1,"A woman is found dead, the victim of an honor killing by her husband and brother-in-law for seeking a divorce."
11766,29/6/2009,Iraq,Hamdaniya,9,10,19,A 5-year-old child is among nine Iraqis killed by Islamic bombers.
11767,29/6/2009,Thailand,Narathiwat,2,0,2,Two young men are gunned down by Islamic terrorists by the side of the road.
11768,29/6/2009,Philippines,Maguindanao,1,14,15,A Muslim extremist murders a patron at a coffee shop with a homemade bomb.
11769,29/6/2009,Iran,Mashhad,6,0,6,Six political activists are hanged.
11770,30/6/2009,Iraq,Shurqat,2,0,2,Jihadis shoot two people riding in a civilian vehicle.
11771,30/6/2009,Thailand,Pattani,1,0,1,Muslim bombers kill a local soldier on patrol.
11772,30/6/2009,Afghanistan,Torkhum,8,8,16,Four women and two children are among eight people killed by a male suicide bomber disguised in a burka.
11773,30/6/2009,Iraq,Kirkuk,27,80,107,Holy Warriors blow up over two dozen Iraqi civilians at an outdoor market.
11774,30/6/2009,Somalia,Mogadishu,2,5,7,"al-Shabaab militants toss a hand grenade into the street, killing two people."
11775,30/6/2009,Pakistan,Hajika,4,11,15,Four people are killed in a car bombing outside a hotel.
11776,30/6/2009,Canada,"Kingston Mills, ON",4,0,4,Three teenage girls and a 50-year-old woman are murdered by their family in an 'honor killing.'
11777,1/7/2009,Pakistan,Faisalabad,0,1,1,A young Christian is brutally tortured by a Muslim mob on charges of desecrating a Qur'an.
11778,1/7/2009,Pakistan,Nowshera,2,3,5,Two civilians are blown apart in a Sunni rocket attack on a home.
11779,1/7/2009,Pakistan,Dera Ismail Khan,1,1,2,A civilian is killed in a Taliban bombing.
11780,1/7/2009,Pakistan,Jamrud,2,0,2,"Religious extremists ambush two men in a vehicle, shooting both to death."
11781,1/7/2009,Iraq,Baquba,1,3,4,An Iraqi is killed in a Jihad bomb attack.
11782,1/7/2009,Pakistan,Ghaziabad,1,0,1,A 16-year-old Christian boy is tortured to death in a police station.
11783,1/7/2009,Pakistan,Lashkar,2,4,6,Two villagers are cut down by militant Muslims in an automatic weapons attack.
11784,1/7/2009,Pakistan,Hangu,1,9,10,A local police officer is killed in a Taliban ambush.
11785,1/7/2009,Pakistan,Lahore,0,15,15,Fifteen Christian women and children are burned when a Muslim mob throws acid on them.
11786,2/7/2009,England,London,0,1,1,"A 24-year-old man is blinded, suffers the loss of his tongue and 90% burns during an 'honor' attack in which he was forced to drink acid and had it thrown on him by angry Muslims."
11787,2/7/2009,Saudi Arabia,Riyadh,2,0,2,Two sisters are shot to death outside a women's shelter by their brother after being accused of 'illicit relations.'
11788,2/7/2009,Pakistan,Dera Ismail Khan,2,6,8,"Suspected Islamists toss a grenade into a shop, killing two people."
11789,2/7/2009,Pakistan,Peshawar,2,2,4,Two local police are killed in a remote-controlled bomb attack by Talibanis.
11790,2/7/2009,Iraq,Baghdad,4,31,35,Four Iraqis are blown apart by a series of Jihad bomb blasts.
11791,2/7/2009,Pakistan,Chacho Wali,2,0,2,A young couple is shot to death in for marrying against their family's will.
11792,2/7/2009,Pal. Auth.,Gaza,1,0,1,A Palestinian girl is killed from an errant Hamas mortar shell intended for Israelis.
11793,3/7/2009,Ethiopia,Dessie,2,0,2,Two Christians are shot to death by Muslim gunmen while working on a church.
11794,3/7/2009,India,Kishtwar,2,1,3,Hizb-ul-Mujahideen militants slit the throat of one individual and shot another to death.
11795,4/7/2009,Mali,Tessalit,24,3,27,"al-Qaeda militants ambush a group of local soldiers, killing some on the spot and then executing others taken hostage."
11796,4/7/2009,Iraq,Yusufiya,1,12,13,One person is killed when Jihadis bomb a vegetable market.
11797,4/7/2009,Iraq,Mosul,4,0,4,Two brothers are among four people shot to death in separate terror attacks.
11798,4/7/2009,Ingushetia,Nazran,9,9,18,"A brutal, well-planned ambush by Mujahideen leaves nine police officers dead."
11799,4/7/2009,Somalia,Mogadishu,23,50,73,Twenty-three civilian bystanders are killed during an attack by al-Shabaab militants on government troops.
11800,4/7/2009,Pakistan,Dera Ismail Khan,1,0,1,A local trader is gunned down by sectarian rivals.
11801,4/7/2009,Pakistan,Mohmand,12,0,12,"Islamic radicals ambush a group of tribesmen, killing at least a dozen."
11802,4/7/2009,Somalia,Mogadishu,1,0,1,"Islamists shoot a 22-year-old journalist in the stomach, then shoot at those trying to help so that he eventually bleeds to death."
11803,5/7/2009,Saudi Arabia,Riyadh,2,0,2,A brother shoots his two young sisters to death for 'mixing with unrelated men.'
11804,5/7/2009,Pakistan,Mohmand,2,0,2,"Two tribesmen are kidnapped by Sunni hardliners, then murdered by having their throats slit."
11805,5/7/2009,Pakistan,Lahore,1,0,1,A man is gunned down in the name of honor by his new wife's son.
11806,5/7/2009,Philippines,Cotabato,6,44,50,A Religion of Peace nail bomb outside a Christian church leaves at least six innocents dead.
11807,6/7/2009,Pakistan,Dera Ismail Khan,5,2,7,Five Shias and Sunnis are killed in three separate sectarian attacks.
11808,6/7/2009,Iraq,Mosul,1,12,13,"Two policemen are stabbed to death by Muslim terrorists, who also murder a teenager in a separate bombing."
11809,6/7/2009,Iraq,Baghdad,5,0,5,Mujahideen gunmen take down five Iraqis at a checkpoint.
11810,7/7/2009,Pakistan,Lahore,0,1,1,"A Christian man is crippled by a Muslim, who shoots him eight times in the legs for refusing to pay Jizya."
11811,7/7/2009,Thailand,Pattani,1,0,1,A 40-year-old Buddhist man is shot to death by Muslim radicals while shopping at a grocery.
11812,7/7/2009,Thailand,Narathiwat,2,0,2,Two teenagers riding a motorbike are taken out by Religion of Peace gunmen.
11813,7/7/2009,Pakistan,Khyber,1,0,1,A 55-year-old tribal leader is kidnapped and murdered by Sunni extremists.
11814,7/7/2009,Philippines,Jolo,2,27,29,"Abu Sayyaf militants detonate a bomb outside a second Christian church, killing two innocents."
11815,7/7/2009,Afghanistan,Khost,1,28,29,"Religious extremists throw a grenade into the street, killing one civilian and injuring children."
11816,7/7/2009,Afghanistan,Nuristan,8,8,16,"Armed fundamentalists storm a police post, killing eight local officers."
11817,7/7/2009,Pakistan,Peshawar,2,3,5,Taliban assassins take down two civilians in separate attacks.
11818,7/7/2009,Iraq,Mosul,4,0,4,A father and son are among four Iraqis gunned down by Mujahideen.
11819,8/7/2009,India,Kulgam,1,1,2,A shepherd and a 13-year-old boy are shot point-blank by Islamic terrorists.  The boy survives with critical injuries.
11820,8/7/2009,Ingushetia,Nazran,1,0,1,"Muslim militants open fire on a government vehicle, killing a guard."
11821,8/7/2009,Pakistan,Peshawar,1,4,5,A female suicide bomber manages to kill one other person.
11822,8/7/2009,Iraq,Musayyib,2,18,20,"Mujahideen attempt to blow up a wedding, killing two of the guests."
11823,8/7/2009,Iraq,Baghdad,2,5,7,A man and his teenage son are taken down by sectarian bombers while tending their garden.
11824,8/7/2009,Iraq,Mosul,15,24,39,"Fifteen people are blown apart by two Jihad bombs, one near a mosque and the other in a commercial district."
11825,8/7/2009,Thailand,Pattani,1,0,1,A villager is gunned down by Muslim terrorists while driving his pickup truck.
11826,9/7/2009,Jordan,Amman,1,0,1,"A second woman is stabbed to death by her brother, who finishes the job with a rock.  Her crime was talking to a man."
11827,9/7/2009,Thailand,Pattani,1,5,6,Islamists kill a local soldier with a roadside bomb.
11828,9/7/2009,Jordan,Amman,1,0,1,A 27-year-old woman is stabbed to death by her younger brother for bringing dishonor to the family by getting pregnant.
11829,9/7/2009,Iraq,Tal Afar,35,61,96,Thirty-five Iraqis are murdered by Fedayeen suicide bombers along a residential street.
11830,9/7/2009,Pakistan,Peshawar,1,3,4,A power company employee dies from shrapnel injuries suffered from a Mujahideen bombing.
11831,9/7/2009,Pakistan,Bannu,2,5,7,The Taliban take out two local soldiers with a roadside bombing.
11832,9/7/2009,Afghanistan,Samangan,2,2,4,Two local policemen are murdered in a Taliban attack on a remote post.
11833,9/7/2009,Iraq,Baghdad,16,66,82,Sixteen  Iraqis are blown to bits in two marketplace bombings.
11834,9/7/2009,Afghanistan,Kabul,25,4,29,More than a dozen children are among twenty-five innocents annihilated in a suicide blast.
11835,9/7/2009,France,Lyon,1,0,1,"A 22-year-old woman is murdered by her 17-year-old ""religious"" brother, angry over a sexual affair."
11836,9/7/2009,Pakistan,Bajaur,4,0,4,Islamic terrorists attack a check post and shoot four security personnel to death.
11837,10/7/2009,Somalia,Baidoa,7,0,7,"al-Shabaab Islamists stage the public beheading of seven people for ""being Christian."""
11838,10/7/2009,China,Urumqi,137,800,937,"Chinese Muslims rampage through Han neighborhoods, murdering one-hundred and forty, including women and children.  A bus full of passengers is set ablaze, women are raped and decapitated heads are strung up on highways."
11839,10/7/2009,Thailand,Pattani,1,0,1,An elderly man is shot to death in a Mujahideen drive-by attack.
11840,11/7/2009,Pakistan,Kohat,3,6,9,Three security personnel are murdered by a Taliban remote-controlled bomb.
11841,11/7/2009,Iraq,Baghdad,4,12,16,Four people are killed when fundamentalists bomb a billiards hall.
11842,11/7/2009,Iraq,Mosul,8,39,47,Eight Iraqis are blown up in a Jihad car bombing.
11843,11/7/2009,Afghanistan,Paktia,18,20,38,"Taliban fundamentalists stage a brutal ambush on a road construction crew, leaving eighteen dead."
11844,11/7/2009,Afghanistan,Ghazni,8,1,9,Four security guards are killed in a Taliban rocket attack.  Another four are cut down by a roadside bomb in Logar.
11845,11/7/2009,Somalia,Mogadishu,1,0,1,A government official is murdered in an ambush by Jihadis.
11846,11/7/2009,Somalia,Mogadishu,3,1,4,Three Ugandan peacekeepers are killed in an al-Shabaab mortar attack.
11847,12/7/2009,Iraq,Kirkuk,1,0,1,A Christian man is pulled from his car and murdered in front of his daughter.
11848,12/7/2009,Iraq,Jurf al-Sakhar,1,0,1,al-Qaeda gunmen murder a civilian.
11849,12/7/2009,Pakistan,Lahore,1,0,1,A 23-year old woman is shot to death by her cousin over unapproved sexual relations.
11850,12/7/2009,Iraq,Baghdad,4,33,37,Four people are killed when Islamists place bombs at four Christian churches.
11851,13/7/2009,Afghanistan,Kabul,4,0,4,Taliban bombers send four local police to Allah.
11852,13/7/2009,Dagestan,Rostov-on-Don,2,5,7,"Islamists open up on a convoy of local troops at point blank range, killing at least two."
11853,13/7/2009,Chechnya,Grozny,1,0,1,Mujahideen kill a policeman with a bomb.
11854,13/7/2009,Pakistan,Multan,12,61,73,Seven children and three women are among twelve killed when a cleric's explosives go off earlier than expected where they are being stored at his Qur'an school.
11855,13/7/2009,Iraq,Fallujah,1,0,1,A boy is kidnapped and tortured to death by terrorists.
11856,14/7/2009,Pakistan,Khyber,2,3,5,"Islamic militants attack an oil tanker, killing two civilians."
11857,14/7/2009,Iraq,Mosul,1,0,1,A woman is murdered in her home by Jihadi gunmen.
11858,14/7/2009,Iraq,Baghdad,2,0,2,Two traffic cops are gunned down by Mujahideen.
11859,15/7/2009,Afghanistan,Ghazni,2,1,3,Two civilians lose their lives to a Taliban bomb hidden on a bicycle.
11860,15/7/2009,Pakistan,Jandola,2,1,3,Two woman are killed and a child injured when Islamic terrorists lob a rocket into a home.
11861,15/7/2009,Pakistan,Bannu,2,6,8,Mujahideen kill two cops with a roadside bomb.
11862,15/7/2009,Iraq,Ramadi,6,25,31,Six Iraqis are blown up when a Shahid suicide bomber drives into a checkpoint.
11863,15/7/2009,Iraq,Baghdad,5,28,33,Jihadi bombers take the lives of five people attending a funeral.
11864,15/7/2009,Thailand,Pattani,2,1,3,Two civilians are shot to death by Muslim radicals in separate attacks.
11865,15/7/2009,Ingushetia,Border,2,0,2,Two innocents are gunned down in their car by Muslim separatists.
11866,15/7/2009,Chechnya,Grozny,1,0,1,A female human rights activist investigating honor killings is kidnapped and brutally murdered.
11867,16/7/2009,Dagestan,Gedzhukh,1,0,1,A government official is assassinated outside his home by suspected Islamists.
11868,16/7/2009,Pakistan,Peshawar,2,0,2,A UN staff member and a guard are shot to death by Sunni militants at a refugee camp.
11869,16/7/2009,Pakistan,Bajaur,1,0,1,A Taliban rocket attack on a home leaves at least one resident dead.
11870,16/7/2009,India,Doda,1,0,1,Islamic militants kidnap and murder a civilian.
11871,16/7/2009,Pakistan,Miranshah,3,4,7,Mujahideen bombers take out three people traveling in a car.
11872,16/7/2009,Pakistan,Karachi,3,0,3,"Three men are killed in separate sectarian attacks, including one who is brutally tortured before being shot."
11873,16/7/2009,Jordan,Amman,1,0,1,A young man stabs his married sister and smashes her head with a rock over 'immoral behavior.'
11874,16/7/2009,Iraq,Basra,3,1,4,An Iranian-backed militia kills three off-duty US soldiers in a mortar attack.
11875,16/7/2009,Thailand,Narathiwat,1,0,1,Islamists gun down a food vendor.
11876,16/7/2009,Thailand,Yala,1,0,1,A 26-year-old man is murdered inside his home by Muslim radicals.
11877,17/7/2009,Iraq,Garma,2,11,13,"Two young girls, ages 6 and 12, are killed in a brutal bombing by Holy Warriors outside their home."
11878,17/7/2009,India,Shopian,1,0,1,A 17-year-old girl is shot to death in her home by Muslim terrorists.
11879,17/7/2009,Thailand,Yala,2,5,7,Two security personnel are murdered in a militant bomb attack.
11880,17/7/2009,Pakistan,Khyber,1,0,1,A shopkeeper dies in a Taliban bombing at a market.
11881,17/7/2009,Iraq,Baghdad,2,9,11,A married couple is blown apart in a Mujahideen bombing.
11882,17/7/2009,Iraq,Kut,1,0,1,A young woman is shot to death in an apparent honor killing.
11883,17/7/2009,Indonesia,Jakarta,9,50,59,Fedayeen suicide bombers carry out attacks on two luxury hotels that leave at least nine dead.
11884,17/7/2009,Afghanistan,Spin Boldak,11,3,14,Five children are among eleven civilians killed when an Islamist bomb rips through their bus.
11885,17/7/2009,Ingushetia,Sredniye Achaluki,2,0,2,"Islamists open fire on a passing vehicle, killing two people."
11886,18/7/2009,Afghanistan,Nangarhar,2,0,2,Two villagers die defending their homes from a Taliban attack.
11887,18/7/2009,Afghanistan,Zabul,3,3,6,Three local soldiers are blown to bits in a Shahid suicide attack.
11888,18/7/2009,Pakistan,Swat,1,0,1,The Taliban behead a government employee in his home.
11889,18/7/2009,Iraq,Fallujah,1,13,14,A child dies from shrapnel injuries suffered from a bomb attack on a soccer game the day before.
11890,18/7/2009,Iraq,Garma,4,8,12,Four Iraqis are taken out by a Jihadi car bomb.
11891,19/7/2009,India,Doda,1,0,1,Hizb-ul-Mujahideen militants gun down a young civilian.
11892,19/7/2009,Thailand,Narathiwat,1,0,1,A shopkeeper is murdered when Islamic radicals fire into his store.
11893,19/7/2009,Thailand,Yala,1,0,1,Mujahideen shoot a plantation worker to death by the side of the road.
11894,19/7/2009,Afghanistan,Kunduz,1,0,1,A politician is murdered by Taliban gunmen.
11895,19/7/2009,Afghanistan,Torkham,2,1,3,A suicide bomber takes out two Afghanis at a police post.
11896,19/7/2009,Yemen,Sanaa,10,0,10,Ten people are killed when Sunnis and Shias clash over control of a local mosque.
11897,20/7/2009,Turkey,Istanbul,1,0,1,A Christian is stabbed shortly after leaving a church by a Muslim who said he just 'wanted to kill a Christian.'
11898,20/7/2009,Germany,Munich,1,0,1,A Muslim man stabs his ex-wife to death 'in the name of the Qur'an' for being in a relationship.
11899,20/7/2009,Somalia,Mogadishu,2,7,9,Two civilians are killed during an ambush by Islamists.
11900,20/7/2009,Thailand,Pattani,1,0,1,A Buddhist man is shot to death by passing Muslims on a motorcycle.
11901,20/7/2009,Somalia,Mahadday Weyne,1,0,1,A father of two is shot to death by Muslims for leaving Islam and becoming a Christian.
11902,20/7/2009,Pakistan,Lahore,2,0,2,A young couple is murdered by the woman's family for marrying against their will.
11903,20/7/2009,Iraq,Peshawar,4,0,4,Four local cops are gunned down in a brutal ambush by Lashkar-e-Islam.
11904,20/7/2009,Iraq,Mosul,2,1,3,A young girl is among two civilians killed by Islamic gunmen.
11905,20/7/2009,Iraq,Ramadi,4,9,13,Jihadis kill four Iraqis with a car bomb.
11906,21/7/2009,Philippines,Cotabato,1,1,2,An elderly woman farmer is shot to death in her field by Moro Islamists.
11907,21/7/2009,Pal. Auth.,Gaza,0,50,50,About fifty Fatah supporters at a wedding are injured when Hamas operatives detonate a bomb during the reception.
11908,21/7/2009,Dagestan,Khasavyurt,1,0,1,A man is shot to death by Muslim gunmen while sitting in a cafe.
11909,21/7/2009,Iraq,Baghdad,18,113,131,Sunni extremists murder eighteen Iraqis in coordinated bombings around four cities.  The dead include women and children.
11910,21/7/2009,India,Shopian,1,3,4,"Lashkar-e-Toiba militants throw a grenade a group of police, killing one."
11911,21/7/2009,Afghanistan,Paktia,3,4,7,Women and children are among the casualties when suicide bombers dressed as women stage an attack.
11912,21/7/2009,Yemen,Saada,1,2,3,Shiite rebels shoot a security personnel member to death.
11913,22/7/2009,Afghanistan,Kunduz,11,0,11,Four children are among eleven killed in a Taliban rocket attack.
11914,22/7/2009,Iraq,Diyala,5,35,40,Five Shia pilgrims are killed when Sunni gunmen open fire on their bus at close range.
11915,22/7/2009,Thailand,Yala,1,0,1,Islamists gun down a 41-year-old rubber farmer by the side of the road.
11916,23/7/2009,Eritrea,Mitire,1,0,1,A 43-year-old man dies from torture after refusing to renounce his Christian faith.
11917,23/7/2009,Pal. Auth.,Jabalya,1,0,1,A man tortures and kills his daughter after finding her talking on a cell phone and suspected an illicit relation.
11918,23/7/2009,Pakistan,Lahore,1,0,1,A 21-year-old girl is burned to death by her in-laws in an honor killing.
11919,23/7/2009,Yemen,Saada,7,3,10,Shiite extremists ambush and kill seven local soldiers.
11920,23/7/2009,India,Shopian,2,0,2,Islamic terrorists burst into a home and murder a 3-year-old boy and his father.
11921,23/7/2009,Pakistan,Quetta,1,0,1,A school principal is gunned down in a targeted sectarian attack.
11922,23/7/2009,Iraq,Kirkuk,2,5,7,Jihadis end the lives of two civilians with separate roadside bombs.
11923,23/7/2009,Thailand,Pattani,1,0,1,A villager is shot to death outside a store by drive-by Muslim radicals.
11924,23/7/2009,Somalia,Mogadishu,15,55,70,Fifteen civilians are killed during a late evening attack by al-Shabaab and Hizb al-Islam terrorists.
11925,23/7/2009,Philippines,Basilan,3,0,3,A 1-year-old child is among three people gunned down in an Abu Sayyaf drive-by shooting.
11926,24/7/2009,Afghanistan,Khost,0,14,14,Seven remarkably inefficient suicide bombers manage to kill no one but themselves.
11927,24/7/2009,Pakistan,Quetta,1,0,1,A university professor is shot to death in a sectarian attack.
11928,24/7/2009,Iraq,Tal Afar,4,0,4,Four Iraqis are kidnapped and murdered execution-style by suspected al-Qaeda.
11929,25/7/2009,Bangladesh,Charsindhu,0,5,5,A Muslim mob attacks Hindu homes and ransacks a temple.  Five people are injured.
11930,25/7/2009,Pakistan,North Waziristan,1,0,1,A civilian is abducted and beheaded by Sunni radicals.
11931,25/7/2009,Iraq,Fallujah,5,21,26,Five civilians are taken out by a Mujahideen car bombing.
11932,26/7/2009,Chechnya,Grozny,6,10,16,A suicide bomber detonates as he is stopped from entering a concert hall.  At least six innocents die in the blast.
11933,26/7/2009,Afghanistan,Nangarhar,2,0,2,Two road workers are murdered by Taliban bombers.
11934,26/7/2009,Afghanistan,Helmand,3,2,5,A Taliban roadside bomb leave three security guards dead.
11935,26/7/2009,Iraq,Ninewa,1,0,1,A Christian worker is murdered at a Pepsi plant by Islamic gunmen.
11936,26/7/2009,Pakistan,North Waziristan,3,0,3,Three civilians are kidnapped and beheaded by religious extremists.
11937,26/7/2009,Iraq,Khaldiyah,5,12,17,A suicide bomber kills five people trying to stop him from entering a funeral.
11938,26/7/2009,Iraq,Baghdad,4,0,4,Four people are gunned down at a checkpoint by Jihadis.
11939,27/7/2009,Pakistan,Faisalabad,0,1,1,A Hindu human rights lawyer is shot twice by Islamic fundamentalists outside his home.
11940,27/7/2009,Somalia,Merca,4,0,4,Four Christian orphanage workers are beheaded by Islamists after declining the offer to return to Islam.
11941,27/7/2009,Pakistan,Mansehra,1,2,3,"Fundamentalists bomb a shop selling music and DVDs, killing a patron."
11942,27/7/2009,Nigeria,Bauchi,5,12,17,At least three policemen and two civilians are killed during a series of attacks by Boko Haram Islamists.
11943,27/7/2009,Somalia,Mogadishu,6,20,26,Six civilians are killed as a result of an attack on government troops by al-Shabaab militants at a market.
11944,27/7/2009,Thailand,Pattani,1,0,1,A suspected Islamist guns down a man at a wedding.
11945,27/7/2009,Thailand,Pattani,1,0,1,A painter is killed in a Mujahideen drive-by shooting.
11946,27/7/2009,Nigeria,Maiduguri,1,0,1,"A Christian pastor and father of seven is hacked to death by radical Muslims, who then burn down his church."
11947,28/7/2009,Nigeria,Maiduguri,3,0,3,Three Christian pastors are kidnapped by Boko Harem Islamists and then beheaded after they refuse to accept Islam.
11948,28/7/2009,Nigeria,Maiduguri,1,0,1,Islamists pull a Christian man from his home and slit his throat.
11949,28/7/2009,Thailand,Pattani,2,0,2,A Buddhist couple is brutally shot to death by Muslim radicals.
11950,28/7/2009,Afghanistan,Kabul,5,9,14,Five Afghan civilians are murdered in four separate Mujahid attacks around the country.
11951,28/7/2009,Afghanistan,Helmand,8,4,12,Eight security guards are killed when their vehicles are hit by Taliban remote-controlled bombs.
11952,28/7/2009,Philippines,Basilan,1,0,1,"Moro Islamists fire on a passing vehicle, killing one occupant."
11953,28/7/2009,Pakistan,Mingora,1,0,1,A police officer is kidnapped and beheaded by Islamic radicals.
11954,28/7/2009,Pakistan,Miranshah,2,5,7,"A suicide car bomber rams a police checkpoint, killing two local cops."
11955,28/7/2009,Iraq,Baghdad,8,15,23,Jihadis successfully kill eight Iraqis with a bomb hidden on a motorcycle.
11956,29/7/2009,Afghanistan,Kandahar,4,0,4,Religious extremists kill two civilians and two local cops in three attacks.
11957,29/7/2009,Algeria,Tipaza,17,23,40,"Armed fundamentalists hit a security convoy with roadside bombs and automatic weapons fire, killing at least seventeen members."
11958,29/7/2009,Pakistan,Mohmand,2,6,8,A woman is among two vehicle passengers gunned down by Islamists.
11959,29/7/2009,Pakistan,Dera Ismail Khan,1,4,5,A Sunni sectarian attack on Shias leaves at least one dead.
11960,29/7/2009,Thailand,Yala,1,0,1,Mujahideen gun down a 43-year-old man riding a motorcycle.
11961,30/7/2009,Yemen,Sanaa,3,3,6,Three local troops are killed in an al-Qaeda ambush.
11962,30/7/2009,Pakistan,Swat,1,2,3,Islamic terrorists storm the home of a government official and shoot his brother to death.
11963,30/7/2009,Iraq,Qaim,5,39,44,Five civilians are blown to bits by a suicide car bomber.
11964,30/7/2009,Iraq,Baqubah,7,10,17,Seven Iraqis are killed in twin blasts at Sunni political party building.
11965,30/7/2009,Pakistan,Gojra City,7,19,26,"Seven people, including women and children (the youngest of whom was 4), are burned alive when a Muslim mob rampages through a Christian community over rumors of a Qur'an desecration."
11966,31/7/2009,Iraq,Baghdad,33,136,169,"Jihadis place bombs in five rival mosques, sending at least thirty worshippers to Allah and leaving over one-hundred more in agony."
11967,31/7/2009,Pakistan,Koral,3,0,3,A man guns down his sister and two teenage nieces after learning that one of them made a road trip with a stranger.
11968,31/7/2009,Iraq,Mosul,2,2,4,A married couple die from shrapnel injuries when Mujahideen toss a grenade into their home.
11969,31/7/2009,Afghanistan,Farah,4,3,7,"Talibanis ambush a vehicle carrying voting equipment, killing four occupants."
11970,31/7/2009,Iraq,Kirkuk,2,15,17,"Terrorists detonate a car bomb at a marketplace, killing two civilians."
11971,1/8/2009,Pakistan,Gojra,8,18,26,Eight Christians are burned alive by a mob angered over a rumor of Qur'an desecration.
11972,1/8/2009,Afghanistan,Ghazni,1,2,3,A car carrying campaign workers is ambushed by Talibanis.
11973,1/8/2009,India,Srinagar,2,0,2,Jaish-e-Mohammed militants shoot two police officers to death in separate attacks.
11974,1/8/2009,Iraq,Mosul,1,0,1,Sunni terrorists gun down a local traffic cop.
11975,1/8/2009,Afghanistan,Baghlan,3,0,3,Three police are killed in a roadside attack.
11976,2/8/2009,Thailand,Pattani,1,0,1,A Buddhist man is gunned down in a Muslim drive-by.
11977,2/8/2009,Thailand,Pattani,1,0,1,Islamists shoot a 29-year-old man to death as he is riding home from work.
11978,2/8/2009,Dagestan,Makhachkala,4,0,4,Islamic militants gun down three emergency workers (in Ingushetia ) and a police officer.
11979,2/8/2009,Pakistan,Mashogagar,1,0,1,"Muslim militants kidnap a man, murder him in captivity, and then plant explosives on his body to kill others."
11980,2/8/2009,Pakistan,Paharipura,2,0,2,Two police are gunned down in a terrorist ambush.
11981,2/8/2009,India,Shopian,1,0,1,Mujahideen gunmen murder a man while he is visiting an orchard.
11982,2/8/2009,Iraq,Haditha,7,34,41,Car bombers successfully take down seven Iraqis at an outdoor market.
11983,2/8/2009,Chechnya,Sharoi,5,4,9,"Jihad Warriors ambush two vehicles carrying police, blasting and shooting five officers to death."
11984,3/8/2009,Algeria,Kabylie,4,0,4,Four civilians are cut to pieces by automatic weapons fire from Islamic fundamentalists.
11985,3/8/2009,Iraq,Iskandariya,1,3,4,A Shiite pilgrim is murdered by suspected Sunnis.
11986,3/8/2009,Iraq,Hilla,6,27,33,"Islamic terrorists bomb two passenger buses, killing six innocents."
11987,3/8/2009,Iraq,Fallujah,5,8,13,Car bombers take out five Iraqis.
11988,3/8/2009,Somalia,Medina,1,5,6,"In Islamist tosses a grenade at a group of soldiers in a commercial district, killing one."
11989,3/8/2009,Pakistan,Gorja,1,0,1,A Christian man succumbs to injuries suffered by a Muslim mob attack.
11990,3/8/2009,Afghanistan,Herat,12,26,38,A woman and a 12-year-old girl are among a dozen Afghanis blown apart by Sunni bombers along a city street.
11991,3/8/2009,Afghanistan,Ghazni,1,4,5,A civilian is killed by a Taliban bomb.
11992,3/8/2009,Pakistan,Miranshah,9,12,21,Nine people are killed in a Jihad rocket attack.
11993,4/8/2009,Iraq,Mussayab,1,0,1,Mujahideen shoot a policeman's brother to death.
11994,4/8/2009,Afghanistan,Zabul,2,17,19,A Shahid suicide bomber manages to send two Afghanis to Allah.
11995,4/8/2009,Pakistan,Datakhel,2,3,5,Two women die from shrapnel injuries following a rocket attack by Islamic hardliners.
11996,4/8/2009,Pakistan,Chashma,3,3,6,Three civilians are killed when the Taliban fire a missile into a home.
11997,4/8/2009,Thailand,Narathiwat,1,0,1,A woman is murdered by Religion of Peace gunmen.
11998,4/8/2009,Thailand,Yala,1,0,1,Islamists gun down a 57-year-old man as he returns home from work.
11999,4/8/2009,Pakistan,Lahore,2,0,2,A factory owner and guard are beaten to death by a mob after an employee accuses one of desecrating the Qur'an.
12000,4/8/2009,Iraq,Baghdad,1,0,1,al-Qaeda brutally beheads a 'police informant' and releases the video.
12001,5/8/2009,Iraq,Ramadi,1,4,5,A woman is killed in a Jihad car bomb blast.
12002,5/8/2009,Afghanistan,Nangarhar,5,0,5,Five civilians are blown to bits by Taliban bombers.
12003,5/8/2009,Iraq,Jalawla,1,0,1,A young shepherd is murdered by Islamic bombers.
12004,5/8/2009,Iraq,Baghdad,5,8,13,Five local police are taken out by a Jihadi roadside bomb.
12005,5/8/2009,Thailand,Pattani,1,0,1,A middle-aged Buddhist man is murdered by Islamic gunmen as he returns home from market.
12006,5/8/2009,Thailand,Narathiwat,2,0,2,Two young men are shot to death by Mujahideen.
12007,5/8/2009,Afghanistan,Nangahar,6,0,6,Six civilians are taken down by Taliban bombers along a highway.
12008,6/8/2009,Pakistan,Yasrab Colony,2,0,2,A pregnant woman and her lover are killed by being thrown into a well alive by their family.
12009,6/8/2009,Pakistan,Multan,1,0,1,A member of the minority Ahmadiyya is assassinated in his own home by Religion of Peace gunmen.
12010,6/8/2009,Pakistan,Dera Ismail Khan,2,0,2,Two shopkeepers are murdered in a sectarian shooting.
12011,6/8/2009,Pakistan,Bajaur,1,0,1,Taliban assassins take down a local soldier standing guard.
12012,6/8/2009,Iraq,Khanaqin,2,0,2,A man and woman are shot to death inside a vehicle by suspected hardliners.
12013,6/8/2009,Iraq,Kirkuk,5,32,37,Jihadi bombers take out five Iraqis at a market.
12014,6/8/2009,Iraq,Mosul,1,0,1,A woman is gunned down by Muslim terrorists.
12015,6/8/2009,Iraq,Baghdad,1,4,5,A Shiite pilgrim is killed by Sunni bombers.
12016,6/8/2009,Afghanistan,Helmand,10,5,15,Two women and two children are among ten Afghanis murdered by two Fedayeen bombers.
12017,6/8/2009,Iran,Tabriz,7,0,7,Seven lawyers representing pro-reformists are murdered by the Revolutionary Guard while in detention.
12018,7/8/2009,Afghanistan,Ghazni,1,2,3,A security guard is murdered by Taliban bombers.
12019,7/8/2009,Afghanistan,Kandahar,6,4,10,Terrorists use two roadside bombs to kill six local security personnel.
12020,7/8/2009,Pakistan,Tank,19,18,37,Nineteen people are killed when Taliban hardliners attack a peace committee.
12021,7/8/2009,Pakistan,Khyber,1,0,1,A civilian is killed in a battle between rival Islamists.
12022,7/8/2009,Iraq,Baghdad,3,13,16,Sunni bombers take out three more Sunni pilgrims.
12023,7/8/2009,Iraq,Baghdad,6,24,30,A half-dozen people are killed in an attack on a marketplace.
12024,7/8/2009,Chechnya,Grozny,2,1,3,A Mujahideen bombing at a restaurant and another along a highway leave two dead.
12025,7/8/2009,Iraq,Mosul,38,95,133,At least thirty-eight people are blown to bits when Sunni bombers blast a Shia mosque.
12026,7/8/2009,Pakistan,Lahore,3,0,3,Three people are gunned down by a relative over a suspected sexual affair.
12027,8/8/2009,Yemen,Baqim,8,0,8,Eight people are killed when Sunnis and Shias work out their differences in the usual way.
12028,8/8/2009,Thailand,Pattani,1,0,1,A man is gunned down outside his home in a Muslim drive-by attack.
12029,8/8/2009,Afghanistan,Helmand,5,0,5,Five civilians are incinerated by Taliban bombers.
12030,8/8/2009,Iraq,Mosul,1,0,1,Sunni gunmen murder a cop at an intersection.
12031,8/8/2009,Somalia,Mogadishu,2,4,6,al-Shabaab militants kill two local police with a roadside bomb.
12032,9/8/2009,Pakistan,North Waziristan,2,3,5,Two local soldiers are blasted to bits by Taliban bombers while traveling in a vehicle.
12033,9/8/2009,Iraq,Baghdad,2,0,2,Two Kurds are gunned down by Sunni terrorists.
12034,9/8/2009,Pakistan,Bannu,3,0,3,Two farmers are among three people taken down in an ambush by Islamic militants.
12035,9/8/2009,Pakistan,Mohmand,5,0,5,"The Taliban attack a peace committee, killing five people."
12036,9/8/2009,Thailand,Yala,1,0,1,Mujahideen shoot a village chief to death as he is riding a motorcycle with his wife.
12037,9/8/2009,Somalia,Mogadishu,2,0,2,Two civilians are taken out in a bombing by Muslim militants.
12038,10/8/2009,Pakistan,North Waziristan,1,3,4,Gul Bahadur terrorists kill a soldier as he is fetching water.
12039,10/8/2009,Afghanistan,Logar,5,26,31,Five innocents are killed when Islamic fundamentalists in vests assault a government building.
12040,10/8/2009,Dagestan,Derbent,1,1,2,Islamic extremists kill a border guard with a bomb.
12041,10/8/2009,Iraq,Khazna,42,190,232,"al-Qaeda detonate massive truck bombs 500 feet apart in a residential neighborhood of religious minorities, leveling homes and leaving over forty dead."
12042,10/8/2009,Iraq,Baghdad,7,42,49,Muslim bombers kill seven day laborers as they are enjoying their morning tea.
12043,10/8/2009,Iraq,Baghdad,10,35,45,Ten construction workers are murdered by Sunni bombers.
12044,10/8/2009,Iraq,Baghdad,5,35,40,Three innocents are killed in three Jihad bombing attacks.
12045,11/8/2009,Jordan,Nasser,1,0,1,A 16-year-old girl is shot eight times in various parts of her body by an uncle because she had been raped.
12046,11/8/2009,Iraq,Baghdad,8,30,38,Islamists blast eight Iraqis to death with bombs at a cafe and an apartment complex.
12047,11/8/2009,Pakistan,Mohmand,1,0,1,The Taliban kidnap and murder a tribal elder.
12048,11/8/2009,Pakistan,Peshawar,2,3,5,"Sunni militants fire a rocket into a residential area, killing two people."
12049,11/8/2009,Afghanistan,Kabul,5,4,9,The Taliban murder five local police with a roadside bomb.
12050,12/8/2009,Thailand,Pattani,1,4,5,"Mujahideen gunmen spray a tea shop with bullets from a moving truck, killing one person inside."
12051,12/8/2009,Jordan,Madaba,1,0,1,A pregnant woman is shot four times in the head by her brother for marrying by choice.
12052,12/8/2009,Afghanistan,Gereshk,14,0,14,"Taliban bombs kill fourteen civilians, including three children."
12053,12/8/2009,Pakistan,Orakzai,1,0,1,A schoolteacher is gunned down by Muslim terrorists.
12054,12/8/2009,India,Baramulla,1,9,10,A civilian is killed when Islamists hurl a grenade into a crowded area.
12055,12/8/2009,Afghanistan,Zabul,2,6,8,Two civilians are killed by Islamic bombers while traveling in a vehicle.
12056,12/8/2009,Afghanistan,Kunduz,3,0,3,Mujahideen storm a police post and shoot three people to death.
12057,12/8/2009,Iraq,Ramadi,2,7,9,A Fedayeen suicide bomber takes out two Iraqis.
12058,12/8/2009,Iraq,Mosul,4,5,9,An elderly man and communications worker are among four Iraqis killed in terror attacks.
12059,13/8/2009,Somalia,Mogadishu,2,4,6,An elderly man and a 10-year-old girl are among the casualties when Islamists mortar a residential neighborhood.
12060,13/8/2009,Dagestan,Buinaksk,7,0,7,Seven women are murdered at a sauna by Muslim terrorists.
12061,13/8/2009,Iraq,Mosul,21,35,56,"Two Fedayeen in bomb vests attack a cafe, leaving over twenty innocents dead and another thirty in agony."
12062,13/8/2009,Pakistan,Wana,4,2,6,al-Qaeda linked militants take out four civilians with a motorcycle bomb.
12063,13/8/2009,Pakistan,Bajour,2,0,2,Two men are kidnapped by the Taliban and then raked with machine-gun fire.
12064,13/8/2009,Dagestan,Buinaksk,4,5,9,"Islamic militants attack a police post, killing four officers."
12065,13/8/2009,Iraq,Baghdad,2,13,15,A bicycle bomb kills two civilians.
12066,13/8/2009,Thailand,Yala,2,4,6,Two patrons are murdered by Islamic gunmen while sitting in a tea shop.
12067,13/8/2009,Afghanistan,Helmand,3,2,5,Three British soldiers providing security for a meeting of tribal elders are killed in a heinous double bomb ambush.
12068,14/8/2009,Dagestan,Makhachkala,2,0,2,Two traffic cops are brutally gunned down by Islamic rebels.
12069,15/8/2009,Egypt,Cairo,1,0,1,A 22-year-old Christian conscript is murdered in his barracks after suffering horrible abuse over his religion.
12070,15/8/2009,Algeria,Tizi Ouzou,1,2,3,Islamic fundamentalists kill a guard at a beach with a bomb and small arms fire.
12071,15/8/2009,Iraq,Mosul,6,9,15,Five local cops and a taxi driver are taken down by Islamic terrorists.
12072,15/8/2009,Dagestan,Makhachkala,2,0,2,Two police are killed in separate sniper attacks by Muslim militants.
12073,15/8/2009,Pakistan,Khawaza Kehla,5,4,9,"A suicide car bomber rams into a checkpoint, killing five Pakistani soldiers."
12074,15/8/2009,Afghanistan,Kabul,7,91,98,Seven civilians are blown to bits by a Fedayeen suicide car bomber.
12075,15/8/2009,Afghanistan,Kabul,4,0,4,The Taliban manage to kill four civilians with a remote-controlled bomb.
12076,15/8/2009,Somalia,Mogadushu,5,20,25,Islamic militia kill five people in their homes with a mortar barrage.
12077,16/8/2009,India,Doda,1,0,1,A 26-year-old man is abducted and shot to death by Mujahideen.
12078,16/8/2009,Pakistan,Swat,1,3,4,At least one Pakistani is killed by a Shahid suicide bomber.
12079,16/8/2009,Pakistan,Swat,21,0,21,The bodies of twenty-one victims of Taliban executions are discovered in three locations.
12080,16/8/2009,Thailand,Narathiwat,2,0,2,Two men are shot to death by Mujahideen.
12081,16/8/2009,Iraq,Baghdad,8,21,29,Eight Iraqis at a market are murdered by Jihad bombers.
12082,16/8/2009,Iraq,Fallujah,4,5,9,"al-Qaeda gunmen attack a home, killing four residents."
12083,16/8/2009,Thailand,Yala,1,0,1,Muslim extremists slit the throat of a Buddhist rubber plantation worker.
12084,17/8/2009,Ingushetia,Nazran,25,160,185,"A suicide bomber rams an explosives-laden car into a government building, causing at least twenty other deaths."
12085,17/8/2009,Pakistan,Peshawar,7,9,16,Three children and two women are among seven innocents blown to bits by a Fedayeen car bomber at a gas station.
12086,17/8/2009,Pakistan,Sindh,1,6,7,A local leader is killed in a sectarian attack.
12087,17/8/2009,Iraq,Mussayab,2,1,3,Suspected al-Qaeda gun down two Iraqis at a checkpoint.
12088,17/8/2009,Afghanistan,Kabul,1,0,1,An American civilian is killed during a Taliban attack in the eastern part of the country.
12089,18/8/2009,Pakistan,Peshawar,1,0,1,A civilian is kidnapped and beheaded by Religion of Peace militants.
12090,18/8/2009,Pakistan,Miranshah,7,4,11,"A suicidal Sunni rams a group of local soldiers with an explosives-laden car, killing four, along with three civilian passersby."
12091,18/8/2009,Afghanistan,Badakshan,4,0,4,Taliban terrorists murder all four workers transporting election materials.
12092,18/8/2009,Afghanistan,Uruzgan,5,0,5,A Fedayeen suicide bomber takes out five Afghanis.
12093,18/8/2009,Iraq,Baghdad,2,15,17,Mujahideen plant a bomb near a school that leaves two people dead.
12094,18/8/2009,Iraq,Mosul,2,0,2,Two civilians are killed in separate Jihad bombings.
12095,18/8/2009,Afghanistan,Kabul,8,53,61,Holy Warriors murder eight in a brutal suicide car bomb attack along a city street.
12096,18/8/2009,Somalia,Bulahawa,1,0,1,A 41-year-old Christian is hunted down and shot to death for leaving Islam.
12097,19/8/2009,Somalia,Beledweyn,3,0,3,Two brothers are among three civilians gunned down by suspected Hizbul Islam.
12098,19/8/2009,Belgium,Jette,0,1,1,"A man who says he was sent by Allah to punish women who wear makeup, walks into a beauty salon and attacks an employee while quoting the Qur'an."
12099,19/8/2009,Afghanistan,Spin Boldak,4,0,4,Religious extremists plant a bomb that leaves four Afghans dead.
12100,19/8/2009,Afghanistan,Paktika,4,0,4,"Four civilians, including two women, are blown to bits by a Mujahideen roadside bomb."
12101,19/8/2009,Iraq,Kirkuk,0,0,0,Islamic militants kidnap and murder a Christian doctor.
12102,19/8/2009,Afghanistan,Kandahar,4,0,4,Two government officials are taken down by a Taliban landmine.  Another roadside attack elsewhere leaves two police dead.
12103,19/8/2009,Pakistan,Bajaur,3,0,3,Three people are shot to death by suspected Taliban.
12104,19/8/2009,Thailand,Yala,1,0,1,A villager is shot five times by Islamists while walking to a market.
12105,19/8/2009,Iraq,Baghdad,95,563,658,Islamic bombers stage several coordinated blasts and manage to kill nearly one-hundred Iraqis and injure about six-hundred others.
12106,19/8/2009,Philippines,Guindulungan,1,1,2,Muslim terrorists storm a village and kill a 41-year-old resident.
12107,20/8/2009,Afghanistan,Kandahar,1,0,1,The Taliban kill a man with a rocket attack.
12108,20/8/2009,Thailand,Pattani,1,0,1,A Buddhist villager is murdered by Muslim gunmen while working on his motorcycle.
12109,20/8/2009,Iraq,Babel,6,80,86,"Six civilians are killed in two Jihad bombings, one at a market."
12110,20/8/2009,Philippines,Cotabato,1,20,21,"Islamic terrorists toss a grenade at a wedding party, killing at least one member."
12111,20/8/2009,Somalia,Bulahawa,12,8,20,A dozen people lose their lives to al-Shabaab violence.
12112,20/8/2009,Somalia,Ahlu Sunna,33,22,55,Thirty-three people are killed when Ahlu Sunna fundamentalists lay siege to a town.
12113,21/8/2009,Pakistan,Peshawar,1,1,2,"Islamic extremists fire on a police patrol, killing one officer."
12114,21/8/2009,Chechnya,Grozny,5,3,8,Separate Shahid suicide attacks leave five people dead.
12115,21/8/2009,Afghanistan,Balkh,1,0,1,An election official is murdered by Sunni radicals.
12116,21/8/2009,Afghanistan,Ghazni,2,0,2,"Islamic extremists attack a polling station, killing two defenders."
12117,21/8/2009,Iraq,Baghdad,2,20,22,Two people are murdered at a market after terrorists plant a bomb in a vegetable cart.
12118,21/8/2009,Iraq,Mosul,4,1,5,Sunni insurgents blow up four local soldiers with a car bomb along a city street.
12119,21/8/2009,Somalia,Mogadishu,22,40,62,Nearly two-dozen civilians lose their lives to an assault by Islamic terrorists.
12120,21/8/2009,Pakistan,Multan,1,2,3,A girl dies from injuries after three sisters are tortured by the their brothers for leaving the house without permission.
12121,21/8/2009,Afghanistan,Helmand,6,0,6,Six civilians are blown to bits by a Taliban landmine.
12122,22/8/2009,Iraq,Mosul,1,0,1,"Jihadis kidnap a civilian, then slit his throat."
12123,22/8/2009,Thailand,Yala,3,4,7,Three public servants are blasted to death by Muslim terrorists.
12124,22/8/2009,Pakistan,Peshawar,2,3,5,A suicide bomber takes out two innocents near a hospital.
12125,22/8/2009,Iraq,Mosul,3,0,3,Mujahideen bombers kill a local mayor and two young children.
12126,22/8/2009,Iraq,Mosul,2,0,2,Two girls are shot to death by suspected Sunni terrorists.
12127,22/8/2009,Iraq,Mosul,2,0,2,Fundamentalists murder a liquor store owner and one other person.
12128,22/8/2009,Thailand,Narathiwat,1,2,3,"Mujahideen fire into a pickup truck, killing a man and seriously injuring his wife and son."
12129,22/8/2009,Thailand,Yala,3,4,7,"Muslim militants stop a vehicle with a bomb, then machine-gun three occupants to death."
12130,22/8/2009,Afghanistan,Kandahar,0,2,2,Taliban fundamentalists cut the fingers off of two women for voting in the election.
12131,22/8/2009,Afghanistan,Baghlan,6,0,6,Taliban bombers send six Afghan police to Allah.
12132,23/8/2009,Thailand,Narathiwat,2,3,5,Two local soldiers are killed in a brutal ambush by Muslim militants.
12133,23/8/2009,Pakistan,South Waziristan,4,0,4,"Islamic radicals attack a vehicle carrying a tribal elder, leaving him and three family members dead."
12134,23/8/2009,Pakistan,Bajaur,1,2,3,A guard is killed when sectarian Jihadis fire into a rival mosque.
12135,23/8/2009,Iraq,Abu Khamis,2,0,2,A man and his son are murdered by al-Qaeda bombers.
12136,23/8/2009,Pakistan,Momin,3,15,18,"A Shahid suicide bomber targets a funeral, killing three people, including two women."
12137,23/8/2009,Pakistan,Sarjani,3,0,3,A man guns down his wife and two daughters on suspicion of 'loose character.'
12138,23/8/2009,Somalia,Mogadishu,6,12,18,Six civilians are killed by gunfire as Hizb Al-Islam vows to step up Ramadan violence.
12139,24/8/2009,Algeria,El Guemaichia,3,2,5,Two emergency workers are killed when Islamic fundamentalists hide a bomb under the body of a murdered civilian.
12140,24/8/2009,Pakistan,Khyber Pass,1,1,2,Islamic militants murder a journalist riding on a bus.
12141,24/8/2009,Iraq,Kut,10,19,29,Four women and two children are among ten Iraqis blown to bits by bombs placed on buses.
12142,24/8/2009,Afghanistan,Helmand,2,0,2,Two 25-year-old Estonian soldiers are killed by Islamic militants while patrolling the border.
12143,25/8/2009,Afghanistan,Paktika,4,0,4,Four civilian construction workers are blown to bits by Taliban bombers.
12144,25/8/2009,Thailand,Narathiwat,0,42,42,Islamists injure forty-two people with a powerful car bomb outside a restaurant.
12145,25/8/2009,Afghanistan,Kandahar,41,66,107,"Religious extremists detonate several car bombs outside a construction company, incinerating at least forty souls."
12146,25/8/2009,Iraq,Abu Ghraib,2,0,2,A professor in his home is among two people murdered by Mujahideen.
12147,25/8/2009,Chechnya,Mesker-Yurt,4,3,7,"A suicide bomber attacks a car wash, killing four people."
12148,26/8/2009,Afghanistan,Paktika,2,1,3,Religious extremists blow two civilians to bits with a roadside bomb.
12149,26/8/2009,Algeria,Kabylie,1,0,1,Islamic fundamentalists murder a 37-year-old civilian.
12150,26/8/2009,Afghanistan,Baghlan,1,2,3,A Pakistani engineer is shot to death by suspected extremists.
12151,26/8/2009,Afghanistan,Kunduz,1,0,1,A government official is taken out in a Taliban roadside bombing.
12152,26/8/2009,Pakistan,Wana,2,0,2,Two local soldiers are shot to death by Muslim radicals.
12153,26/8/2009,Thailand,Yala,1,0,1,A female plantation worker is blown to bits by Mujahideen bombers.
12154,26/8/2009,Thailand,Yala,2,0,2,Two men are gunned down in separate Muslim drive-by attacks.
12155,27/8/2009,Pakistan,Tokham,22,27,49,A teenage suicide bomber pretending to beg for food blows up twenty-two Pakistani soldiers gathered to break their Ramadan fast.
12156,27/8/2009,Thailand,Yala,1,0,1,A 70-year-old man is gunned down outside of his home by Muslim militants.
12157,27/8/2009,Iraq,Mosul,5,10,15,Five Iraqis are murdered in various Mujahideen shooting and bombing attacks.
12158,27/8/2009,Afghanistan,Khost,4,0,4,Four local cops are taken out with a Taliban landmine.
12159,28/8/2009,Iraq,Mosul,5,6,11,A young girl shot to death is among five Iraqis murdered in at least two Jihad attacks.
12160,28/8/2009,Thailand,Pattani,1,17,18,"Islamists hurl a grenade at a group of villagers playing an outdoor game, killing a 62-year-old."
12161,28/8/2009,Pakistan,Quetta,6,7,13,Six Christians are gunned down after refusing a 'convert or die' offer from Islamists.
12162,29/8/2009,Sudan,Wernyol,43,62,105,"An Islamic-backed militia targets Christian villagers, hacking or shooting at least 43 to death including a senior church leader."
12163,29/8/2009,Yemen,Sawad,9,16,25,Shiite rebels kill nine local tribesmen in a mortar attack.
12164,29/8/2009,Algeria,Algiers,5,3,8,Five people are killed in two terrorist attacks by armed fundamentalists.
12165,29/8/2009,Iraq,Hamad,12,15,27,"A Fedayeen truck bomber detonates near a police station, killing at least a dozen innocents."
12166,29/8/2009,Iraq,Mosul,6,23,29,Six Iraqis at a market are blown to bits by Jihadi bombers.
12167,29/8/2009,Afghanistan,Zabul,2,21,23,"A Fedayeen bomber blows himself up in front of a bazaar, killing two civilian bystanders."
12168,29/8/2009,Iraq,Mosul,1,0,1,A young girl is gunned down by Muslim terrorists.
12169,29/8/2009,Pakistan,Bannu,2,0,2,"Terrorists ram a police vehicle, then open up with automatic weapons, killing two officers."
12170,30/8/2009,Pakistan,Swat,3,0,3,Two political activists and a student are murdered by suspected hardliners.
12171,30/8/2009,Iraq,Baghdad,2,13,15,"Separate bombings, one a Shahid, leave two civilians dead."
12172,30/8/2009,Pakistan,Mingora,16,11,27,Sixteen local cops are murdered by a Shahid suicide bomber.
12173,30/8/2009,Iraq,Mosul,1,0,1,A woman is shot to death by Mujahideen.
12174,31/8/2009,India,Srinagar,2,12,14,Jamiat-Ul-Mujahideen terrorists gun down two guards outside a bank.
12175,31/8/2009,Iraq,Khanaqin,1,12,13,Jihadi bombers kill one civilian and leave a dozen more with injuries.
12176,1/9/2009,Afghanistan,Zabul,1,3,4,An Afghan civilian is taken down by a roadside bomb.
12177,1/9/2009,Afghanistan,Border,1,0,1,"Video surfaces of the Taliban strapping explosives to a man accused of spying, then detonating him."
12178,1/9/2009,Pakistan,Mohmand,1,0,1,A tribal elder is murdered outside his home by Mujahid gunmen.
12179,1/9/2009,India,Poonch,1,0,1,Lashkar-e-Toiba terrorists shoot an Indian soldier to death during an infiltration attempt from Pakistan.
12180,1/9/2009,Iraq,Mosul,3,1,4,The head of a local charity is among three people gunned down by Sunni militants.
12181,1/9/2009,Somalia,Mogadishu,2,10,12,Two civilians die from gunshot injuries suffered during an attack by Islamic militants.
12182,2/9/2009,Iraq,Tal Afar,2,0,2,A married couple is brutally gunned down by Islamic terrorists.
12183,2/9/2009,Afghanistan,Kabul,23,50,73,"A Shahid blows himself up outside a mosque, taking twenty-three Afghans with him."
12184,2/9/2009,Thailand,Pattani,5,0,5,Four men are shot to death in separate Muslim terror attacks. (A fifth is killed in Yala)
12185,2/9/2009,Pakistan,Hub,3,0,3,Three people are shot dead in a targeted sectarian attack.
12186,2/9/2009,India,Rajouri,2,0,2,Two local cops are killed in a brutal Mujahideen ambush.
12187,2/9/2009,Iraq,Mosul,2,1,3,A 19-year-old girl in her home is among two people executed by Jihadis.
12188,2/9/2009,Afghanistan,Jowzjan,1,6,7,Taliban bombers kill one civilian by planting a remote-controlled bomb on a bicycle.
12189,2/9/2009,Thailand,Pattani,2,0,2,Muslim gunmen murder a man and his 13-year-old son.
12190,2/9/2009,Thailand,Narathiwat,1,1,2,Terrorists gun down a man and injure his wife.
12191,2/9/2009,Pakistan,Bannu,2,0,2,"Two small girls, ages 8 and 13, die from shrapnel injuries when Islamists toss a grenade into their home."
12192,2/9/2009,Thailand,Narathiwat,2,0,2,A man in a tea shop is among two people murdered by Muslim militants
12193,3/9/2009,Thailand,Pattani,1,27,28,"Twenty-seven people are injured, and an elderly man killed, when Muslims toss a bomb into a restaurant packed with Buddhists."
12194,3/9/2009,Iraq,Mussayab,4,24,28,"Sunnis bombers take down four Shiites, preparing to break Ramadan fast outside a mosque."
12195,4/9/2009,Afghanistan,Nimroz,3,0,3,Three security guards are murdered by a Shahid suicide bomber.
12196,4/9/2009,Pakistan,Peshawar,2,0,2,Two local police are gunned down point-blank by Islamic gunmen while sitting in their car.
12197,4/9/2009,Ingushetia,Dattykh,3,2,5,Islamic militants murder three local police with a roadside bomb.
12198,4/9/2009,Thailand,Pattani,2,0,2,A man and his 15-year-old son are slaughtered by Mujahid gunmen.
12199,4/9/2009,Thailand,Yala,1,12,13,A policeman is burned alive in his car by Jihadis outside a restaurant.
12200,5/9/2009,Afghanistan,Kunar,2,3,5,Two women are killed by a Taliban mortar attack on their neighborhood.
12201,5/9/2009,Pakistan,Swat,2,1,3,Holy Warriors gun down two brothers outside their home.
12202,5/9/2009,Iraq,Kirkuk,1,0,1,"A 62-year-old man is abducted, bound and executed by Mujahideen."
12203,5/9/2009,Somalia,Mogadishu,6,18,24,Children are among the dead when al-Shabaab Islamists stage an attack in a residential area.
12204,5/9/2009,Thailand,Yala,1,1,2,A Buddhist rubber tapper is gunned down by Muslim radicals.
12205,6/9/2009,Iraq,Mosul,2,0,2,An elderly woman and her 3-year-old granddaughter are successfully taken out in their home by Mujahideen gunmen.
12206,6/9/2009,Pakistan,Mirpurkhas,1,0,1,A pregnant woman is shot to death by Sunnis for switching to the Shia sect.
12207,6/9/2009,Chechnya,Grozny,1,0,1,Islamic militants shoot a young traffic policeman to death.
12208,6/9/2009,Iraq,Baghdad,1,6,7,A civilian is killed in a Jihad bombing.
12209,6/9/2009,Thailand,Yala,3,0,3,A 61-man is mowed down along with his son and daughter in an automatic weapons attack by Islamic separatists.
12210,6/9/2009,Iraq,Mosul,2,0,2,A man and his son are murdered by Jihadi roadside bombers.
12211,7/9/2009,Iraq,Kirkuk,1,0,1,An oil company employee is killed in a drive-by Mujahideen shooting.
12212,7/9/2009,Afghanistan,Kabul,3,2,5,"A family of three, including the parents and child, are wiped out by a Taliban rocket as they are sleeping in their home."
12213,7/9/2009,Iraq,Baqubah,6,9,15,Six Shiites are blown to bits by a Sunni Shahid at a mosque.
12214,7/9/2009,Iraq,Karbala,4,8,12,"Islamists blow up a passenger bus, killing four."
12215,7/9/2009,Afghanistan,Uruzgan,1,20,21,A child loses his life to shrapnel injuries from after an attack by Sunni terrorists.
12216,7/9/2009,Iraq,Ramadi,9,13,22,A Shahid suicide bomber blows nine Iraqis straight to Allah.
12217,7/9/2009,Pakistan,South Waziristan,5,0,5,Taliban militants take out five local soldiers in a roadside attack.
12218,8/9/2009,Pakistan,NWFP,1,1,2,Taliban militants kidnap a Greek professor after killing his guard.
12219,8/9/2009,Thailand,Pattani,1,0,1,A teacher is taken down by Islamic gunmen.
12220,8/9/2009,Afghanistan,Kabul,3,9,12,Three Afghan civilians are blown to bits by a Shahid suicide bomber.
12221,8/9/2009,Afghanistan,Baghlan,1,21,22,Sunni terrorists murder a local cop with a bomb.
12222,8/9/2009,Iraq,Baghdad,12,26,38,Five separate roadside attacks around the country leave a dozen Iraqis dead.
12223,8/9/2009,Pakistan,Orakzai,4,6,10,Four Shiite school children are gunned down in cold blood by Sunni extremists.
12224,8/9/2009,Somalia,Mogadishu,8,31,39,Eight civilians are killed when religious hardliners attack government troops.
12225,8/9/2009,Afghanistan,Nuristan,8,8,16,"Taliban militants stage a brutal siege on two government buildings, killing eight guards in the process."
12226,9/9/2009,Iraq,Kirkuk,8,2,10,Women and children are among eight members of a family murdered by an al-Qaeda car bomb.
12227,9/9/2009,Afghanistan,Logar,25,0,25,Fifteen schoolchildren are among twenty-five innocents blown to bits by Taliban bombers.
12228,9/9/2009,Thailand,Pattani,2,0,2,Two more Buddhist villagers are shot to death by Muslim radicals in separate attacks.
12229,9/9/2009,Pakistan,South Waziristan,1,2,3,Islamic radicals kill an elderly man with a bomb.
12230,9/9/2009,Iraq,Karbala,4,0,4,Jihadis murder four Iraqis with a roadside blast.
12231,9/9/2009,Thailand,Pattani,1,0,1,"Islamists shoot a Buddhist to death in cold blood, then set fire to the body."
12232,10/9/2009,Jordan,Aqaba,1,0,1,"A Muslim man guns down his teenage sister for ""knowing many men."""
12233,10/9/2009,Afghanistan,Kunduz,7,2,9,Taliban terrorists attack a police post and kill seven officers.
12234,10/9/2009,Iraq,Wardek,20,27,47,"A Shahid suicide bomber drives a truck packed with explosives into a village, killing at least twenty innocent people."
12235,10/9/2009,Afghanistan,Helmand,2,4,6,Two civilians are murdered by a Fedayeen suicide bomber.
12236,10/9/2009,Iraq,Mahmudiya,4,29,33,A double bombing at a market leaves four patrons dead.
12237,10/9/2009,Pakistan,South Waziristan,2,4,6,Two public workers are killed in a Mujahideen rocket attack.
12238,10/9/2009,Thailand,Yala,2,0,2,Two men are gunned down by Mujahideen in separate attacks.
12239,10/9/2009,Dagestan,Makhachkala,2,0,2,Two government officials are murdered by Muslim gunmen on consecutive days.
12240,11/9/2009,Ethiopia,Senbete,0,3,3,A Muslim mob ransacks two Christian churches and seriously injures three Christian worshippers.
12241,11/9/2009,Afghanistan,Kandahar,2,0,2,A child is among two people blown into pieces by a Fedayeen suicide bomber.
12242,11/9/2009,Afghanistan,Farah,3,0,3,Three civilians are killed when a Taliban rocket strikes their home.
12243,11/9/2009,Iraq,Safara,5,0,5,Five Iraqi police are gunned down at point blank range by Muslim terrorists.
12244,11/9/2009,Ingushetia,Nazran,1,4,5,A local police officer dies from injuries suffered from a suicide bomber.
12245,11/9/2009,Somalia,Mogadishu,15,27,42,"Fifteen people, including nine disabled patients at a hospital, are killed when Islamic militia slam mortars into a neighborhood."
12246,11/9/2009,Afghanistan,Uruzgan,14,0,14,Fourteen car passengers are massacred by Taliban bombers.
12247,11/9/2009,Afghanistan,Kunar,6,0,6,Six security guards are murdered by Mujahideen.
12248,11/9/2009,Afghanistan,Kandahar,6,0,6,Sunni hardliners kill six civilians with a roadside bomb.
12249,12/9/2009,Iraq,Baghdad,4,24,28,A double bombing by sectarian Jihadis at a mosque leaves four dead.
12250,12/9/2009,India,Srinagar,3,10,13,A woman and two others are taken out be a car bomb.
12251,12/9/2009,Pakistan,Landikotal,3,0,3,Two brothers are among three men gunned down by Mujahideen.
12252,12/9/2009,Iraq,Baqubah,4,0,4,Two women are among four people blown to bits by an al-Qaeda bomb.
12253,12/9/2009,Ingushetia,Nazran,1,0,1,A prosecutor is gunned down outside his home by suspected Islamic rebels.
12254,12/9/2009,Thailand,Yala,0,0,0,"Suspected Islamists slit a teenager's throat, then set fire to his body."
12255,12/9/2009,Bangladesh,Dhaka,1,0,1,A group of Muslims brutally torture and murder a young Christian student.
12256,13/9/2009,Bangladesh,Dhaka,1,0,1,A Christian evangelist dies from injuries suffered from severe torture at the hands of a Muslim gang.
12257,13/9/2009,Thailand,Yala,5,0,5,Five local security personnel are ambushed and killed by Islamic radicals while on a break.
12258,13/9/2009,Iraq,Muqdadiya,2,12,14,"Muslim terrorists set off a bomb at a market, killing two patrons."
12259,13/9/2009,India,Kishtwar,1,0,1,A civilian is shot to death by Hiz-bul-Mujahideen.
12260,13/9/2009,Pakistan,Khyber,3,2,5,Islamic militants kill three local soldiers in a landmine attack.
12261,13/9/2009,Iraq,Baghdad,1,4,5,"A cafe is bombed by Mujahid, leaving at least one patron dead."
12262,14/9/2009,Pakistan,Sialkot,1,0,1,A young Christian is beaten to death after being arrested for blasphemy.
12263,14/9/2009,Pakistan,Karachi,1,0,1,A courageous security guard loses his life defending an oil refinery against Islamic militants.
12264,14/9/2009,Iraq,Mosul,3,1,4,A woman and her daughter are among four casualties of Mujahideen bombers.
12265,14/9/2009,Iraq,Buhriz,1,1,2,Islamic bombers take out an antiques dealer.
12266,14/9/2009,Iraq,Baqubah,5,5,10,"Five people are killed in two Jihad bombings, one of which was in front of a movie theater."
12267,14/9/2009,Iraq,Mukheefa,1,0,1,A college student is shot to death by Muslim terrorists while walking home.
12268,15/9/2009,Italy,Trieste,1,1,2,An 18-year-old girl dies from being stabbed in the throat by her father for falling in love with a non-Muslim.
12269,15/9/2009,Somalia,Merca,1,0,1,A 69-year-old Christian is executed by al-Shabaab militants after they find him carrying Bibles through their checkpoint.
12270,15/9/2009,Iraq,Baghdad,2,5,7,"Jihadis fire mortars into a populated area, killing two Iraqis."
12271,16/9/2009,Afghanistan,Khost,1,2,3,"Islamists detonate a bomb in a shop, killing one civilian."
12272,16/9/2009,Afghanistan,Kandahar,2,8,10,A Fedayeen suicide bomber sends two civilians to Allah.
12273,16/9/2009,Iraq,Khalis,3,6,9,Jihadi car bombers take out three Iraqis.
12274,16/9/2009,Thailand,Narathiwat,1,0,1,A man picking up groceries in his truck is gunned down by Muslim radicals.
12275,16/9/2009,Egypt,Bagur,1,2,3,A 63-year-old Christian is stabbed to death by a rampaging Muslim.
12276,16/9/2009,Philippines,Tungawan,3,0,3,Moro Islamists murder three people by throwing a grenade into a village.
12277,17/9/2009,Pakistan,Peshawar,2,0,2,Two members of a family are kidnapped and tortured to death by Sunni hardliners.
12278,17/9/2009,Thailand,Pattani,3,2,5,A Buddhist laborer is among three civilians shot to death by Islamic terrorists in separate attacks.
12279,17/9/2009,Somalia,Mogadishu,21,30,51,Over twenty African peacekeepers and civilians are killed in a devastating suicide truck bomb attack.
12280,17/9/2009,Afghanistan,Kabul,16,40,56,Civilians and soldiers are among the dead as a Shahid suicide bomber detonates along a city street.
12281,17/9/2009,Iraq,Tal Afar,3,3,6,A suicide truck bomber takes down three civilians.
12282,17/9/2009,Iraq,Tuz Khurmato,2,1,3,Two Iraqis are killed in a Mujahideen bombing.
12283,17/9/2009,Thailand,Pattani,2,2,4,"Two Buddhist security personnel, one of whom was with his wife, are killed in separate Muslim shootings."
12284,18/9/2009,Algeria,Kabylie,1,0,1,A civilian is gunned down by fundamentalists.
12285,18/9/2009,Algeria,Boumerdes,1,0,1,Islamic fundamentalists kill a local soldier with a bomb.
12286,18/9/2009,Iraq,Mahmoudiya,7,21,28,Jihadi car bombers hit a market as it is packed with Ramadan shoppers.  Seven Iraqis are killed.
12287,18/9/2009,India,Doda,2,0,2,Islamic terrorists ambush and kill two police officers.
12288,18/9/2009,Pakistan,Ustarzai,39,54,93,Thirty-nine innocents are slaughtered by a devastating Lashkar-i-Jhangvi Al-Alami bomb attack on a busy Shiite market.
12289,18/9/2009,Pakistan,Kohat,3,0,3,Three mourners at a funeral are shot to death by Sunni militants.
12290,18/9/2009,Pakistan,Hangu,1,0,1,The mayor of a town is gunned down in a sectarian attack.
12291,19/9/2009,Afghanistan,Kandahar,5,16,21,Five Afghans are murdered by a Shahid suicide bomber.
12292,19/9/2009,Afghanistan,Kandahar,2,0,2,A Taliban bomb hidden in a bicycle leaves two civilians dead.
12293,19/9/2009,Afghanistan,Helmand,1,1,2,A Danish soldier is killed by a sniper while on patrol.
12294,19/9/2009,Pakistan,Malakand,5,0,5,Five people are riddled with bullets when Talibanis open point blank on a passenger vehicle.
12295,19/9/2009,Pakistan,Darra Adam Khel,2,0,2,A suspected suicide attack kills two innocents.
12296,19/9/2009,Iraq,Mosul,1,2,3,An 11-year-old boy dies from injuries following a Jihad bombing.
12297,19/9/2009,Afghanistan,Herat,2,7,9,"Two children, ages 7 and 10, are blasted to death by a female suicide bomber."
12298,19/9/2009,Iraq,Zubair,2,0,2,Two members of a religious minority are murdered by Muslim gunmen.
12299,20/9/2009,Somalia,Wanlaweyn,2,0,2,al-Shabaab Islamists gun down two demonstrators who are protesting them.
12300,20/9/2009,Sudan,Jonglei,51,46,97,Fifty-one non-Muslim villagers are massacred in an assault by armed forces directed by the Islamic Republic.
12301,20/9/2009,Pakistan,Hangu,4,4,8,Four people are machine-gunned to death at a market by Muslim terrorists.
12302,20/9/2009,Iraq,Iskandariya,1,4,5,"Suspected al-Qaeda bomb a cemetery, killing at least one mourner."
12303,20/9/2009,Ingushetia,Gazi-Yurt,2,1,3,Two local police are gunned down by Islamic militants.
12304,20/9/2009,Russia,Cherkessk,1,0,1,A moderate cleric is assassinated by Wahabbi extremists.
12305,20/9/2009,India,Ganderbal,1,1,2,"Mujahideen barge into a home and shot two sisters, killing one."
12306,21/9/2009,Philippines,Sulu,8,9,17,Abu Sayyaf terrorists kill eight soldiers in an ambush.
12307,21/9/2009,Iraq,Latifiya,3,2,5,Three people are incinerated by a Jihad bomb blast at a gas station.
12308,22/9/2009,Somalia,Mogadishu,8,20,28,Eight civilians are killed during an attack by Islamic hardliners.
12309,22/9/2009,India,Baramulla,1,4,5,A local soldier is gunned down in an ambush by Islamic militants.
12310,22/9/2009,Afghanistan,Farah,5,2,7,Five civilians are blown to bits when their car is hit by a Taliban roadside bomb.
12311,23/9/2009,Afghanistan,Herat,1,2,3,"A teenage boy is gunned down in his home by Islamic militants, who also injure his sister and mother."
12312,23/9/2009,Iraq,Mosul,4,1,5,Four Iraqis are killed in two Jihad bombing attacks.
12313,23/9/2009,Afghanistan,Kandahar,7,0,7,Three children and two women are among seven innocents wiped out by a Taliban roadside bomb.
12314,23/9/2009,Thailand,Pattani,2,0,2,"Two Buddhists, one a 19-year-old woman, are brutally murdered by Muslim gunmen."
12315,23/9/2009,Thailand,Yala,1,1,2,A 16-year-old boy is shot to death by Muslim radicals in a drive-by attack.
12316,24/9/2009,Somalia,Mogadishu,5,10,15,Five civilians die in an ambush claimed by Hizbul Islam.
12317,24/9/2009,Afghanistan,Helmand,4,2,6,Taliban hardliners murder four police with a roadside bomb.
12318,24/9/2009,Iraq,Mosul,2,0,2,Sunni gunmen take down two local cops at a checkpoint.
12319,24/9/2009,Pakistan,Bannu,9,0,9,Islamic radicals open fire on two cars carrying tribal elders.  Nine victims are cut down.
12320,25/9/2009,Afghanistan,Herat,4,0,4,The Taliban shoot three civilians and hang another.
12321,26/9/2009,Iraq,Mosul,1,0,1,An off-duty policeman is shot to death by Sunni terrorists.
12322,26/9/2009,Pakistan,Peshawar,11,94,105,Eleven people outside a bank are murdered by a Jihad car bomb.
12323,26/9/2009,Pakistan,Bannu,13,64,77,"A truck bomber detonates outside a police station, killing thirteen people on the street, including a young child."
12324,26/9/2009,Thailand,Narathiwat,2,0,2,A man and his wife are brutally gunned down by Islamic radicals.
12325,27/9/2009,Chechnya,Stary Achkoi,2,0,2,Muslim gunmen murder a man and his son as they are sitting in their car.
12326,27/9/2009,Pakistan,Sargodha,2,0,2,A man shoots his teen daughter and her lover to death in the name of honor.
12327,27/9/2009,Afghanistan,Farah,5,0,5,Taliban bombers take out five civilians traveling in a car.
12328,27/9/2009,Thailand,Yala,1,1,2,A man visiting his brother's grave is murdered by Muslim bombers.
12329,27/9/2009,Afghanistan,Herat,4,17,21,Four civilians are blown to bits by a motorcycle suicide bomber.
12330,27/9/2009,Iraq,Ramadi,4,8,12,A Shahid suicide bomber blasts four Iraqis to death outside a police station.
12331,27/9/2009,Afghanistan,Badghis,1,0,1,An 'enemy of Allah' is hanged by Sunni hardliners.
12332,28/9/2009,Somalia,Marerey,1,0,1,A 46-year-old Christian woman is shot to death by Islamists after being found with Bibles.
12333,28/9/2009,Jordan,Amman,1,0,1,A 40-year-old divorced mother of five is stabbed fifteen times by her brothers for having a 'bad reputation.'
12334,28/9/2009,Thailand,Pattani,1,0,1,Suspected Muslim insurgents stab a man to death.
12335,28/9/2009,Afghanistan,Kunar,6,0,6,Six civilians traveling in a car are massacred by Taliban bombers.
12336,28/9/2009,Thailand,Pattani,2,0,2,Islamic separatists murder two civilians in their home.
12337,28/9/2009,Thailand,Narathiwat,2,0,2,Two villagers are gunned down by Muslim militants.
12338,28/9/2009,Iraq,Diwaniyah,3,5,8,"Jihadis bomb a minibus, killing three passengers."
12339,28/9/2009,Iraq,Ramadi,7,16,23,Seven people are murdered when a Fedayeen suicide bomber detonates along a city street.
12340,28/9/2009,Iraq,Baghdad,5,28,33,Vicious back-to-back bombings leave five Iraqis dead.
12341,28/9/2009,Pakistan,Bannu,4,0,4,Four people are incinerated by a suicide bomber.
12342,28/9/2009,India,Pulwama,1,0,1,A young woman is cut down by Lashkar-e-Toiba gunmen.
12343,28/9/2009,Pakistan,Orakzai,1,0,1,A man is abducted and killed by Islamic terrorists.
12344,28/9/2009,Pakistan,North Waziristan,2,5,7,"Islamic radicals fire rockets into a military base, killing two local soldiers."
12345,28/9/2009,Iraq,Tal Afar,4,0,4,Four Kurds are captured and executed by al-Qaeda.
12346,28/9/2009,Somalia,Mogadishu,2,0,2,Two 'enemies of Allah' are executed at a livestock market.
12347,29/9/2009,Somalia,Mogadishu,8,6,14,Eight civilians are killed during an ambush by Islamic militia.
12348,29/9/2009,Somalia,Kismayo,1,0,1,A local businessman is assassinated by Islamists.
12349,29/9/2009,India,Baramulla,3,2,5,Islamic militants cut down three police standing guard at a bus station.
12350,29/9/2009,Iraq,Baghdad,18,55,73,At least eighteen Iraqis are killed in multiple terror attacks around the country.
12351,29/9/2009,Thailand,Pattani,1,0,1,Islamic radicals gun down a civilian in a drive-by.
12352,29/9/2009,Afghanistan,Kandahar,30,39,69,Ten children and seven women are among thirty people killed when religious extremists bomb a passenger bus.
12353,29/9/2009,Thailand,Pattani,2,2,4,A Buddhist woman is among two people killed when Islamic 'insurgents' spray a home with automatic weapons fire.
12354,30/9/2009,Thailand,Narathiwat,1,1,2,A local village head is murdered by Muslim gunmen.
12355,30/9/2009,Philippines,Jolo,3,2,5,"Abu Sayyaf terrorists kill three soldiers riding in a vehicle, including two American seamen."
12356,30/9/2009,Pal. Auth.,Hebron,1,0,1,A 16-year-old is strangled by her family in an honor killing.
12357,30/9/2009,Pakistan,Swat,1,0,1,A family man who sheltered a Chinese engineer who escaped from the Taliban is murdered.
12358,30/9/2009,India,Bandipora,1,0,1,Islamic militants storm a home and murder a resident.
12359,30/9/2009,Iraq,Baghdad,1,1,2,"Mujahideen plant a bomb under a car, killing a man and injuring his wife."
12360,30/9/2009,Iraq,Baghdad,1,8,9,A university student is murdered by Jihad bus bombers.
12361,30/9/2009,Iraq,Mahmudiya,3,1,4,Three Iraqi police are gunned down point-blank by Sunni ambushers at a checkpoint.
12362,1/10/2009,Somalia,Mogadishu,5,6,11,"Islamists shell a vegetable market, killing five civilians, including women."
12363,2/10/2009,Thailand,Pattani,2,0,2,A middle-aged Buddhist man is among two people murdered separately by Muslim gunmen.
12364,2/10/2009,Afghanistan,Kunar,1,3,4,"Taliban extremists attack a group of trucks, killing one of the drivers."
12365,2/10/2009,India,Sopore,1,0,1,A civilian is killed by religious militants.
12366,2/10/2009,Pakistan,Mardan,2,0,2,Islamic radicals murder two local police.
12367,2/10/2009,Iraq,Diyala,2,0,2,A barber is among two people taken down by Religion of Peace gunmen.
12368,2/10/2009,Iraq,Shurouq,1,4,5,"Terrorists plant a bomb at a mosque, killing an imam who also worked as a policeman."
12369,2/10/2009,Somalia,Kismayo,22,70,92,Civilians are among the two dozen people killed when Islamic factions clash.
12370,2/10/2009,Somalia,Mogadishu,6,15,21,Six people are killed when Muslim radicals mortar a main market.
12371,2/10/2009,Russia,Kabardino-Balkaria,1,3,4,Muslim gunmen kill a police officer in a drive-by.
12372,3/10/2009,Afghanistan,Kunduz,4,20,24,Four civilians at a market are blown to bits by a Taliban planted bomb.
12373,3/10/2009,Pakistan,Bajur,2,0,2,A tribal elder and a civilian are murdered separately by Muslim extremists.
12374,3/10/2009,Afghanistan,Wardak,2,0,2,An Islamic militant dressed as a local soldier shoots two American troops to death as they sleep.
12375,3/10/2009,Iraq,Mosul,3,0,3,A beheaded woman is among three people killed by terrorists in three incidents.
12376,3/10/2009,Pakistan,Islamabad,1,2,3,"Three Hindu men are abducted, one of whom is murdered in captivity."
12377,4/10/2009,India,Srinagar,1,0,1,Muslim cops kill a Hindu boy for marrying a Muslim girl.
12378,4/10/2009,Iraq,Kirkuk,1,0,1,A 55-year-old Christian nurse is kidnapped and tortured to death by Religion of Peace militants.
12379,4/10/2009,Iraq,Baghdad,2,4,6,A truck driver is among two people killed in two Jihad bombings.
12380,4/10/2009,Thailand,Narathiwat,1,0,1,A villager is shot in the neck and then set on fire by Religion of Peace separatists.
12381,4/10/2009,Iraq,Kirkuk,1,0,1,A woman is shot to death in an 'honor killing.'
12382,4/10/2009,Somalia,Kismayo,8,14,22,Eight people are killed when rival Islamic hardliners clash.
12383,5/10/2009,Pakistan,Islamabad,5,6,11,Two women are among five people killed when a suicide bomber detonates at a UN World Food Program office.
12384,5/10/2009,Iraq,Kirkuk,1,0,1,The tortured body of a Christian businessman is discovered three days after being kidnapped by Muslims.
12385,5/10/2009,Thailand,Narathiwat,1,17,18,Islamists gun down a laborer and also set off a bomb at a Buddhist festival.
12386,5/10/2009,Iraq,Mosul,1,0,1,A 10-year-old boy is taken out by a bomb hidden in a garbage can.
12387,5/10/2009,Iraq,Haditha,6,15,21,A half-dozen funeral mourners are blown to bits by a suicide bomber.
12388,5/10/2009,Philippines,Jolo,1,1,2,Abu Sayyaf shot a guard for a bridge construction crew to death.
12389,6/10/2009,Iraq,Amiriyeh,7,25,32,"Terrorists set off a bus bomb near a mosque, killing at least seven Iraqis along the crowded street."
12390,6/10/2009,Thailand,Narathiwat,4,42,46,"Islamic militants kill four civilians in separate bombings, including a Buddhist woman at a restaurant."
12391,6/10/2009,Afghanistan,Ghazni,2,25,27,"Taliban militants rocket a passenger bus, killing two men."
12392,7/10/2009,Afghanistan,Ghazni,3,0,3,Taliban bombers take out three local cops.
12393,7/10/2009,Iraq,Abu Ghraib,2,9,11,Two civilians are killed when Mujahideen toss a grenade at a hospital.
12394,7/10/2009,Iraq,Shirqat,3,0,3,The tortured bodies of three kidnapped police officers are found.
12395,7/10/2009,Thailand,Pattani,2,0,2,"Islamists shoot two men to death, one as he is driving his child to school."
12396,8/10/2009,Iraq,Yusufiya,3,10,13,"Suspected Islamists set off a bomb outside a shop, killing three civilians."
12397,8/10/2009,Iraq,Jalawla,2,4,6,Two Iraqis are murdered by Jihadi bombers.
12398,8/10/2009,Afghanistan,Kabul,17,76,93,"A suicide bomber detonates outside the Indian embassy, ending the lives of seventeen innocents."
12399,9/10/2009,Iraq,Saqlawiya,3,0,3,al-Qaeda bombers murder a cleric and two of his associates on their way home.
12400,9/10/2009,Pakistan,Peshawar,52,100,152,Over fifty innocent civilians at a market are incinerated by a dedicated Sunni suicide car bomber.
12401,9/10/2009,Somalia,Mogadishu,3,0,3,al-Shabaab militants shoot three rivals to death.
12402,9/10/2009,Afghanistan,Paktia,6,3,9,A suicide bomber murders six guards at a road construction project.
12403,9/10/2009,Afghanistan,Kabul,2,4,6,Two Polish soldiers assisting a road construction project are killed by Taliban bombers.
12404,9/10/2009,Chechnya,Grozny,1,3,4,"Islamic insurgents fire an RPG at a police post, killing one officer."
12405,10/10/2009,Somalia,Mogadishu,1,0,1,A Christian pastor is shot to death by al-Shabaab militants as he is returning home.
12406,10/10/2009,Afghanistan,Kunduz,1,0,1,A young policeman is murdered by Taliban bombers.
12407,10/10/2009,Pakistan,Khuzdar,2,0,2,Suspected Islamists machine-gun two truck drivers to death.
12408,10/10/2009,Somalia,Kismayo,25,41,66,Twenty-five people are killed when Hizbul Islam hard-liners attack their rivals.
12409,10/10/2009,Pakistan,Rawalpindi,9,0,9,"Islamic militants storm a security headquarters, killing six officers in the siege and three more taken hostage."
12410,10/10/2009,Somalia,Mogadishu,1,0,1,al-Shabaab militants shoot a man to death at a market.
12411,10/10/2009,Somalia,Afgoye,1,0,1,A Hizbul Islam leader is gunned down by Islamic rivals.
12412,11/10/2009,Iraq,Ramadi,19,80,99,"Three horrific bombings, one at a hospital, leave nineteen innocents dead."
12413,11/10/2009,Thailand,Narathiwat,1,0,1,Muslim militants murder a 37-year-old civilian sitting in a tea shop.
12414,11/10/2009,Thailand,Pattani,1,0,1,A cattle rancher is shot to death in his field by Religion of Peace gunmen.
12415,11/10/2009,Thailand,Yala,1,0,1,A butcher on his way home is gunned down by Islamists.
12416,11/10/2009,Iraq,Mosul,2,0,2,"A university student is among two civilians murdered by the terror group, Islamic State of Iraq."
12417,12/10/2009,Pakistan,Quetta,1,0,1,A Shia man is gunned down in a sectarian attack.
12418,12/10/2009,Iraq,Abu Khamis,2,2,4,"Terrorists target the mayor of a town with a bomb, killing two of his sons instead."
12419,12/10/2009,Iraq,Buhriz,4,5,9,Jihadi bombers take out four Iraqis in multiple attacks.
12420,12/10/2009,Pakistan,Alpuri,41,45,86,A 12-year-old suicide bomber slaughters forty-one people at a crowded market.
12421,13/10/2009,Iraq,Baquba,6,10,16,"A Shahid detonates himself in a cafe, killing at least six others."
12422,13/10/2009,Somalia,Mogadishu,4,11,15,Four people are killed when Hizbul Islam terrorists ambush government troops.
12423,14/10/2009,Iraq,Karbala,6,45,51,"Sunni bombers strike three groups of praying Shias in separate attacks, leaving a half-dozen dead."
12424,14/10/2009,Afghanistan,Zabul,2,6,8,Religious extremists kill two local soldiers with a roadside bomb.
12425,14/10/2009,Pakistan,Sherazi Mohalla,1,0,1,A man is stabbed to death in front of his wife and child by his in-laws for marrying without permission.
12426,15/10/2009,Pakistan,Lahore,28,67,95,"Shahid suicide attackers brutally assault two police academies, killing nearly thirty people."
12427,15/10/2009,Pakistan,Peshawar,1,12,13,A 6-year-old child is blown apart by a remote-controlled car bomb along a city street.
12428,15/10/2009,Pakistan,Kohat,11,16,27,Eleven people are murdered when a Fedayeen car bomber plows into a crowd.
12429,16/10/2009,Somalia,Mogadishu,1,0,1,A young policeman is gunned down in an Islamist drive-by.
12430,16/10/2009,Iraq,Mosul,1,0,1,A local soldier standing guard is murdered by a suicide bomber.
12431,16/10/2009,Iraq,Tal Afar,15,70,85,"A suicide bomber at a rival mosque yell's 'Allah Akbar', then opens up on worshippers with a machine-gun before detonating, leaving at least fifteen dead in the massacre."
12432,16/10/2009,Pakistan,Peshawar,15,24,39,Two girls are among fifteen innocents incinerated by Fedayeen suicide bombers.
12433,17/10/2009,Pakistan,FATA,3,6,9,Three local soldiers are killed in a bomb set by religious extremists.
12434,17/10/2009,Iraq,Mosul,4,4,8,A child is among four people cut down by Islamic militants in separate attacks.
12435,17/10/2009,Iraq,Falluja,4,10,14,"Mujahideen set off a roadside bomb, killing four local security personnel."
12436,18/10/2009,India,Poonch,1,0,1,A local soldier is murdered when terrorists plant a landmine in the road.
12437,18/10/2009,Iraq,Mosul,1,5,6,Muslim gunmen take down a child in a drive-by.
12438,18/10/2009,Iraq,Adhamiya,8,29,37,"Mujahideen set off two bombs in commercial areas, sending eight civilians to Allah."
12439,18/10/2009,Iran,Pisheen,42,25,67,"A suicidal Sunni from the 'Soldiers of God' group detonates in a gymnasium, slaughtering nearly fifty people."
12440,18/10/2009,Egypt,Attaleen,1,0,1,Muslims gun down a 61-year-old Christian whose son was dating a Muslim girl.
12441,18/10/2009,Iraq,Baghdad,5,16,21,Five patrons at a cafe are blown to bits by a bomb planted on a motorcycle.
12442,19/10/2009,Somalia,Bardere,1,0,1,An official is assassinated by al-Shabaab.
12443,19/10/2009,Somalia,Galkayo,1,0,1,A Christian woman is murdered by Islamists inside her home for refusing to wear a veil.
12444,19/10/2009,Iraq,Baghdad,4,13,17,"Jihadis bomb a restaurant and a minibus, killing at least four innocents."
12445,19/10/2009,Thailand,Yala,0,28,28,"Islamic militants set off a bomb at a packed market, injuring over two dozen."
12446,20/10/2009,Pakistan,Orakzai,2,0,2,Two young police recruits are abducted and shot to death in captivity by hardliners.
12447,20/10/2009,Iraq,Saqlawiya,4,12,16,Four people are murdered when Mujahideen set off a car bomb at a gas station.
12448,20/10/2009,Iraq,Mosul,2,0,2,Two men are kidnapped and murdered by Muslim terrorists.
12449,20/10/2009,Pakistan,Islamabad,6,29,35,"Two suicide bombers attack a women's university about a minute apart, leaving six students and staff dead."
12450,20/10/2009,Thailand,Narathiwat,1,0,1,Islamists shoot a 57-year-old man to death inside his construction shop.
12451,21/10/2009,Philippines,Patikul,1,2,3,Abu Sayyaf members plant a bomb near a water pipe which kills an inspector.
12452,21/10/2009,Thailand,Narathiwat,3,2,5,A woman is among three construction workers murdered by Mujahideen.
12453,21/10/2009,Thailand,Narathiwat,2,0,2,Two men are gunned down by Islamic militants in separate attacks.
12454,21/10/2009,Iraq,Iskandariya,2,12,14,"Jihadis bomb a livestock market, killing at least two attendees."
12455,21/10/2009,Iraq,Mosul,2,0,2,A girl and her father are murdered by Muslim gunmen.
12456,21/10/2009,Iraq,Bousef,2,0,2,A man and woman are gunned down by Sunni militants.
12457,21/10/2009,Iraq,Kirkuk,2,1,3,A shopkeeper and journalist are killed in separate attacks.
12458,22/10/2009,Russia,Plievo,1,0,1,Fundamentalists murder a shop owner for selling alcohol.
12459,22/10/2009,Somalia,Mogadishu,18,60,78,"Islamic militia mortar an airport, killing at least eighteen innocents."
12460,22/10/2009,Pakistan,Islamabad,2,0,2,Talibanis assassinate a brigadier and his driver in broad daylight in the capital.
12461,22/10/2009,Thailand,Yala,1,0,1,Muslim radicals shoot a man to death inside his home.
12462,22/10/2009,Ingushetia,Nazran,1,2,3,Islamists kill the driver of a police vehicle with a roadside bomb.
12463,22/10/2009,Algeria,Kabylia,7,2,9,Seven security personnel are cut down by automatic weapons at close range while they are riding a bus.
12464,23/10/2009,Pakistan,South Waziristan,18,6,24,"Eighteen people in a wedding party, mostly children, perish in a horrific bombing attack on a minibus."
12465,23/10/2009,Pakistan,Kamra,8,17,25,"A Fedayeen pedals to paradise, taking eight others with him in the suicide blast outside an aeronautical complex."
12466,23/10/2009,Pakistan,Peshawar,0,15,15,"Islamists car bomb a restaurant, injuring fifteen people."
12467,23/10/2009,Thailand,Yala,2,1,3,"Two men are murdered by Mujahideen gunmen, one in his home."
12468,23/10/2009,Thailand,Pattani,1,0,1,A 29-year-old villager is shot in the head by Muslim militants.
12469,23/10/2009,Iraq,Abu Ghraib,2,3,5,"Islamic radicals bomb a family in their vehicle, killing two members."
12470,23/10/2009,Thailand,Pattani,1,0,1,A 23-year-old man is murdered by Islamic terrorists.
12471,24/10/2009,Thailand,Pattani,1,0,1,A Buddhist working as a janitor is shot to death by Muslim militants at a tea shop.
12472,24/10/2009,Thailand,Pattani,1,0,1,Islamists gun down a farmer in his field.
12473,24/10/2009,Pakistan,Punjab,1,0,1,A police officer is killed by a Fedayeen bomber.
12474,24/10/2009,Iraq,Tikrit,2,7,9,A suicide bomber takes out seven at a political headquarters.
12475,25/10/2009,Iraq,Baghdad,160,540,700,Two massive car bombs take out one-hundred and sixty Iraqis standing near or in government buildings.  The dead include 30 children at a day care center.  The Islamic State of Iraq takes responsibility.
12476,25/10/2009,Somalia,Merca,2,0,2,Two men are shot to death by al-Shabaab militants
12477,25/10/2009,Yemen,Dalea,2,3,5,Two local soldiers are gunned down in a suspected sectarian ambush.
12478,26/10/2009,Iraq,Karbalah,4,12,16,A suicide bomber sends four souls to Allah.
12479,26/10/2009,Thailand,Pattani,2,0,2,Dedicated Muslims gun down two Buddhist civilians looking for food.
12480,26/10/2009,Iraq,Mosul,2,2,4,Mujahideen gunmen murder two civilians.
12481,27/10/2009,Pakistan,Mohmand,2,3,5,"Religious extremists attack a police post, killing two officers."
12482,27/10/2009,Pakistan,Bajaur,1,0,1,Taliban radicals shoot a man to death while he is sitting in his shop.
12483,27/10/2009,Iraq,Baiji,1,0,1,Terrorists attack a bomb to a car which kills an 11-year-old boy trying to remove it.
12484,27/10/2009,Iraq,Tikrit,2,0,2,"Jihadis blow up an oil tanker, killing the two drivers."
12485,28/10/2009,Iraq,Baghdad,3,4,7,Three women sitting on a minibus are blown to bits by Islamic bombers.
12486,28/10/2009,Thailand,Pattani,1,0,1,A 78-year-old Buddhist man is shot off his motorbike by Muslim terrorists.
12487,28/10/2009,Iraq,Mosul,3,5,8,Mujahideen kill three civilians with a roadside bomb.
12488,28/10/2009,Afghanistan,Kabul,9,9,18,"Mujahideen force their way into a UN guesthouse, where they murder nine people, including six international workers."
12489,28/10/2009,Thailand,Pattani,1,0,1,"Muslim radicals shoot a Buddhist motorcycle shop owner to death, then set fire to his body."
12490,28/10/2009,Pakistan,Peshawar,117,200,317,Over one-hundred people - mostly women and children - are blown to bits by a massive car bomb blast at a busy market.
12491,28/10/2009,Thailand,Pattani,2,0,2,Two civilians are gunned down in separate Muslim drive-bys.
12492,29/10/2009,Iraq,Baquba,1,2,3,A civilian is taken out by a Fedayeen suicide bomber outside a hospital.
12493,29/10/2009,Iraq,Mosul,3,1,4,Sunni gunmen murder three Iraqi policemen at point-blank range.
12494,29/10/2009,Afghanistan,Kandahar,4,0,4,A child is among four Afghan civilians torn to pieces by an Islamist bomb.
12495,30/10/2009,Iraq,Baghdad,1,3,4,Mujahideen bombers murder a government official.
12496,30/10/2009,Afghanistan,Nangarhar,9,0,9,All nine civilians riding in a taxi are slaughtered by Taliban bombers.
12497,30/10/2009,Iraq,Tikrit,1,0,1,A young man has his throat slashed by Sunni militants.
12498,30/10/2009,Pakistan,Pir Sarhandi Goth,1,0,1,An older homosexual man is pulled from his home and beaten to death by a Muslim mob.
12499,30/10/2009,Thailand,Yala,1,1,2,"A Buddhist woman is brutally shot to death, and her husband is seriously injured, by Muslim radicals."
12500,31/10/2009,Thailand,Yala,1,0,1,"Islamists kidnap a local man, handcuff him, then shoot him in the head."
12501,31/10/2009,Philippines,Sulu,1,4,5,"Moro Islamists open fire on a passing patrol, killing at least one."
12502,31/10/2009,Pakistan,Khyber,2,7,9,"Sunni hardliners blow up a girls' school and mortar a residential neighborhood, killing two civilians."
12503,31/10/2009,Pakistan,Bara,7,12,19,Lashkar-e-Islam members use a roadside bomber to murder seven security personnel.
12504,1/11/2009,Somalia,Lascanood,5,4,9,Suspected Shabaab radicals blow up a car with five people inside.
12505,1/11/2009,Iraq,Karbala,3,15,18,Terrorists plant a bomb on a bus that leaves three people dead.
12506,1/11/2009,Dagestan,Bavtugai,1,0,1,A local mosque official is assassinated by extremists.
12507,1/11/2009,India,Srinagar,2,0,2,Islamists murder two traffic cops in a hit-and-run surprise attack at an intersection.
12508,1/11/2009,Philippines,Banisilan,1,2,3,"Moro Islamists ambush a car carrying civilians, shooting at least one to death."
12509,1/11/2009,Iraq,Mussayab,9,38,47,"Jihadis rig a bicycle with explosives, then set it off in a market, killing at least nine innocents."
12510,1/11/2009,Iraq,Ramadi,3,5,8,A Fedayeen suicide bomber takes down three Iraqis.
12511,2/11/2009,Thailand,Yala,2,0,2,Two men riding in a pickup truck are shot to death by a terrorist disguised in a burka.
12512,2/11/2009,Thailand,Pattani,2,0,2,Two security personnel are gunned down by Muslim rebels in separate attacks.
12513,2/11/2009,USA,"Glendale, AZ",1,1,2,A woman dies from injuries suffered when her father runs her down with a car for being too 'Westernized.'
12514,2/11/2009,Thailand,Narathiwat,1,0,1,Islamists break into a house and murder a villager.
12515,2/11/2009,Thailand,Yala,2,0,2,Two men are killed in a Religion of Peace drive-by.
12516,2/11/2009,Pakistan,Lahore,0,25,25,Twenty-five people are injured when a suicide bomber detonates along a city street.
12517,2/11/2009,Iraq,Khanaqin,2,0,2,A man and his son are gunned down by Muslim terrorists.
12518,2/11/2009,Pakistan,Rawalpindi,36,63,99,"Fundamentalists set off a massive bomb near a line of people outside a bank, putting down at least thirty-five."
12519,3/11/2009,Thailand,Pattani,2,0,2,Two Buddhist truck drivers are brutally slain and then burned by Religion of Peace extremists.
12520,3/11/2009,Afghanistan,Helmand,5,8,13,"A Taliban gunmen disguised as a policeman suddenly opens fire at a police base, killing five British soldiers in cold blood."
12521,3/11/2009,Saudi Arabia,Jazan,1,11,12,"Islamic rebels gun down a security officer ""with the support and assistance of Allah."""
12522,3/11/2009,Iraq,Abu Ghraib,3,0,3,"Mujahid bombers wipe out a family of three, including a girl."
12523,3/11/2009,Yemen,Hadramut,8,0,8,"al-Qaeda militants open fire on a vehicle, machine-gunning eight people to death."
12524,4/11/2009,Pakistan,Bajaur,2,2,4,Two female schoolteachers are brutally shot to death by Taliban extremists.
12525,5/11/2009,USA,"Ft. Hood, TX",13,31,44,"A Muslim psychiatrist yelling 'Allah Akbar' murders thirteen unarmed U.S. soldiers on their base in Texas, including a pregnant woman."
12526,5/11/2009,Philippines,Zamboanga,2,8,10,Two people are killed when suspected Islamists fire into a commuter bus.
12527,6/11/2009,Pakistan,Hangu,1,4,5,A policeman is gunned down by Islamic terrorists.
12528,6/11/2009,Iraq,Baqubah,1,1,2,Sunni fundamentalists shoot a barber to death.
12529,6/11/2009,Iraq,Rashad,1,0,1,Suspected al-Qaeda gunmen take down an Iraqi.
12530,6/11/2009,Somalia,Merca,1,0,1,A 33-year-old man is brutally stoned to death for adultery.  The execution takes about seven minutes.
12531,7/11/2009,Afghanistan,Helmand,3,0,3,"Religious extremists blow up a vehicle carrying local soldiers, killing three."
12532,7/11/2009,Yemen,Al Khubah,4,36,40,"Shiite rebels reportedly shell a residential area, killing four women from the same family."
12533,7/11/2009,Pakistan,Hangu,3,2,5,"Islamic hardliners attack a local military base with rockets, killing three."
12534,7/11/2009,Iraq,Abu Ghraib,1,3,4,An al-Qaeda bombing leaves one dead.
12535,8/11/2009,Iraq,Kut,1,0,1,"A young woman is kidnapped, bound and shot to death by Muslim terrorists."
12536,8/11/2009,Iraq,Kirkuk,1,0,1,Mujahideen gun down an oil company worker.
12537,8/11/2009,Somalia,Hodon,2,8,10,Two civilians are killed during an attack by Islamic militia.
12538,8/11/2009,Pakistan,Mattani,12,36,48,"A Fedayeen suicide bomber strikes a packed market, blasting at least a dozen innocents to death."
12539,8/11/2009,India,Rajouri,2,1,3,A man and his wife are murdered in their home by intruding Islamic gunmen.
12540,8/11/2009,Thailand,Pattani,2,3,5,A young man eating in a restaurant is among two people killed in separate Mujahid shootings.
12541,9/11/2009,Pakistan,Bajaur,3,1,4,Three local soldiers are murdered in two Mujahideen bombing and shooting attacks.
12542,9/11/2009,Iraq,Kut,1,0,1,A young woman is the victim of an honor killing by her brother.
12543,9/11/2009,Philippines,Jolo,1,0,1,Abu Sayyaf militants cut the head off of a Christian school principal and leave it in a paper bag at a gas station.
12544,9/11/2009,Thailand,Yala,1,1,2,A young Buddhist man collecting plants is brutally ambushed and killed by Religion of Peace advocates.
12545,9/11/2009,Pakistan,Peshawar,3,5,8,A woman and a rickshaw driver are among three people blown up by a Shahid suicide bomber.
12546,9/11/2009,Thailand,Narathiwat,1,0,1,Islamists shoot and kill a 53-year-old riding home on his motorcycle.
12547,9/11/2009,Algeria,Tarah,2,5,7,Fundamentalists set off a bomb that kills five local soldiers.
12548,10/11/2009,Iran,Tehran,1,0,1,The Islamic Republic of Iran assassinates a doctor who exposed torture by poisoning his salad.
12549,10/11/2009,Thailand,Pattani,1,0,1,A villager is gunned down by Muslim militants.
12550,10/11/2009,Afghanistan,Paktika,2,13,15,"The Taliban fire a rocket into a home, killing two residents."
12551,10/11/2009,Thailand,Narathiwat,1,0,1,Islamists murder a man as he is walking outside his home.
12552,10/11/2009,Iraq,Balad,2,2,4,Two policemen are cut down in an urban ambush by Sunni gunmen.
12553,10/11/2009,Pakistan,Peshawar,34,104,138,Thirty-four people are blown to bits by a Shahid car bomber along a crowded city street lined with shops.  Women and children are among the dead.
12554,11/11/2009,Somalia,Puntland,2,0,2,A judge and a lawmaker are assassinated by suspected al-Shabaab militants in separate incidents.
12555,11/11/2009,Pakistan,Mohmand,10,14,24,"Two local soldiers, kidnapped and beheaded, are among ten murdered by Taliban Islamists in two attacks."
12556,11/11/2009,Afghanistan,Zabul,2,3,5,Two civilians are blown to bits by a Fedayeen suicide bomber.
12557,12/11/2009,Pakistan,Peshawar,1,0,1,An Iranian official is gunned down in a sectarian attack blamed on a Sunni group.
12558,12/11/2009,Pakistan,Hangu,2,6,8,"Taliban extremists detonate explosives outside a home, killing at least two residents."
12559,12/11/2009,Iraq,Mosul,3,0,3,"Three civilians are killed in separate Mujahid shooting attacks, including a teenager."
12560,12/11/2009,Thailand,Pattani,2,0,2,Muslim radicals gun down a older Buddhist couple at a rice mill.
12561,12/11/2009,Iraq,Baghdad,1,0,1,A female high school teacher is shot to death by Muslim terrorists.
12562,12/11/2009,Afghanistan,Nangarhar,2,2,4,Two children are blown to bits by Islamic bombers.
12563,13/11/2009,Pakistan,Bannu,6,27,33,Six people lose their lives to a suicide car bomber.
12564,13/11/2009,Afghanistan,Kabul,2,4,6,A Taliban blast leaves at least two Afghans dead.
12565,13/11/2009,Pakistan,Peshawar,10,55,65,A Shahid suicide truck bomber takes out ten at a government building.
12566,13/11/2009,Iraq,Baghdad,2,0,2,A policeman and his brother are murdered by Islamic gunmen.
12567,13/11/2009,Afghanistan,Kabul,4,0,4,Two civilians and three soldiers are killed in separate roadside bombings by religious fundamentalists.
12568,13/11/2009,Iraq,Mosul,1,0,1,A young man is kidnapped and shot in the head by terrorists.
12569,13/11/2009,Thailand,Yala,1,0,1,An 18-year-old is shot to death in a Religion of Peace drive-by attack.
12570,14/11/2009,Somalia,Mogadishu,1,0,1,A 23-year-old Christian convert is kidnapped by Islamists and executed with two shots to the head.
12571,14/11/2009,Somalia,Mogadishu,5,11,16,At least five civilians are killed during a mortar attack by Islamic militia.
12572,14/11/2009,Pakistan,Peshawar,15,25,40,Four children and a woman are among fifteen innocents blown to bits by a suicide bomber.
12573,14/11/2009,Iraq,Mosul,1,0,1,A 16-year-old Christian boy is gunned down outside his home by suspected radicals.
12574,14/11/2009,Thailand,Narathiwat,2,0,2,Two men are murdered by Muslim gunmen at a wood processing plant.
12575,15/11/2009,Pakistan,Bajaur,1,0,1,An anti-Taliban tribal leader is murdered and his home destroyed.
12576,15/11/2009,Iraq,Mosul,1,5,6,Jihadi bombers take out a 12-year-old child.
12577,16/11/2009,India,Kupwara,2,0,2,"Pakistani infiltrators attack an Indian security patrol, killing two members."
12578,16/11/2009,India,Samba,2,0,2,Mujahideen kill a border policeman and his driver with a landmine.
12579,16/11/2009,Iraq,Kirkuk,6,17,23,Six people are blown to bits by Islamic car bombers.
12580,16/11/2009,Iraq,al-Saadan,13,0,13,al-Qaeda militants kidnap and execute thirteen Sunni Iraqis.
12581,16/11/2009,Afghanistan,Tagab,14,38,52,"Religious extremists rocket a market, killing at least fourteen people."
12582,16/11/2009,Pakistan,Peshawar,4,43,47,A Fedayeen suicide bomb blast outside a shop leaves at least four dead.
12583,17/11/2009,Thailand,Pattani,1,0,1,A Holy Warrior on a motorbike guns down a school bus driver through his side window.
12584,17/11/2009,Afghanistan,Helmand,2,0,2,Two Afghan civilians are killed in a roadside attack by Sunni terrorists.
12585,17/11/2009,Afghanistan,Kunduz,4,0,4,Taliban hardliners murder four guards at a security firm.
12586,17/11/2009,Somalia,Eelboon,1,0,1,A 29-year-old woman is planted in the ground and pelted to death with stones over adulterous sex.
12587,17/11/2009,Iraq,Baghdad,2,6,8,A Jihad bomb kills two Iraqis.
12588,19/11/2009,Thailand,Pattani,1,0,1,Muslims shoot a 32-year-old Buddhist construction worker to death as he is traveling to pick up his children.
12589,19/11/2009,Thailand,Pattani,1,0,1,A 35-year-old Buddhist university employee is gunned down by Islamists.
12590,19/11/2009,Pakistan,Peshawar,19,50,69,Nineteen innocents are incinerated in a suicide bomb attack on a courthouse.
12591,19/11/2009,Afghanistan,Oruzgan,10,13,23,A Shahid suicide car bomber takes out ten civilians along a city street.
12592,19/11/2009,Russia,Moscow,1,1,2,An anti-Islam priest is assassinated in his own church by a suspected Muslim gunman.
12593,19/11/2009,Pakistan,Karachi,1,0,1,A Shiite cleric is gunned down by sectarian rivals.
12594,19/11/2009,Pakistan,Orakzai,2,0,2,A policeman and his elderly father a shot to death by Taliban militants.
12595,20/11/2009,Iraq,Mosul,3,5,8,Three Iraqis are blown apart by a roadside bomb.
12596,20/11/2009,Pakistan,Peshawar,3,7,10,Jihadis take out three policemen with a shrapnel bomb.
12597,20/11/2009,Pakistan,Karachi,1,1,2,A Sunni is shot to death by sectarian rivals.
12598,20/11/2009,Afghanistan,Farah,16,25,41,"A suicide bomber on a motorcycle detonates in the middle of a packed market, slaughtering about sixteen shoppers."
12599,21/11/2009,Philippines,Surallah,1,0,1,A 5-year-old girl is killed when Muslim rebels fire on a group of soldiers.
12600,21/11/2009,Iraq,Mosul,1,0,1,A school teacher is assassinated by Muslim gunmen.
12601,21/11/2009,Pakistan,North Waziristan,4,0,4,Four security officers are killed in a rocket attack by Taliban fundamentalists.
12602,21/11/2009,Saudi Arabia,Jebel Rumayh,3,3,6,Shiite radicals infiltrate the border and kill three Saudi soldiers.
12603,22/11/2009,Afghanistan,Spin Boldak,5,0,5,All five passengers in a police vehicle are ripped to shreds by a Sunni bomb.
12604,22/11/2009,Iraq,Mosul,1,4,5,A child is incinerated in a thermal bomb attack by Muslim terrorists.
12605,22/11/2009,Afghanistan,Helmand,3,2,5,Taliban radicals take out three local security personnel in a roadside attack.
12606,22/11/2009,Iraq,Garma,7,5,12,"Sunnis bomb a checkpoint, killing seven Iraqis."
12607,22/11/2009,Somalia,Afmadow,2,0,2,At least two civilians are killed in the crossfire when rival Islamist groups clash.
12608,22/11/2009,Thailand,Pattani,1,0,1,A female Buddhist teacher is gunned down in front of her home by Islamic militants.
12609,22/11/2009,Afghanistan,Landikotal,6,10,16,"The Taliban mortar a crowded bazaar, killing at least six civilians."
12610,24/11/2009,Iraq,Baghdad,2,0,2,Two Sunni imams are assassinated in separate bomb attacks.
12611,24/11/2009,Afghanistan,Khost,4,0,4,Two women are among four civilians shot to death at point-blank range by Mujahideen.
12612,24/11/2009,Afghanistan,Khost,5,3,8,Four children are blown to bits when Islamic fundamentalists set off a roadside bomb next to a family vehicle.
12613,24/11/2009,Thailand,Pattani,2,0,2,Two young men are shot to death by Muslim militants in separate attacks.
12614,24/11/2009,Pakistan,Bajaur,3,4,7,Two children are among three members of a family killed when suspected Mujahid rocket their home.
12615,25/11/2009,Thailand,Narathiwat,1,0,1,Islamic gunmen murder a 47-year-old man as he is returning home from a tea shop.
12616,25/11/2009,Iraq,Mosul,3,1,4,Islamist bombers take out three Iraqi cops.
12617,25/11/2009,Yemen,San'a,1,0,1,al-Qaeda posts a video of the torture and gruesome execution of a 41-year-old intelligence officer.
12618,25/11/2009,Iraq,Karbala,5,36,41,Five people are murdered by a brutal double bombing at a restaurant.
12619,25/11/2009,Iraq,Tarmiya,6,0,6,A married couple and two daughters are among six innocents slain in a sectarian home invasion.
12620,25/11/2009,Somalia,Mogadishu,1,1,2,A civilian is killed when Jihadis throw a grenade into the street.
12621,26/11/2009,Dagestan,Makhachkala,1,0,1,A police officer is gunned down by Muslim militants.
12622,26/11/2009,Iraq,Iskandariya,2,28,30,Children are among the casualties when Sunni radicals set off a bomb at a crowded marketplace.
12623,26/11/2009,Iraq,Yousifiya,2,10,12,"Jihadis explode a car bomb at a bus stop, killing two Iraqis."
12624,26/11/2009,Thailand,Yala,1,0,1,Islamists shoot a 62-year-old civilian to death as he is riding a motorbike.
12625,27/11/2009,Pal. Auth.,Gaza,1,0,1,A woman is strangled with a wet towel by her family members to restore their 'honor'.
12626,27/11/2009,Russia,Bologoye,26,96,122,Twenty-six passengers are killed when Islamic terrorists derail a train with a bomb.
12627,27/11/2009,Afghanistan,Farah,3,0,3,Three Afghanis are taken out by a Fedayeen suicide bomber.
12628,27/11/2009,Pakistan,Bajaur,1,3,4,A tribal leader is assassinated by Taliban bombers at a mosque.
12629,28/11/2009,Somalia,Baladweyn,2,1,3,Two clerics are assassinated by Hizbul-Islam gunmen outside a mosque.
12630,28/11/2009,India,Bhopal,3,0,3,Three people are gunned down in an ambush by a SIMI terrorist.
12631,29/11/2009,Iraq,Ghalbiyah,1,2,3,Suspected al-Qaeda bombers take down another Iraqi.
12632,29/11/2009,Pakistan,Kohat,33,65,98,At least thirty people celebrating a holiday are blown to bits when a suicide car bomber plows into a crowded market.
12633,29/11/2009,Afghanistan,Nimroz,6,2,8,Six Afghan police officers are murdered in cold blood by a Talibani disguised as one of them.
12634,30/11/2009,Iraq,Mosul,1,3,4,Muslim gunmen ambush a car carrying a family from a religious minority.  The father is killed.  Two women and a child are injured.
12635,30/11/2009,Thailand,Pattani,1,0,1,A man is shot to death inside his home by Islamic radicals.
12636,1/12/2009,Pakistan,Swat,1,0,1,Islamic fundamentalists murder the head of a local peace committee.
12637,1/12/2009,Pakistan,Orakzai,3,0,3,Three tribal leaders are assassinated by Sunni terrorists.
12638,1/12/2009,Pakistan,Swat,1,13,14,A teen suicide bomber murders a lawmaker inside his home.
12639,1/12/2009,Somalia,Bosasso,2,25,27,"Suspected hardliners toss a grenade into a movie theater, leaving two patrons dead from shrapnel injury."
12640,2/12/2009,Iraq,Baghdad,1,0,1,A civilian is gunned down in a sectarian attack at a cafe.
12641,2/12/2009,Pakistan,Islamabad,2,11,13,"A young man straps explosives to his body and detonates at the entrance of a naval complex, killing two security guards."
12642,3/12/2009,Ingushetia,Malgobek,1,0,1,A government official is assassinated by Islamic militants.
12643,3/12/2009,Iraq,Baghdad,1,6,7,Mujahideen blow up a civilian at a market.
12644,3/12/2009,Somalia,Mogadishu,22,46,68,Doctors and students are among twenty-two people blown to bits at a medical school graduation by a Shahid.
12645,3/12/2009,Iraq,Tikrit,11,15,26,"A Fedayeen suicide bomber blows himself up at a packed market, taking eleven innocents with him."
12646,3/12/2009,Thailand,Pattani,3,0,3,A 17-year-old boy is among three members of a family brutally gunned down in their home by Islamic separatists.
12647,3/12/2009,Pakistan,Karol,1,0,1,A Christian man is shot to death by Muslims after refusing to 'embrace' Islam.
12648,4/12/2009,USA,"Binghamton, NY",1,0,1,A non-Muslim Islamic studies professor is stabbed to death by a Muslim grad student in revenge for 'persecuted' Muslims.
12649,4/12/2009,India,Srinagar,0,0,0,Al-Nasireen gunmen assassinate a political leader outside his home.
12650,4/12/2009,Pakistan,Mohmand Agency,6,13,19,Mujahideen bombers take out six members of a wedding party traveling in a mini-bus.
12651,4/12/2009,Iraq,Tuz Khormato,1,0,1,An ethnic minority member is gunned down in his home by Islamic terrorists.
12652,4/12/2009,Pakistan,Rawalpindi,40,86,126,Seventeen children at a mosque are among nearly forty people cut down in a barbaric shooting and bombing attack by Sunni hardliners.
12653,4/12/2009,Dagestan,Khasavyurt,2,7,9,A civilian having lunch at a cafe is among two people murdered by Muslim terrorists in separate attacks.
12654,4/12/2009,Jordan,Amman,1,0,1,"A 34-year-old woman, nine months pregnant, is stabbed to death by her brother over alleged adultery."
12655,5/12/2009,Philippines,Jolo,1,12,13,One person is killed when suspected Abu Sayyaf militants set off a bomb.
12656,5/12/2009,Iraq,Mosul,5,1,6,Mujahideen shoot five people to death including a mother and an elderly civilian.
12657,6/12/2009,Somalia,Bosaso,1,0,1,A cleric is assassinated by suspected Islamic militia.
12658,6/12/2009,Pakistan,Bajaur,2,2,4,The Taliban murder two tribesmen outside a mosque.
12659,6/12/2009,Iraq,Abu Ghraib,4,0,4,Four local police manning a checkpoint are machine-gunned to death at point-blank range.
12660,7/12/2009,Pakistan,Lahore,50,150,200,At least fifty people are incinerated by twin bombings at a crowded marketplace.
12661,7/12/2009,Iraq,Baghdad,8,40,48,Seven children are among eight dead when Sunni radicals bomb a Shia school.
12662,7/12/2009,Thailand,Narathiwat,2,11,13,A Buddhist man and woman are murdered by Muslim bombers at a busy market.
12663,7/12/2009,Thailand,Pattani,1,4,5,A pro-government cleric is gunned down by Islamic separatists.
12664,7/12/2009,India,Baramulla,1,0,1,Muslim terrorists gun down a political worker outside his home.
12665,7/12/2009,Pakistan,Karachi,1,0,1,A Shia leader is shot to death by Sunni rivals.
12666,7/12/2009,Iraq,Tarmiyah,1,4,5,A woman is blown murdered in her home by Mujahid bombers.
12667,7/12/2009,Iraq,Tarmiyah,8,0,8,Six Iraqis are gunned down by al-Qaeda.  Two more bodies are discovered in Kirkuk.
12668,7/12/2009,Pakistan,Peshawar,11,45,56,Eleven people at a courthouse are blown to bits by a Fedayeen suicide bomber.
12669,8/12/2009,Pal. Auth.,Jerash,1,0,1,A man stabs his 30-year-old sister to death over suspected immoral behavior.
12670,8/12/2009,Iraq,Baghdad,127,448,575,"Five car bombs, one outside a fine arts center, leave at least one-hundred and twenty Iraqis dead and nearly five hundred more in agony."
12671,8/12/2009,Pakistan,Multan,12,20,32,A dozen Pakistanis are blown to bits by Taliban bombers.
12672,9/12/2009,Iraq,Baghdad,4,11,15,Two street sweepers are among four Iraqis murdered by Islamic bombers in attacks on a library and minibus.
12673,9/12/2009,Thailand,Pattani,1,0,1,A civilian is shot to death in his car by Muslim militants.
12674,9/12/2009,Thailand,Yala,1,17,18,A series of bombs rocks several neighborhoods.  A bomb disposal technician is killed.
12675,9/12/2009,Iraq,Mosul,2,0,2,Two Christian brothers are kidnapped and shot to death by Muslim terrorists.
12676,10/12/2009,Thailand,Narathiwat,3,8,11,Three Buddhist women are torn to shreds by a remote-controlled bomb planted on a motorcycle outside a restaurant.
12677,11/12/2009,Afghanistan,Paktika,5,15,20,Five people are blown to bits by a Shahid suicide bomber.
12678,11/12/2009,Iraq,Baghdad,1,3,4,"Jihadis plant a bomb under a family car, killing the father and injuring three relatives."
12679,11/12/2009,Iraq,Yusufiyah,6,21,27,A car bomb near a shop takes out six Iraqis.
12680,12/12/2009,Iraq,Khalis,1,2,3,A farmer is shot to death by Islamic militants.
12681,12/12/2009,Iraq,Kirkuk,3,4,7,An IED attack leaves three Iraqis dead.
12682,13/12/2009,Iraq,Mosul,2,21,23,A Fedayeen suicide bomber murders two young police recruits.
12683,13/12/2009,Iraq,Fallujah,2,15,17,Islamic bombers manage to kill two Iraqis with a roadside blast.
12684,13/12/2009,Somalia,Afgoye,1,0,1,A 48-year-old man is pelted to death with stones by Hezb al-Islam for adultery.
12685,13/12/2009,Thailand,Pattani,2,0,2,Two civilians are shot to death by Islamic militants in separate attacks.
12686,14/12/2009,Iraq,Baghdad,13,33,46,Jihadi bombers take down thirteen Iraqis with successive blasts.
12687,14/12/2009,Iraq,Balad Ruz,22,29,51,A female suicide bomber ends the lives of nearly two-dozen innocent people in a residential area.
12688,14/12/2009,Afghanistan,Lashkar Gah,16,0,16,Sixteen police officers are killed in two terror attacks by Sunni fundamentalists.
12689,14/12/2009,Thailand,Pattani,1,0,1,A 37-year-old woman is slashed to death by Muslim radicals.
12690,14/12/2009,Iraq,al-Manari,4,0,4,A man and his family are murdered in their home by suspected al-Qaeda.
12691,14/12/2009,Thailand,Narathiwat,1,0,1,Muslims gun down a 38-year-old Buddhist.
12692,14/12/2009,Thailand,Pattani,2,0,2,"Two men are shot to death by Islamic militants, one in his home, the other at a barber shop."
12693,15/12/2009,Afghanistan,Gardez,5,0,5,Five people are blown to bits by Jihadi bombers.
12694,15/12/2009,UAE,Abu Dhabi,2,0,2,"An Arab man stabs two Nepali 'infidels' to death, claiming that he was entitled to do so, as a Muslim."
12695,15/12/2009,Iraq,Nineveh,3,0,3,"Muslim radicals throw grenades into a police patrol, brutally killing three Iraqis."
12696,15/12/2009,Iraq,Mosul,4,40,44,Four Christians are killed when Islamic bombers target a church and Christian school.
12697,15/12/2009,Iraq,Mosul,2,0,2,A woman is among two people incinerated by a thermal bomb.
12698,15/12/2009,Afghanistan,Helmand,2,0,2,Two British soldiers are killed by a suicide bomber as they are walking down a street.
12699,15/12/2009,Pakistan,Dera Ghazi Khan,33,60,93,Thirty-three shoppers at an outdoor market are blown apart by a Fedayeen suicide car bomber.
12700,15/12/2009,Afghanistan,Kabul,7,44,51,A suicide car bomber takes out seven people standing outside a hotel.
12701,15/12/2009,Somalia,Bossasso,3,8,11,"Suspected Islamists blow up a pick-up full of local soldiers, killing three."
12702,15/12/2009,India,Shopian,1,0,1,A 21-year-old woman is gunned down in front of her family by Islamic militants.
12703,16/12/2009,Afghanistan,Herat,4,0,4,Four local cops are slaughtered by a Taliban roadside blast.
12704,16/12/2009,Iraq,Baghdad,2,5,7,Sunni bombers take down two Iraqis riding on a bus.
12705,16/12/2009,Pakistan,Khyber,4,27,31,"Fundamentalists throw grenades into a music concert, killing at least four people."
12706,16/12/2009,Thailand,Yala,3,0,3,Three men are shot to death in separate shooting attacks by Islamic insurgents.
12707,17/12/2009,Iraq,Mosul,1,0,1,A 30-year-old Christian man is shot to death in cold blood by Mujahideen.
12708,17/12/2009,Ingushetia,Nazran,2,24,26,Children are among the casualties of a suicide bombing.  A separate shooting leaves two dead.
12709,17/12/2009,Afghanistan,Kandahar,7,3,10,Five women are among seven people murdered by Taliban roadside bombers.
12710,17/12/2009,Pakistan,Bara Tehsil,3,5,8,Three security force personnel are murdered in Taliban ambushes.
12711,17/12/2009,Iraq,Baghdad,1,10,11,A pedestrian is killed by a roadside bomb.
12712,17/12/2009,Thailand,Yala,2,0,2,A 2-year-old girl is gunned down along with her father by Holy Warriors.
12713,18/12/2009,Pakistan,Lower Dir,15,28,43,Children are among fifteen people blown to bits a mosque by a Shahid suicide bomber.
12714,18/12/2009,India,Pulwama,2,0,2,Two people are dragged from their homes and murdered by Mujahideen.  One has his throat slit.
12715,18/12/2009,Iraq,Sulaimaniyah,1,0,1,A civilian is gunned down on his doorstep by Muslim terrorists.
12716,18/12/2009,Somalia,Mogadishu,2,4,6,Two civilians are killed when a mortar fired by suspected Islamic militia strikes a house.
12717,18/12/2009,Pakistan,Haripur,3,0,3,A man and his wife are among three killed in their home by suspected Islamic hardliners.
12718,19/12/2009,Pakistan,Poonch,1,2,3,An Indian border guard is shot by a Muslim sniper from Pakistan.
12719,19/12/2009,Iraq,Mosul,3,1,4,Jihadi gunmen take down three Iraqis in separate attacks.
12720,19/12/2009,Thailand,Narathiwat,3,2,5,Three Buddhists are incinerated when Muslim insurgents blow up a gas tank next to their truck.
12721,20/12/2009,Iraq,Mosul,2,0,2,Mujahideen gun down two local cops.
12722,20/12/2009,Somalia,Mogadishu,1,3,4,One Somali is killed in a mortar attack by Islamic militia.
12723,21/12/2009,Iraq,Tal Afar,4,5,9,A Fedayeen suicide bomber takes out four Iraqis.
12724,21/12/2009,Somalia,Mogadishu,5,0,5,Five Somalis near a minibus are murdered by al-Shabaab bombers.
12725,21/12/2009,Yemen,Abyan,2,9,11,"al-Qaeda militants booby-trap an area with explosives, killing two civilians."
12726,22/12/2009,Iraq,Iskandariya,1,4,5,A civilian dies from shrapnel injures after Jihadis detonate a bomb on a minibus.
12727,22/12/2009,Thailand,Pattani,1,1,2,"Islamic gunmen fire into a family home, killing a 3-year-old girl and seriously injuring her sister."
12728,22/12/2009,Thailand,Pattani,1,0,1,A 37-year-old father is shot full of holes by Muslim militants after dropping his children off at school.
12729,22/12/2009,India,Pampore,2,1,3,Hizbul Mujahideen militants shoot two local cops to death.
12730,22/12/2009,Pakistan,Peshawar,3,16,19,A woman is among three people at a press club blown to bits by a Shahid suicide bomber.
12731,23/12/2009,Iraq,Mosul,2,0,2,A bomb placed near an ancient Christian church kills two people.
12732,23/12/2009,Afghanistan,Helmand,3,5,8,Three innocents are cut down by a Taliban bomb planted on a bicycle.
12733,23/12/2009,Iraq,Baghdad,5,46,51,Sunni bombers murder five Shia pilgrims in three separate attacks.
12734,23/12/2009,Afghanistan,Helmand,3,4,7,Three civilians are killed when fundamentalists detonate a bomb at a bazaar.
12735,23/12/2009,Afghanistan,Spin Boldak,2,3,5,Talibanis take down two civilians with a roadside bomb.
12736,24/12/2009,Iraq,Mosul,1,0,1,A Christian is gunned down in front of his home by Islamists.
12737,24/12/2009,Afghanistan,Paktika,2,0,2,Two civilians are murdered by Jihadi roadside bombers.
12738,24/12/2009,Iraq,Baghdad,12,53,65,Jihadis murder a dozen mourners when they bomb two separate funerals.
12739,24/12/2009,Somalia,Mogadishu,6,25,31,Six civilians are killed during an attack by Hizb al-Islam fundamentalists.
12740,24/12/2009,Pakistan,Rawalpindi,1,2,3,A 6-year-old girl is dismembered by a suicide bomber.
12741,24/12/2009,Iraq,Kirkuk,4,0,4,Four Iraqis are gunned down by suspected al-Qaeda militants.
12742,24/12/2009,Iraq,Hilla,25,105,130,"A crowded bus station is the target of Sunni bombers, who leave twenty-five Iraqis dead and nearly one hundred more in agony."
12743,24/12/2009,Afghanistan,Kandahar,8,3,11,A Shahid suicide bomber on a horse car murders eight innocent people.
12744,24/12/2009,Israel,Einav,1,0,1,An Israeli father of seven is shot to death in his car by Palestinian terrorists.
12745,24/12/2009,Pakistan,Peshawar,4,24,28,"A suicide bomber detonates near a Christian school, killing four others."
12746,25/12/2009,Pakistan,Kalar Kahar,0,60,60,About sixty Christians are injured when a Muslim mob attacks them during Christmas prayers.
12747,25/12/2009,Pakistan,Peshawar,2,0,2,Islamists gun down two local cops.
12748,25/12/2009,Iraq,Baghdad,10,51,61,Ten Shiite pilgrims are murdered in three separate bombing attacks by sectarian rivals.
12749,25/12/2009,Iraq,Mosul,3,0,3,Three unarmed census workers are shot to death in cold blood by Sunni insurgents.
12750,25/12/2009,Algeria,Tizi Ouzou,1,2,3,A local soldier is murdered by fundamentalist bombers.
12751,26/12/2009,Pakistan,Punjab,0,2,2,Two young Christians are shot in the chest after refusing to convert to Islam.
12752,26/12/2009,Pakistan,Karachi,0,26,26,Shiite radicals are suspected of detonating a roadside bomb that injures some twenty-six people at a funeral.
12753,26/12/2009,Iraq,Baghdad,6,22,28,"Two bombs, one near a tent distributing food to Shia pilgrims, leave six Iraqis dead."
12754,26/12/2009,Thailand,Pattani,1,0,1,A man is murdered in front of his home by Muslim separatists.
12755,27/12/2009,Iraq,Touz Khormato,5,25,30,Five Shia pilgrims are blown to bits by Sunni terrorists.
12756,27/12/2009,Iran,Tehran,9,60,69,"Basij militia and Islamic state police fire into a crowd of protesters, killing at least nine."
12757,27/12/2009,Pakistan,Muzaffarabad,15,100,115,"A Shahid suicide bomber blows himself up at a rival mosque, taking at least fifteen innocents with him."
12758,27/12/2009,Pakistan,Sadda,6,0,6,"Islamic fundamentalists blow up a family home, killing six occupants, including five young children."
12759,27/12/2009,Thailand,Yala,2,1,3,Islamists shoot two men to death as they are riding a motorcycle.
12760,28/12/2009,Somalia,Gedo,1,0,1,Islamic militia are suspected of murdered a humanitarian worker in his home.
12761,28/12/2009,Nigeria,Bauchi,3,12,15,At least three security forces are killed during attacks by a local Islamist sect.
12762,28/12/2009,Pakistan,Orakzai,9,6,15,"Taliban hardliners assault a village, killing nine defense volunteers."
12763,28/12/2009,Iraq,Mosul,2,0,2,Jihadi gunmen take down two cement workers.
12764,28/12/2009,Afghanistan,Badghis,2,3,5,Two local cops are murdered in a Taliban ambush.
12765,28/12/2009,Pakistan,Karachi,45,82,127,More than forty people in a religious procession are sent straight to Allah by a Fedayeen suicide bomber.
12766,28/12/2009,Pakistan,Chamarkand,2,5,7,Two local soldiers are killed in a Taliban rocket attack on their checkpoint.
12767,29/12/2009,Pakistan,Lahore,2,0,2,"A man slits his daughter's throat, and stabs her lover to death, over a suspected illicit affair."
12768,29/12/2009,Iraq,Tal Massoud,5,0,5,Four people are shot to death and one beheaded by suspected al-Qaeda elements.
12769,29/12/2009,Iraq,Baghdad,4,18,22,Two woman are among four Iraqis murdered in two Jihad attacks.
12770,29/12/2009,Afghanistan,Herat,1,2,3,"A terrorist in an Afghan army uniform opens fire on three unsuspecting NATO soldiers, killing one."
12771,29/12/2009,Thailand,Pattani,1,0,1,A 45-year-old man is gunned down in his pickup truck by Islamic radicals.
12772,29/12/2009,Thailand,Pattani,1,0,1,A 49-year-old man is shot to death by militant Muslims at a tea shop.
12773,30/12/2009,India,Baramulla,4,0,4,"Hizb-ul-Mujahideen gunmen open up on four Indian cops at point-blank range, leaving all four dead."
12774,30/12/2009,Iraq,Ramadi,27,105,132,"Twin suicide blasts take down over twenty-five Iraqis and leave over one hundred others with injuries, including lost limbs."
12775,30/12/2009,Iraq,Khalis,7,25,32,"Dedicated Sunnis bomb a Shia religious festival, leaving seven dead."
12776,30/12/2009,Afghanistan,Kandahar,5,0,5,A female reporter is among five Canadians killed by a Taliban roadside bomb.
12777,30/12/2009,Thailand,Pattani,2,0,2,Two volunteers guarding teachers are taken down in a Mujahideen bombing.
12778,30/12/2009,Afghanistan,Khost,8,6,14,Eight American civilians are murdered by a Shahid suicide bomber at a gymnasium.
12779,30/12/2009,Pakistan,Bajaur,1,0,1,A tribal elder is brutally murdered by the Taliban and dropped by the roadside.
12780,30/12/2009,Thailand,Pattani,1,0,1,Muslim gunmen take out a civilian as he is driving home.
12781,30/12/2009,Thailand,Narathiwat,3,0,3,A Buddhist civilian is among three people killed in an Islamist drive-by shooting.
12782,31/12/2009,Thailand,Yala,2,0,2,Two civilians riding a motorbike are shot to death by Islamic militants.
12783,31/12/2009,Pakistan,Kalat,2,2,4,Two oil truck drivers are shot to death by Muslim radicals.
12784,31/12/2009,Afghanistan,Uruzgan,6,0,6,Six civilians are beheaded by Islamic hardliners.
12785,1/1/2010,Somalia,Hodan,1,0,1,Islamists murder a 41-year-old Christian convert and church leader.
12786,1/1/2010,Pakistan,Shah Hason Khel,105,100,205,Children are amply represented among over one hundred spectators massacred at a volleyball tournament by a Fedayeen suicide bomber.
12787,2/1/2010,Afghanistan,Kandahar,4,0,4,Four American soldiers guarding a marketplace are murdered by a Taliban bomb.
12788,2/1/2010,Pakistan,Orakzai,3,0,3,Three civilian village guards are ambushed and killed by Islamic militants.
12789,2/1/2010,Iraq,Baghdad,1,21,22,Jihadi bombers take out a civilian and injure two dozen others.
12790,2/1/2010,Iraq,Mosul,2,0,2,Two local cops are gunned down by Sunni terrorists.
12791,2/1/2010,Somalia,Dhusamareb,47,150,197,al-Shabaab Islamists assault a small town.  At least four dozen people are killed in the fighting.
12792,2/1/2010,Afghanistan,Nimroz,5,6,11,Five civilians are killed when Sunni terrorists bomb their pickup truck.
12793,3/1/2010,Pakistan,Bajaur,2,4,6,Two tribal elders are blown to bits by a Taliban roadside bomb.
12794,3/1/2010,Pakistan,Waziristan,2,5,7,A bombing and separate rocket attack leave two people dead.
12795,3/1/2010,Iraq,Tal Abta,3,0,3,Three road construction workers are gunned down by Muslim terrorists.
12796,3/1/2010,Pakistan,Hangu,4,2,6,A Taliban roadside bomb ends the lives of four people.
12797,4/1/2010,Iraq,Mosul,3,1,4,Sunni bombers blast three civilians into pieces.
12798,4/1/2010,Iraq,Kirkuk,3,7,10,Three Iraqis are murdered in a Mujahideen double bombing.
12799,5/1/2010,Pakistan,Karachi,1,0,1,A 70-year-old leader of a religious minority is murdered while sitting in his store by Jihadi gunmen.
12800,5/1/2010,Pakistan,Mohmand,2,2,4,Two civilians are taken down by Taliban rockets.
12801,6/1/2010,Ingushetia,Nazran,1,0,1,Fundamentalists murder a shop owner who ignored their warnings not to sell alcohol (2010).
12802,6/1/2010,Somalia,Bosasso,1,0,1,A lawmaker is assassinated by suspected fundamentalists.
12803,6/1/2010,India,Srinagar,3,11,14,"Jamiat-ul-Mujahideen militants toss grenades and fire into a crowd at a shopping center, killing at least three people."
12804,6/1/2010,Iraq,Mosul,2,1,3,"Two children are killed by a bomb in their home, suspected to have been stored there by their father."
12805,6/1/2010,Egypt,Rafah,1,0,1,Hamas snipers take down an Egyptian soldier.
12806,6/1/2010,Pakistan,Sudhanoti,3,11,14,Three local soldiers are incinerated by a suicide bomber.
12807,6/1/2010,Dagestan,Makhachkala,6,12,18,A suicide bomber murders six Russian police officers.
12808,7/1/2010,Egypt,Nag Hamadi,7,10,17,Six worshippers and one guard are gunned down by Muslim radicals as they leave mass at a Christian church.  A 14-year-old is among the dead.
12809,7/1/2010,Iraq,Khanaqin,3,15,18,Three Iraqis are cut down by a Jihadi bomb.
12810,7/1/2010,Thailand,Yala,1,0,1,A man is ripped in two by a Religion of Peace nail bomb.
12811,7/1/2010,Iraq,Hit,7,6,13,Women and children are among the dead when Mujahideen detonate planted bombs around the bedrooms of four homes.
12812,7/1/2010,Afghanistan,Nangarhar,9,44,53,Four children are among nine Afghans murdered by Islamic bombers in two attacks.
12813,7/1/2010,Afghanistan,Uruzgan,8,0,8,All eight Afghan soldiers riding in a vehicle are killed by a Taliban roadside bomb.
12814,8/1/2010,Afghanistan,Logar,2,0,2,Two Afghans are blown away at point blank range by a Fedayeen.
12815,8/1/2010,Iraq,Ras Al-Jadeh,2,0,2,Jihad bombers kill two local cops.
12816,8/1/2010,Pakistan,Khyber,8,11,19,Three children are among eight civilians murdered by a Lashkar-e-Islam suicide bomber outside a mosque.
12817,8/1/2010,Pakistan,Bajaur,2,2,4,Two people are blown to bits by a Taliban roadside bomb.
12818,8/1/2010,Pakistan,Karachi,5,7,12,Five mourners at a funeral are shot to death by sectarian Jihadis.
12819,9/1/2010,Afghanistan,Helmand,2,6,8,A British journalist is among two killed in a roadside Mujahideen bombing.
12820,9/1/2010,Iraq,Mosul,1,0,1,Freedom fighters kill a 16-year-old boy with a bomb.
12821,10/1/2010,Afghanistan,Uruzgan,3,0,3,Three humanitarian workers die in a Taliban roadside attack.
12822,10/1/2010,India,Kulgam,2,1,3,Hizb-ul-Mujahideen gun down two former members who had renounced violence.
12823,10/1/2010,Pakistan,Mohmand,2,0,2,Suspected Islamists murder two tribal elders.
12824,10/1/2010,Thailand,Narathiwat,2,0,2,Two men sitting in a tea shop are blown away by Muslim terrorists with automatic weapons.
12825,11/1/2010,Iraq,Mosul,1,0,1,A 51-year-old Christian man is brutally gunned down while selling vegetables by the side of the road.
12826,11/1/2010,Dagestan,Kizlyar,2,0,2,A moderate cleric and a former policeman are murdered in separate attacks.
12827,11/1/2010,Pakistan,Peshawar,1,5,6,One person is crushed to death in a Taliban rocket attack.
12828,11/1/2010,Afghanistan,Uruzgan,1,2,3,A policeman is cut down by a suicide bomber.
12829,11/1/2010,India,Jammu,1,0,1,Pakistani terrorists shoot an Indian border guard to death.
12830,12/1/2010,Iraq,Diyala,3,5,8,Terrorists murder three people with a brutal bomb blast.
12831,12/1/2010,France,Paris,0,1,1,An actress-playwright is doused with petrol and nearly set on fire by three Algerians angered by her negative portrayal of Muslim men.
12832,12/1/2010,Iraq,Mosul,1,0,1,A 75-year-old Christian is gunned down in his grocery story by Religion of Peace militants.
12833,13/1/2010,Algeria,Allaghane,2,0,2,Two security personnel are shot to death by Islamic extremists.
12834,13/1/2010,Yemen,Shabwa,2,0,2,Two local soldiers are cut down in an al-Qaeda ambush.
12835,13/1/2010,Afghanistan,Ghazni,1,6,7,An Afghan police officer is murdered by Sunni roadside bombers.
12836,13/1/2010,Iraq,Saqlawiya,7,6,13,A suicide bomber sends seven Iraqis to Allah.
12837,13/1/2010,Thailand,Pattani,1,4,5,"Islamic terrorists ambush a group of electricians, killing one."
12838,13/1/2010,Pakistan,Tank,1,6,7,A child is killed from an explosive planted by religious radicals at a playground.
12839,13/1/2010,Pakistan,Hangu,1,0,1,"A man is kidnapped and beheaded by Muslim militants, who then booby-trap the body."
12840,14/1/2010,Pakistan,Mohmand,2,7,9,Two members of a peace committee are murdered by Taliban roadside bombers while on their way home.
12841,14/1/2010,Iraq,Baqubah,2,10,12,Two people at a market are killed by a Mujahideen market blast.
12842,14/1/2010,Afghanistan,Helmand,1,4,5,A Shahid suicide bomber sends a local cop to paradise.
12843,14/1/2010,Thailand,Pattani,2,0,2,A Buddhist couple is shot to death by Muslims while riding to work.  Their bodies are then burned.
12844,14/1/2010,Afghanistan,Uruzgan,20,13,33,Three children are among twenty civilians blown to bits at a market place by a Fedayeen suicide bomber.
12845,14/1/2010,Ingushetia,Nazran,1,3,4,Islamists shoot a cop to death outside a mosque.
12846,14/1/2010,India,Uttar Pradesh,1,0,1,A 14-year-old member of the area's oppressed Hindu community is raped and killed by two Muslim men.
12847,14/1/2010,Iraq,Najaf,27,111,138,Twenty-seven people are massacred by three separate bomb blasts at a Shia market.
12848,15/1/2010,Kenya,Nairobi,1,5,6,"A Muslim gunmen fires into a crowd, killing one Christian and injuring five."
12849,15/1/2010,Somalia,Lasanod,1,0,1,Suspected Islamists assassinate a senior police officer outside a mosque.
12850,15/1/2010,Afghanistan,Spin Boldak,5,0,5,A mother and her four children are successfully taken out by a fundamentalist bomb attack on their car.
12851,15/1/2010,Somalia,Mogadishu,1,2,3,Three aid workers are kidnapped by suspected Hizbul Islam.  One is found brutally murdered.
12852,15/1/2010,India,Sopore,2,7,9,"Islamic militants assault a police station, killing a civilian and one officer."
12853,16/1/2010,Iraq,Baghdad,5,3,8,Five Iraqis are murdered in various Mujahideen attacks.
12854,16/1/2010,Philippines,North Cotabato,3,3,6,Three civilians are machine-gunned to death in their village by Moro Islamists.
12855,17/1/2010,Iraq,Mosul,2,0,2,At least one of two men gunned down in a targeted shooting is a Christian father of two.
12856,17/1/2010,Iraq,Kharab,3,0,3,"According to reports, three brothers are dragged out of their home and shot to death on their doorstep by Muslim terrorists."
12857,17/1/2010,Nigeria,Jos,48,96,144,"Muslim youth go on a rampage, hacking about 48 Christians to death after an attack outside a church.  The victims include two pastors."
12858,17/1/2010,Afghanistan,Chishti Sharif,6,0,6,"Sunni hardliners open fire on a vehicle, killing six local occupants."
12859,17/1/2010,Thailand,Pattani,2,0,2,Two civilians are gunned down by Islamic radicals in separate attacks.
12860,17/1/2010,Thailand,Pattani,1,0,1,A Buddhist woman is dismembered by a Muslim bomb thrown into a karaoke bar.
12861,18/1/2010,Pakistan,Mohmand,1,2,3,"The Taliban attack a village, killing a defense volunteer."
12862,18/1/2010,Algeria,Kabylie,1,0,1,Armed fundamentalists cut down a cop at point blank range.
12863,18/1/2010,Iraq,Baghdad,5,0,5,"Muslim gunmen storm a humanitarian office, killing four workers and a mother in front of her 3-year-old daughter."
12864,18/1/2010,Afghanistan,Kabul,5,71,76,"Fedayeen stage a massive suicide attack against government buildings in the capital, leaving at least five dead."
12865,18/1/2010,Iraq,Mosul,1,0,1,Islamic terrorists gun down a Christian man inside a grocery.
12866,19/1/2010,Somalia,Mogadishu,19,30,49,Women and children are among nineteen killed when Islamists launch multiple assaults on 'apostates and Christian backers.'
12867,19/1/2010,Somalia,Bosasso,1,0,1,Fundamentalists shoot a man to death inside his bookstore.
12868,19/1/2010,Pakistan,Jandola,2,0,2,Islamic hardliners end the lives of two local soldiers with a bomb.
12869,19/1/2010,Pakistan,Mohmand,2,2,4,"Religious extremists open fire on a peace committee, killing two members."
12870,20/1/2010,Iraq,Mosul,0,45,45,"A suicide bomber injures over forty Iraqis, but manages to kill only himself."
12871,20/1/2010,Pakistan,Karachi,1,0,1,A woman 8-months pregnant is stabbed to death with an axe and dagger by her family for marrying against their will.
12872,21/1/2010,Pakistan,Bajaur,3,22,25,A woman is among three people blown to bits by an Islamic bomb.
12873,21/1/2010,Iraq,Mussayab,1,5,6,Mujahideen murder a cop with a roadside bomb.
12874,21/1/2010,Thailand,Narathiwat,1,0,1,A 42-year-old defense volunteer is gunned down by Islamic radicals while riding a motorcycle.
12875,22/1/2010,Bangladesh,Netrokona,0,2,2,A Catholic humanitarian worker and his wife are attacked by a gang of Muslims.
12876,22/1/2010,Afghanistan,Ghazni,4,1,5,Four soldiers are sent to Allah by Taliban bombers.
12877,22/1/2010,Iraq,Baghdad,2,0,2,Jihadi gunmen assassinate two police officers.
12878,22/1/2010,Pakistan,Pattar,2,0,2,Two tribal elders are murdered by Muslim militants and dumped under a bridge.
12879,22/1/2010,Pakistan,Lahore,1,0,1,"A 12-year-old Christian girl is raped, tortured and killed by her Muslim employer, a respected lawyer."
12880,23/1/2010,Pakistan,North Waziristan,7,0,7,Seven civilians are kidnapped and executed by Sunni hardliners.
12881,23/1/2010,Afghanistan,Khost,1,0,1,A 16-year-old boy is sent straight to Allah by Taliban bombers.
12882,23/1/2010,Afghanistan,Helmand,2,2,4,Muslim radicals take out two children with an IED blast.
12883,23/1/2010,Pakistan,Orakzai,3,0,3,Three local soldiers are ambushed and killed by religious extremists.
12884,23/1/2010,Afghanistan,Helmand,1,0,1,A young marine is murdered by a Fedayeen suicide bomber.
12885,23/1/2010,Afghanistan,Paktika,4,3,7,"Islamic hardliners fire into a taxi, killing three women and a boy."
12886,23/1/2010,Pakistan,Gomal,4,11,15,Two children are among four people dismembered by a suicide bomber.
12887,24/1/2010,Iraq,Mosul,6,2,8,Six Iraqis are killed in two Mujahid bomb blasts.
12888,25/1/2010,Iraq,Mosul,2,0,2,A woman and her daughter are shot to death in their own home by Holy Warriors.
12889,25/1/2010,Iraq,Kirkuk,2,0,2,Two cops sitting at a gas station are wasted by Sunni gunmen.
12890,25/1/2010,Iraq,Baghdad,41,102,143,Three horrific bomb attacks on hotels leave at least three dozen dead and many more in agony.
12891,25/1/2010,Somalia,Sool,2,3,5,Two police officers are killed by a bomb hidden in a mosque.
12892,25/1/2010,Yemen,Sanaa,3,0,3,"al-Qaeda militants attack a checkpoint, killing three local soldiers."
12893,26/1/2010,Pakistan,Salarzai,1,0,1,A local tribesman is abducted and murdered by Sunni extremists.
12894,26/1/2010,Thailand,Pattani,3,0,3,Two Buddhist construction workers are among three people gunned down Islamic separatists in two attacks.
12895,26/1/2010,Iraq,Baghdad,22,80,102,A Shahid suicide bomber murders over twenty people working at a police crime lab.
12896,26/1/2010,Iraq,Mosul,0,1,1,A Christian shopkeeper is targeted by Muslim gunmen and seriously injured.
12897,26/1/2010,Somalia,Mogadishu,5,3,8,"al-Shabaab Islamists bomb a hospital clinic, killing at least five."
12898,26/1/2010,Afghanistan,Helmand,4,0,4,Talibanis ambush and kill four local policemen in the middle of the night.
12899,27/1/2010,Pakistan,Mardan,1,5,6,A drive-by attack by Sunni hardliners leaves one cop dead.
12900,27/1/2010,Iraq,Baghdad,2,5,7,A woman is among two people murdered by Mujahid gunmen.
12901,27/1/2010,Iraq,Mosul,2,0,2,Muslim terrorists shoot two people to death.
12902,27/1/2010,Pakistan,Dir,3,0,3,Three children are murdered by Taliban bombers while grazing their family goats.
12903,27/1/2010,Somalia,Hiran,8,0,8,"Rival Islamic groups Hizbul Islam and al-Shabaab go on a beheading spree, lopping off at least four heads apiece."
12904,27/1/2010,Ingushetia,Nazran,2,2,4,Two police officers die in the hospital from injuries suffered in a Islamic ambush.
12905,27/1/2010,Somalia,Mogadishu,1,0,1,Islamists assassinate a local official at a market.
12906,28/1/2010,Iran,Tehran,2,0,2,Two people are executed for 'waging war against Allah'.
12907,28/1/2010,Ingushetia,Nazran,1,0,1,"Islamic militants fire on a car, killing the driver."
12908,28/1/2010,Iraq,Mosul,4,3,7,Jihadi bombers take down four Iraqis.
12909,28/1/2010,Iraq,Adel,1,0,1,An imam is gunned down by Muslim rivals while leaving a mosque.
12910,28/1/2010,Somalia,Mogadishu,2,5,7,Two Ugandan peacekeepers die from shrapnel injuries suffered during an Islamist mortar attack.
12911,29/1/2010,Afghanistan,Wardak,2,0,2,"An interpreter suddenly turns on two US soldiers, killing both."
12912,29/1/2010,Afghanistan,Lashkar Gah,1,3,4,At least one civilian is killed during a sustained Taliban assault on a commercial district.
12913,29/1/2010,Somalia,Mogadishu,10,35,45,An al-Shabaab ambush leaves at least 10 people dead.
12914,29/1/2010,India,Kishtwar,2,0,2,Two Indian troops are gunned down in cold blood by Islamic militants.
12915,29/1/2010,Thailand,Pattani,1,2,3,A bomb detonated at a mosque kills a local soldier.
12916,30/1/2010,Pakistan,Bolochistan,3,7,10,"Sectarian Jihadis fire into a bus filled with Shia pilgrims, killing at least three."
12917,30/1/2010,Somalia,Mogadishu,12,25,37,A mother and her two children are among a dozen civilians burned or blasted to death when Islamists lob mortars into their neighborhood.
12918,30/1/2010,Iraq,Samarrah,2,20,22,Two people at a restaurant are blown to bits by a Fedayeen suicide bomber.
12919,30/1/2010,Thailand,Pattani,2,0,2,A man and his wife are murdered by Islamic radicals while on their way to work at a rubber plantation.
12920,30/1/2010,Afghanistan,Uruzgan,1,1,2,A baby is killed when religious extremists use the mother as a human shield in an attack on Afghan troops.
12921,30/1/2010,Iraq,Baghdad,1,4,5,Sunni bombers take out a Shia pilgrim.
12922,30/1/2010,Pakistan,North Waziristan,2,0,2,"The Taliban abduct two civilians, then shoot them to death in captivity."
12923,30/1/2010,Pakistan,Bajaur,16,20,36,A suicide bomber at a market sends sixteen shoppers straight to Allah.
12924,31/1/2010,Pakistan,Mohmand,2,2,4,The Taliban take out two local troops with a landmine.
12925,31/1/2010,Thailand,Pattani,3,1,4,A 6-year-old boy and his parents are brutally shot to death by Religion of Peace advocates.
12926,31/1/2010,Somalia,Mogadishu,8,55,63,A mother and her 4-year-old child are among eight civilians killed during an al-Shabaab mortar attack.
12927,31/1/2010,Iraq,Mosul,1,0,1,A young woman is shot to death inside her home by Muslim terrorists.
12928,1/2/2010,Ingushetia,Nazran,1,3,4,"A bomb planted in a kindergarten explodes, leaving one person dead."
12929,1/2/2010,Iraq,Baghdad,54,117,171,"A female suicide bomber murders fifty-four innocent Shia pilgrims at a hospitality tent, mostly women and children."
12930,1/2/2010,Ingushetia,Nazran,1,3,4,"Islamists fire five grenades into a building, killing at least one occupant."
12931,2/2/2010,Pakistan,Mohmand,2,2,4,Two members of a peace community pay the ultimate price when Islamic hardliners blow them up.
12932,2/2/2010,Philippines,Maluso,1,8,9,Suspected Abu Sayyaf militants plant a landmine that kills one local soldier.
12933,2/2/2010,Iraq,Karbalah,3,21,24,Three Shia pilgrims are murdered by Sunni bombers.
12934,3/2/2010,Germany,Northrhein-Westphalia,1,0,1,A mother of four is beheaded and then has her fingers cut off in a suspected 'honor' attack by her husband.
12935,3/2/2010,Pakistan,Swat,9,115,124,Four children are among nine people killed when the Tehrik-e-Taliban bomb am opening ceremony at a girl's school.
12936,3/2/2010,Iraq,Karbalah,23,147,170,"A Fedayeen bomber passes out fruit to children before detonating, killing nearly two dozen."
12937,3/2/2010,Iraq,Baghdad,1,3,4,Sunni bombers send a Shia pilgrim straight to Allah.
12938,3/2/2010,Iraq,Touz Khormato,1,0,1,A teacher is kidnapped and killed by Muslim radicals.
12939,3/2/2010,Thailand,Narathiwat,1,0,1,A rubber tapper working with his wife is shot in the back by Muslim militants with a shotgun
12940,4/2/2010,Somalia,Mudug,1,0,1,A young boy is shot to death by Islamists after trying to escape forced prayers at a mosque.
12941,4/2/2010,Turkey,Kahta,1,0,1,A 16-year-old girl is buried alive by her family as punishment for talking to boys.
12942,4/2/2010,Afghanistan,Kandahar,3,17,20,Three people are dismembered by a Shahid suicide bomber.
12943,4/2/2010,Iraq,Baghdad,1,0,1,A man leaving a mosque is killed by a suspected Mujahid.
12944,5/2/2010,Afghanistan,Helmand,2,20,22,Two civilians are incinerated by a Taliban roadside bomb.
12945,5/2/2010,India,Baramulla,2,0,2,A civilian and local cop are murdered in a Mujahideen ambush.
12946,5/2/2010,Pakistan,Malakand,1,0,1,A local soldier standing guard is gunned down in cold blood by Islamists.
12947,5/2/2010,Pakistan,Karachi,33,80,113,"A Christian family and dozens of Shiites are blown to bits by Sunni bombers at two locations, one a hospital."
12948,5/2/2010,Iraq,Karbalah,41,154,195,A barbaric Sunni double car-bombing against Shia pilgrims at a religious festival leaves at least forty dead.
12949,5/2/2010,India,Sopore,3,0,3,"Islamic terrorists approach a police checkpoint and open fire, killing a civilian and two officers."
12950,6/2/2010,Thailand,Narathiwat,1,1,2,A local soldier in a moving truck is killed by a Mujahideen sniper.
12951,7/2/2010,Pakistan,North Waziristan,1,0,1,An Afghan refugee is kidnapped and murdered by Islamic hardliners.
12952,7/2/2010,Iraq,Mosul,1,1,2,A female veterinarian is shot to death by Holy Warriors.
12953,7/2/2010,Iraq,Diwaniya,1,3,4,"Jihadis bomb a minibus, killing one occupant."
12954,7/2/2010,Afghanistan,Kandahar,4,2,6,"Islamists detonate a hidden bomb under a bridge, taking out a car full of local cops."
12955,7/2/2010,Afghanistan,Mazar-e Sharif,3,1,4,Two Swedes and their interpreter are shot to death by religious extremists dresses as police.
12956,8/2/2010,Pakistan,Punjab,0,1,1,A Christian man is beaten unconscious for refusing to embrace Islam.
12957,8/2/2010,Thailand,Pattani,1,0,1,Islamic radicals target a Buddhist teacher riding home on his motorcycle.  He is shot and then set on fire.
12958,8/2/2010,Somalia,Mogadishu,10,20,30,al-Shabaab claims responsibility for a series of attacks that leave at least ten civilians dead.
12959,8/2/2010,Thailand,Yala,1,0,1,A 41-year-old man is shot to death in his own backyard by Islamists.
12960,8/2/2010,Pakistan,Khyber,1,4,5,A young girl is killed in a rocket attack by Sunni hardliners.
12961,8/2/2010,India,Sopore,1,0,1,A police officer is gunned down by Muslim militants.
12962,8/2/2010,Iraq,Baghdad,1,3,4,One civilian is killed by Jihadi bombers while crossing a bridge.
12963,8/2/2010,Pakistan,Rawalpindi,4,1,5,"Muslim terrorists open fire on a vehicle, killing two occupants and two bystanders."
12964,9/2/2010,Iraq,Baghdad,1,1,2,Muslim assassins murder a man in front of his wife.
12965,9/2/2010,Egypt,Menoufia,1,0,1,A young Christian carpenter is gunned down at close range by a Muslim policeman in a suspected sectarian attack.
12966,9/2/2010,Sudan,al-Baytari,4,15,19,Janjiweed militia attack a refugee camp and murder four residents.
12967,10/2/2010,Pakistan,Khyber,1,2,3,The Taliban murder a member of a rescue team.
12968,10/2/2010,Iraq,Baquba,2,1,3,Jihadi gunmen take down two Iraqis in their own home.
12969,10/2/2010,Iraq,Abu Ghraib,2,4,6,Two Iraqi cops are blown apart by Mujahideen bombers.
12970,10/2/2010,Thailand,Pattani,1,0,1,A Buddhist man at a bird singing competition is brutally gunned down by Muslim radicals.
12971,10/2/2010,Israel,Nablus,1,0,1,A Palestinian policeman walks up to an Israeli soldier and stabs him to death.
12972,10/2/2010,Thailand,Pattani,2,0,2,Two men are shot to death by Mujahideen in separate attacks.
12973,10/2/2010,Pakistan,Khyber,18,10,28,"A teenage Fedayeen suicide bomber detonates along a highway, killing nearly twenty others."
12974,10/2/2010,Somalia,Hamarjajab,5,7,12,al-Shabaab militants take out five Somalis with a roadside bomb.
12975,11/2/2010,Thailand,Narathiwat,1,0,1,A tailor is gunned down while carrying his young son in front of his home.
12976,11/2/2010,Dagestan,Makhachkala,2,0,2,Bombing and shooting attacks leave two people dead.
12977,11/2/2010,Philippines,Cotabato,1,0,1,Muslim extremists shoot a man to death as he is riding a motorbike to work.
12978,11/2/2010,Pakistan,Bannu,15,24,39,Fifteen innocents are blown to bits in a double suicide bombing by Islamic militants.
12979,11/2/2010,Iraq,Mosul,1,0,1,Jihadis murder a 17-year-old with an IED.
12980,11/2/2010,Iraq,Baghdad,1,0,1,An imam at a mosque is gunned down by sectarian rivals.
12981,12/2/2010,Thailand,Pattani,1,0,1,A 38-year-old man is murdered by Muslim gunmen.
12982,12/2/2010,Iraq,Buhriz,2,0,2,A man and his son are blown to bits by Jihadi bombers.
12983,12/2/2010,Yemen,Saada,1,7,8,Militant Shiites ambush and kill a government soldier.
12984,12/2/2010,Somalia,Afgoye,2,0,2,al-Shabaab Islamists shoot two civilians to death.
12985,13/2/2010,Thailand,Narathiwat,1,0,1,A 44-year-old man is gunned down by Islamic militants while using the restroom.
12986,13/2/2010,Thailand,Pattani,1,2,3,Muslim militants shoot a man sitting on his front porch with friends.
12987,13/2/2010,Afghanistan,Kandahar,2,7,9,A Fedayeen suicide bomber sends two other souls to Allah.
12988,13/2/2010,Iraq,Kufa,6,10,16,A female suicide bomber murders at least six Shia pilgrims headed to a religious ceremony.
12989,13/2/2010,India,Pune,17,37,54,Five women are more than a dozen innocents blasted to death by a Mujahid bomber at a bakery near a Jewish center.
12990,13/2/2010,Pakistan,Kasur,1,0,1,A Muslim mob beats a young man to death after his father declares himself a prophet.
12991,14/2/2010,Iraq,Mosul,1,1,2,Islamists enter a Christian businessman's home and murder him.
12992,14/2/2010,Pakistan,Sindh,3,16,19,"Suspected fundamentalists bomb a movie theater, leaving at least three innocents dead."
12993,14/2/2010,Pakistan,Khyber,3,0,3,Muslim radicals gun down three civilians in separate attacks.
12994,14/2/2010,Iraq,Baghdad,2,6,8,"Mujahideen bomb a cafe, killing two patrons."
12995,14/2/2010,Thailand,Pattani,2,0,2,Islamists brutally murder a Buddhist woman and her 13-year-old daughter.
12996,14/2/2010,Ingushetia,Nazran,2,0,2,Jihadis wipe out a young man and his mother near the entrance to a mosque.
12997,14/2/2010,Dagestan,Novogodari,3,0,3,A young girl is among three people killed when Muslim gunmen open up on a vehicle.
12998,15/2/2010,Somalia,Diif,1,0,1,A man is beheaded by al-Shabaab.
12999,15/2/2010,Lebanon,Ain el Hilweh,2,0,2,"An attack by a Sunni fundamentalist group leaves two people dead, including a woman."
13000,15/2/2010,Somalia,Mogadishu,2,2,4,"An al-Shabaab suicide bomber targets a moving vehicle, killing two bystanders."
13001,15/2/2010,Thailand,Narathiwat,1,0,1,A 36-year-old man is shot to death by Islamic militants at his work site.
13002,15/2/2010,Iraq,Mosul,1,0,1,A 20-year-old Christian student is kidnapped and brutally murdered by Mujahideen.
13003,15/2/2010,Yemen,Jawf,1,0,1,A 51-year-old man is shot to death by Shia radicals while eating lunch.
13004,15/2/2010,Thailand,Narathiwat,2,0,2,A rubber tapper and her daughter are gunned down by Muslim radicals on the plantation where they worked.
13005,15/2/2010,Iraq,Mosul,1,0,1,A 42-year-old Christian is shot to death in front of his store.
13006,16/2/2010,Iraq,Mosul,2,9,11,Holy Warriors manage to kill two Iraqis with a car bomb.
13007,16/2/2010,Iraq,Mosul,2,0,2,A woman and a civil servant are gunned down in separate Jihad attacks.
13008,17/2/2010,Iraq,Mosul,1,0,1,Another young Christian is shot to death by Muslim extremists.
13009,17/2/2010,Philippines,Mindanao,1,2,3,A 9-year-old boy is taken down by a Moro Islamist landmine.
13010,17/2/2010,Thailand,Narathiwat,2,0,2,Religion of Peace advocates behead two government soldiers trying to guard teachers.
13011,18/2/2010,Pakistan,Mingora,1,2,3,"Taliban hard-liners ambush a police patrol, killing one officer."
13012,18/2/2010,Iraq,Mosul,0,22,22,A Jihadi car bombing injures two dozen people.
13013,18/2/2010,Thailand,Yala,1,12,13,Industrious Islamists shoot a civilian to death in one district and set off a motorcycle bomb in another.
13014,18/2/2010,Pakistan,Tirah,31,110,141,Thirty people are incinerated by a Shahid suicide bomber at a rival mosque.
13015,18/2/2010,Iraq,Baghdad,13,26,39,A Fedayeen suicide bomber sends over a dozen Iraqis to Allah.
13016,19/2/2010,Afghanistan,Kandahar,4,0,4,Four civilians are taken down by a Taliban roadside bomb.
13017,19/2/2010,Iraq,Tal Afar,1,0,1,Islamic gunmen murder a cop on his way home.
13018,19/2/2010,Iraq,Ramadi,10,15,25,Terrorists successfully kill ten Iraqis with a car bomb.
13019,19/2/2010,Philippines,Basilan,2,1,3,Two local soldiers killed by an Abu Sayyaf bomb.
13020,19/2/2010,Somalia,Kismayo,1,0,1,al-Shabaab Islamists shoot a man to death at a roadblock.
13021,20/2/2010,England,Huddersfield,1,0,1,A Muslim gang of five beats a Sikh shopkeeper to death with a hammer.
13022,20/2/2010,Somalia,Buale,1,0,1,Muslim extremists murder a man for refusing to pay zakat.
13023,20/2/2010,Afghanistan,Helmand,6,2,8,"The Taliban open fire on a group of police officers clearing a poppy field, killing six."
13024,20/2/2010,Pakistan,Swat,1,0,1,The body of a businessman kidnapped earlier by Islamic fundamentalists is discovered.
13025,20/2/2010,Iraq,Mosul,3,2,5,Three Iraqis are dismembered by Sunni bombers.
13026,20/2/2010,Iraq,Mosul,1,0,1,A 57-year-old Christian shopkeeper is kidnapped and brutally shot to death by Muslim kidnappers.
13027,20/2/2010,Ingushetia,Nazran,2,37,39,Two people are blown to bits by an Islamic bomb.
13028,20/2/2010,Afghanistan,Helmand,2,0,2,Two civilians on a motorcycle are murdered by Mujahid bombers.
13029,20/2/2010,Bangladesh,Baghaichhari,8,200,208,At least eight people are killed when Muslim villagers riot against Christian and Buddhist neighbors.
13030,20/2/2010,Pakistan,Balakot,1,3,4,Three suicide attackers manage to kill only one police officer in assaults on two stations.
13031,21/2/2010,Somalia,Mogadishu,3,0,3,Three men are killed in a Hizbul Islam bombing.
13032,21/2/2010,Iraq,Taji,1,7,8,"Sunni gunmen fire on a bus carrying Shia pilgrims, killing at least one passenger."
13033,21/2/2010,Iraq,Tikrit,1,2,3,A suicide bomber targeting a mosque manages to kill one civilian.
13034,21/2/2010,Iraq,Khanaqin,5,1,6,Jihadis gun down five guards at a power station at point-blank range
13035,21/2/2010,Pakistan,Khyber,2,0,2,"The heads of three Sikhs, kidnapped by the Taliban, are discovered.  Two were businessmen who did not pay the Jizya.  The other would not embrace Islam."
13036,22/2/2010,Indonesia,Aceh,2,0,2,A man and his son are shot to death by Jemaah Islamiyah linked terrorists.
13037,22/2/2010,Iraq,Baghdad,8,0,8,"Eight Shia family members, including a pregnant woman are shot and beheaded in their home by suspected al-Qaeda."
13038,22/2/2010,Pakistan,Swat,6,5,11,A half-dozen people are taken down by a Shahid suicide bomber at a marketplace.
13039,22/2/2010,Pakistan,Mingora,13,41,54,Four women are among more than a dozen innocents blasted to death by a Shahid suicide bomber.
13040,22/2/2010,India,Baramulla,1,3,4,"A local family is brutally assaulted by Muslim thugs, who smash the head of their 10-day old infant with a rock."
13041,22/2/2010,Thailand,Narathiwat,2,0,2,Two guards at a shop are shot to death in a Muslim drive-by.
13042,22/2/2010,Iraq,Baghdad,4,0,4,Sunni militants invade a home and gun down a Shia woman and her three daughters.
13043,22/2/2010,Pakistan,Peshawar,1,1,2,A prominent Shia leader is assassinated by Sunni gunmen.
13044,22/2/2010,Algeria,Boumerdes,1,5,6,A local soldier is killed in a bomb attack by Islamic fundamentalists.
13045,22/2/2010,Iraq,Baghdad,7,8,15,A university professor and a street sweeper are among seven people shot to death by Muslim terrorists in separate attacks.
13046,22/2/2010,Iraq,Ramadi,5,5,10,"A Jihadi car bomb takes down five Iraqis outside a government building, including a 6-year-old boy."
13047,23/2/2010,Ingushetia,Ordzhonikidzevskaya,1,0,1,A security officer is gunned down in his car by Muslim rebels.
13048,23/2/2010,Afghanistan,Lashkar Gah,7,14,21,Seven civilians at a bus stop are blown to pieces by a bicycle bomb.
13049,23/2/2010,Iraq,Baghdad,3,5,8,"Islamists plant a bomb on a dead body, which kills three people assigned to remove the corpse."
13050,23/2/2010,Iraq,Mosul,2,5,7,Jihadis gun down two local cops.
13051,23/2/2010,India,Baramulla,3,3,6,"Islamic militants open fire on a group of Indian soldiers, killing three."
13052,23/2/2010,Iraq,Mosul,3,0,3,A Christian father and his two sons are murdered in their home.  They were relatives of a priest.
13053,24/2/2010,Dagestan,Gergebilsky,5,1,6,Three separate terror attacks over four days leave five police officers dead.
13054,24/2/2010,Pakistan,North Waziristan,3,0,3,"Three civilians have their throats cut by the Taliban, who throw their headless bodies into a ditch."
13055,24/2/2010,Pakistan,Hangu,3,3,6,"Suspected Islamic radicals fire on a railway car, killing three passengers, including a college student."
13056,24/2/2010,Iraq,Baghdad,1,0,1,Terrorists assassinate a judge with a bomb outside his home.
13057,24/2/2010,Pakistan,Peshawar,4,0,4,"Four young brothers, ages 4 to 17, are destroyed by a Taliban rocket attack on their home."
13058,25/2/2010,Somalia,Dhobley,1,0,1,Islamists behead a man for expressing loyalty to a rival group.
13059,25/2/2010,Saudi Arabia,Riyadh,1,3,4,Four British cyclists are deliberately run down by drivers in two cars.  A 54-year-old humanitarian worker dies from injuries.
13060,25/2/2010,India,Pulwama,1,0,1,Mujahideen gun down a shopkeeper.
13061,25/2/2010,Iraq,Mosul,2,0,2,Two members of a minority community are gunned down in their store by militant Muslims.
13062,25/2/2010,Iraq,Mosul,2,0,2,Two women are killed in separate Jihad attacks.  One is stabbed and the other beheaded.
13063,26/2/2010,Pakistan,Lahore,0,3,3,A Christian family is terrorized in their home by a Muslim gang.  One girl is raped and the other stabbed four times.
13064,26/2/2010,Liberia,Voinjama,4,23,27,A Muslim mob burns churches and kills at least four Christians.
13065,26/2/2010,Iraq,Baghdad,1,0,1,An imam is shot to death by members of a rival mosque.
13066,26/2/2010,Iraq,Mosul,3,22,25,Three Iraqis are taken down by a Jihadi bomb planted in a dumpster.
13067,26/2/2010,Somalia,Mogadishu,4,5,9,An Islamist landmine attack leaves four local soldiers dead.
13068,26/2/2010,Afghanistan,Kabul,17,32,49,"Religious extremists attack guesthouses with suicide bombs and gunfire, killing seventeen people, including several foreigners."
13069,27/2/2010,Egypt,Teleda,0,2,2,"A pastor and his wife are brutally gunned down by Religion of Peace advocate, angry that they are trying to build a church."
13070,27/2/2010,Somalia,Diif,1,0,1,A man is beheaded by Islamic militia.
13071,27/2/2010,Thailand,Pattani,1,0,1,Islamic separatists pump a 70-year-old man full of bullets as he is walking home.
13072,27/2/2010,Philippines,Tubigan,15,13,28,Women and five children (ages 1 to 11) are among thirteen gunned down by Moro Islamists sweeping through a Christian village.
13073,27/2/2010,Pakistan,Dera Ismail Khan,1,7,8,A sectarian sniper takes down one civilian in a Sunni procession.
13074,27/2/2010,Pakistan,Karak,4,23,27,A child is among four locals murdered in separate suicide bombings.
13075,27/2/2010,Pakistan,Dera Ismail Khan,7,38,45,Seven people are killed in a sectarian mob attack on a seminary.
13076,28/2/2010,Iraq,Khalidiya,2,2,4,Jihadis take out two Iraqis with a car bomb.
13077,28/2/2010,Afghanistan,Kabul,5,2,7,Muslim terrorists shoot five family members to death inside their home.
13078,28/2/2010,Afghanistan,Helmand,11,0,11,Two women and two children are among eleven civilians taken down by Islamic bombers.
13079,28/2/2010,Afghanistan,Khost,6,0,6,Six local soldiers die in two Taliban bomb attacks.
13080,1/3/2010,India,Shimoga,1,0,1,A man dies from injuries after being hit with stones thrown by a mob angered over a newspaper article deemed insulting to Islam.
13081,1/3/2010,Philippines,Mindanao,1,0,1,A Chinese national dies from health complications suffered during an Abu Sayyaf kidnapping.
13082,1/3/2010,Afghanistan,Baghdad,3,0,3,A 10-year-old boy is among three people killed by dedicated Islamic bombers.
13083,1/3/2010,Iraq,Baghdad,4,0,4,"Islamic fundamentalists bomb a liquor store, killing the owner and three patrons."
13084,1/3/2010,Pakistan,Karak,4,24,28,A Holy Warrior sends four innocents to Allah with a suicide bomb.
13085,1/3/2010,Afghanistan,Kandahar,4,0,4,Four civilians die in a brutal suicide attack on a bridge.
13086,1/3/2010,Afghanistan,Lashkar Gah,2,0,2,Two employees of a construction company are incinerated by a Sunni roadside bomb.
13087,1/3/2010,Afghanistan,Kandahar,1,15,16,A civilian is killed by a Taliban bomb.
13088,2/3/2010,Pakistan,Khuzdar,2,12,14,"Suspected fundamentalists bomb a music show, killing two college students."
13089,2/3/2010,Thailand,Pattani,2,2,4,"Islamists open fire on a father and his three daughters, killing him and a 7-year-old."
13090,3/3/2010,Iraq,Mosul,1,0,1,An imam is gunned down in his mosque by Religion of Peace rivals.
13091,3/3/2010,Iraq,Baquba,33,55,88,Three Shahid suicide bombers take down more than thirty Iraqis in coordinated attacks.
13092,3/3/2010,Iraq,Kirkuk,2,0,2,Terrorists stab a man and his wife to death inside their home.
13093,3/3/2010,Somalia,Mogadishu,12,49,61,Children are among those killed during an al-Shabaab assault.
13094,4/3/2010,Pakistan,Chamarkand,1,0,1,One person is killed when religious extremists attack a security post with rockets.
13095,4/3/2010,Iraq,Baghdad,17,61,78,"Three separate Jihad bombings take the lives of seventeen people, including voters waiting in line."
13096,4/3/2010,Afghanistan,Kandahar,5,0,5,Five construction workers are shot to pieces at point-blank range by Islamic terrorists.
13097,5/3/2010,Somalia,Dhobley,1,0,1,A mother of four is dragged out of her home and beheaded by Islamic hardliners.
13098,5/3/2010,Pakistan,Hangu,12,35,47,At least four women are among a dozen dead Shiites after a Sunni suicide bomber detonates near a passenger bus.
13099,5/3/2010,Iraq,Mussayab,1,0,1,A child is blown apart by Mujahideen bombers.
13100,6/3/2010,Iraq,Najaf,4,54,58,Four Shia pilgrims are killed when Sunni radicals bomb a shrine.
13101,6/3/2010,Iraq,Garma,1,2,3,A woman is taken out by a Jihadi bomber.
13102,6/3/2010,Thailand,Narathiwat,1,0,1,A taxi driver dies after a savage machete attack by Muslim separatists.
13103,7/3/2010,Afghanistan,Baghlan,19,0,19,At least 19 civilians are killed when the Taliban and Hezb-e-Islami fundamentalist terror groups clash.
13104,7/3/2010,Pakistan,Lahore,1,0,1,A Christian man dies during a home invasion by Muslim gunmen.
13105,7/3/2010,Yemen,Sanaa,2,0,2,Two hospital guards are gunned down by an al-Qaeda terrorist.
13106,7/3/2010,Pakistan,Orakzai,1,0,1,The beheaded body of a tribal elder is found a few days after his abduction by the Taliban.
13107,7/3/2010,Iraq,Baghdad,51,140,191,Over fifty Iraqis are taken down in a series of bomb blasts and shootings around the country by Mujahideen intent on disrupting elections.
13108,7/3/2010,India,Srinagar,1,0,1,A 30-year-old shopkeeper is murdered by Islamic gunmen.
13109,7/3/2010,Nigeria,Dogo Nahauwa,528,600,1128,"Over five-hundred Christians, mostly women and children, are hacked to death by Muslim raiders with machetes in a night-time attack on their village.  The killers yelled 'Allah Akbar,' as they chopped."
13110,8/3/2010,Iraq,Fallujah,2,1,3,Two civilians are gunned down by Sunni terrorists.
13111,8/3/2010,Pakistan,Lahore,15,60,75,Fifteen people are blown to bits by a Fedayeen suicide bomber at an office park.
13112,8/3/2010,Pakistan,South Waziristan,2,1,3,Two tribal elders are blown apart by a Taliban roadside bomb.
13113,8/3/2010,Pakistan,Lashkar-e-Islam,2,0,2,Lashkar-e-Islam gunmen take down two people in separate attacks.
13114,8/3/2010,Afghanistan,Badghis,12,0,12,Ten civilians and two local cops are dismembered by two Sunni bombs.
13115,8/3/2010,Niger,Niamey,5,0,5,Five members of a border patrol lose their lives to an al-Qaeda ambush.
13116,9/3/2010,Pakistan,Punjab,1,0,1,A 36-year-old Christian is hacked to death with an ax after refusing to embrace Islam.
13117,9/3/2010,Somalia,Mogadishu,3,0,3,At least three civilians are killed during an attack by Islamic militia.
13118,9/3/2010,Somalia,Mogadishu,1,0,1,Islamists assassinate a rival in an open-air market.
13119,9/3/2010,Thailand,Pattani,1,0,1,"A 45-year-old salesman is shot once in the back of the head, then set on fire by Religion of Peace terrorists."
13120,9/3/2010,Afghanistan,Khost,2,3,5,A Shahid suicide bomber at a military base kills two soldiers.
13121,9/3/2010,Lebanon,Hakr al-Daheri,1,0,1,A 24-year-old woman with a boyfriend is shot twice in the head by her brother to 'cleanse the family honor.'
13122,9/3/2010,Iraq,Mosul,1,0,1,Sunni terrorists gun down a man at a bus station.
13123,10/3/2010,Dagestan,Yasnaya Polyana,1,0,1,A local religious teacher is shot to death by rivals.
13124,10/3/2010,Afghanistan,Faryab,2,4,6,Two children are blown apart by a terrorist landmine.  Four others are injured.
13125,10/3/2010,Somalia,Mogadishu,42,83,125,At least forty civilians are killed during a sustained assault by al-Shabaab militia.
13126,10/3/2010,Pakistan,Oghi,6,0,6,Six aid workers of a Christian charity are herded out of their office by Muslim gunmen and machine-gunned to death.
13127,10/3/2010,Afghanistan,Paktika,5,4,9,Five security personnel are killed by a Shahid suicide bomber.
13128,11/3/2010,Somalia,Mogadishu,2,0,2,Two telecom employees are dragged into the street and beheaded by Religion of Peace extremists.
13129,11/3/2010,Thailand,Pattani,3,1,4,Three telephone company workers are shot by Mujahideen and then set on fire while still alive.
13130,11/3/2010,Thailand,Pattani,1,0,1,Islamists gun down a 61-year-old Buddhist broom salesman.
13131,11/3/2010,Afghanistan,Kapisa,5,3,8,Four children and one adult are dismembered by a Taliban roadside blast.
13132,11/3/2010,Pakistan,Peshawar,4,21,25,A child is among four people taken down by a suicide bomber.
13133,11/3/2010,Pakistan,Karachi,4,0,4,Four Sunnis are shot to death by Shiites while riding in a car.
13134,11/3/2010,Afghanistan,Paktia,3,1,4,Three local security personnel are murdered by fundamentalist bombers.
13135,11/3/2010,Pakistan,Bajaur,2,0,2,Two people are killed in a shooting ambush by Islamic militants.
13136,12/3/2010,Iraq,Zoubaa,1,1,2,Freedom fighters kill a young boy outside of a policeman's home.
13137,12/3/2010,Thailand,Yala,2,2,4,A respected police chief is murdered by Islamic bombers six months short of retirement.
13138,12/3/2010,Egypt,Marsa Matruh,0,23,23,Twenty-three Christians are injured when a Muslim mob attacks their community after rumors of a church construction.
13139,12/3/2010,Iraq,Karbalah,2,3,5,"A car bomb follows prayers, leaving two dead."
13140,12/3/2010,Pakistan,Lahore,62,85,147,Over sixty innocents are sent to Allah by two Fedayeen suicide bombers.
13141,12/3/2010,India,Srinagar,1,0,1,A civilian standing outside a mosque is murdered by a Mujahideen sniper.
13142,13/3/2010,Pakistan,Mingora,17,51,68,Seventeen people at a courthouse are blown to bits by a Tehreek-e-Taliban suicide bomber pulling a rickshaw.
13143,13/3/2010,Pakistan,Mohmand,3,0,3,Three tribal members are machine-gunned to death by Religion of Peace radicals.
13144,13/3/2010,Iraq,Baghdad,3,19,22,Three Iraqis are taken down by a pair of Jihad blasts.
13145,13/3/2010,Afghanistan,Kandahar,35,52,87,About thirty innocent people are incinerated by a series of paradise-seeking suicide bombers
13146,14/3/2010,Afghanistan,Marjah,1,0,1,A reported beheading of a local civilian by the Taliban is confirmed.
13147,14/3/2010,Pakistan,Dera Ismail Khan,1,0,1,Islamic terrorists kill a civilian with a landmine.
13148,14/3/2010,Pakistan,Khyber,2,0,2,An electrician is among two civilians shot to death by Islamic militants.
13149,14/3/2010,Iraq,Mosul,1,0,1,An imam leaving a mosque is gunned down by Religion of Peace rivals.
13150,14/3/2010,Iraq,Mosul,4,2,6,Four local cops are cut to pieces by Jihadi roadside bombers.
13151,14/3/2010,India,Srinagar,1,5,6,"Islamic militants lob a hand grenade at a police vehicle, killing one officer."
13152,15/3/2010,Somalia,Mahaday,1,0,1,The Christian pastor of an underground church is hunted down like an animal by Islamists and shot to death.  (He was not a convert to Islam).
13153,15/3/2010,Iraq,Khaldiya,1,0,1,A Sunni cleric is assassinated by Religion of Peace rivals.
13154,15/3/2010,Iraq,Mosul,3,2,5,Three police are killed in separate Mujahideen attacks.
13155,15/3/2010,Afghanistan,Ghazni,3,0,3,Three civilians are shredded by a Taliban shrapnel bomb.
13156,15/3/2010,Iraq,Fallujah,8,28,36,"A Shahid suicide bomber detonates among a group of laborers, leaving at least eight dead."
13157,16/3/2010,India,Srinagar,4,9,13,A salesman is among four people murdered in two separate attacks by Islamic snipers.
13158,16/3/2010,Thailand,Narathiwat,1,1,2,Islamic radicals shoot a 43-year-old Buddhist civilian to death.
13159,16/3/2010,Iraq,Mosul,2,0,2,A woman and her daughter are gunned down by Sunni terrorists.
13160,16/3/2010,Thailand,Pattani,1,1,2,Islamists shoot a 38-year old teacher to death in an attack that leaves his 7-year-old son injured.
13161,16/3/2010,Iraq,Mussayab,8,11,19,Jihadis plant two bombs on a bus that leave eight dead and eleven more in agony.
13162,16/3/2010,Pakistan,Kurram,3,0,3,Three local tribesmen are killed in a botched kidnapping attempt by Taliban hardliners.
13163,17/3/2010,Pakistan,Khyber,5,2,7,Five security personnel are slain by an Islamist attack on a check post.
13164,17/3/2010,Iraq,Mosul,1,0,1,A 55-year-old Christian father is shot down in cold blood.
13165,17/3/2010,Nigeria,Dyie,13,6,19,"Thirteen more Christian villagers are massacred by Muslim raiders in an overnight attack, including a mother and two children burned to death.  Victims also had their tongues cut out."
13166,17/3/2010,Thailand,Yala,1,2,3,Muslim militants murder a teenage boy and seriously injure his parents.
13167,17/3/2010,Dagestan,Vedeno,3,2,5,Arab Jihadists gun down three local cops.
13168,18/3/2010,Dagestan,Batayurt,1,0,1,An investigator is ambushed and murdered by armed Muslims on his way home.
13169,18/3/2010,Pakistan,Mohmand,1,0,1,A young girl is taken out by a Taliban landmine.
13170,18/3/2010,Pakistan,Bajaur,1,0,1,Islamists gun down an off-duty policeman on his way home.
13171,18/3/2010,Iraq,Mosul,2,1,3,A woman in her home is among two people murdered by Islamic terrorists.
13172,18/3/2010,Iraq,Baghdad,1,0,1,Islamic terrorists murder a woman inside her home.
13173,18/3/2010,Iraq,Sherquat,2,0,2,Two men are abducted and beheaded by suspected al-Qaeda.
13174,18/3/2010,Israel,Netiv Haasara,1,0,1,A 30-year-old farm laborer is killed by a Palestinian rocket fired from Gaza.
13175,19/3/2010,Pakistan,Kurram,2,3,5,"Islamists attack the houses of peace committee members, leaving two dead."
13176,19/3/2010,Iraq,Baghdad,4,7,11,Four Iraqis are blown to bits by Mujahideen bombers.
13177,19/3/2010,Thailand,Pattani,1,0,1,Muslim radicals gun down an auto parts salesman.
13178,20/3/2010,Pakistan,Peshawar,1,0,1,"Hardliners beat a student to death for playing music, which they consider to be against Islamic teaching."
13179,20/3/2010,Pakistan,Kurram,1,6,7,A woman is killed in the crossfire when rival religious groups clash.
13180,20/3/2010,Pakistan,Quetta,4,0,4,Four Shias are shredded by gunfire in a suspected sectarian attack.
13181,20/3/2010,Somalia,Kismayo,1,0,1,Islamists gun down a rival.
13182,21/3/2010,Pakistan,Quetta,4,5,9,"A suicide bomber on a bicycle pedals to paradise, taking four innocents with him."
13183,21/3/2010,Afghanistan,Helmand,10,7,17,Ten Afghans at a market are blown to bits by a Shahid suicide bomber.
13184,21/3/2010,Iraq,Garma,2,0,2,A man and wife are shot to death in their home by al-Qaeda.
13185,21/3/2010,Afghanistan,Khost,3,3,6,Three young men are killed when Islamists bomb a picnic area.
13186,21/3/2010,Pakistan,North Waziristan,4,0,4,Tehreek-e-Taliban hardliners abduct and execute four local tribesmen.
13187,21/3/2010,Iraq,Mosul,1,0,1,An elderly man is gunned down in his home by Islamic terrorists.
13188,21/3/2010,Iraq,Yusufiya,3,5,8,Three Iraqis are taken down by a roadside bomb.
13189,22/3/2010,Pakistan,Rawalpindi,1,1,2,A Christian dies after being burned alive three days earlier for refusing to embrace Islam.  His wife was also raped.
13190,22/3/2010,Iraq,Baghdad,2,0,2,Two city workers are brutally shot to death by Muslim terrorists.
13191,22/3/2010,Iraq,Mosul,1,0,1,An electrician is murdered in front of his home by drive-by Jihadis.
13192,22/3/2010,Iraq,Radwaniya,2,0,2,Islamic 'insurgents' gun down two policemen.
13193,23/3/2010,Somalia,Afgoye,1,0,1,Islamists execute a Christian father of ten children at close range in front of his home.
13194,23/3/2010,Pakistan,Orakzai,1,0,1,A tribal elder is abducted and executed by religious extremists.
13195,23/3/2010,Iraq,Balad Ruz,1,0,1,Suspected al-Qaeda bombers take down a Sunni leader.
13196,24/3/2010,Iraq,Hit,3,2,5,A teenage suicide bomber murders three people in their home.
13197,24/3/2010,Iraq,Radwaniya,5,0,5,Five Iraqi soldiers are shot to death execution style at a checkpoint.
13198,24/3/2010,Afghanistan,Uruzgan,2,0,2,Two men working for a land-mine clearing operation are murdered by Islamists.
13199,24/3/2010,Afghanistan,Ghazni,3,0,3,Three local cops are blasted to death by Taliban bombers.
13200,24/3/2010,Afghanistan,Kabul,2,1,3,"Islamic militants stop a vehicle with a roadside bomb, then machine-gun the occupants."
13201,25/3/2010,Pakistan,Orakzai,2,0,2,Two tribal elders are abducted and beheaded by Religion of Peace radicals.
13202,25/3/2010,Iraq,Baghdad,2,0,2,Suspected al-Qaeda bombers murder a Sunni.
13203,25/3/2010,Iraq,Touz Khormato,2,6,8,Two people are killed by Jihadi bombers.
13204,25/3/2010,Iraq,Ramadi,1,8,9,A Shahid suicide bomber takes out an Iraqi.
13205,25/3/2010,Afghanistan,Khost,2,4,6,Two Afghan civilians are killed when Islamic hardliners attack a NATO base.
13206,25/3/2010,Iraq,Baghdad,2,0,2,A mother and daughter are brutally shot to death in their home by Muslim terrorists.
13207,26/3/2010,Germany,Berlin,0,3,3,Two Jewish women and a man are brutally beaten after their identity is confirmed by Muslim attackers.
13208,26/3/2010,Afghanistan,Khost,1,3,4,An aid worker is killed when Talibanis fire on a group rebuilding a school.
13209,26/3/2010,Iraq,Khalis,53,105,158,Two massive bomb blasts at a shopping area leave over fifty innocent people dead.
13210,26/3/2010,Israel,Gaza Border,2,2,4,Two Israeli soldiers are killed by Hamas gunfire.
13211,27/3/2010,Iraq,Saadiya,3,1,4,"Islamic terrorists open fire on a group of civilians outside their home, killing three."
13212,27/3/2010,Somalia,Mogadishu,4,2,6,"al-Shabaab Islamists kill four people, including a woman, with a roadside bomb."
13213,27/3/2010,Afghanistan,Helmand,1,0,1,A suicide bomber murders a British soldier clearing mines from a civilian road.
13214,27/3/2010,Afghanistan,Kabul,6,7,13,Children are among the casualties of three bombings that leave six civilians dead around the country.
13215,28/3/2010,Somalia,Mogadishu,1,0,1,A Somali tribal elder is assassinated by suspected Hizbul-Islam militants.
13216,28/3/2010,Pakistan,Thal,6,0,6,Six truck drivers bringing supplies to a Shia town are kidnapped and shot dead in captivity by Sunni radicals.
13217,28/3/2010,Iraq,Quaim,6,24,30,Six people at a construction site are killed in a coordinated series of bomb blasts.
13218,28/3/2010,Iraq,Mosul,1,3,4,A 3-year-old child dies when Mujahideen bombers target a Christian woman and her three daughters in their home.
13219,29/3/2010,Pakistan,Peshawar,2,3,5,A teenage suicide bomber sends two Pakistanis to Allah.
13220,29/3/2010,Pakistan,Kurram,3,0,3,The Taliban kidnap and cut the throats of three tribal elders.
13221,29/3/2010,Iraq,Karbala,12,74,86,A triple suicide bombing at a restaurant and an ambulance stand leaves a dozen dead.
13222,29/3/2010,Pakistan,Mamoond,2,8,10,Two people are killed by a Fedayeen suicide bomber.
13223,29/3/2010,Pakistan,Tank,1,2,3,A Shahid suicide bomber murders a civilian on his way home from a village defense meeting.
13224,29/3/2010,Iraq,Kirkuk,1,0,1,Terrorists kidnap a police officer and shoot him to death.
13225,29/3/2010,Thailand,Yala,1,0,1,A village chief is brutally gunned down at a wedding by Muslim separatists.
13226,29/3/2010,Russia,Moscow,38,102,140,Female suicide bombers massacre about forty subway commuters and leave another one-hundred in agony.
13227,30/3/2010,Afghanistan,Herat,5,2,7,The Taliban murder five civilians with a roadside bomb.
13228,30/3/2010,Iraq,Mosul,2,0,2,Two civilians are shot to death by Sunni militants.
13229,30/3/2010,India,Hyderabad,1,25,26,"Muslims attack a Hindu festival, burning cows, destroying property and stabbing a 22-year-old to death."
13230,31/3/2010,Thailand,Pattani,1,0,1,A 45-year-old civilian is shot twice in the back of the head by Muslim militants.
13231,31/3/2010,Iraq,Mosul,2,0,2,Sunni bombers take out a couple of local cops.
13232,31/3/2010,Dagestan,Kizlyar,12,23,35,"Two suicide bombers send twelve innocent souls to Allah, including rescue workers."
13233,31/3/2010,Afghanistan,Lashkar Gah,13,43,56,A dozen people at a wheat market (including eight children) are blown to bits by a Jihad bicycle bomb.
13234,31/3/2010,Thailand,Pattani,1,2,3,Islamic militants shoot one man to death and wound two others as they are watching TV in their home.
13235,31/3/2010,Pakistan,Khyber,6,20,26,Six security personnel are killed in a sustained attack by armed fundamentalists.
13236,1/4/2010,Iraq,Baghdad,2,0,2,A woman and girl are 'slaughtered' by suspected terrorists.
13237,1/4/2010,Pakistan,Faisalabad,3,0,3,Two brothers are among three members of the Ahmadi religious minority brutally gunned down on their way home from work.
13238,1/4/2010,Thailand,Narathiwat,6,10,16,Six Buddhist villagers are ambushed and shot to death by Religion of Peace radicals.
13239,2/4/2010,Somalia,Mogadishu,20,62,82,At least twenty civilians are killed in a 'relentless' assault by al-Shabaab on government positions.
13240,2/4/2010,India,Rajouri,1,0,1,Lashkar-e-Toiba members draw in and kill a soldier with a phony surrender offer.
13241,2/4/2010,Pakistan,Kurram,1,1,2,"Islamic militants fire into a civilian vehicle, killing one occupant."
13242,2/4/2010,Afghanistan,Khost,3,0,3,Three security guards are killed by Sunni hardliners in two bombings.
13243,2/4/2010,Iraq,Jalawla,2,1,3,A boy and his father are killed by roadside bombers.  The boy's mother is injured.
13244,2/4/2010,Iraq,Hor Rajib,25,6,31,"al-Qaeda Islamists roll into a village and tie up 20 men and five women, then shoot some to death and slit the throat of others."
13245,3/4/2010,Iraq,Baghdad,41,237,278,"Three bloody suicide blasts target the Iranian, Egyptian and German embassies, leaving at least forty dead."
13246,3/4/2010,Afghanistan,Marja,2,4,6,Women and children are among the casualties when a loaded tractor runs over a Taliban landmine.
13247,3/4/2010,Dagestan,Kizlyar,1,0,1,A cop is gunned down in an Islamic drive-by.
13248,3/4/2010,Afghanistan,Helmand,3,0,3,Three Afghan cops are taken down by Taliban bombers.
13249,3/4/2010,Algeria,Tifra,8,4,12,"Fundamentalists detonate two bombs an hour apart, sending eight souls to Allah."
13250,4/4/2010,Pakistan,Mohmand,3,0,3,Three villagers are cut down by a Taliban ambush.
13251,4/4/2010,Iraq,Mosul,3,40,43,Jihadis detonate a car bomb that kills at least three Iraqis.
13252,4/4/2010,Thailand,Narathiwat,3,9,12,"Muslim terrorists open fire inside a tea shop, killing at least three civilians."
13253,4/4/2010,Pakistan,Punjab,0,10,10,Ten Christians are severely beaten by Muslim fundamentalists.
13254,5/4/2010,Iraq,al-Shalamija,2,2,4,Jihadi bombers take down two local cops.
13255,5/4/2010,Pakistan,Nasirabad,2,0,2,A woman and her lover are shot by her brother in an honor killing.
13256,5/4/2010,Nigeria,Jos,3,12,15,Three Christians are killed when their peaceful rally is attacked by militant Muslims.
13257,5/4/2010,Iraq,Baghdad,6,0,6,"Four children, ages 6 to 11, are among a family of six Shia massacred in their home by Sunni gunmen"
13258,5/4/2010,Pakistan,Peshawar,4,18,22,Tehreek-e-Taliban attack the US consulate in a coordinated bombing and shooting attack that leaves four dead.
13259,5/4/2010,Pakistan,Timergarah,55,80,135,Fifty-five people at a political rally are dismembered by Mujahideen bombers.
13260,5/4/2010,Ingushetia,Karabulak,2,1,3,Two Russian cops are murdered by a Fedayeen suicide bomber.
13261,6/4/2010,Iraq,Baghdad,50,187,237,"At least fifty Iraqi civilians, including children, are blown to Allah by dedicated Sunni bombers."
13262,7/4/2010,Russia,Baksan,2,0,2,Two police officers are gunned down in a brutal ambush by suspected Islamists.
13263,7/4/2010,Algeria,Boumerdes,1,2,3,Fundamentalists kill a civilian along a busy street.
13264,7/4/2010,India,Kupwara,1,1,2,Lashkar-e-Toiba terrorists shoot an Indian soldier to death.
13265,7/4/2010,Pakistan,Hangu,2,0,2,Two brothers are gunned down in their home by a religious extremist.
13266,7/4/2010,Iraq,Mosul,2,4,6,Two civilians are murdered by Jihadi bombers.
13267,7/4/2010,Afghanistan,Jalalabad,1,15,16,A Shahid suicide bomber murders a civilian.
13268,8/4/2010,Iraq,Shabak,1,1,2,Islamic militants invade the home of a Shabak religious minority member and shoot him to death.
13269,8/4/2010,Nigeria,Dakyo,2,0,2,A teenager is among two Christians stabbed to death by Muslim attackers.
13270,8/4/2010,Iraq,Khalis,2,0,2,Two civilians are shot dead at a marketplace by Mujahideen.
13271,9/4/2010,Ingushetia,Ekazhevo,1,0,1,"A female suicide bomber walks up to a group of local cops and detonates, killing at least one of them."
13272,9/4/2010,Iraq,Mosul,2,0,2,Two Iraqis are murdered by Islamic gunmen along a city street.
13273,10/4/2010,Iraq,Mosul,2,0,2,A 10-year-old child is among two people blown apart by Mujahid bombers.
13274,10/4/2010,Russia,Nalchik,1,0,1,Muslim terrorists are suspected in the car bombing death of a police officer.
13275,10/4/2010,Iraq,Fallujah,1,4,5,A woman is the only fatality when an Islamic bomb breaks up a family gathering.
13276,10/4/2010,Iraq,Qayara,3,0,3,Three Iraqis are taken down by Jihadi bombers.
13277,10/4/2010,Afghanistan,Herat,3,8,11,Three civilians are blown to bits by a Taliban bomb.
13278,10/4/2010,Afghanistan,Kandahar,2,3,5,A bomb and rocket attack on a home leave two Afghans dead and a mother and two daughters severely injured.
13279,11/4/2010,Pakistan,Mardan,1,2,3,A police officer is killed by an Islamist ambush.
13280,11/4/2010,Iraq,Udhaim,3,1,4,Three young brothers are dismembered by a terrorist bomb.
13281,12/4/2010,Iraq,Baghdad,5,12,17,"A Fedayeen detonates along a city street, killing five innocents."
13282,12/4/2010,Iraq,Mosul,3,15,18,Three Iraqis are taken out by a Shahid suicide car bomber.
13283,12/4/2010,Somalia,Mogadishu,1,0,1,A university student is killed when Islamic militia mortar an airport.
13284,12/4/2010,Somalia,Mogadishu,6,10,16,Six Somalis are destroyed by coordinated al-Shabaab bombings.
13285,12/4/2010,Afghanistan,Kabul,3,4,7,Three women die from trauma suffered during a Sunni mortar attack.
13286,12/4/2010,Afghanistan,Faryab,4,2,6,Four police officers are murdered by Taliban bombers.
13287,13/4/2010,Pakistan,Sargodha,0,1,1,A Christian barber is badly beaten and sodomized by an angry mob for cutting a Muslim's beard (on request).
13288,13/4/2010,Afghanistan,Kandahar,1,0,1,An 18-year-old woman is brutally shot to death by an Islamic fundamentalist.
13289,13/4/2010,Philippines,Isabela,9,7,16,"Abu Sayyaf terrorists disguised as policemen attack a Christian town, shooting and blasting nine people to death and destroying a Catholic church."
13290,13/4/2010,Iraq,Baghdad,3,5,8,Suspected fundamentalists plant a shrapnel bomb at a liquor store shredding three patrons.
13291,14/4/2010,USA,"Marquette Park, IL",5,2,7,"After quarrelling with his wife over Islamic dress, a Muslim convert shoots his family members to 'take them back to Allah' and out of the 'world of sinners'."
13292,14/4/2010,Thailand,Narathiwat,1,0,1,Islamic radicals murder a village defense volunteer by slashing the back of his head and letting him bleed to death.
13293,14/4/2010,Indonesia,Jarkata,3,156,159,"Muslims enraged by a rumor of a revered scholar's tomb desecration attack security forces, hacking at least three to death."
13294,14/4/2010,Iraq,Mosul,2,0,2,A nurse is among two civilians gunned down by Islamic terrorists.
13295,14/4/2010,Iraq,Baghdad,2,6,8,A Sunni cleric is cut down by Religion of Peace rivals outside his mosque. A separate al-Qaeda attack leaves another Iraqi dead.
13296,15/4/2010,Dagestan,Krasny Voskhod,1,0,1,A local village chieftain is shot for resisting Islamic insurgents.
13297,15/4/2010,Chechnya,Achkhoi-Martan,3,1,4,Holy Warriors rip apart three Russians with a roadside bomb.
13298,15/4/2010,Afghanistan,Kandahar,6,16,22,A half dozen innocents are sent to Allah by Shahid suicide bomber.
13299,15/4/2010,Yemen,Shabwa,2,1,3,Separate al-Qaeda bomb blasts leave two people dead.
13300,15/4/2010,Pakistan,Mingora,2,0,2,Teenage Talibanis gun down two people in broad daylight.
13301,15/4/2010,Iraq,Mosul,4,0,4,Three women are among four civilians shot to death in their own home by Mujahideen.
13302,15/4/2010,Iraq,Samarrah,14,0,14,The bodies of fourteen kidnapping victims of a Sunni terror group are found in a mass grave.
13303,15/4/2010,Thailand,Pattani,2,1,3,"Muslim militants shoot three people, including a pork vendor."
13304,15/4/2010,Nigeria,Boto,2,0,2,A Christian pastor and his wife are abducted by Muslims and burned to a crisp.
13305,15/4/2010,Turkey,Istanbul,1,0,1,An entire family is involved in the 'honor' suffocation of a 2-day-old out-of-wedlock infant.
13306,16/4/2010,Iraq,Baaj,2,0,2,Islamists kidnap two men and shoot them in the back of the head.
13307,16/4/2010,Pakistan,Quetta,10,35,45,"A suicidal Sunni detonates in a crowd of Shia protesters outside a hospital, sending at least ten to Allah."
13308,17/4/2010,Pakistan,Kohat,41,62,103,"Two suicide bombers, dressed in burqas, blow up forty-one refugees lining up for food at a displaced persons camp."
13309,17/4/2010,Iraq,Basra,1,2,3,Islamists gun down a woman and injure her husband and son.
13310,18/4/2010,Iraq,Bartala,1,0,1,A member of the Shabak religious minority is kidnapped and murdered.
13311,18/4/2010,Iraq,Mosul,4,0,4,Three women are among four civilians shot to death in their home by Mujahideen.
13312,18/4/2010,Pakistan,Peshawar,7,26,33,A child is among seven people blown into pieces by a Shahid car bomber.
13313,18/4/2010,Somalia,Mogadishu,16,24,40,Islamists murder sixteen people with a landmine and mortar attack on an airport.
13314,18/4/2010,Iran,Urmiye Prison,2,0,2,The Islamic republic tortures to Kurdish prisoners to death on the same day.
13315,19/4/2010,Afghanistan,Kabul,2,6,8,A suicide bomber kills two soldiers at their base.
13316,19/4/2010,Afghanistan,Kandahar,3,4,7,Three children are brutally killed when Islamists set off a bomb hidden in a donkey cart.
13317,19/4/2010,Pakistan,Peshawar,25,48,73,About two dozen patrons at a market are sent to Allah by a Holy Warrior in a suicide vest.
13318,19/4/2010,Pakistan,Peshawar,1,15,16,A young boy is killed when a Fedayeen suicide bomber attacks a school.
13319,19/4/2010,Afghanistan,Kandahar,1,0,1,A popular politician is assassinated by hardliners at a mosque.
13320,19/4/2010,Pakistan,Landikotal,1,1,2,"Islamists send a mortar into a school principal's home, killing a woman and injuring her daughter."
13321,19/4/2010,Pakistan,Swat,2,3,5,Two villagers sitting outside a shop are gunned down by Mujahideen.
13322,19/4/2010,Iraq,Baqubah,2,2,4,Jihadi bombers take down two civilians.
13323,19/4/2010,Nigeria,Riyom,4,0,4,Four Christian farmers are murdered in their field by Muslim terrorists.
13324,20/4/2010,Pal. Auth.,Surif,1,0,1,A 20-year-old woman is tied up and thrown down a well by her conservative family for dating the wrong man.
13325,20/4/2010,Pakistan,Hangu,4,12,16,Four locals are blown to bits by Sunni bombers.
13326,20/4/2010,Iraq,Hit,3,0,3,Three Iraqis are murdered by a roadside bomb.
13327,20/4/2010,Iraq,Tarmiyah,5,0,5,Three young children are beheaded along with two women in a home by suspected al-Qaeda.
13328,20/4/2010,Dagestan,Makhachkala,3,0,3,Islamic militants ambush two policemen with automatic weapons.
13329,21/4/2010,Pakistan,Sargodha,1,1,2,Two young Christian brothers (ages 12 and 14) are beaten with an iron rod by a Muslim yelling religious slurs.  One dies.
13330,21/4/2010,Thailand,Narathiwat,1,0,1,Islamists shoot a 20-year-old man to death in his home.
13331,21/4/2010,Thailand,Pattani,1,0,1,A 56-year-old man is murdered by Muslim gunmen.
13332,21/4/2010,Pakistan,Khyber,1,4,5,"A woman is killed, and her four children injured, by mortar shell fired by suspected militants."
13333,21/4/2010,India,Jammu,1,0,1,Mujahideen shoot an Indian police officer to death.
13334,21/4/2010,Iraq,Baqubah,3,14,17,"Jihadis bomb a restaurant near a school, a teacher and student are among three who die from shrapnel."
13335,21/4/2010,Iraq,Baghdad,2,0,2,Two victims of sectarian violence are found dead.
13336,21/4/2010,Somalia,Mogadishu,5,0,5,Five construction workers are kidnapped and beheaded by Islamic fundamentalists.
13337,21/4/2010,Thailand,Pattani,2,52,54,An Islamic insurgent throws a grenade into a group of policemen.
13338,22/4/2010,Pakistan,Charsadda,4,0,4,"The Taliban spray a car with automatic weapons, slaying the four occupants."
13339,22/4/2010,Iraq,Souz,1,3,4,"Terrorists set off a bomb at a home, killing a resident."
13340,22/4/2010,Thailand,Narathiwat,1,0,1,A young man is gunned down by Muslim radicals at a nightclub.
13341,23/4/2010,England,Leicester,0,1,1,"A Sikh man is brutally beaten by a gang of Muslims, who shout ""Allah"" during the attack and pull off his religious necklace."
13342,23/4/2010,Pakistan,Miranshah,4,0,4,"Four captives are butchered by Islamic hardliners, two of whom are beheaded."
13343,23/4/2010,Iraq,Baghdad,69,303,372,"Devoted Sunnis slaughter seventy Shiite Iraqis in at least five deadly bomb blasts at mosques, homes and a shopping district."
13344,23/4/2010,Pakistan,Datta Khel,7,16,23,"Religious extremists ambush a Pakistani military convoy, killing seven."
13345,24/4/2010,Pakistan,Karachi,1,0,1,A Christian police officer is kidnapped and brutally tortured to death by Religion of Peace advocates.
13346,24/4/2010,Iraq,Baghdad,3,19,22,"Jihadis bomb a marketplace, taking down three Iraqis."
13347,24/4/2010,Iraq,Mosul,3,0,3,Two civilians and one defense volunteer are gunned down by Muslim militants.
13348,24/4/2010,Somalia,Mogadishu,2,2,4,al-Shabaab Islamists kill two government soldiers with a landmine.
13349,24/4/2010,Pakistan,Akwal,3,1,4,Three guards are gunned down when Taliban terrorists attack NATO tankers.
13350,24/4/2010,Nigeria,Jos,5,0,5,Three Christians stabbed to death and two others hacked to pieces with machetes by a Muslim mob.
13351,25/4/2010,Afghanistan,Zabul,4,12,16,"A suicide bomber detonates at a bazaar, blowing four innocents straight to Allah."
13352,25/4/2010,Thailand,Pattani,1,4,5,"Islamists fire on a garbage truck, killing one worker."
13353,26/4/2010,Afghanistan,Kunduz,3,4,7,Three people die from a Taliban rocket attack.
13354,26/4/2010,India,Budgam,1,1,2,Islamic militants gun down a local cop.
13355,26/4/2010,Iraq,Fallujah,3,2,5,Three Iraqis are taken out by Jihadi bombers.
13356,26/4/2010,Iraq,Baqubah,2,7,9,Two people are murdered in separate Mujahideen bomb blasts.
13357,27/4/2010,Iraq,Baghdad,4,2,6,A family of four is obliterated by sectarian bombers.
13358,27/4/2010,Somalia,Afgoi,1,0,1,A respected humanitarian worker is shot to death by suspected Hizbul Islam.
13359,27/4/2010,Iraq,Kirkuk,1,1,2,Jihadis take down a student in a drive-by attack.
13360,27/4/2010,Iraq,Baghdad,2,12,14,Two local soldiers are killed when Jihadis fire mortars from a residential neighborhood.
13361,27/4/2010,Somalia,Mogadishu,2,8,10,"Islamists attack a rival mosque, killing two."
13362,27/4/2010,Afghanistan,Kandahar,3,35,38,A Fedayeen suicide bomber sends three airport workers to Allah.
13363,28/4/2010,Pakistan,Quetta,1,0,1,A Christian man is gunned down by suspected Muslim militants as he is washing a car.
13364,28/4/2010,Iraq,Baghdad,6,18,24,Jihadi bombers manage to take down six Iraqis along a city street.
13365,28/4/2010,Afghanistan,Khost,12,0,12,"Islamic hardliners murder a dozen civilians, mostly women and children, with a roadside bomb."
13366,28/4/2010,Pakistan,Peshawar,4,15,19,"A Shahid suicide car bomber plows into a group of Pakistanis, killing at least four."
13367,28/4/2010,Thailand,Pattani,1,2,3,A 41-year-old female health volunteer is shot in the head by Muslim rebels.
13368,28/4/2010,Yemen,Damaj,4,0,4,Shiite rebels kill four people in two separate attacks.
13369,29/4/2010,Somalia,El Bahay,6,10,16,Six people are taken out by an al-Shabaab attack on a village.
13370,29/4/2010,Iraq,Baghdad,1,0,1,A car bomb at a rival mosque leaves one dead.
13371,29/4/2010,Dagestan,Kazbekovsky,2,17,19,Two local cops are blown to bits by a Fedayeen suicide bomber.
13372,29/4/2010,Iraq,Baghdad,8,20,28,"Suspected fundamentalists bomb a liquor store, killing eight civilians."
13373,30/4/2010,Pakistan,Karachi,1,5,6,Islamists murder a civilian with a bomb attached to a motorcycle.
13374,30/4/2010,Pakistan,Karam Kot,1,0,1,The body of a brutally slain intelligence officer is found three weeks after being kidnapped.
13375,30/4/2010,Iraq,Garma,3,10,13,Three patrons are killed when Islamic militants toss a bomb into a marketplace.
13376,30/4/2010,India,Batamaloo,1,0,1,Angry Muslims stone an innocent civilian to death over the cancellation of a religious march.
13377,30/4/2010,France,Strasbourg,0,1,1,A Jewish man is stabbed in the neck and hit in the face with an iron bar by a Muslim yelling about a Zionist conspiracy.
13378,1/5/2010,Somalia,Mogadishu,45,70,115,Forty-five people die from shrapnel and burn injuries when Islamists bomb a rival mosque.
13379,1/5/2010,Russia,Nalchik,1,29,30,"Muslim radicals set off a bomb at a race track, killing an elderly veteran of World War II."
13380,1/5/2010,Pakistan,Swat,3,12,15,Three innocents are incinerated by a suicide bomber at a shop.
13381,1/5/2010,Iraq,Mosul,1,0,1,Sectarian Jihadis gun down a teacher leaving a mosque.
13382,1/5/2010,Iraq,Baghdad,3,2,5,Three Iraqis are killed by a car bomb.
13383,2/5/2010,Pakistan,Swat,1,3,4,A young woman is killed when religious extremists throw a grenade into her home.
13384,2/5/2010,Iraq,Mosul,4,171,175,"Four people are killed, and over one-hundred injured when Islamic bombers target buses carrying young Christian students."
13385,2/5/2010,Somalia,Kismayo,2,12,14,Two people are killed when Muslim terrorists toss a grenade into a rival mosque.
13386,2/5/2010,Afghanistan,Paktia,8,14,22,Religion of Peace hardliners massacre a busload of women and children with a roadside bomb.
13387,3/5/2010,Afghanistan,Khost,1,2,3,A civilian is blown to bits by a Shahid suicide bomber.
13388,3/5/2010,Iraq,Kirkuk,1,0,1,An accused sorcerer is shot to death outside his home.
13389,3/5/2010,Iraq,Sharqat,2,4,6,Jihadi bombers take down two Iraqis.
13390,4/5/2010,Somalia,Xarardheere,1,0,1,Islamists pull a 57-year-old Christian father of three from his home and execute him for running an underground church.
13391,4/5/2010,Somalia,Hawa Abdi,1,0,1,A man is assassinated by Islamic gunmen as he leaves a mosque.
13392,4/5/2010,Iraq,Mosul,3,0,3,"Freedom fighters gun down a pharmacist, woman, and rival imam in separate attacks."
13393,4/5/2010,Afghanistan,Kunduz,3,0,3,Three civilians are captured and executed by the Taliban.
13394,5/5/2010,Iraq,Mosul,1,0,1,A college student is kidnapped and murdered by Ansar al-Islam.
13395,5/5/2010,Iraq,Ameriya,4,0,4,"Four people, including a rival imam are murdered by Sunni gunmen."
13396,5/5/2010,Iraq,Mosul,2,1,3,Islamic terrorists gun down two Iraqis in cold blood.
13397,5/5/2010,Afghanistan,Nimruz,4,15,19,A woman is among four Afghans murdered by a Fedayeen assault on a government building.
13398,5/5/2010,Somalia,Mogadishu,1,0,1,An anti-Islamist journalist is kidnapped and slain by his abductors.
13399,6/5/2010,Pakistan,Cantt,1,0,1,A civilian is murdered by a Shahid suicide bomber.
13400,6/5/2010,Pakistan,Bahawalnagar,1,0,1,A 15-year-old teenager dies from shrapnel injuries after militants throw a grenade into his home.
13401,6/5/2010,India,Rafiabad,2,0,2,Two security personnel are killed when Mujahid open fire on them from a house.
13402,6/5/2010,Iraq,Baghdad,2,4,6,Jihadi bombers take down two locals at a town square.
13403,6/5/2010,Thailand,Yala,1,0,1,A 52-year-old man is shot to death by Mujahideen while sitting in this truck
13404,7/5/2010,Iraq,Mosul,1,0,1,"A 16-year-old boy dies from gunshot wounds to the head, suffered during an Ansar al-Islam kidnapping."
13405,7/5/2010,Iraq,Rashad,3,4,7,Three Iraqis are taken down in a suspected al-Qaeda ambush.
13406,7/5/2010,Somalia,Shabelle,4,10,14,Four hospital guards are shot dead by Hizbul Islam members while working their post.
13407,7/5/2010,Pakistan,Ghazi Kot,4,1,5,Religious extremists machine-gun four local cops taking shelter from the rain inside a shed.
13408,7/5/2010,Dagestan,Derbent,1,5,6,A woman standing on a railway platform is shredded by a Jihad bomb.
13409,8/5/2010,Afghanistan,Herat,4,0,4,Talibanis behead four Afghans.
13410,8/5/2010,Iraq,Mosul,3,2,5,A woman is among three people gunned down in separate Mujahideen attacks.
13411,8/5/2010,Iraq,Amirli,3,5,8,A mother and her son are among three killed when Islamic terrorists plant a bomb in a home.
13412,9/5/2010,Iraq,Tehran,5,0,5,"The Islamic Republic executes five political prisoners, calling them 'enemies of Allah.'"
13413,9/5/2010,India,Ganderbal,1,0,1,Hizb-ul-Mujahideen murder the young brother of a former militant in his home in revenge for his leaving.
13414,9/5/2010,Iraq,Mosul,1,0,1,An elderly man is shot to death in front of his home by terrorists.
13415,9/5/2010,Philippines,Cotabato,1,9,10,"Militant Muslims are suspected of tossing a grenade into a rival mosque, leaving at least one dead."
13416,10/5/2010,Switzerland,Hongg,1,0,1,A 16-year-old girl is honor killed by her father with an axe.
13417,10/5/2010,Pakistan,Orakzai,9,5,14,"Islamic fundamentalists attack a local army post, killing nine defenders."
13418,10/5/2010,Pakistan,Karachi,1,0,1,A Shia doctor and father of two is gunned down in a sectarian attack.
13419,10/5/2010,Iraq,Baghdad,114,350,464,"Suicide bombings at a textiles factory and a wave of other terror attacks on Iraqis, including at marketplaces and mosques, leave over one-hundred dead."
13420,11/5/2010,Iraq,Baghdad,5,16,21,A Christian community may have been the target of a double bombing that leaves five dead.
13421,11/5/2010,Afghanistan,Kandahar,1,0,1,Islamic hardliners shoot a civilian to death inside his home.
13422,12/5/2010,Somalia,Mogadishu,1,5,6,An al-Shabaab bombing leaves one person dead.
13423,12/5/2010,Pakistan,Peshawar,3,3,6,Islamic bombers send three seminary students to Allah.
13424,12/5/2010,Pakistan,Chaman,2,2,4,A teenager is among two killed when Muslim extremists blow up a tanker truck.
13425,12/5/2010,Iraq,Baghdad,7,22,29,"Jihadis detonate a bomb outside a cafe, murdering seven patrons."
13426,12/5/2010,Afghanistan,Kandahar,1,0,1,Islamic militants claim credit for the targeted assassination of a prison official.
13427,12/5/2010,Afghanistan,Uruzgan,3,0,3,A Fedayeen suicide bomber takes out three local cops.
13428,12/5/2010,Pakistan,North Waziristan,2,0,2,Tehreek-e-Taliban members kidnap and shoot two civilians to death.
13429,12/5/2010,Iraq,Baghdad,9,39,48,Nine Iraqis are brought down by two terrorist bombings.
13430,13/5/2010,Pakistan,Karachi,1,0,1,A child is shot dead in a suspected sectarian attack.
13431,13/5/2010,Iraq,Baghdad,5,12,17,Five Iraqis are sent to paradise by Mujahideen bombers.
13432,13/5/2010,Dagestan,Makhachkala,8,4,12,Eight workers on their way to repair a cell phone tower are blown to bits by Islamic bombers.
13433,14/5/2010,India,Srinagar,1,5,6,One officer is killed when Islamists hurl a grenade toward a group of local cops.
13434,14/5/2010,India,Hyderabad,1,0,1,Tehreek Galba-e-Islam terrorists on a motorcycle gun down a cop.
13435,14/5/2010,Iraq,Tal Afar,25,108,133,"Muslim terrorists stage a huge suicide bombing on a soccer game, leaving at least two dozen spectators dead."
13436,14/5/2010,Thailand,Narathiwat,1,0,1,Islamists shoot a public health official six times in the chest and head.
13437,14/5/2010,Iraq,Mosul,1,0,1,A tailor who makes military uniforms is shot to death by Mujahideen.
13438,14/5/2010,Iraq,Baghdad,4,8,12,Four people are killed when terrorists detonate a bomb at a park.
13439,14/5/2010,Iraq,Jbala,0,20,20,Twenty Shias are injured when rivals blow up their mosque.
13440,14/5/2010,Afghanistan,Ghazni,5,0,5,Five private security guards are murdered in a Muslim ambush.
13441,15/5/2010,Yemen,Hibailin,1,2,3,Suspected al-Qaeda assassinate a guard.
13442,15/5/2010,Afghanistan,Khost,4,0,4,"The Taliban kidnap and brutally slaughter four Afghan members of a wedding party, including the groom."
13443,15/5/2010,Iraq,Mosul,3,0,3,"A child, shepherd and mosque official are killed in separate Mujahid attacks."
13444,16/5/2010,Afghanistan,Herat,2,2,4,Two Italian peacekeepers succumb to injuries from a roadside bombing.
13445,16/5/2010,Somalia,Mogadishu,16,31,47,Sixteen civilians are killed during a vicious mortar attack by Islamic militia.
13446,16/5/2010,Afghanistan,Kandahar,1,0,1,Muslim gunmen on a motorcycle murder a man sitting in his car.
13447,16/5/2010,Afghanistan,Kunar,3,0,3,A pro-peace cleric is gunned down along with two family members by Islamic hardliners.
13448,17/5/2010,Pakistan,Tank,1,0,1,A pro-government tribal elder is murdered by Islamists on his way home.
13449,17/5/2010,Iraq,al-Bushaneen,1,0,1,A cleric is shot to death in front of his family by Muslim radicals.
13450,17/5/2010,Thailand,Yala,1,0,1,A Buddhist school administrator is murdered by Muslim assassins on his way to work.
13451,17/5/2010,Thailand,Pattani,1,0,1,Three Muslims shoot a Buddhist public works official to death.
13452,17/5/2010,Iraq,Sadiyah,1,0,1,al-Qaeda behead a rival cleric and hang his head from a utility pole.
13453,18/5/2010,Pakistan,Dera Ismail Khan,14,17,31,"A bicycle bomber blasts fourteen souls to Allah, including a small girl."
13454,18/5/2010,Afghanistan,Kabul,18,47,65,At least eighteen people are massacred by a Fedayeen suicide bomber.
13455,18/5/2010,Afghanistan,Kabul,1,9,10,A Taliban rocket attack kills a US citizen.
13456,18/5/2010,India,Poonch,2,3,5,Two Indian soldiers are murdered in a Jihad ambush.
13457,18/5/2010,Iraq,Yathrib,2,1,3,Islamic terrorists blow up two Iraqi women in their home.
13458,19/5/2010,Somalia,Mogadishu,2,0,2,Two children are killed when Islamic militia fire a mortar into their home.
13459,19/5/2010,Somalia,Mogadishu,1,0,1,An African peacekeeper is taken out by an Islamist bomb.
13460,19/5/2010,Philippines,Basilan,2,2,4,Abu Sayyaf militants ambush and kill two policemen.
13461,19/5/2010,Iraq,Mussayab,6,19,25,Six people at a restaurant are blown to bits by Islamic bombers.
13462,19/5/2010,Iraq,Mosul,2,1,3,Mujahideen gun down two local soldiers at a checkpoint.
13463,19/5/2010,Algeria,Boumerdes,2,18,20,An al-Qaeda roadside blast takes out two local soldiers.
13464,19/5/2010,Russia,Dagestan,3,0,3,Muslim radicals gun down two local cops and kill a third with a bomb in neighboring Chechnya.
13465,19/5/2010,Thailand,Yala,1,0,1,A 46-year-old civilian is shot and then set on fire by Religion of Peace separatists.
13466,20/5/2010,Thailand,Narathiwat,1,0,1,Muslim gunmen murder a 56-year-old villager.
13467,20/5/2010,Pakistan,North Waziristan,2,0,2,The Taliban strap explosives to two civilians and detonate them in a public execution.
13468,20/5/2010,Iraq,Mosul,3,8,11,A Shahid suicide bomber takes out three Iraqis.
13469,20/5/2010,Thailand,Yala,1,0,1,A Buddhist woman is gunned down in her grocery story by Muslim terrorists.
13470,21/5/2010,Pakistan,Mir Ali,1,0,1,Hardliners abduct and murder a local tribesman.
13471,21/5/2010,Iraq,Muqdadiya,4,1,5,Mujahideen invade a home and shoot four family members to death.
13472,21/5/2010,Thailand,Pattani,1,0,1,Holy Warriors shoot a Buddhist nurse in the head as she is riding to work.
13473,21/5/2010,Iraq,Diyala,35,69,104,A Fedayeen drives an explosives-laden minibus into a crowd of shoppers and cafe patrons.
13474,21/5/2010,Somalia,Mogadishu,3,5,8,Three civilians are killed during an al-Shabaab attack.
13475,22/5/2010,Thailand,Yala,2,0,2,"Two women, one of whom was pregnant, are murdered in cold blood by Mujahid gunmen."
13476,22/5/2010,Thailand,Narathiwat,2,0,2,Two civilians are shot to death by Muslim terrorists.
13477,22/5/2010,Somalia,Mogadishu,20,55,75,Twenty civilians are crushed and dismembered during an Islamic mortar attack.
13478,22/5/2010,Pakistan,FATA,1,0,1,"A tribesman, abducted the Taliban, is found dead."
13479,22/5/2010,Pakistan,Baizai,1,3,4,A member of a peace committee is murdered in an Islamist ambush.
13480,22/5/2010,Iraq,Mosul,2,4,6,Two Iraqis are taken out in a bomb blast.
13481,22/5/2010,Russia,Prokladnyi,3,0,3,Two women and one man are gunned down in cold blood by suspected Islamic insurgents.
13482,22/5/2010,Afghanistan,Kandahar,3,0,3,A civilian and two military engineers are killed by a Taliban roadside bomb.
13483,23/5/2010,India,Sopore,1,0,1,Islamic militants are suspected in the murder of a local official.
13484,23/5/2010,Nigeria,Jos,2,0,2,Two Christians are hacked to death with machetes by passing Muslims.
13485,24/5/2010,Pakistan,Quetta,2,15,17,Women and children are among the casualties when Sunni bombers target a Shia scholar.
13486,24/5/2010,Iraq,Mosul,1,0,1,An elderly woman is murdered inside her home by Mujahideen.
13487,24/5/2010,Iraq,Mosul,2,1,3,Religious extremists assassinate a secular lawmaker and his driver.
13488,24/5/2010,Afghanistan,Faryab,1,2,3,Taliban terrorists assassinate an Afghan elder and peace advocate.
13489,24/5/2010,Afghanistan,Khost,6,0,6,Six residents of a small village are shot to death in cold blood by Islamic fundamentalists.
13490,24/5/2010,Afghanistan,Farah,5,8,13,Five civilians riding a bus are blown to bits by Taliban bombers.
13491,24/5/2010,Iraq,Ramadi,1,0,1,Jihadis kill a young man with a bomb planted outside his kitchen.
13492,25/5/2010,Philippines,Talipao,3,3,6,"Three members of a family are blown apart, when Abu Sayyaf members throw a grenade into their home."
13493,25/5/2010,Iraq,Baghdad,15,3,18,al-Qaeda radicals gun down fifteen people working at a gold market.
13494,26/5/2010,Pakistan,Lahore,1,0,1,Terrorists murder a lawyer outside a courthouse with a grenade.
13495,26/5/2010,Iraq,Mosul,3,0,3,Three policemen are murdered by Mujahideen.
13496,26/5/2010,Thailand,Yala,2,52,54,"Islamic militants set off a bomb in front of a car dealership, killing two people."
13497,26/5/2010,Russia,Starvropol,7,40,47,Two young girls are among seven killed when terrorists bomb a concert hall.
13498,26/5/2010,Somalia,Mogadishu,6,20,26,Six people are counted dead following an al-Shabaab militia attack around a city square.
13499,27/5/2010,Iraq,Mosul,1,11,12,"Mujahid gun down a civilian and mortar a factory, wounding eleven people."
13500,27/5/2010,Pakistan,Bajur,3,1,4,A married couple and their son are brutally gunned down in their home by Islamic fundamentalists.
13501,28/5/2010,Pakistan,Quetta,4,0,4,Lashkar-e-Jhangvi gunmen take down four policemen at point-blank range.
13502,28/5/2010,Pakistan,Karachi,1,0,1,One person is killed when rival Islamic sects clash.
13503,28/5/2010,Pakistan,Lahore,98,110,208,Orthodox Sunni terrorists stage a bloody grenade and firearms assault on two mosques belonging to a minority sect.  Nearly one hundred worshippers are murdered.
13504,28/5/2010,Somalia,Mogadishu,3,1,4,Two children are among three civilians blown to bits by Islamic militia bombers.
13505,28/5/2010,Pakistan,Faisalabad,0,5,5,"Muslims fire into a Christian community, hitting five innocents."
13506,29/5/2010,Dagestan,Kaspiysk,1,2,3,Islamic militants send a police officer to Allah with a roadside bomb.
13507,29/5/2010,Pakistan,Lahore,3,1,4,Three police officers are cut down by Islamic gunmen at a checkpoint.
13508,29/5/2010,Iraq,Mosul,2,0,2,Terrorists gun down a farmer and his son in their field.
13509,30/5/2010,Dagestan,Botayurt,1,1,2,"Muslim militants fire into a cafe, killing a patron."
13510,30/5/2010,Afghanistan,Khost,19,23,42,A Fedayeen suicide bomber takes out nearly twenty local recruits.
13511,30/5/2010,Iraq,Mosul,1,3,4,One civilian is killed in a shooting attack by Muslim radicals.
13512,30/5/2010,Thailand,Pattani,1,0,1,A 50-year-old Buddhist is shot to death by four Muslims while sitting in a tea shop.
13513,30/5/2010,Afghanistan,Badakhshan,7,1,8,Taliban fundamentalists murder seven local cops with a roadside bomb.
13514,31/5/2010,Jordan,Amman,1,0,1,A 20-year-old woman is stabbed to death by her older brother in an honor killing.
13515,31/5/2010,Pakistan,Lahore,6,6,12,Six people are killed when Islamic militants storm a hospital.
13516,31/5/2010,Ingushetia,Malgobek,1,2,3,Islamic militants kill an off-duty policeman at a gas station.
13517,31/5/2010,Pakistan,Quetta,2,0,2,A prayer leader and his companion are murdered by sectarian rivals.
13518,31/5/2010,Iraq,Baghdad,2,10,12,Jihadis gun down a man sitting in a cafe and successfully kill a civilian in a separate bomb attack.
13519,1/6/2010,Pakistan,Karachi,1,0,1,A Shia is brutally shot to death in a sectarian attack.
13520,1/6/2010,Pakistan,Mohmand,3,0,3,Three civilians are gunned down by Taliban militants.
13521,1/6/2010,Iraq,Mosul,3,1,4,Mujahid successfully kill three Iraqis with an incendiary bomb.
13522,1/6/2010,Pakistan,Muslimabad,2,0,2,A woman and her new husband are murdered by her former in-laws in an honor killing.
13523,2/6/2010,Dagestan,Gubden,1,0,1,"A year after murdering a forester, Islamic radicals return to the home and kill his son as well."
13524,2/6/2010,Afghanistan,Nawzad,4,0,4,Two young boys are among four civilians taken out by Islamist roadside bomb.
13525,2/6/2010,Afghanistan,Marjah,4,0,4,Four civilians are killed in their home during a Taliban ambush on a security patrol.
13526,2/6/2010,Iraq,Mosul,1,0,1,Islamic militants kidnap a local soldier and slit his throat.
13527,2/6/2010,Iraq,Abu Ghraib,1,3,4,A Jihad bomb blast leaves one Iraqi dead.
13528,3/6/2010,Somalia,Mogadishu,2,5,7,Two Ugandan peacekeepers are murdered by al-Shabaab terrorists.
13529,3/6/2010,Thailand,Pattani,1,0,1,A Buddhist schoolteacher is gunned down by Religion of Peace proponents.
13530,3/6/2010,Iraq,Abu Ghraib,8,0,8,Eight victims of a Shiite death squad are found in a mass grave.
13531,3/6/2010,Turkey,Iskenderun,1,0,1,A Catholic bishop is stabbed to death by a Muslim who says it was Allah's will.
13532,3/6/2010,Iraq,Sinjar,4,14,18,Four people are killed when Islamic fundamentalist bombers target and liquor stores.
13533,3/6/2010,Pakistan,Quetta,2,0,2,A man murders his sister and her lover for having 'illicit relations'.
13534,3/6/2010,Pakistan,Sahiwal,0,3,3,A pastor and his pregnant wife are brutally assaulted by angry Muslims accusing them of evangelism.
13535,4/6/2010,Philippines,Sumisip,2,1,3,Two residents are killed when Abu Sayyaf fire into a village.
13536,4/6/2010,Pakistan,Datta Khel,1,0,1,An elderly man is beheaded by Religion of Peace zealots.
13537,4/6/2010,Pakistan,Miranshah,1,0,1,A civilian is captured by the Taliban and shot to death.
13538,4/6/2010,Iraq,Mosul,2,4,6,Terrorists murder two civilians with a roadside bomb.
13539,4/6/2010,Iraq,Missan,2,2,4,Two Iraqis are killed when Muslim radicals rocket an airport.
13540,4/6/2010,Dagestan,Makhachkala,1,1,2,Muslim radicals shoot a rival imam to death in front of his mosque.
13541,4/6/2010,Ingushetia,Malgobek,1,16,17,An attack on a shop by Islamic militants leaves one person dead.
13542,4/6/2010,Ingushetia,Sagapshi,2,21,23,A grocery store clerk is gunned down by Islamists who plant a bomb that then kills a rescue worker.
13543,4/6/2010,Philippines,Basilan,3,0,3,Abu Sayyaf members kidnap and murder three villagers.  The victims were manual laborers.
13544,5/6/2010,Afghanistan,Kandahar,1,15,16,"Muslim terrorists set off a bicycle bomb in front of a Red Cross office, killing a bystander."
13545,5/6/2010,Yemen,Marib,3,0,3,An al-Qaeda ambush leaves three locals dead.
13546,5/6/2010,Pakistan,Khyber,2,0,2,Two passersby are killed in a shootout between rival Islamist groups.
13547,5/6/2010,Iraq,Mosul,2,0,2,Two politicians are assassinated by Muslim terrorists in separate attacks.
13548,6/6/2010,Iraq,Baghdad,6,18,24,Six people are ripped apart by two Jihad bomb blasts.
13549,6/6/2010,Afghanistan,Kandahar,1,11,12,At least one person is killed by a Taliban roadside attack.
13550,6/6/2010,Thailand,Pattani,3,0,3,"Three Buddhist workers, including a woman, are shot to death by Islamic terrorists on a shrimp farm."
13551,6/6/2010,Thailand,Narathiwat,1,0,1,A 34-year-old man is gunned down in front of his home by Muslim radicals.
13552,7/6/2010,Algeria,Bejaia,3,5,8,Fundamentalists kill three security personnel with two planted bombs.
13553,7/6/2010,Iraq,Abu Ghraib,3,2,5,An imam and his family are cut down in front of their house by Religion of Peace rivals.
13554,7/6/2010,Iraq,Sunidij,3,1,4,Three brothers are shot to death in their home by Muslim terrorists.
13555,7/6/2010,Iraq,Baghdad,6,37,43,A series of bombs packed with ball-bearings shred at least six Iraqis.
13556,7/6/2010,Afghanistan,Kandahar,2,0,2,An American civilian training Afghan police officers is among two killed in a Fedayeen attack.
13557,8/6/2010,Iraq,Kirkuk,1,0,1,A Christian father is murdered outside his home by Islamist gunmen.
13558,8/6/2010,Pakistan,Quetta,1,0,1,A Hindu trader is shot to death by Muslim kidnappers.
13559,8/6/2010,Pakistan,Punjab,4,3,7,Four drivers are burned to death when Mujahideen set fire to a supply convoy.
13560,8/6/2010,Pakistan,Orakzai,6,8,14,"Religious fanatics storm a police checkpoint, killing six officers."
13561,8/6/2010,Iraq,Mosul,2,0,2,Islamic militants gun down an unmarried couple.
13562,8/6/2010,Iraq,al-Halla,3,1,4,"Jihadis spray the inside of a vehicle with automatic weapons, taking out three civilians."
13563,8/6/2010,Afghanistan,Sangin,1,0,1,A 7-year-old boy is kidnapped and hanged by Sunni fundamentalists.
13564,9/6/2010,Pakistan,Quetta,4,0,4,The Taliban are suspected in a shooting attack that leaves four local cops dead.
13565,9/6/2010,Thailand,Yala,1,23,24,A 5-year-old girl is murdered in a grenade attack by Islamic separatists.
13566,9/6/2010,Iraq,Baghdad,2,5,7,A husband and his wife are brutally executed in their own home by Mujahideen.
13567,9/6/2010,Afghanistan,Nadahan,40,73,113,Forty people at a wedding are incinerated by a Fedayeen suicide bomber.
13568,9/6/2010,Afghanistan,Kandahar,1,0,1,Religious fanatics drag a local city official from his home and murder him.
13569,9/6/2010,Pakistan,Karachi,1,0,1,A Shia is shot to death by sectarian rivals.
13570,9/6/2010,Pakistan,Mohmand,2,0,2,Two local soldiers are killed by a Taliban ambush.
13571,9/6/2010,Somalia,Mogadishu,5,0,5,Five government workers are blown to bits by an Islamist roadside bomb.
13572,9/6/2010,Iraq,Muqdadiya,2,4,6,A suicide bomber on a motorcycle murders two civilians.
13573,9/6/2010,Iraq,Shurqat,2,2,4,Two Iraqis are gunned down by suspected al-Qaeda.
13574,10/6/2010,Pakistan,Karachi,1,3,4,"Islamists are suspected of bombing a Navy office, leaving one dead."
13575,10/6/2010,Iraq,Kirkuk,1,0,1,A woman is shot to death inside her home by Mujahid.
13576,10/6/2010,Iraq,Baghdad,4,8,12,A Shahid suicide bomber murders four civilians.
13577,10/6/2010,Iraq,Tikrit,5,15,20,Five people are taken out in a Religion of Peace bomb blast.
13578,11/6/2010,Pakistan,Karachi,1,0,1,Sunni assassins shoot a Shia father to death on his way to work.
13579,11/6/2010,Thailand,Pattani,1,0,1,A 29-year-old man is gunned down by Islamic militia outside a motorcycle repair shop.
13580,11/6/2010,Afghanistan,Mata Khan,4,0,4,Four construction workers are brutally shot to death by Sunni fundamentalists.
13581,11/6/2010,Iraq,Jalawla,8,27,35,Jihadis take out eight souls with a suicide blast.
13582,11/6/2010,Iraq,Baghdad,3,9,12,"Terrorists plant a bomb in a garbage pile, killing three bystanders."
13583,11/6/2010,Algeria,Lakhdaria,4,20,24,Four people are killed when fundamentalists blow up an explosives laden truck along a city street.
13584,11/6/2010,Afghanistan,Kandahar,9,8,17,Four women and three children riding a minibus are among nine civilians torn apart by an Islamist shrapnel bomb.
13585,11/6/2010,Afghanistan,Zabul,4,0,4,Four human beings at a market are blown to Allah by a suicide bomber.
13586,11/6/2010,Philippines,Maluso,3,0,3,Three lumberjacks are kidnapped and beheaded by Abu Sayyaf militants.
13587,11/6/2010,Russia,Nalchik,1,0,1,A cop is killed by gunfire from a mosque.
13588,12/6/2010,Dagestan,Kaspiisk,1,5,6,A bomb takes down a firefighter.
13589,12/6/2010,Pakistan,Karachi,2,0,2,Sunni and Shia exchange targeted assassinations.
13590,12/6/2010,Afghanistan,Kandahar,5,0,5,Five local cops are dismembered by a Taliban roadside blast.
13591,12/6/2010,Thailand,Yala,4,0,4,Four civilians are gunned down in separate attacks by Muslim radicals.
13592,12/6/2010,Dagestan,Derbent,2,1,3,Islamic snipers take down two local police.
13593,12/6/2010,Iraq,Mosul,1,0,1,Holy Warriors shoot a woman to death in her home.
13594,12/6/2010,Pakistan,Khyber,2,0,2,Two tribesmen are kidnapped and murdered by Islamic fundamentalists.
13595,12/6/2010,Somalia,Huruwaa,2,0,2,Two men are shot to death by Islamic militia for watching the World Cup on TV.
13596,13/6/2010,Pakistan,Quetta,1,0,1,A videotape is released showing the slaughter of a humanitarian worker in captivity.
13597,13/6/2010,Canada,"Montreal, QB",0,1,1,A 19-year-old girl is stabbed by her mother in an honor attack.
13598,13/6/2010,Thailand,Yala,2,26,28,A 34-year-old Buddhist is among two who die from injuries suffered when Islamic separatists throw a bomb into a tea shop.
13599,13/6/2010,Pakistan,Karachi,1,0,1,A member of a peace committee is shot full of holes by local Taliban.
13600,13/6/2010,Iraq,Baghdad,24,46,70,"al-Qaeda militants storm a bank, killing two dozen people with bombs and bullets."
13601,13/6/2010,Iraq,Mosul,3,0,3,"Mujahideen gun down three Iraqis, including a woman."
13602,13/6/2010,Thailand,Yala,1,3,4,A soldier protecting teachers is taken apart by an Islamic bomb.
13603,13/6/2010,Pakistan,Bajaur,3,0,3,A married couple and their young son are murdered by her strict Muslim family for marrying for love.
13604,14/6/2010,Iraq,Sammarah,1,0,1,A convert to Christianity is murdered by his own son and nephew for 'abandoning Islam'.
13605,14/6/2010,Pakistan,Peshawar,0,1,1,A Christian professor is badly beaten by his students for refusing to embrace Islam.
13606,14/6/2010,Pakistan,Bannu,2,4,6,Two police officers are killed when Islamic militants ambush them with grenades and gunfire.
13607,14/6/2010,Pakistan,Karachi,2,0,2,An elderly man is among two people shot to death in separate sectarian attacks.
13608,14/6/2010,Thailand,Narathiwat,1,0,1,A Buddhist man on his way to buy food is shot twice in the head and back by Muslim terrorists.
13609,14/6/2010,Iraq,Mosul,1,25,26,Jihadis manage to kill a patron with a bomb at a local market.
13610,14/6/2010,Iraq,Balad,3,0,3,Three Iraqis are shot to death by suspected al-Qaeda.
13611,14/6/2010,Iraq,Baghdad,2,4,6,Muslim terrorists murder two local policemen with an IED.
13612,14/6/2010,Israel,Hebron,1,2,3,Palestinian gunmen shoot an Israeli police officer to death.
13613,14/6/2010,Afghanistan,Wardok,4,0,4,Four local cops are taken down in two attacks by Sunni fundamentalists.
13614,15/6/2010,Afghanistan,Herat,6,0,6,The Taliban take down six civilians with two remote-controlled bomb attacks.
13615,15/6/2010,Afghanistan,Helmand,2,0,2,Two British soldiers are shot while trying to guard Afghan civilians.
13616,15/6/2010,Pakistan,Mohmand,2,0,2,Two members of a peace committee are cut down by religious extremists while returning home.
13617,15/6/2010,Iraq,Mosul,1,0,1,al-Qaeda militants assassinate a local official.
13618,15/6/2010,Iraq,Mosul,3,0,3,Three Iraqis are murdered in their home by Mujahid gunmen.
13619,15/6/2010,Afghanistan,Kandahar,3,1,4,"The Taliban detonate a bomb next to a car, killing a 17-year-old boy and two others."
13620,16/6/2010,Dagestan,Kizilyurt,1,0,1,A suspected Muslim gunmen kills the head of a local employment center.
13621,16/6/2010,Iraq,Baghdad,1,4,5,A street beggar is killed when terrorists attach a bomb to a car.
13622,17/6/2010,Pakistan,Maidan Wardak,1,0,1,A civilian is abducted by the Taliban and brutally beheaded.
13623,17/6/2010,Pakistan,Karachi,2,0,2,A Shia doctor is among two people shot to death in sectarian attacks.
13624,17/6/2010,Iraq,Abu Saida,2,3,5,Two policemen are murdered by Jihadi bombers.
13625,17/6/2010,Iraq,Fallujah,5,1,6,"al-Qaeda gunmen wipe out a family of five Iraqis in their home, including a baby."
13626,17/6/2010,Thailand,Pattani,2,0,2,Two Buddhists are gunned down by Muslim terrorists in separate attacks.
13627,18/6/2010,Dagestan,Kaspiisk,1,3,4,"Muslim 'insurgents' fire into a car, killing a Russian."
13628,18/6/2010,Pakistan,Mohmand,6,0,6,Six local soldiers are abducted and executed in captivity by Sunni fundamentalists.
13629,18/6/2010,Iraq,Tuz Khurmato,8,63,71,Eight people are cut to pieces by a parked car bomb outside a home.
13630,18/6/2010,Iraq,Samarrah,1,0,1,An older man is shot to death in his home by his own son because he interpreted for U.S. troops.
13631,18/6/2010,Iraq,Qaim,4,6,10,Four local security personnel are murdered by Jihadi roadside bombers.
13632,18/6/2010,Iraq,Baqubah,0,30,30,Thirty people are injured when Mujahideen set off a car bomb in a residential neighborhood.
13633,18/6/2010,Somalia,Mogadishu,3,0,3,At least three Somali troops are killed during a brutal al-Shabaab ambush.
13634,18/6/2010,Iraq,Qaim,7,10,17,Seven Iraqi soldiers are taken down by Islamic gunmen.
13635,19/6/2010,Yemen,Aden,11,4,15,"al-Qaeda gunmen walk into a government building and calmly gun down eleven people, including women and a young child."
13636,19/6/2010,Thailand,Pattani,2,1,3,"A married couple is murdered in their car by Religion of Peace gunmen, who also injure their 2-year-old daughter."
13637,19/6/2010,Pakistan,Dera Ismail Khan,1,8,9,A passerby is killed when Jihadi bombers target a police vehicle.
13638,19/6/2010,Iraq,Jbala,3,0,3,Three Iraqis are shot to death by suspected al-Qaeda.
13639,20/6/2010,India,Sopore,1,0,1,Mujahideen shoot a civilian to death.
13640,20/6/2010,Afghanistan,Nangarhar,2,0,2,Fundamentalists murder two children when they hit their home with a rocket.
13641,20/6/2010,Afghanistan,Lashkar Gah,3,15,18,A 12-year-old girl is among three civilians killed when Islamists bomb a bank.
13642,20/6/2010,Pakistan,Peshawar,2,0,2,Two women are executed by the Taliban for committing adultery.
13643,20/6/2010,Pakistan,Khyber,5,2,7,Five members of a family are exterminated in their own home by Muslim gunmen.
13644,20/6/2010,Iraq,Baghdad,8,0,8,Six prostitutes and two johns are shot to death by Islamic fundamentalists in a brothel.
13645,20/6/2010,Iraq,Baghdad,4,16,20,Four Iraqis are taken out by Jihadi bombers.
13646,20/6/2010,Pakistan,Dir,2,2,4,Two recruits are killed when Fedayeen storm a police training camp.
13647,20/6/2010,Iraq,Baghdad,28,57,85,"Twenty-eight souls, including women and children, are sent to Allah by two Shahid two suicide bombers at a bank."
13648,20/6/2010,Pakistan,Kupwara,2,2,4,"Pakistanis fire across the border into India, killing two porters."
13649,20/6/2010,India,Poonch,1,2,3,An Indian trooper is taken down by an Islamist IED blast.
13650,21/6/2010,Pakistan,Punjab,5,0,5,Religious clerics lead a mob into the home of a Christian man and slaughter his wife and four children.
13651,21/6/2010,Thailand,Pattani,0,3,3,A mother and two children suffer shrapnel injuries when Muslim rivals toss a grenade into their mosque.
13652,21/6/2010,Pakistan,Quetta,2,0,2,Two Shia brothers are shot dead by a Sunni terrorist outfit.
13653,21/6/2010,Afghanistan,Awtar,1,0,1,Sunni fundamentalists kidnap and behead a local leader.
13654,21/6/2010,Afghanistan,Kunar,12,14,26,The Taliban claim a suicide bombing at a clinic that leaves a dozen dead.
13655,21/6/2010,Pakistan,Karachi,1,2,3,"Sectarian Jihadis fire on a group of brothers, killing one."
13656,21/6/2010,Afghanistan,Helmand,10,2,12,Ten local police are cut down by a Taliban roadside bomb.
13657,21/6/2010,Sudan,Darfur,3,1,4,Three UN troops are murdered by suspected Islamic-backed militia while guarding civilian engineers.
13658,22/6/2010,Iraq,Mosul,3,0,3,Two women and a man are reported killed by Sunni bombers.
13659,22/6/2010,Iraq,Fallujah,1,0,1,A critic of al-Qaeda is assassinated by the Islamist group.
13660,22/6/2010,India,Kupwara,1,0,1,An Indian officer succumbs to injuries from a militant terror attack.
13661,22/6/2010,Pakistan,Orakzai,7,12,19,Seven security personnel are slain in two Taliban ambushes.
13662,22/6/2010,Iraq,Baghdad,2,8,10,Two Iraqis are killed by a roadside bomb.
13663,22/6/2010,Ukraine,Dneprovka,1,0,1,A Muslim fanatic yells 'Allah Akbar' as he stabs a 5-year-old boy to death.
13664,23/6/2010,Afghanistan,Uruzgan,7,0,7,Seven construction workers are blown to bits by Taliban bombers.
13665,23/6/2010,Pakistan,Karachi,2,0,2,Two lovers are gunned down in an honor killing.
13666,23/6/2010,Philippines,Basilan,4,2,6,Four mini-bus passengers are machine-gunned to death by Religion of Peace advocates.
13667,24/6/2010,Iraq,Mosul,8,19,27,Dedicated Fedayeen suicide bombers take out eight Iraqis in two attacks.
13668,24/6/2010,Iraq,Khalis,7,0,7,A woman and two brothers are among seven Sunnis shot to death by suspected al-Qaeda in three attacks.
13669,25/6/2010,Iraq,Samarrah,11,0,11,Eleven victims of Islamic terrorists are pulled from a well.
13670,25/6/2010,Algeria,Stah Guenter,5,1,6,Five members of a wedding party are cut to pieces by Islamic gunmen.
13671,25/6/2010,Afghanistan,Uruzgan,11,0,11,"Eleven civilians are murdered by the Taliban, six of whom are beheaded."
13672,25/6/2010,Algeria,Tebessa,0,5,5,"Two children, including a baby, are injured when Islamic fundamentalists open up on their car with automatic weapons."
13673,25/6/2010,Dagestan,Nazran,2,0,2,Two local cops are gunned down in their vehicle by passing Jihadis.
13674,26/6/2010,Dagestan,Kizilyurt,2,0,2,A local businessman is among two people shot to death by suspected Islamic militia.
13675,26/6/2010,Afghanistan,Panjwaii,2,0,2,Two Canadian medics are murdered by Taliban ambushers while traveling to defuse a bomb.
13676,26/6/2010,Iraq,Fallujah,4,0,4,al-Qaeda gunmen murder four jewelry shop owners.
13677,27/6/2010,India,Jolly,1,0,1,A 21-year-old Muslim girl dies from being thrown down the stairs by her family for having sex.
13678,27/6/2010,Afghanistan,Meymaneh,4,0,4,Four Norwegian soldiers riding along a highway are killed by a Taliban bomb blast.
13679,27/6/2010,Bosnia,Bugojno,1,6,7,"Wahhabis bomb a police station, killing one officer."
13680,28/6/2010,DRC,Mutwanga,16,0,16,ADF Islamic rebels attack a village and murder sixteen civilians.
13681,28/6/2010,Ethiopia,Jarar,7,6,13,Seven soldiers are killed in a raid by Ogaden Jihadis.
13682,28/6/2010,Afghanistan,Ghazni,8,0,8,Sunni hardliners use a roadside bomb to kill eight civilians.
13683,28/6/2010,Iraq,Baghdad,2,4,6,"Muslim terrorists attack a family inside their home, leaving two women dead."
13684,28/6/2010,Pakistan,Bajaur,4,0,4,Four local soldiers are murdered in a Taliban ambush.
13685,28/6/2010,Afghanistan,Zabul,6,5,11,"Religious extremists bomb a vehicle from a private security firm, killing six occupants."
13686,28/6/2010,Pakistan,Karachi,4,0,4,Four civilians are murdered in separate sectarian attacks.
13687,28/6/2010,Iraq,Baghdad,2,4,6,Mujahid bombers take down two local cops.
13688,29/6/2010,Somalia,Mogadishu,4,15,19,Four civilians are killed during an al-Shabaab attack on a government building.
13689,29/6/2010,Afghanistan,Kabul,1,0,1,A UN staffer is gunned down in a brutal Islamic ambush at an intersection.
13690,29/6/2010,Iraq,Baghdad,1,0,1,An 18-year-old girl is taken down by Mujahid gunmen.
13691,29/6/2010,Afghanistan,Farah,4,0,4,Four local soldiers are dismembered by a roadside bomb.
13692,29/6/2010,Iraq,Baiji,3,13,16,A Jihadi car bomb leaves three people dead.
13693,29/6/2010,Iraq,Khalis,4,0,4,"Suspected insurgents murder four members of the same family outside their home, including a 9-year-old girl."
13694,29/6/2010,Iraq,Mosul,3,0,3,A woman shot to death in her home is among three people killed in separate attacks.
13695,30/6/2010,Pakistan,Hub,4,5,9,Four factory workers are killed when sectarian Jihadis toss a grenade under their car.
13696,30/6/2010,Iraq,Baghdad,2,1,3,Mujahid shoot two policemen to death at a checkpoint.
13697,30/6/2010,Chechnya,Grozny,0,7,7,A suicide bomber near a concert hall injures seven people.
13698,30/6/2010,Algeria,Tinzaouatine,11,0,11,Eleven local security personnel are shot to pieces at point-blank range by Islamic fundamentalists.
13699,30/6/2010,Iraq,Mosul,1,0,1,A 13-year-old girl is murdered by an Islamist bomb blast near her home.
13700,30/6/2010,Iraq,Kirkuk,1,0,1,A woman is tortured and killed by Sunni insurgents.
13701,30/6/2010,Pakistan,Tumair,1,0,1,A 17-year-old girl is shot in the head by her uncle after a jirga determines that she deserves to die for marrying for love.
13702,30/6/2010,Ethiopia,Nogob,9,11,20,Ogaden Fedayeen stage a nighttime raid and kill eleven local soldiers
13703,1/7/2010,Ethiopia,Shabelle,6,8,14,A Muslim 'commando' murders six Ethiopian soldiers.
13704,1/7/2010,Somalia,Hudur,1,0,1,"A Christian convert from Islam is publicly executed in a soccer stadium by Islamists, leaving behind a pregnant widow."
13705,1/7/2010,Pakistan,Quetta,2,1,3,Two young girls die from splinter injuries suffered in a grenade attack on their home.
13706,1/7/2010,Thailand,Narathiwat,5,0,5,Civilians are among five shot to pieces at point-blank range by Muslim radicals while riding in a truck.
13707,1/7/2010,India,Udhampur,1,0,1,"Hizb-ul-Mujahideen abduct a civilian, then shoot him as he is trying to escape."
13708,1/7/2010,India,Kupwara,2,0,2,Islamic militants shoot two Indian soldiers to death during an infiltration attempt from Pakistan.
13709,1/7/2010,Iraq,Samarrah,1,2,3,One person is killed in their own home by sectarian bombers.
13710,1/7/2010,Iraq,Baghdad,1,9,10,A Sunni leader is killed by a bomb planted by suspected a Shia militia.
13711,1/7/2010,Pakistan,Lahore,44,175,219,Over forty Sufi worshippers are blown to bits in their own mosque by Sunni bombers.
13712,1/7/2010,Yemen,Zinjibar,1,0,1,al-Qaeda gunmen assassinate a local official.
13713,2/7/2010,Kosovo,Mitrovica,1,10,11,"Muslims throw a grenade into a pro-Serb rally, killing one participant."
13714,2/7/2010,Afghanistan,Kunduz,5,20,25,"Six Shahid suicide bombers target a humanitarian agency, murdering five innocents."
13715,2/7/2010,Thailand,Yala,3,0,3,Jihadis take out three school guards with a roadside blast on their vehicle.
13716,2/7/2010,Pakistan,Quetta,1,0,1,"Sunnis fire from a moving car on a Shia scholar, killing him on the spot."
13717,2/7/2010,Pakistan,Khyber,3,2,5,Islamic hardliners execute three local soldiers and keep two others in captivity.
13718,2/7/2010,Iraq,Ramadi,1,0,1,A Sunni scholar is murdered by sectarian rivals.
13719,2/7/2010,Iraq,Mandali,1,0,1,A pregnant woman is found dead from a suspected honor killing.
13720,2/7/2010,Thailand,Pattani,1,0,1,A 46-year-old man is gunned down by Muslim radicals while riding home.
13721,3/7/2010,Yemen,Batis,1,0,1,al-Qaeda kidnap and execute a local intelligence officer.
13722,3/7/2010,Nigeria,Kizachi,7,5,12,A school teacher and mother of six are among seven Christians brutally executed in their homes by Muslim raiders.
13723,3/7/2010,Pakistan,Khyber,2,5,7,Islamic militants kill two locals with a bomb.
13724,3/7/2010,Pakistan,Gurguri,4,7,11,Four security personnel are murdered by Taliban roadside bombers.
13725,4/7/2010,Nigeria,Ganawuri,3,0,3,Muslims hack three Christians to death.
13726,4/7/2010,Iraq,Mosul,2,4,6,A Shahid suicide bomber takes out two Iraqis.
13727,4/7/2010,Iraq,Baqubah,2,0,2,Two brothers are gunned down by Muslim terrorists.
13728,4/7/2010,Thailand,Yala,2,3,5,Two people are killed when Islamic insurgents detonate a bomb outside a school.
13729,4/7/2010,Afghanistan,Helmand,5,8,13,Four children are among five innocents blown to bits by Taliban bombers at a market.
13730,4/7/2010,Pakistan,Kalat,4,7,11,"Sectarian Jihadis open fire on a vehicle carrying day laborers, taking down four."
13731,4/7/2010,Iraq,Ramadi,4,23,27,Women and children are among the casualties when a female suicide bomber blows herself outside a building entrance.
13732,4/7/2010,Ingushetia,Magas,2,4,6,Islamists murder two Russian soldiers in a brutal ambush.
13733,4/7/2010,India,Kerala,0,1,1,A Christian professor has his forearm and hand hacked off by Muslims for the alleged crime of insulting Muhammad.
13734,4/7/2010,Iraq,Mosul,1,0,1,Suspected Mujahid shoot a young child in the head and chest.
13735,5/7/2010,Egypt,Cairo,0,1,1,A Christian convert survives an attempt by Muslim radicals to behead him for leaving the faith.
13736,5/7/2010,Yemen,Hadramout,2,3,5,An al-Qaeda ambush leaves two locals soldiers dead.
13737,5/7/2010,Nigeria,Jos,3,0,3,Three Christian farmers are brutally slain in a 'mindless' attack by militant Muslims.
13738,5/7/2010,Pakistan,Lower Dir,1,14,15,One person is killed by a suicide car bomber.
13739,5/7/2010,Chechnya,Vedensky,1,2,3,A Russian serviceman is assassinated by Mujahideen gunmen.
13740,5/7/2010,Pakistan,Peshawar,1,0,1,A tribal elder is gunned down by Islamic militants.
13741,5/7/2010,Iraq,Kirkuk,1,0,1,A Sunni is handcuffed and murdered by suspected al-Qaeda.
13742,5/7/2010,Somalia,Labadhagah,8,0,8,"Rival Islamic groups clash, leaving eight dead in drive-by assassinations."
13743,5/7/2010,Iraq,Mosul,1,0,1,A 54-year-old Christian father of three bleeds to death after Islamists bomb his car in a targeted attack.
13744,6/7/2010,Pakistan,Karachi,1,0,1,A Shia civilian is killed by Sunni gunmen.
13745,6/7/2010,Iraq,Mosul,2,0,2,Two women are brutally shot to death by Jihadis passing by in a car.
13746,6/7/2010,Iraq,Baghdad,6,37,43,Six Shiite pilgrims are dismembered by Sunni bombers in three attacks.
13747,6/7/2010,Afghanistan,Ghazni,6,0,6,Six construction workers are kidnapped by Sunni hardliners and then murdered in captivity.
13748,7/7/2010,Afghanistan,Kabul,1,0,1,Talibanis gun down a cop.
13749,7/7/2010,Iraq,Abu Ghraib,5,6,11,"al-Qaeda gunmen target the homes of policemen and other officials, leaving several family members dead."
13750,7/7/2010,Iraq,Fallujah,5,4,9,A Fedayeen suicide bomber takes out five Iraqis.
13751,7/7/2010,Somalia,Elasha,2,3,5,A teenager is among two people slain when Islamic fundamentalists toss a grenade into a house where people are watching the World Cup.
13752,7/7/2010,Iraq,Baghdad,54,265,319,Women and children are among the dead as three suicide bombers target Shia pilgrims in separate and horrific attacks.
13753,8/7/2010,Philippines,Talipao,3,0,3,Three men are hacked to death by Abu Sayyaf ambushers.
13754,8/7/2010,Afghanistan,Paktia,6,0,6,Six civilians are crushed by debris when hardliners fire a rocket into a bazaar.
13755,8/7/2010,Iraq,Baghdad,28,98,126,Twenty-eight more Shia pilgrims are massacred in at least four separate Sunni bomb attacks.
13756,8/7/2010,Pakistan,Karachi,0,7,7,Seven Hindus are badly beaten after one of them (a boy) drinks water from a mosque.
13757,9/7/2010,Afghanistan,Ghazni,1,0,1,A government official is assassinated by the Taliban on his way into work.
13758,9/7/2010,Jordan,Naur,1,0,1,A married woman suspected of having an extra-marital affair is stabbed to death by her brothers.
13759,9/7/2010,Pakistan,Mohmand,105,75,180,"Children are among over one hundred innocents blown apart by a suicide bomber while they are waiting in line for humanitarian aid, including wheelchairs."
13760,9/7/2010,Iraq,Baghdad,6,20,26,A Shahid suicide successfully takes out six Iraqis in a neighborhood.
13761,10/7/2010,Afghanistan,Paktia,11,0,11,Eleven Shia men are shot to death by Sunni rivals in a sectarian attack.
13762,10/7/2010,Afghanistan,Kabul,11,0,11,Eleven policemen are killed in two Taliban terror attacks.
13763,10/7/2010,Pakistan,Makeen,3,5,8,"Tehreek-e-Taliban ambush a police post, killing three officers."
13764,10/7/2010,India,Gari Madhiya,2,0,2,A 16-year-old girl and her lover are honor killed execution style by her family.
13765,10/7/2010,Dagestan,Makhachkala,1,0,1,A senior judge is assassinated by Islamic terrorists.
13766,10/7/2010,Afghanistan,Kandahar,1,5,6,Islamists use a remote-controlled bomb on a motorcycle to take down a civilian.
13767,11/7/2010,Pakistan,Quetta,1,0,1,A man is kidnapped and tortured to death by sectarian rivals.
13768,11/7/2010,India,Doda,1,0,1,A civilian is cut down outside his home by Mujahideen gunmen.
13769,11/7/2010,Iraq,Dania,1,2,3,A civilian is killed in a Jihad bombing.
13770,11/7/2010,Uganda,Kampala,76,65,141,Over seventy innocent people watching the World Cup are blown to bits in two separate bombings by Islamic extremists.
13771,12/7/2010,England,London,0,1,1,A religious studies teacher is badly beaten by four Muslims intent on punishing him for 'insulting Islam' by teaching girls.
13772,12/7/2010,Thailand,Narathiwat,1,1,2,Islamic insurgents ambush and murder a 55-year-old cop.
13773,12/7/2010,Pakistan,Orakzai,1,4,5,Islamists blow up a primary school and kill a security official.
13774,12/7/2010,Pakistan,Karachi,1,1,2,A seminary teacher's driver is killed during an assassination attempt by disgruntled fundamentalists.
13775,12/7/2010,Afghanistan,Helmand,0,21,21,Twenty-one civilians are wounded by a Taliban blast at a crowded bazaar.
13776,12/7/2010,India,Nadia,0,3,3,Three Hindu girls are gang-raped and tortured by a group of Muslims.  The youngest two are 13-years-old.
13777,13/7/2010,Dagestan,Derbent,1,3,4,"Terrorists fire on a group of youth, killing one."
13778,13/7/2010,Pakistan,Karachi,1,0,1,A woman is shot to death by her son in an honor killing.
13779,13/7/2010,Pakistan,Karachi,0,1,1,A Christian woman is raped and then thrown from a roof by a Muslim doctor.
13780,13/7/2010,Afghanistan,Helmand,9,0,9,Sunni hardliners manage to take down nine Afghan civilians by bombing their minibus.
13781,13/7/2010,Iraq,Baghdad,2,5,7,Two local cops are taken down by Jihad bombers.
13782,13/7/2010,Afghanistan,Paktika,2,0,2,Two security guards are sent to Allah by Taliban roadside bombers.
13783,13/7/2010,Afghanistan,Uruzgan,1,0,1,Fundamentalists set up a fake roadblock and then shoot a motorist to death.
13784,13/7/2010,Iraq,Khalis,3,7,10,Three people are killed by a terrorist bombing while protesting terrorist bombings.
13785,13/7/2010,Iraq,Yusufiya,5,0,5,Five members of a family are brutally slaughtered in their own home by al-Qaeda.
13786,13/7/2010,Afghanistan,Kandahar,9,9,18,"A suicide bomb attack on an Afghan security headquarters leaves nine dead, including five civilians."
13787,14/7/2010,Dagestan,Kirov-Aul,1,0,1,A local village administrator loses his life to Muslim terror while riding home from work.
13788,14/7/2010,Yemen,Zijibar,3,10,13,Hooded al-Qaeda militants assault a government building.  At least three defenders are killed.
13789,14/7/2010,Iraq,Amiriya,4,7,11,Three women and a child are brutally slaughtered in the home of a Sufi cleric by sectarian Jihadis.
13790,14/7/2010,Thailand,Yala,1,0,1,A villager is gunned down by Islamic terrorists.
13791,14/7/2010,Pakistan,Bostikhel,2,0,2,Two brothers are abducted and beheaded by religious extremists.
13792,14/7/2010,Iraq,Baghdad,1,0,1,A university professor is assassinated by suspected fundamentalists.
13793,14/7/2010,Iraq,Baghdad,2,4,6,Jihadis take down two civilians with a roadside bomb.
13794,15/7/2010,Iraq,Tikrit,9,15,24,A Mujahid car bomb along a city street takes down nine Iraqis.
13795,15/7/2010,Iraq,Mahmoudiya,2,10,12,Two people are killed by a bomb planted on a motorcycle.
13796,15/7/2010,Iran,Zahedan,27,80,107,At least twenty-seven people are killed when a Sunni suicide bomber takes out a mosque full of Shia worshippers.
13797,15/7/2010,Pakistan,Mingora,6,45,51,"Six innocents are taken down by a suicide bomber, including women and children."
13798,15/7/2010,Pakistan,Sukkur,5,6,11,"Five members of a church, including the pastor are brutally shot to death outside the building by Religion of Peace advocates."
13799,16/7/2010,Ethiopia,Addis Ababa,0,1,1,A Christian convert is brutally beaten by angry Muslims.
13800,16/7/2010,Turkey,Diyarbakir,1,0,1,A young member of an Islamist organization is arrested for strangling his 17-year-old sister in an honor killing a month earlier.
13801,16/7/2010,Thailand,Yala,2,1,3,"A 53-year-old Buddhist woman bleeds to death after Islamists set off two bombs, killing two people."
13802,16/7/2010,Iraq,Fallujah,2,0,2,A teacher is among two civilians shot to death by Islamic terrorists.
13803,16/7/2010,Iraq,Abu Ghraib,3,2,5,Jihadis take down three Iraqis with a roadside bomb.
13804,16/7/2010,Dagestan,Makhachkala,1,0,1,A Pentecostal pastor and father of five is shot in the head by Muslim extremists.
13805,16/7/2010,Pakistan,Tirah Valley,10,14,24,Three children are among ten innocents blown to bits at a marketplace by Religion of Peace advocates.
13806,16/7/2010,Pakistan,North Waziristan,2,0,2,The Taliban execute two men by strapping dynamite to their bodies.
13807,17/7/2010,Iraq,Tuz Khormato,2,3,5,Two boys are murdered in what is thought to be a sectarian bombing.
13808,17/7/2010,Nigeria,Jos,10,14,24,"Young children are among ten Christians hacked to death in their homes by Muslims, who also burn a church."
13809,17/7/2010,Pakistan,Kurram,18,2,20,A brutal ambush on Shia civilians by Sunni radicals leaves eighteen dead.
13810,17/7/2010,Algeria,Tebessa,4,0,4,Four people are killed in a suspected al-Qaeda bombing.
13811,18/7/2010,Pakistan,Sargodha,6,20,26,"Six Shia worshippers lose their lives, and several others are dismembered when a Sunni suicide bomber visits their mosque."
13812,18/7/2010,Afghanistan,Kabul,3,42,45,Sunni fundamentalists take out three civilians in a bomb attack.
13813,18/7/2010,Iraq,Balasim,48,50,98,Nearly fifty people are shredded into pieces by suicide bombers striking two crowds.
13814,18/7/2010,Somalia,Lasanod,1,0,1,Islamic militants assassinate a court official.
13815,18/7/2010,Somalia,Mogadishu,12,43,55,A dozen people are left dead after a reported al-Shabaab attack.
13816,18/7/2010,Thailand,Narathiwat,1,0,1,A Malaysian karaoke bar owner is shot to death by Muslim extremists.
13817,18/7/2010,Thailand,Pattani,2,0,2,A middle-aged Buddhist man is among two people shot to death by Islamists in separate attacks.
13818,19/7/2010,Afghanistan,Kandahar,6,4,10,Religious extremists assassinate six local police with a roadside bomb.
13819,19/7/2010,Iraq,Baqubah,4,15,19,Holy warriors bomb a cafe killing four Iraqis.
13820,19/7/2010,Iraq,Mosul,4,5,9,"A Fedayeen suicide bomber plows into another vehicle and detonates, leaving at least four dead."
13821,19/7/2010,Iraq,Fallujah,1,0,1,al-Qaeda members kill a local leader with a car bomb.
13822,19/7/2010,Pakistan,Faislabad,2,1,3,"Two Christian brothers who were pastors, are accused of blasphemy and then brutally gunned down outside a courthouse while in chains."
13823,20/7/2010,Afghanistan,Baghlan,6,0,6,Six police officers are beheaded by Islamic fundamentalists.
13824,20/7/2010,Afghanistan,Mazar-i-Sharif,3,2,5,Two NATO civilians and an Afghan soldier are gunned down by a rogue Afghan soldier.
13825,20/7/2010,Yemen,Harf Sufyan,34,12,46,Thirty-four people are killed when two Shiite groups clash over 'ideological differences.'
13826,20/7/2010,Iraq,Qsaireen,6,8,14,Six Iranian pilgrims are sent straight to Allah by a Sunni suicide bomber at a restaurant.
13827,20/7/2010,Pakistan,Khar,1,0,1,A local soldiers is shot to death in a terrorist ambush.
13828,20/7/2010,Iraq,Qurat Tabba,8,22,30,"Jihadis blow up a market, killing at least eight patrons."
13829,20/7/2010,Kenya,Liboi,1,1,2,"al-Shabaab snipers attack a Kenyan military patrol across the border, killing one officer."
13830,21/7/2010,Somalia,Mogadishu,1,4,5,"Islamic militants enter a Christian home, gun down the father in front of the family and kidnap his wife and children."
13831,21/7/2010,Russia,Baksanskaya,2,0,2,Islamic militants murder two guards at a power plant.
13832,21/7/2010,India,Kishtwar,1,0,1,"Mujahideen beat a shopkeeper in his home in front of his family, then pull him out and shoot him."
13833,21/7/2010,Iraq,Mosul,1,1,2,"A woman is killed, and her child injured, by Jihadi bombers."
13834,21/7/2010,Iraq,Abu Saida,15,44,59,At least fifteen innocents are blown to bits in a bombing outside a mosque.
13835,21/7/2010,Thailand,Pattani,1,0,1,A civilian is gunned down by Muslim militants while on his way home from a tea shop.
13836,22/7/2010,Pakistan,Rawalpindi,0,2,2,Two Christian girls are gang-raped by Muslims.
13837,22/7/2010,Yemen,Ataq,6,1,7,Six local soldiers are taken down in an al-Qaeda ambush.
13838,22/7/2010,India,Kishtwar,1,0,1,"A 42-year-old contractor is abducted, tied up, tortured and then beheaded by Holy Warriors."
13839,22/7/2010,Iraq,Mosul,9,10,19,An imam and a baker are among nine people murdered in various ways in several Mujahid attacks.
13840,22/7/2010,Iraq,Baghdad,3,15,18,"Muslim terrorists send rockets into a commercial district, killing three people."
13841,23/7/2010,Dagestan,Chernyaevka,2,4,6,Children are among the casualties when Muslim gunmen open up on a school bus in one of two separate attacks.
13842,23/7/2010,India,Poonch,1,1,2,An army officer is killed by a terrorist landmine.
13843,23/7/2010,Pakistan,Lahore,1,5,6,A police officer is taken down in an Islamist bombing.
13844,23/7/2010,Pakistan,Bajaur,3,0,3,The Taliban blow three members of a peace committee to kingdom come.
13845,23/7/2010,Jordan,Deir Alla,1,0,1,A man machine-guns his 16-year-old niece after she loses her virginity from a sexual assault.
13846,23/7/2010,Afghanistan,Kandahar,2,2,4,Two local cops are blown to bits by Sunni bombers.
13847,23/7/2010,Afghanistan,Logar,1,1,2,"The Taliban ambush a vehicle carrying two US sailors, killing one and kidnapping the other."
13848,24/7/2010,Dagestan,Kizlyarsky,3,0,3,Muslim militants shoot three local soldiers to death in their vehicle.
13849,24/7/2010,Iraq,Basra,1,4,5,An innocent civilian is murdered by a Jihad bomber.
13850,24/7/2010,Iraq,Mosul,2,18,20,"A shooting and a bombing at a store, leave two people dead."
13851,24/7/2010,Afghanistan,Khost,1,20,21,Muslim radicals plant a bomb in a mosque that kills one person.
13852,24/7/2010,Pakistan,Naushehra,1,1,2,A young man is gunned down by the Taliban while standing outside his home.
13853,25/7/2010,Pakistan,Khyber,2,0,2,Mujahideen pull two occupants out of a vehicle and shoot them in the back of the head.
13854,25/7/2010,Iraq,Mosul,7,2,9,A child is among seven Iraqis killed in a Jihad bombing and separate shooting attack.
13855,25/7/2010,Mali,Baskno,1,0,1,al-Qaeda beheads a 78-year-old French hostage.
13856,25/7/2010,Algeria,Kabylie,1,8,9,A suicide bomber murders a night watchman.
13857,25/7/2010,Yemen,Shabwa,6,0,6,Six soldiers sitting in a car are machine-gunned to death by al-Qaeda at point-blank range.
13858,26/7/2010,Yemen,Lahej,4,9,13,al-Qaeda gunmen take down four local soldiers in an ambush.
13859,26/7/2010,Pakistan,Swat,4,4,8,"Islamic gunmen ambush a family vehicle, leaving four dead, including two children."
13860,26/7/2010,Pakistan,Darra Adamkhel,5,0,5,Three children are killed when Islamic terrorists fire a rocket into a family home.
13861,26/7/2010,Iraq,Karbalah,40,68,108,Sunni bombers take out about forty Shia pilgrims in twin bombings.
13862,26/7/2010,Iraq,Baghdad,4,16,20,"A suicide bomber targets a news channel staff, killing four members."
13863,26/7/2010,Pakistan,Peshawar,8,23,31,Two children are among eight people murdered when a suicide bomber detonates outside the home of a family mourning an earlier killing.
13864,26/7/2010,Thailand,Pattani,1,0,1,A 55-year-old Buddhist teacher is shot to death by Islamic militants while driving home.
13865,27/7/2010,Nigeria,Maiduguri,32,0,32,At least thirty-two policemen are assassinated and 'roasted like animals' by Boko Haram Islamists.
13866,27/7/2010,Somalia,Mogadishu,13,40,53,At least thirteen civilians are killed when Hizbul Islam terrorists attack a government building.
13867,27/7/2010,Iraq,Baghdad,1,4,5,A civilian is taken out by a roadside bomb.
13868,27/7/2010,Iraq,Mosul,2,0,2,Suspected Islamists storm a home and kill a woman and her son.
13869,27/7/2010,Thailand,Narathiwat,1,0,1,A 50-year-old villager is murdered outside his home by Muslim gunmen.
13870,27/7/2010,Thailand,Yala,1,0,1,A 26-year-old man is gunned down by Islamic insurgents.
13871,27/7/2010,Thailand,Pattani,2,0,2,Two civilians are shot to death by Muslim militants in separate drive-bys.
13872,28/7/2010,Afghanistan,Nimroz,25,20,45,Twenty-five bus passengers are murdered in a bloody bombing by Sunni fundamentalists.
13873,28/7/2010,Iraq,Karbala,16,37,53,Jihadis take down sixteen innocents in a rocket attack.
13874,28/7/2010,Iraq,Baghdad,6,15,21,"Six people waiting in line at a bank lose their place in life, courtesy of Muslim bombers."
13875,28/7/2010,Iraq,Mosul,5,6,11,A young girl is among five Iraqis murdered in a series of Mujahideen attacks.
13876,28/7/2010,Afghanistan,Herat,2,0,2,Two Italian soldiers are killed by a Taliban roadside bomb while guarding a highway.
13877,28/7/2010,Afghanistan,Zabul,6,3,9,Six civilians are killed in two Taliban roadside bombings.
13878,28/7/2010,Iraq,Fallujah,2,8,10,Children are among the casualties of an Islamic bombing outside a rival mosque.
13879,29/7/2010,Iraq,Adhamiya,16,14,30,"al-Qaeda terrorists stage a brutal attack on a neighborhood, killing sixteen people and burning their bodies."
13880,29/7/2010,Iraq,Shurqat,4,11,15,A Fedayeen suicide bomber takes down four Iraqis.
13881,29/7/2010,Afghanistan,Ghazni,8,3,11,Eight security guards are ambushed and murdered by religious extremists.
13882,29/7/2010,Pakistan,Kurram,10,0,10,"Shia terrorists pull ten Sunnis from their homes and shoot them to death, then torch the houses."
13883,30/7/2010,Pakistan,Karachi,1,0,1,A young pregnant woman is tortured and murdered in a suspected honor killing.
13884,30/7/2010,Afghanistan,Kandahar,2,1,3,A mother and child are exterminated by Jihadi bombers.
13885,30/7/2010,Afghanistan,Kunduz,3,19,22,Children are among the casualties when a suicide bomber detonates at a soccer game.
13886,30/7/2010,Iraq,Buhriz,4,0,4,Four members of a family are blasted to death by al-Qaeda bombers.
13887,31/7/2010,Chechnya,Grozny,2,0,2,Holy Warriors shoot two policemen to death at a checkpoint.
13888,31/7/2010,Pakistan,North Waziristan,2,0,2,Two Afghan refugees are abducted and shot to death by Islamic fundamentalists.
13889,31/7/2010,Iraq,Tarmiya,3,8,11,Three civilians on a minibus are taken out by Jihadi bombers.
13890,31/7/2010,Iraq,Yusufiya,4,11,15,Four rescue workers are lured to the scene of an earlier bombing and then blasted in a second attack.
13891,1/8/2010,Pakistan,South Waziristan,2,0,2,Religious extremists kill two local soldiers with a roadside bomb.
13892,2/8/2010,Dagestan,Gubden,1,0,1,A long-time campaigner against Islamic extremism is finally taken out by gunmen.
13893,2/8/2010,Afghanistan,Faryab,4,3,7,Four civilians are cut to pieces by Taliban gunmen.
13894,2/8/2010,Iraq,Baghdad,10,22,32,A coffee shop and a residential neighborhood are among a series of bomb blast sites that leave ten dead.
13895,2/8/2010,Iraq,Fallujah,3,7,10,A 4-year-old girl is among three sleeping family members murdered by Islamic bombers.
13896,2/8/2010,Afghanistan,Kandahar,5,1,6,Five children are blown apart by a suicide car bomber.
13897,2/8/2010,Jordan,Aqaba,1,5,6,A Palestinian rocket attack on an Israeli resort overshoots its mark and kills a taxi driver in Jordan.
13898,3/8/2010,Iraq,Baghdad,5,0,5,The Islamic State of Iraq machine-guns five soldiers to death at point-blank range.
13899,3/8/2010,Iraq,Mosul,9,15,24,Two vicious bombings leave nine Iraqis dead.
13900,3/8/2010,Iraq,Kut,12,55,67,Two car bombs at a market leave a dozen people dead and fifty others wounded.
13901,3/8/2010,Dagestan,Makhachkala,2,0,2,Two police officers are assassinated by Islamic separatists at a market.
13902,4/8/2010,Afghanistan,Uruzgan,1,1,2,"Terrorists detonate a bomb at a bazaar, killing one civilian."
13903,4/8/2010,Thailand,Pattani,1,0,1,A Buddhist is gunned down in an Islamist drive-by.
13904,4/8/2010,Afghanistan,Helmand,1,0,1,A young child is killed in a fundamentalist IED attack.
13905,4/8/2010,Somalia,Bondhere,3,12,15,Three cleaning women are exterminated by an al-Shabaab bomb blast.
13906,4/8/2010,Pakistan,Peshawar,4,11,15,A hero cop is among four blown apart by a Shahid suicide car bomber.
13907,5/8/2010,Philippines,Zamboanga,5,24,29,A suicide bomber at an airport murders five other people.
13908,5/8/2010,Pakistan,Quetta,1,1,2,"Islamic militants open fire on an oil tanker, killing the driver."
13909,5/8/2010,Iraq,Abu Ghraib,3,0,3,A woman is among three people shot to death in their home by Muslim radicals.
13910,5/8/2010,Iraq,Baghdad,6,8,14,Two shootings by terrorists take down six Iraqis.
13911,5/8/2010,Iraq,Tikrit,3,0,3,An al-Qaeda attack leaves three people dead.
13912,5/8/2010,Ingushetia,Nazran,2,0,2,Two cops are gunned down by suspected Islamic separatists.
13913,5/8/2010,Yemen,Abyan,3,1,4,al-Qaeda terrorists ambush and kill three members of a patrol.
13914,5/8/2010,Afghanistan,Kunduz,7,13,20,A Fedayeen suicide bomber murders seven local police.
13915,5/8/2010,India,Baramulla,1,2,3,"Islamic militants fire on a security patrol, killing one member."
13916,6/8/2010,Russia,Baksan,2,0,2,Two security personnel are brutally shot to death while sitting in their car.
13917,6/8/2010,Iraq,Kirkuk,1,0,1,Muslim radicals shoot a woman to death.
13918,6/8/2010,Iraq,Baghdad,2,13,15,Two civilians are blown to bits by Jihadi bombers.
13919,7/8/2010,Thailand,Narathiwat,1,0,1,A 43-year-old Buddhist woman is brutally machine-gunned to death by Muslim radicals on her farm.
13920,7/8/2010,Iraq,Basra,43,185,228,Over forty people are massacred by Islamic terrorists at a market.  Most burn to death in a fire caused by bombs.
13921,7/8/2010,Iraq,Garma,3,15,18,"al-Qaeda militants detonate a bomb outside a home, killing three residents."
13922,7/8/2010,Afghanistan,Nuristan,10,0,10,"Ten members of a medical team, including Christian doctors, are pulled out of their cars and executed by devout Muslim fundamentalists, who spare an Afghan able to recite the Quran."
13923,7/8/2010,Thailand,Pattani,2,1,3,A Buddhist husband and wife are murdered by Muslim gunmen in their motorcycle shop.  Their 4-year-old nephew is wounded.
13924,7/8/2010,Thailand,Yala,1,0,1,Muslim terrorists kill an off-duty soldier on his motorcycle.
13925,7/8/2010,Afghanistan,Maiwand,1,1,2,A child is murdered by Sunni bombers.
13926,7/8/2010,Afghanistan,Helmand,5,13,18,A bomb hidden in a wheelbarrow leaves five innocents dead.
13927,7/8/2010,Afghanistan,Helmand,1,0,1,A British father of four is shot to death by a Taliban prisoner who seizes a weapon on his way to a prayer session.
13928,8/8/2010,Indonesia,Bekasi,0,12,12,A mob of hundreds of Muslims chase and beat Christian worshippers after disrupting their service.
13929,8/8/2010,Iraq,Ramadi,8,50,58,Eight Iraqis are pasted by Jihadi bombers.
13930,8/8/2010,Iraq,Fallujah,4,14,18,Four civilians lose their lives in two car bombings.
13931,9/8/2010,Iraq,Baghdad,3,10,13,Three traffic cops are taken down by Jihadi bombers.
13932,9/8/2010,Afghanistan,Badghis,1,0,1,A pregnant woman accused of adultery is whipped 200 times and then shot three times in the head by Islamic fundamentalists.
13933,9/8/2010,Thailand,Narathiwat,1,0,1,Muslim terrorists stab and partially behead a young plantation worker.
13934,10/8/2010,Russia,Kabardino-Balkaria,2,0,2,Two people are killed when Muslim terrorists fire at tourists at a resort.
13935,10/8/2010,Afghanistan,Kabul,5,1,6,Blood and body parts are scattered about following a double suicide attack that leaves five Afghans dead.
13936,10/8/2010,Afghanistan,Helmand,5,0,5,Five local security personnel are killed when Islamic fundamentalists fire a rocket through their vehicle.
13937,10/8/2010,India,Baramulla,3,0,3,Islamic radicals machine-gun three cops to death.
13938,10/8/2010,Pakistan,Mohmand,3,0,3,Three members of a security patrol are killed in an ambush by Islamic militants.
13939,10/8/2010,Iraq,Baghdad,5,16,21,Terrorists take down five Iraqis with two bombs.
13940,11/8/2010,India,Rajouri,2,21,23,"Lashkar e-Toiba terrorists fire on a bus, murdering two civilians, including a woman."
13941,11/8/2010,Pakistan,Karachi,2,0,2,Two Shias are shot to death by Sunnis in separate drive-by attacks.
13942,11/8/2010,Pakistan,Mohmand,1,3,4,"A woman is killed, and her three sons injured, when militants fire a rocket into their home."
13943,11/8/2010,Iraq,Baghdad,1,1,2,Jihadis gun down two cops and kill a civilian with a bomb.
13944,11/8/2010,Iraq,Sadiya,11,4,15,Islamists lure eight police to their deaths by first killing three members of a family and then booby-trapping the house.
13945,12/8/2010,Iraq,Baaj,4,0,4,A bomb placed by Jihadis kills four disposal workers.
13946,13/8/2010,Pakistan,Quetta,1,0,1,"Sunni fundamentalists are suspected of firing into a barbershop, killing the owner."
13947,13/8/2010,Yemen,Lahj,1,0,1,A man is gunned down in an al-Qaeda drive-by outside a mosque.
13948,13/8/2010,Afghanistan,Herat,4,12,16,"The Taliban ambush a convoy of security guards, killing four."
13949,14/8/2010,Afghanistan,Kunduz,1,0,1,A local cop is shot to death by Uzbek Islamists.
13950,14/8/2010,Afghanistan,Dam Abad,3,1,4,Three children are torn apart by a rocket fired into their home by Islamic hardliners.
13951,14/8/2010,Egypt,Shimi,0,11,11,Eleven Christians are injured in assaults by Muslims stirred to anger by a local cleric.
13952,14/8/2010,Iraq,Baghdad,6,15,21,"Islamic terrorists take down six Iraqis in a series of attacks, including policemen who were set on fire."
13953,14/8/2010,Thailand,Yala,2,0,2,A Buddhist man and wife are brutally murdered by Muslim gunmen while riding to their plantation.
13954,14/8/2010,Thailand,Pattani,1,0,1,A local cop is shot to death by Islamic militants while traveling to work.
13955,14/8/2010,Pakistan,Sindh,2,8,10,A woman and boy are left dead when Muslim rivals attack each other over where to build a madrasah.
13956,14/8/2010,India,Sopore,1,0,1,Islamic terrorists kidnap and murder a civilian.
13957,15/8/2010,Iraq,Numaniya,1,0,1,Muslim gunmen murder an Iraqi pharmacist who had returned from studies in the U.S.
13958,15/8/2010,Iraq,Jurf al-Sakhar,3,2,5,Three worshippers are shot to death outside a mosque by sectarian rivals.
13959,15/8/2010,Iraq,Baghdad,9,27,36,Nine Iraqis are taken down by Jihadis in a series of attacks.
13960,16/8/2010,Afghanistan,Ghazni,2,5,7,A remote-controlled bomb on a bridge takes out two civilians.
13961,16/8/2010,Iraq,Muqdadiya,4,9,13,Four Iranian pilgrims on a bus are targeted and killed by Sunni bombers.  Women and children are among the victims.
13962,16/8/2010,Somalia,Mogadishu,9,53,62,Nine refugees are killed when al-Shabaab Islamists attack a displaced persons camp.
13963,16/8/2010,Pakistan,Karachi,4,0,4,Sunnis shoot four Shia to death in separate attacks.
13964,16/8/2010,Somalia,Elasha Biyaha,1,0,1,A cleric who advocated peace is assassinated by Islamists.
13965,16/8/2010,Afghanistan,Kunduz,2,0,2,A couple in their 20's is stoned by Islamic fundamentalists for having sex.  The man has to be finished off with a gunshot.
13966,16/8/2010,Afghanistan,Farah,2,0,2,Two people are killed when Taliban gunmen fire into a bazaar.
13967,16/8/2010,Afghanistan,Herat,5,2,7,Three women and a child are among five civilians killed by a Taliban bomb attack on their car.
13968,17/8/2010,Iraq,Baghdad,61,129,190,Over sixty young Iraqis lining up for work are senselessly cut to shreds by a Shahid suicide nail-bomber.
13969,17/8/2010,Russia,North Ossetia,2,23,25,Two people are dead and twenty-three others injured in a suicide attack and separate cafe bombing.
13970,17/8/2010,Afghanistan,Zabul,2,0,2,A man and his wife are shot to death in their home by religious extremists.
13971,17/8/2010,Afghanistan,Spin Boldak,8,0,8,Eight civilians are murdered by a Taliban bomb attack on a home.
13972,17/8/2010,Somalia,Mogadishu,1,2,3,A civilian is killed when Mujahideen toss a grenade at a police station.
13973,17/8/2010,Iraq,Baghdad,10,46,56,"Sunni militants detonate a fuel tanker in a Shia neighborhood, incinerating ten innocents."
13974,17/8/2010,Pakistan,Peshawar,2,0,2,Two civilians are murdered at a mosque by Taliban gunmen.
13975,17/8/2010,Pakistan,Karachi,1,0,1,A leader of a minority religious sect is gunned down by mainstream rivals.
13976,17/8/2010,Iraq,Diyala,3,0,3,An auditor and two judges are assassinated by Islamic terrorists in separate attacks.
13977,18/8/2010,Indonesia,Medan,1,1,2,A security guard is killed when a terror cell linked to a radical cleric robs a bank.
13978,18/8/2010,India,Kulgam,2,0,2,Two civilians grazing cattle are abducted and murdered by Religion of Peace radicals.
13979,18/8/2010,India,Sopore,1,2,3,"Islamic militants attack a lawmaker's home, killing a guard."
13980,18/8/2010,Iraq,Diyala,3,0,3,Three brothers are brutally murdered on their own farm by Mujahideen.
13981,18/8/2010,Pakistan,Nazimabad,1,0,1,A children's doctor is shot to death by sectarian rivals.
13982,18/8/2010,Iraq,Tikrit,2,3,5,Two civilians are blown to bits by a Jihadi bomb.
13983,18/8/2010,Iraq,Mosul,4,2,6,Four Iraqis are taken down in separate terror attacks.
13984,18/8/2010,Afghanistan,Kandahar,1,0,1,A suicide bomber takes out an Afghan cop.
13985,18/8/2010,Pal. Auth.,Gaza,1,0,1,A 62-year-old woman is murdered outside her own home by Islamic fundamentalists.
13986,19/8/2010,Afghanistan,Logar,2,0,2,The bodies of two men are discovered after they were kidnapped and murdered in captivity.
13987,19/8/2010,Pakistan,Orakzai,1,0,1,A security guard is gunned down by Muslim militants.
13988,19/8/2010,Iraq,Mosul,3,4,7,A kidnapped civilian is among three Iraqis murdered in separate attacks.
13989,19/8/2010,China,Xinjiang,7,14,21,"An explosives-laden vehicle is plowed into a crowd and detonated, leaving seven dead."
13990,19/8/2010,Afghanistan,Nangarhar,2,14,16,Two civilians are killed when the Taliban blow up a fuel truck.
13991,19/8/2010,Yemen,Abyan,2,1,3,al-Qaeda militants machine-gun two cops to death at point-blank range.
13992,19/8/2010,Algeria,Baghlia,3,4,7,"Fundamentalists ambush a group of soldiers, killing three."
13993,20/8/2010,Pakistan,Dera Ismail Khan,2,1,3,Islamic militants are suspected of gunning down two cops.
13994,20/8/2010,Iraq,Baghdad,3,6,9,Jihadis shoot an electrical worker to death and take out two other civilians with a bomb.
13995,20/8/2010,Pakistan,Sanghar,1,0,1,A leader of the peaceful Ahmadi sect is shot in the head by orthodox Sunni.
13996,20/8/2010,Yemen,Loder,11,0,11,Eleven local soldiers are killed when al-Qaeda militants fire a rocket into a passing vehicle.
13997,20/8/2010,Afghanistan,Helmand,30,17,47,Some thirty workers and guards are massacred when Islamic fundamentalists assault a construction company.
13998,20/8/2010,Afghanistan,Kandahar,1,0,1,A civilian is brutally executed and tied between two roadside bombs by the Taliban.
13999,20/8/2010,Thailand,Yala,1,0,1,A 63-year-old civilian is shot to death by Muslim terrorists.
14000,21/8/2010,Dagestan,Kizlyar,1,3,4,Children are among the casualties when Jihadis attempt to blow up a passing car.
14001,21/8/2010,Ethiopia,Addis Ababa,0,1,1,A popular church leader is brutally assaulted by Muslims with wooden clubs.
14002,21/8/2010,Pakistan,Baghlia,6,5,11,Six members of a peace committee are blow to bits by Mujahid bombers.
14003,21/8/2010,Afghanistan,Herat,2,0,2,Two men are shot to death by the Taliban (the second in Kandahar).
14004,21/8/2010,Afghanistan,Paktika,8,5,13,Eight Afghans are murdered by Taliban bombers in two attacks.
14005,21/8/2010,Afghanistan,Helmand,6,0,6,Six Afghan cops are bound and executed by religious hardliners.
14006,21/8/2010,Iraq,Baghdad,3,1,4,Three cops are taken down by Islamic terrorists in separate attacks.
14007,22/8/2010,Pakistan,Dera Ismail Khan,1,0,1,Sunni terrorists gun down an innocent Shia father of two young children.
14008,22/8/2010,India,Pulwama,1,0,1,Islamic radicals murder the son of a welfare employee.
14009,22/8/2010,Pakistan,Peshawar,1,3,4,A civilian is taken down in a militant ambush.
14010,22/8/2010,Iraq,Mussayab,1,11,12,One employee is killed when a sectarian bomb blast rips through a store.
14011,22/8/2010,India,Kulgam,2,0,2,A mother and her teen daughter are brutally murdered in their own home by Religion of Peace gunmen.
14012,22/8/2010,Tajikistan,Dushanbe,5,1,6,Islamic militants beat five prison guards to death.
14013,23/8/2010,Pakistan,Landikotal,2,0,2,Local Taliban burn two men alive in their truck.
14014,23/8/2010,Iraq,Baiji,7,0,7,Suspected al-Qaeda shoot seven oil workers to death.
14015,23/8/2010,Pakistan,Matni,3,3,6,Three people are blown to bits by Mujahid bombers at a market
14016,23/8/2010,Iraq,Baghdad,3,15,18,A mortar attack and separate bombing at a coffee shop leave three dead.
14017,23/8/2010,Pakistan,South Waziristan,26,40,66,A suicide bomber at a seminary sends two-dozen other souls to Allah.
14018,23/8/2010,Pakistan,Kurram,8,10,18,Islamist bombers take out seven tribal elders and a teacher at a school.
14019,23/8/2010,Thailand,Pattani,2,4,6,Two civilians are machine-gunned to death by Muslim insurgents in separate attacks.
14020,24/8/2010,Pakistan,Peshawar,1,0,1,A peace activist and father is killed in captivity by Sunni militants.
14021,24/8/2010,Pakistan,Bajaur,1,0,1,A young man is abducted and murdered by Tehreek-e-Taliban.
14022,24/8/2010,Iraq,Baqubah,3,13,16,Three Iraqis are taken out by a Fedayeen suicide bomber.
14023,24/8/2010,Iraq,Baghdad,3,0,3,A man at a market and another in his home are among three gunned down by Muslim assassins.
14024,24/8/2010,Somalia,Mogadishu,33,150,183,"A barbaric assault on a hotel by Muslim terrorists leaves women, children and more than a dozen visiting lawmakers dead."
14025,24/8/2010,Iraq,Fallujah,2,2,4,Two children are successfully killed by Mujahideen bombers in a blast that also leaves their mother wounded.
14026,24/8/2010,Mali,Bamako,1,0,1,An older pensioner taken prisoner by al-Qaeda is murdered in captivity.
14027,25/8/2010,Afghanistan,Badghis,3,0,3,Two Spanish soldiers training local cops are shot to death along with their translator by their driver.
14028,25/8/2010,Yemen,Zinjibar,4,1,5,al-Qaeda gunmen on motorcycles massacre four security men in a drive-by.
14029,25/8/2010,Thailand,Pattani,1,0,1,A 57-year-old rubber tapper is killed by drive-by Jihadis.
14030,25/8/2010,Iraq,Baghdad,63,277,340,Jihadis take out over sixty Iraqis in a series of coordinated blasts from Basra to Kut.
14031,25/8/2010,Pakistan,Bajaur,1,0,1,Islamic militants shoot a tax collector to death on his way home.
14032,25/8/2010,Pakistan,Mohmand,2,2,4,A mother and her 9-year-old child are brutally murdered by Islamist gunmen.
14033,25/8/2010,Pakistan,Swat,3,6,9,Three Christian aid workers helping flood victims are kidnapped and murdered by Islamic fundamentalists.
14034,26/8/2010,Philippines,Balili,4,0,4,Maranao Muslims pull four people off a bus and shoot them to death.
14035,26/8/2010,Afghanistan,Kunduz,8,1,9,Eight policemen are machine-gunned to death by Taliban ambushers.
14036,26/8/2010,Pakistan,Bajaur,1,0,1,Islamists murder the son of a surrendered militant.
14037,26/8/2010,Iraq,Muqdadiya,6,0,6,Six Sunnis are gunned down by suspected al-Qaeda.
14038,26/8/2010,Iraq,Mosul,4,11,15,Children are among the casualties in a series of Mujahideen attacks.
14039,26/8/2010,Somalia,Mogadishu,14,8,22,Fourteen Somalis are shredded by two al-Shabaab bomb blasts.
14040,26/8/2010,Thailand,Pattani,1,0,1,A 42-year-old civilian dies from injuries after being shot twice in the chest by Muslim militants.
14041,26/8/2010,Thailand,Yala,1,0,1,Muslim terrorists gun down a Buddhist railway worker.
14042,26/8/2010,Thailand,Narathiwat,1,0,1,A 30-year-old teacher is shot to death by Islamic radicals while leaving school.
14043,26/8/2010,Thailand,Pattani,1,0,1,A 52-year-old man is killed in a Muslim ambush.
14044,27/8/2010,Nigeria,Borno,3,0,3,Boko Haram Islamists shoot three policemen to death in two drive-bys.
14045,27/8/2010,Iraq,Mahaweel,2,0,2,A blast takes down two civilians.
14046,27/8/2010,Iraq,Baaj,3,0,3,Three Iraqis are gunned down by Mujahid.
14047,27/8/2010,Iraq,Shurqat,3,3,6,A suspected al-Qaeda attack leaves three dead.
14048,27/8/2010,Pakistan,Ghaziabad,1,0,1,A 35-year-old mother of three is killed by her brother on suspicion of unauthorized sex.
14049,27/8/2010,Iraq,Mosul,2,0,2,A middle-aged Buddhist couple is brutally murdered by Muslim gunmen as they are returning from market.
14050,27/8/2010,Iraq,Kirkuk,1,3,4,A child is taken down by Islamic bombers.
14051,27/8/2010,Iraq,Mosul,1,0,1,The body of a Christian man is found several days after he is kidnapped.
14052,27/8/2010,Thailand,Yala,1,0,1,A young woman is shot to death by Religion of Peace proponents.
14053,27/8/2010,Thailand,Pattani,1,0,1,A 21-year-old man is murdered by Muslim gunmen.
14054,28/8/2010,Pakistan,Khyber,1,0,1,A local soldier is kidnapped and shot full of holes by Mujahideen.
14055,28/8/2010,Thailand,Narathiwat,1,0,1,A 40-year-old man is shot in the head by Muslim militants.
14056,28/8/2010,Yemen,Abyan,10,2,12,Ten local soldiers are ambushed and killed by terrorists who burn their bodies while chanting 'Allah akbar.'
14057,29/8/2010,Pakistan,Khyber,2,4,6,The Taliban kill two local soldiers with a roadside bomb.
14058,29/8/2010,Iraq,Mosul,5,12,17,A woman is among five Iraqis murdered by Islamic terrorists.
14059,29/8/2010,Afghanistan,Kabul,6,0,6,Five election workers and a candidate are kidnapped and murdered by Taliban freedom fighters.
14060,29/8/2010,Thailand,Narathiwat,1,0,1,A 2-year-old boy dies after being shot in the head by Muslim militants.
14061,29/8/2010,Thailand,Pattani,2,0,2,A middle-aged Buddhist couple are shot to death in their pickup by Islamic separatists.
14062,29/8/2010,Chechnya,Tsentoroi,7,5,12,"A wave of armed Islamists attack a village, killing at least seven."
14063,29/8/2010,Philippines,Bukidnon,0,2,2,'Irate Muslims' throw a grenade into a Catholic church during mass.
14064,30/8/2010,Iraq,Baghdad,1,3,4,Jihadi car bombers kill a civilian.
14065,30/8/2010,Somalia,Mogadishu,4,8,12,Four guards at the presidential palace are killed during an al-Shabaab mortar attack.
14066,30/8/2010,Afghanistan,Helman,1,0,1,An Estonian solder is murdered by Taliban bombers.
14067,30/8/2010,Afghanistan,Jalalabad,1,3,4,The Taliban assassinate a local official with a bomb.
14068,30/8/2010,Afghanistan,Marjah,2,1,3,Two civilians are shot to death at a mosque by fundamentalists.
14069,31/8/2010,Somalia,Las Anod,1,0,1,A man is shot outside his doorstep by Islamic militia.
14070,31/8/2010,Afghanistan,Badakhshan,3,0,3,Three Oxfam humanitarian workers are taken out in a brutal roadside blast.
14071,31/8/2010,Afghanistan,Kabul,3,12,15,Three supreme court employees are riddled with bullets by Holy Warriors.
14072,31/8/2010,India,Kishtwar,1,0,1,A cop is murdered inside his home by Hizb-ul- Mujahideen.
14073,31/8/2010,India,Bandipora,1,2,3,An Indian soldier is ambushed and killed by Pakistani terrorists.
14074,31/8/2010,Iraq,Mosul,2,1,3,Two brothers are shot to death by suspected Mujahideen.
14075,31/8/2010,Afghanistan,Kabul,11,0,11,Eleven US troops on security patrol are killed in three roadside bombings.
14076,31/8/2010,Israel,Hebron,4,0,4,A pregnant woman is among four young Jews gunned down in cold blood by Hamas terrorists.
14077,31/8/2010,Pakistan,Kurram,7,1,8,At least one woman and two children are among seven murdered in two home invasions by Religion of Peace radicals.
14078,31/8/2010,Somalia,Mogadishu,8,14,22,Five men and three women are taken down by al-Shabaab bombers.
14079,1/9/2010,Pakistan,Lahore,43,270,313,Over thirty Shia pilgrims in a procession are dismantled by a car bomb blast and two Sunni suicide bombers.
14080,1/9/2010,Afghanistan,Helmand,0,15,15,"Fifteen people at a market are badly injured, many with limbs torn from their bodies, by a Taliban blast."
14081,1/9/2010,Afghanistan,Kandahar,2,2,4,Two Afghans are blown to bits by a Taliban bomb hidden on a motorcycle.
14082,1/9/2010,Algeria,Boumerdes,2,26,28,A Fedayeen suicide bomber kills two local soldiers and injures dozens more.
14083,1/9/2010,Iraq,Mosul,3,6,9,A woman is among three Iraqis taken down by a Jihadi bombing and shooting attack.
14084,1/9/2010,Thailand,Pattani,2,0,2,A Buddhist couple in their 50's are brutally murdered by Jihadi gunmen.
14085,1/9/2010,Thailand,Yala,1,0,1,A 49-year-old security worker is shot to death as he is riding home from work.
14086,1/9/2010,Israel,Samaria,0,2,2,A rabbi and his wife are shot by Palestinian terrorists while riding in their car.
14087,1/9/2010,Pakistan,Karachi,1,0,1,A young mother is burned to death by her in-laws in a suspected honor killing.
14088,2/9/2010,Pakistan,Turbat,2,8,10,"Sunni gunmen open fire on a bus full of Shia pilgrims, killing at least two."
14089,2/9/2010,Sudan,Tabra,74,79,153,"Janjiweed militia on camels sweep through a market and slaughter over seventy people, including eighteen children."
14090,2/9/2010,Pakistan,Bajaur,1,2,3,A female teacher is shot to death by Holy Warriors.
14091,2/9/2010,Pakistan,Kyber,1,0,1,Mujahideen kidnap and brutally murder a taxi driver returning from a friend's funeral.
14092,2/9/2010,Iraq,Baghdad,2,0,2,A taxi driver and senior education ministry official are gunned down in separate attacks.
14093,2/9/2010,Iraq,Baiji,2,5,7,Suspected al-Qaeda shoot two opponents to death.
14094,2/9/2010,Thailand,Pattani,1,1,2,A 35-year-old man is murdered in an Islamist drive-by.
14095,3/9/2010,Pakistan,Peshawar,1,3,4,Muslim militants slay a local cop with a roadside bomber.
14096,3/9/2010,Iraq,Mosul,1,0,1,An imam is gunned down outside his mosque by Religion of Peace rivals.
14097,3/9/2010,Iraq,Baghdad,4,4,8,Four Iraqis are shot or blown up around the country by Mujahideen.
14098,3/9/2010,Azerbaijan,Gumbashly,1,1,2,One dead as a 'religious dispute' between mosque members results in gunfire.
14099,3/9/2010,Pakistan,Quetta,73,149,222,Over sixty innocents are slaughtered when a suicide bomber targets a Shia procession.
14100,3/9/2010,Pakistan,Mardan,1,2,3,"A Sunni suicide bomber detonates at an Ahmadiyya (minority sect) mosque, killing one."
14101,3/9/2010,Tajikistan,Khujand,2,25,27,A suicide bomber injures twenty-five and kills 2.
14102,3/9/2010,Somalia,Galgala,5,0,5,At least five Puntland soldiers are killed in an ambush by Islamic militants.
14103,4/9/2010,Afghanistan,Kandahar,3,11,14,Three civilians including a child are blown to bits by a Fedayeen martyr.
14104,4/9/2010,Pakistan,Sindh,2,0,2,The wife and nephew of a police officer are murdered by suspected radicals.
14105,4/9/2010,Afghanistan,Ghazni,1,0,1,Sunni extremists behead a Shia businessman.
14106,4/9/2010,Dagestan,Makhachkala,1,3,4,Terrorists manage to kill one person with a car bomb.
14107,4/9/2010,Afghanistan,Faryab,3,5,8,Three local cops are exterminated in a brutal ambush.
14108,4/9/2010,Afghanistan,Kunduz,7,17,24,A child is among seven murdered by a Shahid suicide bomber outside a butcher shop.
14109,4/9/2010,Thailand,Pattani,1,1,2,"Islamist open fire on two civilians riding a motorcycle, killing one."
14110,5/9/2010,Nigeria,Borno,2,4,6,A trader is among two men shot to death by Boko Haram Islamists.
14111,5/9/2010,Yemen,Abyan,3,0,3,Three people are shot to death in an al-Qaeda ambush.
14112,5/9/2010,Dagestan,Buinaksk,5,36,41,A Shahid suicide car bomber sends five other souls to Allah.
14113,5/9/2010,Iraq,Baghdad,12,36,48,"Six Fedayeen attack a government building, killing a dozen Iraqis."
14114,5/9/2010,Pakistan,Punjab,1,0,1,An oil rig driver is killed by Islamic snipers.
14115,6/9/2010,Pakistan,Kohat,21,40,61,Women and children are most of the two dozen victims in a powerful suicide blast on their residential compound.
14116,6/9/2010,Afghanistan,Paktika,3,5,8,Freedom fighters shoot three children to death.
14117,6/9/2010,Pakistan,Lakki Marwat,19,46,65,Nine schoolchildren are among nineteen innocent lives snuffed out by Holy Warrior suicide bombers.
14118,6/9/2010,Afghanistan,Kabul,1,0,1,A 45-year-old news anchor is the target of a 'brutal beheading' near his home.
14119,6/9/2010,Iraq,Samarra,5,0,5,Five construction workers building a youth center are stabbed and shot to death in a barbaric Mujahideen attack.
14120,6/9/2010,Thailand,Yala,1,0,1,A middle-aged woman is shot to death by Mujahid while walking home.
14121,6/9/2010,Thailand,Pattani,2,0,2,A janitor is among two civilians assassinated by Muslim gunmen in separate attacks.
14122,6/9/2010,Afghanistan,Baghlan,2,0,2,The Taliban kill a district governor and his bodyguard in an ambush.
14123,6/9/2010,Tajikistan,Dushanbe,0,7,7,Fundamentalists toss a bomb into a disco.
14124,6/9/2010,Algeria,Skikda,3,2,5,al-Qaeda murder three local cops with a roadside bomb.
14125,6/9/2010,Algeria,Tebessa,2,0,2,Fundamentalists kill two local security personnel with a bomb.
14126,7/9/2010,Iraq,Samarra,3,0,3,A married couple are among three family members slain in their home by Sunni gunmen.
14127,7/9/2010,Russia,Baksanenok,1,0,1,Suspected Islamists assassinate a judge.
14128,7/9/2010,Pakistan,Punjab,2,0,2,Terrorists murder a man and his nephew.
14129,7/9/2010,Iraq,Baghdad,2,6,8,Mujahid manage to take down two Iraqis with a roadside bomb.
14130,7/9/2010,Iraq,Mosul,1,0,1,A woman is shot to death by Muslim terrorists.
14131,7/9/2010,Thailand,Narathiwat,2,0,2,"Two middle aged Buddhist teachers, husband and wife, are murdered by Islamic radicals."
14132,7/9/2010,Thailand,Narathiwat,1,0,1,A young Buddhist is gunned down in an Muslim drive-by attack.
14133,7/9/2010,Iraq,Baghdad,1,0,1,A TV anchor who tried to end sectarian violence is shot outside his home by a sectarian faction.
14134,7/9/2010,Pakistan,Hangu,1,2,3,A police officer succumbs to injury after clinging to life for a few days following an Islamist bombing.
14135,8/9/2010,Pakistan,Khyber,4,0,4,Four political activists are shot to death by suspected Taliban.
14136,8/9/2010,Iraq,Baghdad,3,19,22,Three people are killed by a car bomb blast.
14137,8/9/2010,Iraq,Baghdad,3,12,15,A Shahid suicide bomber takes out three Iraqis.
14138,8/9/2010,Iraq,Kirkuk,4,10,14,Four people are murdered by Islamic bombers.
14139,8/9/2010,Nigeria,Bauchi,4,8,12,"Boko Haram Islamists assault a prison, killing two employees and two civilians."
14140,9/9/2010,Iraq,Baghdad,2,2,4,Two people are reportedly killed when gunmen open fire on an Anglican church in an incident tied to a threatened Quran burning.
14141,9/9/2010,Dagestan,Derbent,2,0,2,Two men are gunned down in separate Mujahideen attacks.
14142,9/9/2010,Pakistan,Khyber,3,0,3,Three laborers working in a forest are abducted and murdered by Tehreek-e-Taliban.
14143,9/9/2010,Iraq,Baghdad,3,10,13,Three Iraqis are taken out by Jihadi car bombers.
14144,9/9/2010,Iraq,Abu Ghraib,1,0,1,A policeman is killed in his own home by terrorists.
14145,9/9/2010,Thailand,Yala,1,0,1,Muslim separatists shoot a 52-year-old Buddhist in the head then kick his body under a bridge.
14146,9/9/2010,Russia,Vladikavkaz,18,123,141,"A Shahid drives an explosives-laden vehicle into a market, blasting seventeen shoppers to bits."
14147,9/9/2010,Somalia,Mogadishu,9,3,12,"Five Fedayeen suicide bombers storm an airport and kill nine others, including two women."
14148,9/9/2010,Pakistan,Kurram,10,4,14,Militants murder ten bus passengers with an explosive device.
14149,9/9/2010,Iraq,Diyala,1,0,1,A woman is beheaded in her own home by suspected al-Qaeda 'insurgents'.
14150,9/9/2010,Iraq,Muqdadiya,1,1,2,A cleric is beheaded and set on fire by Freedom Fighters.
14151,9/9/2010,Yemen,Moudia,3,4,7,"al-Qaeda assault a military checkpoint, killing three Yemenis."
14152,9/9/2010,Pakistan,Quetta,5,4,9,"A suicide bomber detonates inside an official's home, taking five lives."
14153,10/9/2010,Ingushetia,Nazran,1,0,1,Muslim separatists shoot a man to death outside an auto repair shop.
14154,10/9/2010,Dagestan,Makhachkala,1,0,1,An off-duty cop is gunned down at his father's home by Islamic radicals.
14155,11/9/2010,Iraq,Baghdad,2,4,6,Two Iraqis die from splinter injuries after Jihadis send rockets into a commercial district.
14156,12/9/2010,Indonesia,Bekasi,0,2,2,Holy Warriors beat a pastor with a board and stab a worshipper in the stomach as there are on their way to church.
14157,12/9/2010,Dagestan,Makhachkala,1,0,1,Muslim extremists shoot a man to death in his car.
14158,12/9/2010,Afghanistan,Helmand,2,12,14,Two locals are taken down by a bomb.  A rocket attack elsewhere injures ten family members.
14159,12/9/2010,Iraq,Buhriz,1,3,4,A woman and two children are among the casualties of a vicious bombing.
14160,12/9/2010,Iraq,Baquba,2,1,3,Two Iraqis are blown up by Jihadi bombers.
14161,12/9/2010,Iraq,Hudayyeb,1,1,2,"Two men are shot, one of them an elderly man by his own al-Qaeda sons."
14162,12/9/2010,Somalia,Mogadishu,5,24,29,Five Somalis are blown to bits when Islamic militia detonate a bomb outside a mosque.
14163,13/9/2010,Ethiopia,Dufti,0,1,1,A group of Islamists stab a Christian who had left Islam.
14164,13/9/2010,India,Poonch,1,0,1,Islamic terrorists abduct a civilian from his home and murder him.
14165,13/9/2010,India,Pulwama,1,0,1,Lashkar-e-Toiba radicals intrude into a local soldier's home and shoot him to death.
14166,13/9/2010,Pakistan,Kurram,6,4,10,A half dozen people are sent to Allah by suspected Tarik-e-Taliban bombers.
14167,13/9/2010,Iraq,Baghdad,4,6,10,"Four Iraqis are murdered in separate Mujahideen attacks, including a father in front of his family."
14168,14/9/2010,Pakistan,Hangu,1,0,1,Islamists shoot a journalist to death outside a press club.
14169,14/9/2010,Iraq,Baghdad,1,0,1,A woman of 'ill-repute' is hanged in her own home by suspected fundamentalists.
14170,14/9/2010,Iraq,Mosul,2,0,2,Two men are gunned down in separate attacks.
14171,14/9/2010,Ingushetia,Nazran,0,1,1,An imam who spoke out against Islamic terrorism is quickly neutralized by a car bomb.
14172,15/9/2010,Iraq,Tal Afar,10,5,15,"A minibus is blasted by Jihadi bombers, leaving ten riders dead."
14173,15/9/2010,Afghanistan,Kandahar,2,0,2,Two children are murdered by Taliban bombers.
14174,15/9/2010,Afghanistan,Balkh,2,0,2,Two election workers are gunned down in cold blood by religious radicals.
14175,16/9/2010,Dagestan,Kaspiisk,1,0,1,A shooting at a hospital by suspected 'insurgents' leaves one person dead.
14176,16/9/2010,Pakistan,Khar,2,0,2,"Islamic militants attack a home, killing two people inside, including a teen."
14177,16/9/2010,Iraq,Abu Saida,2,0,2,A man and his wife are gunned down by al-Qaeda.
14178,16/9/2010,Iraq,Samarrah,3,6,9,A Fedayeen suicide bomber takes out three Iraqis.
14179,16/9/2010,Thailand,Narathiwat,2,0,2,Islamic 'insurgents' riddle a Buddhist father and his teenage son with automatic weapons fire.
14180,16/9/2010,Afghanistan,Ghazni,5,2,7,Five employees of a security firm are brutally murdered in their office by Taliban fundamentalists.
14181,16/9/2010,Philippines,Basilan,3,0,3,Abu Sayyaf militants shoot three local soldiers to death in a surprise attack.
14182,16/9/2010,Yemen,Shabwa,2,0,2,"al-Qaeda ambush two local security personnel, leaving both dead."
14183,16/9/2010,Somalia,Mogadishu,3,6,9,"Islamic militia send mortars into a government complex, killing at least three."
14184,17/9/2010,Iraq,Hawija,4,9,13,Jihadi bombers take down four civilians with a roadside blast.
14185,17/9/2010,Afghanistan,Balkh,9,0,9,Nine people are dismembered when a horse-drawn cart gets blasted by Taliban bombers.
14186,18/9/2010,Kenya,Nairobi,0,6,6,"Six Christian missionaries are abducted, raped and tortured for three days by Muslims proclaiming the truth of Islam."
14187,18/9/2010,Afghanistan,Nazyan,2,1,3,Two people are killed by a Taliban rocket attack.
14188,18/9/2010,Afghanistan,Baghlan,7,5,12,Seven locals are killed in an Islamist assault on a voting station.
14189,18/9/2010,Afghanistan,Asadabad,1,1,2,A child is murdered by a Taliban rocket attack.
14190,18/9/2010,Afghanistan,Kunar,1,1,2,A voter and a woman are shot by Sunni terrorists at a polling station.
14191,18/9/2010,Afghanistan,Sharsharak,3,4,7,Children are the casualties of a vicious bombing by Islamic fundamentalists.
14192,18/9/2010,Afghanistan,Zabul,3,0,3,Taliban bombers take out three Afghans.
14193,18/9/2010,Iran,Iranshahr,1,0,1,Jundallah (Soldiers of God) kidnap a civilian and kill him during a rescue attempt.
14194,18/9/2010,Iraq,Mosul,1,0,1,A civilian is brought down by Sunni gunmen.
14195,19/9/2010,Afghanistan,Ghazni,1,8,9,"The Taliban send a mortar into a family home, killing at least one."
14196,19/9/2010,Pakistan,Karachi,1,0,1,A Shia man is murdered by Sunni gunmen.
14197,19/9/2010,Iraq,Baghdad,12,36,48,A vicious bomb blast takes down a dozen innocents.
14198,19/9/2010,Iraq,Baghdad,19,58,77,Islamic bombers disassemble nineteen people waiting in line at a cell phone provider.
14199,19/9/2010,Iraq,Fallujah,6,14,20,Six Iraqis are blown to bits by Jihadi car bombers.
14200,19/9/2010,Iraq,Baghdad,2,0,2,Two minibus passengers are taken down by a roadside bomb.
14201,19/9/2010,India,New Delhi,0,2,2,Two Taiwanese tourists riding a bus are shot by Mujahideen.
14202,19/9/2010,Afghanistan,Kunduz,8,0,8,Eight children bleed out following a Taliban rocket attack.
14203,19/9/2010,Thailand,Narathiwat,2,0,2,Muslim terrorists murder a Buddhist man and his wife and set fire to their house.
14204,19/9/2010,Thailand,Narathiwat,2,0,2,Two elderly Buddhist villagers are shot to death in their homes by Islamic gunmen.
14205,19/9/2010,Afghanistan,Balkh,3,0,3,Three election workers are kidnapped and brutally murdered by Religion of Peace enthusiasts.
14206,19/9/2010,Tajikistan,Rasht,25,20,45,The Islamic Movement of Uzbekistan ambushes and kills twenty-five Tajik troops along the border.
14207,20/9/2010,Pakistan,Liaquatabad,3,2,5,Sectarian snipers take out three mourners at a funeral.
14208,20/9/2010,Iraq,Mosul,1,0,1,Terrorists gun down a cop.
14209,21/9/2010,Iraq,Mosul,4,20,24,Four local cops are taken out by a Jihadi bomb.
14210,21/9/2010,Iraq,Mosul,4,3,7,A woman is among four Iraqis killed in separate terror attacks.
14211,21/9/2010,Pakistan,Karachi,2,2,4,"Sunni radicals fire into a Shia bakery, killing two people."
14212,21/9/2010,Nigeria,Maiduguri,2,0,2,Two people are shot to death by Boko Harem Islamists in a motorbike drive-by.
14213,21/9/2010,Afghanistan,Parwan,5,5,10,Five construction workers are taken apart by Taliban bombers.
14214,21/9/2010,Algeria,Bordj Menaiel,2,3,5,Fundamentalists take down two local security personnel with a roadside blast.
14215,22/9/2010,Pakistan,Khyber,3,1,4,Three local security forces are blown apart by a roadside bomb.
14216,22/9/2010,Iraq,Mosul,1,0,1,Terrorists gun down a civilian.
14217,22/9/2010,Indonesia,Sumatra,3,0,3,Islamic radicals murder three local cops during an assault on their station.
14218,22/9/2010,Somalia,Bosaso,2,2,4,al-Qaeda linked militants kill security personnel with a roadside bomb.
14219,22/9/2010,Yemen,Hawta,1,0,1,A civilian is murdered by al-Qaeda.
14220,23/9/2010,Pakistan,Landi Kotal,3,0,3,Three people burn to death when Islamic militants bomb an oil tanker.
14221,23/9/2010,Iraq,Taji,2,0,2,A man and his wife are shot to death by Holy Warriors.
14222,23/9/2010,Iraq,Mosul,2,0,2,A woman is among two people killed in their own homes by Mujahideen.
14223,23/9/2010,Thailand,Pattani,2,0,2,Two Buddhists are shot to death by militant Muslims as they are delivering noodles to a store.
14224,23/9/2010,Iraq,Baghdad,4,4,8,Four young boys under the age of ten are murdered by a Mujahid bomb attack on their car.
14225,24/9/2010,Dagestan,Makhachkala,1,0,1,A high school principal is murdered in her home by Muslim radicals.
14226,24/9/2010,Chechnya,Grozny,3,0,3,Three soldiers are slain in a Jihadi ambush.
14227,24/9/2010,Iraq,Kohat,2,4,6,Two laborers are shot to death by Islamic militants.
14228,24/9/2010,Iraq,Mosul,1,2,3,"A Shahid suicide bomber detonates at a mosque, killing a bystander."
14229,24/9/2010,Mogadishu,Hiran,2,2,4,Two civilians are killed during an al-Shabaab ambush.
14230,24/9/2010,Dagestan,Makhachkala,2,44,46,Forty-four people are injured when a suicide bomber detonates along a city sidewalk.
14231,25/9/2010,Pakistan,Bahawalpur,2,6,8,"Gunmen open fire on a rival mosque, killing at least two."
14232,25/9/2010,Afghanistan,Balkh,1,15,16,A civilian is blown to bits by a Fedayeen suicide bomber.
14233,25/9/2010,Yemen,Sanaa,2,8,10,"al-Qaeda snipers fire into a police bus, taking down two occupants."
14234,25/9/2010,Pakistan,Kalat,1,0,1,Taliban sympathizers are suspected of shooting a driver to death and setting fire to his truck.
14235,25/9/2010,Iraq,Baghdad,1,0,1,Terrorists kill a traffic cop with an IED.
14236,26/9/2010,India,Baramulla,1,0,1,Islamic militants gun down a civilian coming out of a mosque.
14237,26/9/2010,Iraq,Mosul,3,0,3,Two brothers shot in their home are among three people murdered by Mujahideen.
14238,26/9/2010,Iraq,Garma,4,4,8,Four Iraqis are blown up by Jihadi car bombers.
14239,26/9/2010,Ingushetia,Yandare,1,1,2,Islamists roll up on a police post and take down one officer at point-blank range.
14240,26/9/2010,Iraq,Baghdad,4,0,4,Four local police are gunned down in separate terror attacks.
14241,27/9/2010,India,Hat Thymmai,1,2,3,A Hindu woman is murdered by Bangladeshi radicals.
14242,27/9/2010,Dagestan,Makhachkala,2,1,3,A girl and her father are shot to death on the doorstep of their home by Muslim terrorists.
14243,27/9/2010,Pakistan,Karachi,1,0,1,Sectarian Jihadis gun down a Shia civilian.
14244,27/9/2010,Iraq,Mosul,2,1,3,A woman and a teacher are shot to death by religious militants.
14245,28/9/2010,Iraq,Samarrah,1,0,1,Terrorists barge into a house and murder a policeman.
14246,28/9/2010,Iraq,Tarmiya,2,8,10,Two Iraqis are killed when a cafe is blasted by a Jihad bomb.
14247,28/9/2010,Afghanistan,Ghazni,5,17,22,Five people are shredded by a Fedayeen suicide bomber.
14248,28/9/2010,Thailand,Pattani,5,3,8,Children are among the victims when Islamic radicals brutally gun down five people buying fruit at a warehouse.
14249,29/9/2010,Russia,Elbrus,2,20,22,A woman is among two people shot to death by Islamists.
14250,29/9/2010,Iraq,Baqubah,1,1,2,A civilian standing near a minibus is gunned down by Holy Warriors.
14251,29/9/2010,Yemen,Shabwa,3,0,3,Three Yemenis are riddled with bullets by al-Qaeda cadres.
14252,30/9/2010,Afghanistan,Kandahar,3,9,12,Three civilians are dismembered by a Shahid suicide bomber.
14253,1/10/2010,Yemen,Sanaa,1,1,2,Two Westerners working for an oil company are gunned down.
14254,1/10/2010,Iraq,Baghdad,3,7,10,A suspected al-Qaeda blast near a mosque leaves three people dead.
14255,1/10/2010,Pakistan,Sindh,5,8,13,Five people are burned alive when Jihadis fire rockets into oil tankers in two separate attacks.
14256,1/10/2010,Pakistan,Haripur,7,0,7,A Christian couple and their five children (ages 6-17) are brutally shot to death in their home by Muslim extremists.
14257,2/10/2010,Afghanistan,Paktika,7,0,7,"Seven members of a family are ripped apart by a Taliban roadside blast, including three children."
14258,2/10/2010,Pakistan,Mardan,1,0,1,Tehreek-e-Taliban militants are suspected of assassinating a rival religious scholar.
14259,2/10/2010,Afghanistan,Helmand,1,1,2,Islamic hardliners kill a child with an IED.
14260,2/10/2010,Iraq,Mosul,3,0,3,Three police officers are taken down by Jihadi bombers.
14261,3/10/2010,Pakistan,Islamabad,6,14,20,Six people are burned to death by a Sunni rocket attack on an industrial complex.
14262,3/10/2010,Pakistan,Miranshah,3,0,3,Three civilians are abducted and executed by Taliban militants.
14263,3/10/2010,Iraq,Mosul,1,0,1,A university professor is killed by fundamentalist gunmen.
14264,3/10/2010,Iraq,Mosul,1,0,1,Terrorists shoot a shepherd to death in his home.
14265,3/10/2010,Iraq,Fallujah,5,4,9,Five Iraqis are murdered in a series of area terror attacks.
14266,3/10/2010,Thailand,Yala,3,3,6,Three local soldiers are ambushed and killed by Muslim separatists.
14267,3/10/2010,Algeria,Tizi Ouzou,5,10,15,Five security personnel in a shooting and bombing ambush by armed fundamentalists.
14268,3/10/2010,Italy,Modena,1,1,2,"A woman is beaten to death by her own husband for trying to stop the forced marriage of her daughter, who is also put in a coma by her brother."
14269,4/10/2010,Somalia,Mogadish,5,19,24,Two women and a child are among five civilians killed during an al-Shabaab attack along a city street.
14270,4/10/2010,Afghanistan,Ghazni,2,6,8,"Hardliners send rockets into a civilian district, killing two."
14271,4/10/2010,Iraq,Jalawla,4,17,21,Four local cops lose their lives to Jihadi bombers.
14272,4/10/2010,Iraq,Garma,1,0,1,A television camera man bleeds out following a targeted bombing.
14273,4/10/2010,Iraq,Mussayab,1,0,1,An Iraqi is murdered by al-Qaeda gunmen.
14274,4/10/2010,Dagestan,Chiryurt,2,0,2,"Suspected Islamists assassinate two local farm officials, both fathers."
14275,4/10/2010,Afghanistan,Kandahar,1,0,1,A local official is gunned down by Islamist while praying at a mosque.
14276,4/10/2010,Afghanistan,Kandahar,4,17,21,Islamic hardliners murder four local cops with a series of bomb blasts.
14277,5/10/2010,Thailand,Pattani,3,0,3,Three Buddhists transporting chickens are pumped full of holes by Muslim separatists at point-blank range.
14278,5/10/2010,Thailand,Yala,1,0,1,A 33-year-old man is murdered in his driveway by Islamic gunmen.
14279,5/10/2010,Thailand,Pattani,1,0,1,A 43-year-old man is shot to death by Muslim militants.
14280,5/10/2010,Pakistan,Sindh,1,0,1,A teacher is gunned down by sectarian assassins.
14281,5/10/2010,Pakistan,North Waziristan,2,8,10,Two local soldiers are sent to Allah by Islamic bombers.
14282,5/10/2010,Afghanistan,Kandahar,9,25,34,Eight civilians are among nine brutally slain in a Taliban ambush.
14283,6/10/2010,Pakistan,Kohat,0,3,3,"Islamists throw a grenade into a house with children, injuring three."
14284,6/10/2010,Iraq,Mosul,2,0,2,Two civilians die from injuries following a drive-by Mujahid shooting.
14285,6/10/2010,Nigeria,Borno,2,0,2,Two statehouse guards are gunned down by Boko Haram Islamists.
14286,6/10/2010,Afghanistan,Mizan,3,0,3,Three farmers carrying produce are brutally blasted to pieces by Taliban hardliners.
14287,7/10/2010,Iraq,Iskandariyah,5,20,25,Sunni militia target a busy marketplace with a shrapnel bomb.  Five patrons are taken out.
14288,7/10/2010,Nigeria,Maiduguri,1,0,1,Boko Haram Islamists assassinate a top politician.
14289,7/10/2010,Tajikistan,Rasht,6,3,9,The Islamic Movement kills six local soldiers with a roadside blast.
14290,7/10/2010,Afghanistan,Baghlan,1,6,7,A Shahid suicide bomber murders a German soldier guarding a road.
14291,7/10/2010,Pakistan,Kar Kandari,2,0,2,Two security personnel are taken down by a Taliban landmine.
14292,7/10/2010,Pakistan,Karachi,9,74,83,Two children are among nine Sufi worshippers taken down by two barbaric suicide blasts at their mosque.
14293,7/10/2010,Iraq,al-Mohandeseen,2,0,2,Suspected Sunni insurgents shoot a 3-year-old girl and her sister to death.
14294,7/10/2010,Iraq,Mosul,2,0,2,A woman and her 13-year-old daughter are murdered in their home by terrorists.
14295,8/10/2010,Philippines,Cotabato,2,1,3,Militant Muslims previously targeting missionaries kill two people and kidnap a woman.
14296,8/10/2010,Georgia,Gudauta,1,2,3,A religious leader is killed when suspected Islamic terrorists fire into their mosque.
14297,8/10/2010,Afghanistan,Takhar,20,35,55,Twenty people at a mosque are sent straight to Allah by Sunni bombers.
14298,8/10/2010,Afghanistan,Kunar,1,0,1,A 35-year-old female British aid worker is captured and blown up in captivity by the Taliban.
14299,8/10/2010,Iraq,Madaen,1,0,1,A young woman is reportedly tortured and killed by al-Qaeda.
14300,8/10/2010,Pakistan,Punjab,0,2,2,An 80-year-old Christian and his elderly wife are beaten unconscious by Muslim attackers.
14301,9/10/2010,Bangladesh,Jhenaidah,0,2,2,An elderly Christian man and his son are beaten by Muslim villagers for refusing to return to Islam.
14302,9/10/2010,Iraq,Yusufiya,2,1,3,Two civilians are shot to death in a Religion of Peace drive-by.
14303,9/10/2010,Iraq,Abu Ghraib,1,4,5,Sectarian Jihadis invade a home and shoot five members of the same family.
14304,9/10/2010,Russia,Kabardino-Balkaria,1,0,1,A court official is murdered by suspected Muslim gunmen while walking home.
14305,9/10/2010,Iraq,Fallujah,3,0,3,Three brothers are pulled out of their home and shot execution style by al-Qaeda.
14306,10/10/2010,Afghanistan,Paktya,9,0,9,Three young children and three women are among nine dismembered by a Taliban bomb.
14307,10/10/2010,Nigeria,Maiduguri,2,0,2,Islamists gun down a rival cleric and his assistant.
14308,10/10/2010,Afghanistan,Farah,4,1,5,Four Italian soldiers are killed in a brutal ambush on their vehicle by religious radicals.
14309,10/10/2010,Iraq,Leheis,3,2,5,Sunni bombers take out three civilians by blasting their minibus.
14310,10/10/2010,Iraq,Mosul,3,0,3,Three Iraqis are cut down by Mujahid gunmen.
14311,11/10/2010,India,Sopore,1,0,1,A local cop is gunned down by Lashkar-e-Toiba.
14312,11/10/2010,Iraq,Youssifiyah,4,2,6,al-Qaeda drag four young men out of their homes and shoot them to death.
14313,11/10/2010,Iraq,Fallujah,2,1,3,Gunmen fire on a man and his wife and murder another person in a home invasion.
14314,11/10/2010,Thailand,Yala,1,0,1,A local soldier is ambushed and murdered on his way to work by Islamic terrorists.
14315,11/10/2010,Afghanistan,Kunar,3,7,10,Two Indians are among three people claimed by a Taliban rocket attack.
14316,11/10/2010,Thailand,Pattani,1,0,1,A fruit trader is machine-gunned by militant Muslims while sitting in his truck.
14317,11/10/2010,Afghanistan,Zabul,4,0,4,Four civilians are blown to bits by a Taliban landmine.
14318,12/10/2010,Iraq,Mosul,3,11,14,Three Iraqis are taken down by two terror bombings.
14319,12/10/2010,Somalia,Mogadishu,5,10,15,A woman and two children are among five killed when an al-Shabaab mortar hits their home.
14320,12/10/2010,Nigeria,Maiduguri,11,4,15,Six civilians and five cops are reportedly gunned down by Boko Haram radicals.
14321,12/10/2010,Afghanistan,Paktika,5,1,6,"A vicious Islamist RPG attack leaves five civilians dead, including a woman and two children."
14322,12/10/2010,Afghanistan,Kunar,1,8,9,One local is killed during a Taliban rocket attack.
14323,13/10/2010,Pakistan,Mohmand,3,0,3,Three tribal elders are assassinated by religious hardliners.
14324,13/10/2010,Thailand,Yala,2,0,2,Two villagers are ambushed and killed while guarding their village from Muslim insurgents.
14325,13/10/2010,Thailand,Pattani,1,0,1,A man is shot to death by Islamic insurgents while walking home.
14326,13/10/2010,Algeria,Tlidjen,5,0,5,Fundamentalists take down five public works officials with a remote-controlled bomb.
14327,14/10/2010,Nigeria,Bauchi,1,0,1,Islamists assassinate a police officer guarding a private residence.
14328,14/10/2010,Pakistan,Sararogha,5,1,6,At least five local soldiers are killed in a Taliban ambush.
14329,14/10/2010,Iraq,Baghdad,1,0,1,A rival cleric is gunned down by militant Islamists.
14330,14/10/2010,Iraq,Baghdad,3,7,10,"Three Iraqis, including a university professor, are murdered in a series of bomb attacks."
14331,14/10/2010,Iraq,Mosul,1,2,3,"Islamic radicals detonate a bomb on a bridge, killing at least one."
14332,14/10/2010,Thailand,Pattani,1,0,1,Islamists murder a bank teller riding a motorcycle.
14333,14/10/2010,Somalia,Haradhere,4,12,16,Pregnant women and children are killed when Hizbul Islam militants open fire on a group protesting their beating teenagers.
14334,14/10/2010,Iraq,Diala,4,7,11,Four people are killed when Islamic terrorists attempt to kill a member of parliament.
14335,14/10/2010,Yemen,Mudia,2,1,3,"al-Qaeda attempts to assassinate a government official, but kills his brother instead."
14336,14/10/2010,Yemen,Abyan,5,8,13,An al-Qaeda ambush on a local military convoy leaves five dead.
14337,14/10/2010,Pakistan,Kotwali,1,0,1,A religious scholar is shot to death by sectarian Jihadis.
14338,15/10/2010,Pakistan,Orakzai,4,6,10,Four villagers are murdered by Mujahideen attackers.
14339,15/10/2010,Afghanistan,Zabul,9,2,11,"Nine civilians, including three women and one child, are taken apart by a Taliban IED blast."
14340,15/10/2010,Pakistan,Khyber,2,0,2,"Religious hardliners set fire to a truck, burning the driver and a passenger to death."
14341,15/10/2010,Pakistan,Kalat,1,1,2,Suspected Islamists murder the driver of a NATO supply vehicle.
14342,16/10/2010,Afghanistan,Kandahar,1,2,3,A civilian is incinerated when Mujahideen blow up a fuel tanker.
14343,16/10/2010,Afghanistan,Kandahar,1,4,5,A motorbike bomb blast kills a civilian.
14344,16/10/2010,Iraq,Baghdad,2,2,4,Two police officers are gunned down at point-blank range by Islamic terrorists.
14345,16/10/2010,Yemen,Zinjibar,3,2,5,al-Qaeda militants send three local soldiers to Allah via a roadside blast.
14346,16/10/2010,Afghanistan,Uruzgan,2,7,9,Hardliners murder two civilians with a roadside bomb.
14347,17/10/2010,Chechnya,Grozny,2,0,2,Suspected Muslim insurgents take out two local cops in a drive-by shooting.
14348,17/10/2010,Pakistan,Hangu,1,0,1,A peace activist is murdered by Tehreek-e-Taliban gunmen.
14349,17/10/2010,Iraq,Baghdad,4,7,11,A doctor is among four Iraqis taken down by Jihadi bombers.
14350,17/10/2010,Afghanistan,Farah,8,20,28,The Taliban claim to have killed eight humanitarian workers in an attack on their project.
14351,17/10/2010,Pakistan,Orakzai,2,0,2,"Two people are beheaded by Islamic militants, who then post their heads at a bazaar."
14352,18/10/2010,Thailand,Pattani,1,0,1,A 65-year-old man is shot in the head by terrorists while shopping with his daughter.
14353,18/10/2010,Pakistan,Lakki Marwat,0,14,14,Women and children are among the casualties when a suicide bomber detonates at an intersection.
14354,18/10/2010,Afghanistan,Herat,3,0,3,Three civilians bleed out following a Taliban roadside blast.
14355,18/10/2010,Afghanistan,Gereshk,9,0,9,Nine security guards are gunned down by Sunni radicals.
14356,18/10/2010,Afghanistan,Nangarhar,1,3,4,A Taliban roadside blast ends the life of a local cop.
14357,18/10/2010,Iraq,Mosul,1,0,1,Mujahideen shoot an elderly man to death inside his home.
14358,18/10/2010,Iraq,Mosul,2,7,9,A Shahid suicide bomber kills one Iraqi.
14359,18/10/2010,Iraq,Baghdad,1,8,9,Islamists assassinate a local politician with a bomb.
14360,19/10/2010,Nigeria,Maiduguri,1,0,1,Boko Haram Islamists shoot a police officer to death in a drive-by attack.
14361,19/10/2010,Ingushetia,Malgobek,1,0,1,Islamic militants gun down a cop.
14362,19/10/2010,Pakistan,Khyber,3,3,6,Mujahideen murder three local security personnel with a remote-controlled bomb.
14363,19/10/2010,Iraq,Samarrah,3,2,5,Three Iraqis are blown apart by Jihadi bombers.
14364,19/10/2010,Chechnya,Grozny,3,17,20,A coordinated Fedayeen assault on a government building leaves three victims dead.
14365,19/10/2010,Iraq,Tikrit,10,4,14,Children are among the casualties when Islamic militants blow up a home.
14366,19/10/2010,Pakistan,Wana,3,2,5,Three local soldiers are taken out by a terrorist ambush.
14367,20/10/2010,Pakistan,Miranshah,1,0,1,An Afghan civilian is kidnapped and murdered by Islamic extremists.
14368,20/10/2010,Iraq,Mosul,5,0,5,Two women and a 13-year-old girl are among a family of five massacred in their home by Sunni militants.
14369,20/10/2010,Thailand,Yala,1,1,2,Muslim radicals gun down a 27-year-old laborer.
14370,20/10/2010,Afghanistan,Herat,4,0,4,Four policemen are slaughtered in a Mujahideen ambush
14371,20/10/2010,Afghanistan,Ghazni,2,0,2,A man and his 8-year-old daughter are brutally slain by religious hardliners.
14372,20/10/2010,Afghanistan,Nimroz,8,6,14,Eight civilians are disassembled by a Sunni bomb blast.
14373,21/10/2010,Afghanistan,Paktika,2,1,3,Two children are shot to death by Sunni radicals.  A third child is gravely injured.
14374,21/10/2010,Philippines,Matalam,10,30,40,al-Khobar terrorists are suspected in the bombing of a bus that leaves ten civilians dead.
14375,21/10/2010,Pakistan,Hakim Khan,6,0,6,An internal squabble between Talibanis is settled by a roadside bomb.  Six dead.
14376,21/10/2010,Philippines,Maguindanao,2,1,3,Two civilians die from wounds following an Abdul Basit Usman ambush.
14377,22/10/2010,Iraq,Mosul,1,6,7,A civilian is left dead by a Jihad bomb.
14378,22/10/2010,Iraq,Garma,1,1,2,A suspected al-Qaeda bomb leaves one person dead.
14379,22/10/2010,Yemen,Mukalla,1,0,1,A security officer is gunned down at his home by al-Qaeda.
14380,22/10/2010,Nigeria,Bauchi,1,0,1,Boko Haram Islamists shoot a government official in the head and body at his home.
14381,22/10/2010,Pakistan,Peshawar,5,22,27,"Sectarian Religion of Peace rivals toss a bomb into a mosque, killing five worshippers."
14382,22/10/2010,Thailand,Pattani,1,0,1,Two Islamists assassinate a rival imam at his mosque.
14383,22/10/2010,Pakistan,Orakzai,6,3,9,Six Pakistanis are killed by a Taliban roadside blast.
14384,22/10/2010,Afghanistan,Kunar,1,3,4,A civilian loses his life to a Taliban ambush.
14385,22/10/2010,Afghanistan,Nangahar,3,0,3,Hardliners murder a district governor and two others with an IED.
14386,22/10/2010,Thailand,Pattani,1,0,1,A government worker is shot twice in the head by Muslim 'insurgents' on his way to work.
14387,23/10/2010,Somalia,Boondere,12,20,32,A dozen civilians are killed during a series of al-Shabaab attacks.
14388,23/10/2010,Dagestan,Khasavyurt,1,12,13,A local cop is taken out by a Shahid suicide bomber.
14389,23/10/2010,Afghanistan,Kandahar,1,2,3,A suicide bomber on a motorcycle kills a passerby.
14390,23/10/2010,Iraq,Mosul,4,0,4,Three women and one man from the same family are murdered when terrorists invade their home.
14391,23/10/2010,Iraq,Abu Ghraib,2,14,16,Two Iraqis are blown apart by a bomb.
14392,24/10/2010,Iran,Tehran,1,0,1,A devout Muslim beats his Christian relative to death for leaving Islam.
14393,24/10/2010,Iraq,Mosul,5,19,24,Mujahideen take out five civilians with a car bomb.
14394,25/10/2010,Pakistan,Bajaur,1,0,1,A member of a peace committee is assassinated by religious radicals.
14395,25/10/2010,Pakistan,Bajaur,1,1,2,"Islamic militants ambush a checkpoint, killing a local soldier."
14396,25/10/2010,Iraq,Baghdad,1,0,1,A electrical association worker is shot to death by Mujahideen.
14397,25/10/2010,Pakistan,Punjab,7,15,22,Three women are among seven innocents killed by Sunni bombers at a Sufi mosque.
14398,25/10/2010,Thailand,Narathwat,1,15,16,A farmer is murdered in one of a series of bombings by Islamic separatists.
14399,25/10/2010,Afghanistan,Khost,3,10,13,Three people are dismembered by a Fedayeen suicide car bomber.
14400,25/10/2010,Afghanistan,Helmand,2,0,2,Taliban bombers blow two civilians to bits.
14401,25/10/2010,Algeria,Boumerdes,2,3,5,Fundamentalist bombers send two Algerians to Allah.
14402,26/10/2010,Iraq,Kirkuk,10,15,25,Ten people are killed in a daylight robbery at a market by suspected Islamic 'insurgents'.
14403,26/10/2010,Afghanistan,Farah,1,2,3,One other person is killed when two Shahid attack a residence.
14404,26/10/2010,Nigeria,Chewenkur,6,3,9,Four teenagers and two women are hacked to death when Muslims armed with machetes attack a Christian village.
14405,26/10/2010,Afghanistan,Herat,4,3,7,Taliban blow up four local cops with an IED.
14406,27/10/2010,Pakistan,Peshawar,2,0,2,Two policemen are shot to death by Mujahideen.
14407,27/10/2010,Iraq,Himreem,4,0,4,Four Iraqis soldiers are blown to bits by Islamic bombers.
14408,27/10/2010,Iraq,Baghdad,2,5,7,"Shiite militia bomb a Sunni facility, killing two people."
14409,27/10/2010,Iraq,Mosul,3,10,13,A woman is among three Iraqis murdered in two separate attacks.
14410,27/10/2010,Thailand,Yala,1,1,2,A villager is murdered by Muslim gunmen.
14411,27/10/2010,Somalia,Galguduud,6,0,6,Six clerics are shot to death by Ahlu-Sunna terrorists.
14412,28/10/2010,Pakistan,Quetta,4,0,4,Four Shiites are gunned down in a suspected sectarian attack.
14413,28/10/2010,Pakistan,Mohmand,3,0,3,Three accused criminals are beheaded for 'defaming Islam'.
14414,28/10/2010,Pakistan,Ambar,1,4,5,A member of a local peace committee is ambushed and murdered by Jihadis.
14415,28/10/2010,Iraq,Bursa,1,8,9,A Shahid suicide bomber takes out an Iraqi civilian.
14416,28/10/2010,Somalia,Beletweyne,2,0,2,Two teenage girls are publicly executed by an al-Shabaab firing squad.
14417,28/10/2010,Somalia,Hawa Abdi,1,0,1,A Hizbul Islam militant shoots and kills a civilian bus driver.
14418,28/10/2010,Afghanistan,Kandahar,3,0,3,Three local cops are shredded by a Sunni bombing.
14419,28/10/2010,Afghanistan,Kandahar,1,0,1,A government official is gunned down by religious radicals.
14420,28/10/2010,Thailand,Yala,1,0,1,A villager is shot once through the head by Muslim militants.
14421,29/10/2010,Iraq,Diyala,30,70,100,Thirty Iraqis at a crowded cafe are blown apart by a Holy Warrior.
14422,29/10/2010,Pakistan,Baghbana,1,1,2,A 12-year-old boy is among the casualties in an Islamist firing on a tanker.
14423,29/10/2010,Iraq,Baghdad,1,1,2,Terrorists shoot a government official to death and injure his nephew.
14424,30/10/2010,Iraq,Badar,2,0,2,Hardliners ambush and kill two local soldiers.
14425,30/10/2010,Iraq,Abu Ghraib,2,5,7,Two Iraqis lose their lives to a small arms Mujahideen attack.
14426,30/10/2010,Thailand,Pattani,1,0,1,A 48-year-old man is shot and killed by Islamic militants.
14427,30/10/2010,India,Kishtwar,1,0,1,Mujahideen murder an Indian trooper.
14428,30/10/2010,Somalia,Mogadishu,10,7,17,Ten civilian and peacekeepers are taken down by an al-Shabaab roadside blast and shooting.
14429,30/10/2010,Iraq,Baqubah,2,0,2,Two children are machine-gunned to death in their home by Mujahideen.
14430,30/10/2010,Thailand,Yala,1,0,1,Muslim extremists shoot a 78-year-old man to death.
14431,31/10/2010,Somalia,Mogadishu,15,20,35,At least fifteen bodies are counted following a brutal ambush by al-Shabaab radicals.
14432,31/10/2010,Iraq,Baghdad,53,80,133,"Forty-four church members and two young priests are slaughtered when Islamic State of Iraq Fedayeen invade a church, shooting members and tossing grenades into the congregation.  Seven policemen are also killed."
14433,31/10/2010,Iraq,Kurram,3,2,5,Three tribal elders are murdered by Sunni extremists.
14434,31/10/2010,Iraq,Baghdad,6,4,10,A half dozen people are sent straight to Allah by Jihadi bombers.
14435,31/10/2010,Iraq,Mosul,1,7,8,A suicide bomber takes out a cop.
14436,1/11/2010,Afghanistan,Helamand,2,0,2,Two female Afghan aid workers are kidnapped and riddled with bullets by Holy Warriors.
14437,1/11/2010,Iraq,Mosul,5,12,17,An elderly man is among five victims of a series of terror attacks.
14438,1/11/2010,Dagestan,Khasavyurt,1,0,1,A local imam is shot twice in the head by Religion of Peace rivals.
14439,1/11/2010,Thailand,Pattani,1,1,2,Muslim terrorists shoot and kill a policeman.
14440,1/11/2010,Somalia,Modagishu,3,2,5,Three people are torn apart by an Islamist landmine.
14441,1/11/2010,Pakistan,Swabi,2,12,14,Taliban militants stage a Fedayeen assault on a police station.
14442,2/11/2010,Thailand,Pattani,1,1,2,A Buddhist man is murdered by militant Muslims.
14443,2/11/2010,Iraq,Baghdad,110,322,432,At least 13 deadly bomb blasts set by Sunni extremists leave over one-hundred dead in Shia neighborhoods.
14444,3/11/2010,Afghanistan,Helmand,2,0,2,At least two civilians are killed during a sustained Taliban assault.
14445,3/11/2010,Iraq,Mosul,1,0,1,'Insurgents' gun down a 17-year-old boy outside his home.
14446,3/11/2010,Afghanistan,Khost,2,6,8,Two local soldiers are killed by a Shahid suicide bomber.
14447,3/11/2010,Afghanistan,Helmand,5,9,14,Two children are among five civilians cut to pieces by machine-gun fire from religious fundamentalists.
14448,3/11/2010,Afghanistan,Helmand,3,5,8,The Taliban murder three policemen with a roadside bomb.
14449,4/11/2010,Russia,Nalchik,2,0,2,Two hunters are tortured and killed by Islamic militia.
14450,4/11/2010,Pakistan,Khyber,1,3,4,A young boy is killed when Tehreek-e-Taliban militants fire rockets into a village.
14451,4/11/2010,Iraq,Hit,2,0,2,Terrorists assassinate a town's mayor and his driver.
14452,4/11/2010,Yemen,al-Dhalee,2,23,25,Two people are sent to Allah by al-Qaeda bombers.
14453,5/11/2010,Afghanistan,Helmand,2,0,2,Two coalition troops are gunned down by a suspected terrorist in uniform.
14454,5/11/2010,Pakistan,Kalat,1,1,2,"Terrorists open fire on a truck, killing the driver."
14455,5/11/2010,Iraq,Baqubah,3,9,12,Women are among the casualties of a Mujahideen bomb blast.
14456,5/11/2010,Pakistan,Darra Adam Khel,82,80,162,Eleven children are among eighty-two worshippers slaughtered at a mosque by a Shahid suicide bomber yelling 'Allah Akbar'.  Many were crushed by the collapsing roof.
14457,5/11/2010,Afghanistan,Faryab,9,31,40,At least nine people at a bazaar are blown to bits by a teenage suicide bomber.
14458,5/11/2010,Pakistan,Peshawar,4,24,28,Four worshippers are killed when sectarian terrorists throw three grenades into a mosque.
14459,6/11/2010,Afghanistan,Ghazni,5,0,5,The bodies of five policemen are found brutally executed days after their abduction by the Taliban.
14460,7/11/2010,Afghanistan,Bashran,5,6,11,Five civilians are killed when Islamists blow up a family vehicle.
14461,7/11/2010,Iraq,Samarrah,2,3,5,Shia militia are suspected of blowing up two Sunnis.
14462,7/11/2010,Iraq,Mosul,5,1,6,Five Iraqis lose their lives to Muslim terrorists in separate attacks.
14463,7/11/2010,Iraq,Mosul,2,0,2,Two more Christian worshippers are murdered by Muslim gunmen in separate attacks.
14464,8/11/2010,Afghanistan,Lashkar Gah,1,4,5,Hardliners manage to kill a civilian with a bomb hidden in a handcart.
14465,8/11/2010,Thailand,Yala,1,0,1,A 38-year-old villager is shot to death by Muslim militants while grazing his cattle.
14466,8/11/2010,Iraq,Karbalah,14,40,54,Fourteen Shia pilgrims are slaughtered by Sunni terrorists in an attack on their bus.
14467,8/11/2010,Iraq,Najaf,8,31,39,"Sunnis set off a pair of bombs at a Shia shrine, taking down eight innocents."
14468,8/11/2010,Iraq,Basra,13,39,52,Thirteen people are blown to bits by a Jihadi car bomb in a commercial district.
14469,9/11/2010,Afghanistan,Paktia,1,0,1,A Taliban road mine takes out a local official.
14470,9/11/2010,Thailand,Pattani,1,0,1,A 17-year-old boy is ambushed and killed by Mujahideen.
14471,9/11/2010,Thailand,Narathiwat,1,0,1,A woman is gunned down by Islamic insurgents.
14472,9/11/2010,Afghanistan,Uruzgan,7,1,8,"Religious extremists attack a police station, killing at least seven inside."
14473,9/11/2010,Thailand,Pattani,1,0,1,A Buddhist man is murdered by Muslim gunmen.
14474,10/11/2010,Dagestan,Kizlyar,1,6,7,One is left dead after Muslim 'insurgents' open fire on a roadblock.
14475,10/11/2010,Afghanistan,Khost,1,3,4,A suicide bomber takes out an Afghan cop.
14476,10/11/2010,Iraq,Baghdad,6,20,26,"Islamists blast Christian areas of Baghdad with bombs and mortars, killing at least six."
14477,10/11/2010,India,Pattan,2,0,2,Islamic militants brutally shoot two security personnel to death at point blank range in a market.
14478,10/11/2010,Iraq,Mosul,1,0,1,A young girl is taken down by Muslim gunmen.
14479,10/11/2010,Iraq,Iskandariya,3,0,3,Mujahideen murder three brothers with a bomb hidden at a water pump.
14480,11/11/2010,Pakistan,Peshawar,2,4,6,A women and her daughter are crushed to death in their own home by a Taliban rocket attack.
14481,11/11/2010,Dagestan,Makhachkala,7,5,12,Muslim rebels attack and kill seven cops.
14482,11/11/2010,Pakistan,Lahore,1,0,1,A man is shot to death after being accused of burning pages from the Quran.
14483,11/11/2010,Pakistan,Karachi,19,114,133,"Tehreek-i-Taliban suicide bombers drive an explosives-laden vehicle into a police station, killing at least nineteen."
14484,12/11/2010,India,Baramulla,1,0,1,Terrorists shoot a policeman to death.
14485,12/11/2010,Afghanistan,Kabula,2,4,6,A Shahid suicide bomber sends two Afghans to Allah.
14486,12/11/2010,Thailand,Yala,1,0,1,An 18-year-old school volunteer is kidnapped and brutally slain by suspected Muslim separatists.
14487,13/11/2010,Thailand,Narathiwat,1,0,1,A 49-year-old man is shot to death by militant Muslims on his way to work.
14488,13/11/2010,Nigeria,Borno,1,1,2,"Boko Haram Islamists open fire on two soldiers eating in a restaurant, killing one."
14489,13/11/2010,Pakistan,Mohmand,2,0,2,Tehreek-e-Taliban militants ambush and kill two security personnel.
14490,13/11/2010,Iraq,Samarrah,1,0,1,A woman is strangled in a suspected honor killing.
14491,13/11/2010,Pakistan,Peshawar,0,6,6,Six children are injured when suspected Taliban throw a grenade into the home of a peace activist.
14492,13/11/2010,Bangladesh,Doulatpur,1,1,2,A suicide bomber kills one other person at a residence.
14493,13/11/2010,Afghanistan,Kunduz,8,18,26,Eight people at a market are taken apart by a motorcycle bomb.
14494,14/11/2010,Algeria,Freha,1,0,1,A local business man dies from injuries suffered in al-Qaeda captivity.
14495,14/11/2010,Pakistan,Shakai,1,8,9,Fedayeen take down a member of a peace committee in a suicide attack at a market.
14496,14/11/2010,Iraq,Mosul,1,0,1,A 17-year-old boy is gunned down in a shop by terrorists.
14497,14/11/2010,Iraq,Mosul,2,8,10,A Fedayeen suicide bomber takes out two Iraqis.
14498,14/11/2010,Afghanistan,Jalalabad,1,9,10,Women and children are among the casualties of a Sunni bomb.
14499,14/11/2010,Afghanistan,Spin Boldak,2,11,13,"Radicals plant a bomb at a marketplace, killing two patrons."
14500,14/11/2010,Afghanistan,Uruzgan,3,0,3,Three policemen are blown apart by a Taliban bomb.
14501,14/11/2010,Thailand,Yala,1,0,1,Mujahid shoot a man to death in his own living room.
14502,15/11/2010,Sweden,Katrineholm,1,0,1,"A 21-year-old woman is stabbed 53 times by her Muslim father, who was angered by her 'indecent' lifestyle."
14503,15/11/2010,Chechnya,Grozny,1,0,1,A traffic cop is shot to death by Muslim terrorists while on duty.
14504,15/11/2010,Dagestan,Rostov-on-Don,1,0,1,Islamic militants barge into a hospital and shoot a man to death.
14505,15/11/2010,Pakistan,Khyber,2,3,5,"Tehrik-e-Taliban bombers murder two people, including a rival prayer leader."
14506,15/11/2010,Iraq,Mosul,2,18,20,Two people are killed in a Jihad car bomb blast.
14507,15/11/2010,Iraq,Baghdad,2,5,7,Two bombs at a marketplace take down a pair of Iraqis.
14508,15/11/2010,Iraq,Mosul,3,0,3,Three Christian brothers are brutally shot to death in their home by Religion of Peace advocates.
14509,16/11/2010,Afghanistan,Kunduz,2,5,7,Fundamentalists kill two men visiting a graveyard.
14510,16/11/2010,Iraq,Mosul,3,0,3,Two women are among three members of a family murdered in their home by Jihad terrorists.
14511,16/11/2010,Iraq,Mosul,2,0,2,A 6-year-old Christian girl and her father are exterminated by Islamic bombers.
14512,16/11/2010,Somalia,Mogadishu,4,9,13,Four civilians are killed following an al-Shabaab attack.
14513,16/11/2010,Nigeria,Ganmo,1,5,6,One person is dead when rival Muslim groups clash over a prayer ground.
14514,17/11/2010,Iraq,Baqubah,1,0,1,Mujahid bombers take out a civilian.
14515,17/11/2010,Somalia,Mogadishu,5,9,14,An ambush by Islamic militia leaves five civilians dead.
14516,17/11/2010,Pakistan,Khuzdar,0,18,18,Eighteen people are wounded when clerics at a mosque begin shooting at each other to decide who should lead prayer.
14517,18/11/2010,Russia,Oktyabrsky,0,2,2,"A Muslim stabs two police officers, saying he is upset that they do not allow Allah's law to be practiced."
14518,18/11/2010,Iraq,Baqubah,1,0,1,A local Sunni is murdered by suspected al-Qaeda.
14519,19/11/2010,Pakistan,Khurram,3,8,11,A woman and two children are crushed to death by a Taliban rocket strike.
14520,19/11/2010,Iraq,Mosul,2,2,4,Two people are killed in separate terror attacks.
14521,19/11/2010,Nigeria,Maiduguri,2,1,3,"Islamists roll up to a rival mosque and open up with automatic weapons, killing two men and injuring a child."
14522,20/11/2010,Afghanistan,Laghman,4,33,37,"Four civilians, including a mother and child, are cut to shreds in two Fedayeen suicide attacks."
14523,20/11/2010,Iraq,Shirqat,2,0,2,An 8-year-old girl and a woman are disassembled in their own home by Islamist bombers.
14524,21/11/2010,India,Kishtwar,1,2,3,Lashkar-e-Toiba gunmen barge into a home and murder a 60-year-old woman.
14525,21/11/2010,Pakistan,Turbat,5,3,8,Five Shiites are shot to death in a suspected sectarian attack.
14526,21/11/2010,Iraq,Mosul,1,0,1,al-Qaeda storm a home and shoot an 18-year-old to death in front of his parents.
14527,21/11/2010,Iraq,Baqubah,1,0,1,Terrorists kill an old man with a bomb hidden in a cart.
14528,21/11/2010,Afghanistan,Kandahar,1,0,1,Religious extremists drag a laborer out of his home and murder him in front of his children.
14529,22/11/2010,Pakistan,Sargodha,0,1,1,A protestant pastor is beaten and set on fire by six Muslims who caught him evangelizing.
14530,22/11/2010,Iraq,Ramadi,1,2,3,A government official is assassinated by Islamic gunmen.
14531,22/11/2010,Iraq,Amin,1,3,4,One Sunni is killed in a sectarian attack.
14532,22/11/2010,Iraq,Mosul,1,0,1,An elderly Christian woman is strangled in her home by Religion of Peace activists.
14533,22/11/2010,Iraq,Mosul,2,0,2,Two Christian brothers are shot to death in their shop by Muslim extremists.
14534,22/11/2010,Afghanistan,Paktia,4,2,6,Four civilians are blown to bits by a Taliban bomb.
14535,23/11/2010,Iraq,Suwayra,2,0,2,Jihadi bombers send a married couple to Allah.
14536,23/11/2010,Iraq,Baghdad,1,0,1,A doctor is shot to death by 'insurgents'.
14537,23/11/2010,Iraq,Baghdad,5,4,9,Several government officials are gunned down in separate terror attacks.
14538,24/11/2010,Egypt,Giza,1,68,69,"Police shouting 'Allah Akbar' block a church construction and then fire on a group of Coptic demonstrators, killing one."
14539,24/11/2010,India,Moradabad,1,0,1,An 18-year-old Muslim girl is strangled by her father for falling in love with a Hindu boy.
14540,24/11/2010,Afghanistan,Faryab,5,4,9,The Taliban murder five tribal elders with a rocket-propelled grenade.
14541,24/11/2010,Iraq,Shurquat,4,19,23,A suspected al-Qaeda attack leaves four people dead.
14542,24/11/2010,Iraq,Mosul,4,6,10,Jihadis bombers take down four Iraqis.
14543,24/11/2010,Yemen,al-Jawf,17,15,32,"A Sunni suicide bomber plows his car into a religious procession, taking out seventeen Shias."
14544,24/11/2010,Afghanistan,Herat,1,4,5,"The Taliban detonate a bomb under a family vehicle, killing once occupant."
14545,24/11/2010,Thailand,Narathiwat,3,0,3,A 60-year-old is among three Muslims ambushed and killed for being 'traitors to Islam'.
14546,25/11/2010,Kenya,Bardher,1,0,1,A 17-year-old girl is tortured and murdered by her parents for leaving Islam for Christianity.
14547,25/11/2010,Nigeria,Kwata Zawan,3,1,4,Muslim radicals shoot three Christian villagers to death.
14548,25/11/2010,Egypt,Giza,1,0,1,A 4-year-old boy suffocates when tear gas is thrown into a church chapel.
14549,25/11/2010,Pakistan,Khyber,2,6,8,"Terrorists blow up a bridge, killing two passersby."
14550,25/11/2010,Iraq,Tal Afar,3,12,15,Islamic radicals use an IED to kill a 4-year-old child and two others.
14551,25/11/2010,Iraq,Tuz Khormato,4,2,6,Children are among the casualties from a terror blast.
14552,25/11/2010,Iraq,Kirkuk,3,0,3,A woman is among three Iraqis ambushed and killed by Mujahideen.
14553,25/11/2010,Iraq,Baaj,1,0,1,A tailor dies from shrapnel wounds after Jihadis throw a grenade into his home.
14554,26/11/2010,Dagestan,Kizlyarsky,1,0,1,Muslim terrorists shoot a police officer in the chest.
14555,26/11/2010,Yemen,Saada,40,9,49,"Sunnis bomb a Shia funeral procession, leaving at least forty people dead."
14556,27/11/2010,Pakistan,Watta Khel,1,0,1,A 17-year-old girl is shot to death by her father and brother for dishonoring the family.
14557,27/11/2010,Philippines,Marantao,1,0,1,Moro Islamists murder a World Food Program driver delivering rice to the needy.
14558,27/11/2010,Pakistan,Darra Adam Khel,3,0,3,A woman is among three civilians murdered when Islamists ambush a passenger vehicle.
14559,27/11/2010,Iraq,Mosul,2,0,2,A man and his young son are blown to bits by Jihadi bombers.
14560,27/11/2010,Pakistan,Darra Adam Khel,1,0,1,Tehreek-e-Taliban abduct and murder a local man.
14561,27/11/2010,Afghanistan,Paktika,12,16,28,Shahid suicide bombers take down a dozen local police.
14562,27/11/2010,Somalia,Mogadishu,10,20,30,At least ten people bleed out following an al-Shabaab mortar attack.
14563,28/11/2010,Afghanistan,Takhar,1,1,2,Holy Warriors take out a market patron with a bicycle bomb.
14564,28/11/2010,Pakistan,Bakht,1,2,3,A woman is killed and a young boy injured when fundamentalists shell a residential neighborhood.
14565,28/11/2010,Iraq,Meshahda,2,2,4,al-Qaeda cadres storm a home and shoot two people to death.
14566,28/11/2010,Afghanistan,Logar,3,0,3,Three people lose their lives when Sunni hardliners fire on a vehicle.
14567,29/11/2010,Afghanistan,Nangarhar,6,0,6,Six US soldiers training local police are murdered by a terrorist in uniform.
14568,29/11/2010,Pakistan,Karachi,1,0,1,A Shia leader is dragged out of his car and shot to death by militant Sunnis.
14569,29/11/2010,Pakistan,Peshawar,1,1,2,"The Taliban attack a local phone exchange, killing a guard."
14570,29/11/2010,India,Srinagar,1,1,2,Mujahideen kill a policeman and injure a civilian with a grenade thrown into a market.
14571,29/11/2010,Iraq,Baghdad,13,29,42,Thirteen Iraqis are murdered by Islamic terrorists in various attacks around the country.
14572,30/11/2010,Somalia,Bosaso,1,0,1,A judge is assassinated by suspected Islamic militia.
14573,30/11/2010,Thailand,Pattani,1,0,1,Jihadists shoot a school janitor to death.
14574,30/11/2010,Iraq,Mosul,1,1,2,Islamists rush into a Christian shop and gun down the proprietor brothers.
14575,30/11/2010,Pakistan,Bannu,6,22,28,An 8-year-old girl and 3-year-old boy are among six people sent to Allah by a Shahid suicide bomber.
14576,1/12/2010,Iraq,Baghdad,1,0,1,A human rights activist is murdered by Mujahid gunmen.
14577,1/12/2010,Iraq,Qaim,2,2,4,Two Iraqis die from shrapnel injuries following an Islamist bombing.
14578,1/12/2010,India,Srinagar,2,0,2,Mujahideen shoot two local soldiers to death as they are guarding a market.
14579,2/12/2010,Iraq,Baghdad,1,0,1,A woman is shot to death in her home by Islamic 'insurgents'.
14580,2/12/2010,Pakistan,Sukai,1,0,1,A local truck driver is gunned down by Taliban radicals.
14581,2/12/2010,Iraq,Abu Ghraib,2,1,3,A Jihad blast at a water plant leaves two dead.
14582,3/12/2010,Dagestan,Makhachkala,1,0,1,Suspected fundamentalists gun down the head of the country's Judo program.
14583,3/12/2010,Philippines,Langayen,2,0,2,Two village guards are gunned down by Moro Islamists.
14584,3/12/2010,Thailand,Narathiwat,1,0,1,Muslim terrorists shoot a Buddhist to death in his home.
14585,3/12/2010,Thailand,Yala,1,0,1,A 41-year-old rubber plantation worker is gunned down by Islamic separatists while walking home.
14586,3/12/2010,Thailand,Pattani,2,1,3,Two men are murdered by Mujahid gunmen in separate attacks.
14587,3/12/2010,Thailand,Narathiwat,1,0,1,A 36-year-old man is shot to death in his home by Muslim militants.
14588,3/12/2010,Nigeria,Nwachukwu,7,4,11,Christian women and children are slaughtered in their homes by Muslim attackers in a midnight raid.
14589,3/12/2010,Kenya,Nairobi,1,2,3,"Somali terrorists throw a grenade at a Kenyan police vehicle, killing an occupant."
14590,3/12/2010,Iraq,Mosul,1,0,1,A sanitation worker is taken down by Muslim gunmen.
14591,4/12/2010,Iraq,Baghdad,2,28,30,Two Shia pilgrims are sent to Allah by Sunni car bombers.
14592,4/12/2010,Iraq,Baghdad,6,42,48,"Terrorists bomb a marketplace, leaving at least a half dozen shoppers dead."
14593,4/12/2010,Iraq,Baghdad,5,17,22,Five Shia pilgrims from Iran are brutally slain by Sunni bombers near a shrine.
14594,4/12/2010,Nigeria,Maiduguri,3,6,9,A child is among three civilians left dead by a Boko Haram ambush.
14595,5/12/2010,Dagestan,Khasavyurt,1,0,1,A suspected separatist shoots a government official to death in a cafe
14596,5/12/2010,Iraq,Baghdad,2,0,2,Four Holy Warriors bind and stab an elderly Christian couple to death in their home.
14597,5/12/2010,Afghanistan,Gardez,4,18,22,"A Shahid suicide bomber detonates near a small marketplace, taking four innocents with him."
14598,6/12/2010,Russia,Moscow,1,0,1,An armed Muslim immigrant targets and kills a young engineer by shooting him three times in the chest and once in the head.
14599,6/12/2010,Pakistan,Mohmand,45,65,110,Two Holy Warriors massacre over forty innocents with a dual suicide blast at a gathering of tribal leaders in the name of 'enforcing Sharia.'
14600,6/12/2010,Iraq,Baqubah,3,4,7,Three children bleed out when terrorists booby-trap a home.
14601,6/12/2010,Afghanistan,Badghis,3,1,4,The Taliban kill three Afghan troops in a rocket attack.
14602,7/12/2010,Iraq,Tal Afar,1,3,4,"Fundamentalists bomb a computer shop, killing an employee."
14603,7/12/2010,India,Varanasi,1,32,33,A 2-year-old girl is left dead following a Mujahideen blast at a Hindu temple.
14604,8/12/2010,Afghanistan,Kunar,2,2,4,Two civilians are murdered by Taliban attackers.
14605,8/12/2010,Pakistan,Hangu,1,1,2,Islamic militants abduct seven teachers and shoot a policeman to death.
14606,8/12/2010,Iraq,Taji,3,16,19,Jihadist take down three civilians with a car bomb.
14607,8/12/2010,Pakistan,Kohat,19,32,51,"A teen suicide bomber targets a crowd of Shia pilgrims at a bus stop, sending nearly two dozen to Allah, mostly women and children."
14608,8/12/2010,Iraq,Tarmiya,1,3,4,Muslim terrorists shoot a girl to death in her home.
14609,9/12/2010,Iraq,Baghdad,6,6,12,Six Iraqis are killed in separate Mujahideen attacks.
14610,9/12/2010,Somalia,Bosaso,2,0,2,Islamic militia detonate a roadside bomb underneath two Somalis.
14611,10/12/2010,Pakistan,Hangu,17,20,37,Seventeen people are ripped to shreds when a Sunni suicide car bomber plows into a Shia hospital.
14612,10/12/2010,Iraq,Meshahda,3,0,3,Three chicken farmers are gunned down in cold blood by Sunni radicals.
14613,10/12/2010,Iraq,Baghdad,2,7,9,Two civilians at a coffee shop are blown to bits by Jihad bombers.
14614,10/12/2010,Afghanistan,Khan Neshin,15,4,19,Fifteen civilians on their way to a local bazaar are dismembered by Taliban bombers.
14615,11/12/2010,Dagestan,Gubden,1,0,1,A mosque imam is murdered by Religion of Peace rivals.
14616,11/12/2010,Pakistan,Peshawar,2,0,2,Two police are gunned down by Islamic terrorists.
14617,11/12/2010,Sweden,Stockholm,0,2,2,A car bomb and suicide attack on a shopping center leaves two injured.
14618,11/12/2010,Thailand,Yala,1,3,4,Muslim terrorists murder a Thai soldier.
14619,11/12/2010,Pakistan,Peshawar,2,5,7,"Islamists open fire on a police squad, killing two members."
14620,12/12/2010,Thailand,Narathiwat,2,0,2,A 67-year-old woman and her son-in-law are shot to death by Muslim militants.
14621,12/12/2010,Iraq,Ramadi,13,41,54,A Shahid suicide bomber sends thirteen Iraqis straight to Allah.
14622,12/12/2010,Iraq,Baqubah,2,3,5,Two Shia pilgrims are taken down by a Fedayeen suicide bomber.
14623,12/12/2010,Afghanistan,Kandahar,8,4,12,Six U.S. and two local soldiers are killed by a suicide bomber at their base.
14624,12/12/2010,Pakistan,Kurram,3,7,10,Three children are killed when Sunni militants fire rockets into a Shia residential area.
14625,12/12/2010,England,Feltham,0,1,1,Muslim prisoners batter a guard while yelling 'death to the Kuffar'.
14626,13/12/2010,Iraq,Baghdad,2,0,2,Terrorists blow up a little girl and her mother.
14627,13/12/2010,Iraq,Hilla,2,1,3,"A married couple is murdered by Muslim gunmen, who also wound their son."
14628,13/12/2010,Somalia,Mogadishu,12,30,42,A dozen civilians are caught in the crossfire during an al-Shabaab ambush.
14629,13/12/2010,Iraq,Diyala,4,20,24,Four Shiite pilgrims are murdered by a Sunni suicide bomber.
14630,13/12/2010,Pakistan,Gulabad,3,5,8,Two children are among three killed when Islamists detonate a shrapnel bomb next to their school bus.
14631,13/12/2010,Pakistan,Charsadda,2,0,2,Two brothers are shot to death by Islamic militants while on their way home.
14632,14/12/2010,Bangladesh,Rajshahi,1,0,1,A woman dies from injuries suffered by a lashing ordered by Muslim clergy over an adultery charge.
14633,14/12/2010,Pakistan,Peshawar,3,1,4,Sunnis attack an 'unIslamic' shrine and shoot three Sufi infidels to death.
14634,14/12/2010,Afghanistan,Kabul,3,5,8,Three local soldiers are murdered in separate Taliban attacks.
14635,14/12/2010,Pakistan,Mohmand,2,6,8,Muslim radicals attack a police station and kill two officers.
14636,14/12/2010,Iraq,Baghdad,3,19,22,Sectarian rivals murder three more Shia pilgrims with a roadside bomb.
14637,14/12/2010,Iraq,Diyala,2,22,24,Two Shia pilgrims are blown to bits by Sunni bombers.
14638,15/12/2010,Pakistan,Quetta,3,0,3,Sectarian Jihadis gun down two brothers and a child.
14639,15/12/2010,Iran,Chahbahar,41,83,124,"Forty-one Shias, including women and children, are blasted to death in their own mosque by a Sunni suicide bomber."
14640,15/12/2010,Russia,Nalchik,1,0,1,A moderate cleric is shot in front of his home for 'resisting religious extremism.'
14641,15/12/2010,Afghanistan,Kandahar,3,9,12,"Three children are disassembled by fundamentalists, who hide a bomb on a bicycle."
14642,16/12/2010,Pakistan,Muharram,1,25,26,A child is left dead after Sunnis throw a grenade into a funeral procession.
14643,16/12/2010,Iraq,Dujail,2,6,8,Two Shia pilgrims are sent to Allah by Sunni bombers.
14644,16/12/2010,Iraq,Baghdad,6,6,12,Gunmen and bombers take down six Iraqis in separate attacks.
14645,16/12/2010,Somalia,Mogadishu,10,24,34,At least ten civilians are shot to pieces during a sustained al-Shabaab attack in a commercial area.
14646,17/12/2010,Pakistan,Hangu,6,8,14,"Six villagers, including women and children, are crushed to death by a terrorist mortar barrage."
14647,17/12/2010,Yemen,Abyan,3,7,10,"Suspected al-Qaeda militants open fire on a group of local soldiers, killing three."
14648,17/12/2010,Afghanistan,Herat,14,4,18,Fourteen members of the same family are taken apart by a Taliban roadside attack on their minibus.
14649,18/12/2010,Thailand,Yala,2,0,2,Two guards providing security to Buddhists are gunned down by Religion of Peace proponents.
14650,18/12/2010,Thailand,Yala,2,0,2,Islamists slash the throats of two people.
14651,18/12/2010,Russia,Kabardino- Balkaria,7,2,9,Seven hunters are shot to death by Islamic militants in a brutal ambush.
14652,18/12/2010,Afghanistan,Kandahar,2,11,13,A Shahid suicide bomber sends two civilians to Allah.
14653,18/12/2010,Afghanistan,Balkh,1,3,4,Taliban-linked militants murder a Bangladeshi engineer and take three others hostage.
14654,19/12/2010,Iraq,Kirkuk,2,0,2,An oil company employee is among two people gunned down by Mujahideen.
14655,19/12/2010,Israel,Jerusalem,1,1,2,"An American woman on a Christian mission is kidnapped, tied up and stabbed to death by Arab warriors."
14656,19/12/2010,Afghanistan,Kabul,13,17,30,"Thirteen security personnel are killed in two attacks, one by Fedayeen suicide bombers."
14657,20/12/2010,Somalia,Mogadishu,5,10,15,Five civilians are killed when Islamic militia mortar a commercial district.
14658,20/12/2010,Pakistan,Dera Bugti,2,0,2,A father and son are shot to death in their hotel in a suspected sectarian attack.
14659,20/12/2010,Iraq,Mosul,2,0,2,A university professor and a young woman are gunned down by 'Freedom Fighters'.
14660,20/12/2010,Somalia,Mogadishu,5,5,10,An old woman is among five who bleed out following a vicious al-Shabaab roadside bombing.
14661,20/12/2010,Kenya,Nairobi,3,23,26,"Suspected Somali Islamists plant a bomb on a bus, which leaves three passengers dead."
14662,21/12/2010,Pakistan,Kalat,1,0,1,An 82-year-old Hindu teacher is kidnapped and presumed murdered by Muslim fundamentalists.
14663,21/12/2010,Thailand,Pattani,2,0,2,A married couple selling pork are shot to death in their stall by Holy Warriors.
14664,21/12/2010,Thailand,Pattani,1,0,1,A 43-year-old construction worker is murdered by Muslim gunmen.
14665,21/12/2010,Nigeria,Turu,3,2,5,"Angry Muslims armed with swords and machetes assault a group of local Christian villagers, killing three."
14666,22/12/2010,Pakistan,Mohmand,1,3,4,A civilian is killed in a bomb blast.
14667,23/12/2010,Pakistan,Baidnami,3,0,3,Tehreek-e-Taliban militants ambush and kill three policemen.
14668,23/12/2010,Iraq,Baghdad,1,0,1,A Sunni civilian is murdered in a sectarian shooting attack.
14669,23/12/2010,Thailand,Narathiwat,2,2,4,Two off-duty security personnel riding a motorcycle are shot to death by Muslim militants.
14670,23/12/2010,Russia,Shalushki,2,5,7,Islamic militants gun down two village policemen.
14671,23/12/2010,Afghanistan,Kunduz,1,5,6,Children are among the casualties of a Shahid suicide blast.
14672,23/12/2010,Afghanistan,Jalalabad,1,10,11,Taliban bombers take out a civilian with a motorcycle bomb.
14673,24/12/2010,Pakistan,Shahdra,0,1,1,"A 12-year-old Christian girl is kidnapped, raped for eight months and forcibly converted to Islam."
14674,24/12/2010,Pakistan,Khyber,1,0,1,A guard is killed when Islamic militants attack a press club building.
14675,24/12/2010,Iraq,Haswa,5,4,9,Three children are among five family members slain by a sectarian bomb attack on their home.
14676,24/12/2010,Iraq,Samarrah,2,0,2,Two Iraqis are killed by Jihadi bombers.
14677,24/12/2010,Pakistan,Mohmand,11,10,21,"Religious hardliners launch a surprise assault on a local army post, leaving eleven defenders dead."
14678,24/12/2010,Afghanistan,Balkh,1,3,4,The Taliban murder a German aid worker trying to help the locals build roads.
14679,24/12/2010,Thailand,Narathiwat,1,1,2,Muslim separatists walk into a tea shop and machine-gun two patrons.
14680,24/12/2010,Yemen,Zinjibar,1,0,1,al-Qaeda gunmen shoot a local soldier to death.
14681,24/12/2010,Nigeria,Jos,86,74,160,"At least eighty-six people are killed in a series of Islamic bomb blasts and attacks, mostly targeting Christmas Eve church services.  The dead include choir members hacked to death."
14682,25/12/2010,Pakistan,Bajaur,47,81,128,Nearly fifty people lining up for emergency food are blown into pieces by a female suicide bomber.  Children are among the dead.
14683,25/12/2010,Philippines,Sulu,0,11,11,A priest and a 9-year-old girl are among eleven injured when Islamists set off a bomb inside a chapel.
14684,26/12/2010,Pakistan,Mastung,1,0,1,A truck driver's life is snuffed out by Islamist snipers.
14685,27/12/2010,Pakistan,Karachi,5,3,8,A young girl is among three people shot to death in separate sectarian attacks.
14686,27/12/2010,Iraq,Dujail,1,1,2,Jihadi bombers take down a Catholic woman and injure a family member.
14687,27/12/2010,Iraq,Ramadi,17,40,57,"Twin suicide bombers take down seventeen Iraqis, including women and children waiting in line."
14688,27/12/2010,Afghanistan,Kandahar,3,26,29,A Taliban car bombing outside a bank leaves three people dead.
14689,28/12/2010,Somalia,Bakara,8,32,40,Eight civilians are crushed to death by an Islamist rocket attack on their market.
14690,28/12/2010,Nigeria,Maiduguri,3,0,3,Boko Haram Islamists kill three people at a hospital.
14691,28/12/2010,Afghanistan,Paktika,1,7,8,An Afghan security official is taken down by a Shahid suicide bomber.
14692,28/12/2010,Pakistan,Sohbatpur,3,0,3,Three member of a family are murdered in a suspected sectarian attack.
14693,28/12/2010,Pakistan,Karachi,1,0,1,Tehreek-e-Taliban militants shoot a tea vender to death in his stall.
14694,28/12/2010,Iraq,Mosul,5,3,8,Five Iraqis are blown to bits in a car bomb blast.
14695,28/12/2010,Iraq,Tarmiah,5,0,5,Terrorists abduct and execute five men.
14696,28/12/2010,Thailand,Pattani,2,0,2,A Buddhist man and his wife are machine-gunned by Islamic terrorists in front of their home.
14697,28/12/2010,Thailand,Pattani,1,0,1,Muslims shoot a Buddhist civilian to death as he is riding his motorcycle.
14698,28/12/2010,Thailand,Narathiwat,2,0,2,A man and his elderly father are murdered by Islamic gunmen.
14699,29/12/2010,Pakistan,Khyber,1,2,3,A truck driver is taken down by a Muslim ambush.
14700,29/12/2010,Iraq,Mosul,4,4,8,A police chief and three others are cut down by three al-Qaeda suicide bombers.
14701,29/12/2010,Philippines,Mindanao,1,1,2,"Muslim separatists toss a grenade into an army outpost, killing one."
14702,30/12/2010,Iraq,Kirkuk,1,0,1,Sunni terrorists gun down a man in his garden.
14703,30/12/2010,Pakistan,Sindh,3,0,3,Three intelligence personnel are killed in a suspected Taliban ambush.
14704,30/12/2010,Iraq,Baghdad,2,13,15,Coordinated Mujahideen attacks against Christian families leave at least two dead.
14705,30/12/2010,Afghanistan,Helmand,14,4,18,"The Taliban bomb a minibus packed with civilians, taking down at least fourteen."
14706,30/12/2010,Nigeria,Dala,4,8,12,Four people are murdered by Boko Haram Islamists.
14707,31/12/2010,Afghanistan,Zabul,1,6,7,A civilian bleeds out following a Taliban attack.
14708,31/12/2010,Nigeria,Abuja,4,12,16,"Proponents of Islamic law detonate a bomb at a packed market, killing at least four patrons."
14709,31/12/2010,Somalia,Mogadishu,4,10,14,Four civilians are caught in the crossfire during an al-Shabaab ambush along a city street.
14710,31/12/2010,Afghanistan,Gulistan,1,0,1,A religious fanatic with a sniper rifle kills an Italian soldier at his base.
14711,1/1/2011,Afghanistan,Helmand,1,0,1,Religious extremists at a mosque murder a British soldier.
14712,1/1/2011,Somalia,Mogadishu,19,25,44,Children are among at least nineteen civilians cut down by an al-Shabaab ambush along a city street.
14713,1/1/2011,India,Ramban,2,0,2,Lashkar-e-Toiba abduct and murder two border policemen.
14714,1/1/2011,Iraq,Baqubah,1,1,2,A woman dies from a bombing in her own home.
14715,1/1/2011,Iraq,Baghdad,2,0,2,Terrorists shoot two Iraqis to death in their car.
14716,1/1/2011,Egypt,Alexandra,23,77,100,Twenty-three parishioners are incinerated by a Shahid suicide bomb attack on a New Year's Day church mass.
14717,1/1/2011,Thailand,Narathiwat,2,8,10,Two cops are killed while trying to defuse an Islamic marketplace bomb.
14718,2/1/2011,Dagestan,Makhachkala,1,0,1,A folk healer is murdered by Islamists.
14719,2/1/2011,Iraq,Balad,1,9,10,One young man is killed by a bombing attack on the family home of a secular judge.
14720,2/1/2011,Iraq,Qayara,2,3,5,A car bomb attack leaves two people dead.
14721,2/1/2011,Iraq,Kirukuk,1,0,1,"A man is abducted, tortured and murdered by suspected al-Qaeda."
14722,2/1/2011,Philippines,Mamasapano,1,3,4,"Muslim rebels open fire on a family home, killing the father and injuring his wife and children."
14723,2/1/2011,Philippines,Maguindanao,2,3,5,A Christian farmer is gunned down while driving home.
14724,3/1/2011,Maldives,Male,0,1,1,Islamists stab a female activist in the back for opposing Sharia.
14725,3/1/2011,Afghanistan,Baghlan,4,2,6,"Hardliners attack a rival mosque, shooting four people to death."
14726,3/1/2011,Afghanistan,Herat,1,5,6,A civilian is taken down by Taliban bombers.
14727,3/1/2011,Iraq,Baghdad,1,0,1,A Christian woman who survived an Islamist church massacre a few weeks earlier is shot to death in her sleep.
14728,3/1/2011,Pakistan,Orakzai,1,0,1,The Taliban decapitate a hostage with a knife.
14729,3/1/2011,Iraq,Baqubah,3,26,29,A Fedayeen suicide car bomber takes out three Iraqis.
14730,3/1/2011,Iraq,Baghdad,4,2,6,Four people are shot to death by Islamic insurgents.
14731,4/1/2011,Kyrgyzstan,Bishkek,4,0,4,Four security personnel at a checkpoint are machine-gunned to death by religious extremists.
14732,4/1/2011,Dagestan,Makhachkala,1,0,1,A Muslim sniper takes down a local cop.
14733,4/1/2011,Afghanistan,Kabul,1,2,3,An Afghan is killed by a remote-controlled bomb hidden in a rice sack.
14734,4/1/2011,Iraq,Duluiya,2,0,2,Jihadis take down two teenagers with an IED.
14735,4/1/2011,Iraq,Balad,2,0,2,Two brothers are disassembled by a bomb.
14736,4/1/2011,Pakistan,Islamabad,1,0,1,A regional governor is assassinated at a cafe for appealing on behalf of a Christian woman jailed for blasphemy.
14737,5/1/2011,Pakistan,South Waziristan,3,0,3,Islamic militants incinerate three members of a family with a roadside bomb.
14738,5/1/2011,Iraq,Baghdad,1,2,3,A civilian is murdered by Jihadi bombers.
14739,6/1/2011,Somalia,Goobweyne,1,0,1,A 20-year-old mentally ill man is executed by al-Shabaab gunmen.
14740,7/1/2011,Somalia,Warbhigly,1,0,1,Islamic militants slit the throat of a Christian mother of four.
14741,7/1/2011,Iraq,Nasariya,2,3,5,Car bombers take down two members of a Shia family.
14742,7/1/2011,Yemen,Abyan,4,2,6,An al-Qaeda ambush leaves four people dead.
14743,7/1/2011,Afghanistan,Spin Boldak,17,23,40,A suicide bomber at a bath house sends seventeen souls to Allah.
14744,7/1/2011,Iraq,Hussainya,5,1,6,Three children are among five members of a family brutally murdered in a pre-dawn home invasion.
14745,7/1/2011,Yemen,Lawder,13,0,13,At least a dozen local soldiers riding in a water supply convoy are machine-gunned to death by al-Qaeda.
14746,7/1/2011,Thailand,Narathiwat,1,0,1,A villager is shot to death by Islamic 'separatists'.
14747,7/1/2011,Somalia,Hosingo,1,0,1,A goat herder is shot in the head by al-Shabaab for refusing to pay zakat.
14748,7/1/2011,Bangladesh,Chittagong,0,20,20,"Wahabbis and Sunnis clash over control over a mosque, beating rivals and setting fires."
14749,8/1/2011,Iraq,Diala,2,0,2,Two children are torn into pieces when Muslim terrorists detonate a bomb in a chicken coop.
14750,8/1/2011,Thailand,Yala,1,1,2,Islamic militants gun down a policeman in a drive-by.
14751,8/1/2011,Afghanistan,Helmand,3,1,4,A shop owner and two farmers are among three civilians murdered by Taliban bombers.
14752,8/1/2011,Yemen,Lahj,3,9,12,Islamists attack a local security post and kill three defenders.
14753,9/1/2011,Chechnya,Grozny,2,6,8,An electrician is among two people machine-gunned to death in their car by Mujahideen.
14754,9/1/2011,Sudan,Abyei,20,30,50,Twenty locals are killed in an ambush by Arab-Muslim militia.
14755,9/1/2011,Philippines,Basilan,5,1,6,Five traveling businessmen are flagged down and machine-gunned by Abu Sayyaf.
14756,9/1/2011,Niger,Niamey,2,0,2,A young French aid worker and his friend are kidnapped from a restaurant and murdered by al-Qaeda.
14757,9/1/2011,Nigeria,Borno,1,2,3,A guard at a church is shot to death in an Islamist drive-by.
14758,10/1/2011,Afghanistan,Kandahar,3,0,3,Three people are taken apart by a Fedayeen suicide bomber.
14759,10/1/2011,Thailand,Narathiwat,2,0,2,Two 'traitors to Islam' are shot to death on their way to work.
14760,10/1/2011,Somalia,Mogadishu,1,3,4,Woman and children are among the casualties when a Holy Warrior tosses a grenade into the street.
14761,11/1/2011,Dagestan,Makhachkala,1,0,1,A young traffic cop is murdered in an Islamist drive-by.
14762,11/1/2011,Russia,Kenzh,1,0,1,A folk healer is killed in his home by suspected Islamic fundamentalists.
14763,11/1/2011,Pakistan,Lahore,0,2,2,Two Christian women are violently beaten and humiliated by a Muslim mob over claims they had 'abused' Muhammad.
14764,11/1/2011,Dagestan,Makhachkala,1,0,1,A fortune teller is shot in the head by fundamentalists.
14765,11/1/2011,Thailand,Yala,2,0,2,Husband and wife plantation workers are murdered by Muslim terrorists.
14766,11/1/2011,Sudan,Abyei,10,18,28,"Ten Africans, on their way to vote for independence, are ambushed and slain by Arab tribesmen, including the mother of a 3-month-old baby - stabbed to death."
14767,11/1/2011,Pakistan,Hangu,2,0,2,A tribal elder and his driver are machine-gunned in their car by Mujahideen.
14768,11/1/2011,Nigeria,Kuru Station,19,3,22,"Children are among the victims when Muslims attack a Christian village, hacking nineteen to death and burning their homes."
14769,11/1/2011,Egypt,Samalout,1,5,6,A policeman boards a train and opens fire on a group of elderly Christians while yelling 'Allah Akbar.'  A 71-year-old victim dies on the scene.
14770,12/1/2011,Pakistan,Bannu,20,14,34,A Fedayeen suicide car bomber sends at least twenty souls to Allah.
14771,12/1/2011,Afghanistan,Kabul,2,32,34,Two civilians are taken down by a suicide bomber on a passenger bus.
14772,12/1/2011,Pakistan,Peshawar,2,7,9,Two women are blown to bits by Taliban roadside bombers.  Children are among the injured.
14773,12/1/2011,Afghanistan,Farah,2,0,2,Two civilians are murdered by Sunni bombers.
14774,13/1/2011,Afghanistan,Jalalabad,1,3,4,A child bleeds out following a bombing at a market by Islamic extremists.
14775,13/1/2011,Pakistan,Karachi,1,0,1,A Shia is shot to death in a targeted attack by a Sunni.
14776,13/1/2011,Pakistan,Peshawar,1,1,2,Terrorists murder a member of a peace committee outside a mosque.
14777,13/1/2011,Pakistan,Sardikhel,4,5,9,Hardliners take down five local police with a remote-controlled bomb.
14778,13/1/2011,Pakistan,Khyber,1,4,5,A policeman is machine-gunned to death by Islamic militants.
14779,13/1/2011,Iraq,Baghdad,2,9,11,Two people are killed in bombings near a mosque.
14780,13/1/2011,Afghanistan,Bannu,2,3,5,Fundamentalists use a bomb to kill two people.
14781,13/1/2011,Dagestan,Levashinsky,1,0,1,Muslim gunmen murder a man in his own home.
14782,13/1/2011,Dagestan,Makhachkala,1,1,2,A police officer is gunned down by Mujahideen.
14783,14/1/2011,Dagestan,Khasavyurt,4,5,9,"Islamists bomb a cafe, leaving four people dead."
14784,14/1/2011,Pakistan,Pakhtunkhwa,6,3,9,"Religion of Peace advocates slaughter a policewoman and her family in her home, including her children."
14785,14/1/2011,Afghanistan,Zabul,7,0,7,Taliban bombers successfully kill seven civilians riding in a car.
14786,15/1/2011,Afghanistan,Helmand,6,3,9,Six civilians are killed when religious extremists bomb their minivan.
14787,15/1/2011,Thailand,Pattani,1,0,1,A young Buddhist math teacher is shot three times in the head by Islamic terrorists.
14788,15/1/2011,Thailand,Narathiwat,1,0,1,A 51-year-old man is machine-gunned to death in front of a mosque.
14789,15/1/2011,Russia,Kabardino-Balkariya,1,0,1,An Islamic militant shoots a cattle-breeder to death for refusing to finance Jihad.
14790,15/1/2011,Chechnya,Grozny,1,2,3,A roadside bomb leaves one civilian dead.
14791,15/1/2011,Iraq,Mosul,0,1,1,A Christian doctor is brutally shot and seriously injured in a targeted hospital attack.
14792,16/1/2011,Chechnya,Grozny,1,5,6,"Jihadis fire into a checkpoint, killing a policeman."
14793,16/1/2011,Afghanistan,Baghlan,9,0,9,"Six women, two men and a child are blown to bits by Taliban bombers while traveling to a wedding."
14794,16/1/2011,Thailand,Narathiwat,1,1,2,A young man is shot in the head by Jihadis while drinking tea.
14795,16/1/2011,Afghanistan,Pakitya,1,2,3,A Taliban mine dismembers an Afghan civilian.
14796,17/1/2011,Iraq,Mosul,3,0,3,"Three religious minorities, a mother and two daughters, are found dead and suspected to have been murdered for their faith."
14797,17/1/2011,Iraq,Anbar,1,9,10,A Shahid suicide bomber kills at least one Iraqi.
14798,17/1/2011,Pakistan,Hangu,18,9,27,Eighteen people on a bus are ripped apart by fundamentalist bombers.
14799,17/1/2011,Somalia,Mogadishu,5,12,17,"Islamic militants fire a mortar into a residential area, killing five innocents."
14800,18/1/2011,Pakistan,Ghaziabad,2,0,2,A man hacks his wife and 17-year-old daughter to death three months apart with a meat cleaver on suspicion of 'illicit relations'.
14801,18/1/2011,Pakistan,Razmak,3,3,6,Three Pakistanis are killed by a Taliban rocket attack.
14802,18/1/2011,Thailand,Pattani,1,0,1,A 43-year-old Buddhist woman is shot in the head by militant Muslims.
14803,18/1/2011,Thailand,Narathiwat,1,0,1,"Four terrorists, pretending to be customers, shoot a shop owner three times in the chest."
14804,18/1/2011,Iraq,Tikrit,66,160,226,Sixty-six innocents are cut down by a religious radical with a ball-bearing packed suicide vest.
14805,18/1/2011,Pakistan,Hangu,4,0,4,Four men are brutally executed by Tehreek-e-Taliban radicals.
14806,18/1/2011,Afghanistan,Bala Murgab,1,1,2,An Italian soldier is shot in the head by a terrorist wearing a friendly uniform.
14807,19/1/2011,Iraq,Baqubah,15,64,79,Innovative Muslims use an explosives-packed ambulance to slaughter fifteen unsuspecting Iraqis.
14808,19/1/2011,Iraq,Ghalbiyah,2,16,18,Two Shiite pilgrims are sent to Allah by a Sunni suicide bomber.
14809,19/1/2011,Pakistan,Khyber,3,0,3,Three truck drivers are abducted and shot in the head at close range by Holy Warriors.
14810,19/1/2011,Philippines,Albarka,1,0,1,A local soldier dies from injuries suffered during an Abu Sayyaf ambush.
14811,19/1/2011,Afghanistan,Paktika,20,0,20,Thirteen children and six women are among twenty civilians taken out by Taliban roadside bombers.
14812,19/1/2011,Thailand,Narathiwat,4,6,10,Four local soldiers are killed during a surprise assault by Muslim terrorists while they are eating and playing soccer with the locals.
14813,19/1/2011,Pakistan,Peshawar,2,14,16,Children are among the casualties when fundamentalists bomb a school that teaches girls.
14814,20/1/2011,Afghanistan,Kandahar,1,0,1,Sunni fundamentalists calmly walk up to a 50-year-old man and shoot him in the back of the head.
14815,20/1/2011,Thailand,Narathiwat,2,0,2,Terrorists gun down a young married couple at an evening market.
14816,20/1/2011,Thailand,Yala,1,0,1,A 23-year-old man loses his life to an Islamic drive-by.
14817,20/1/2011,Iraq,Karbala,51,182,233,At least fifty Shiites are wiped out by four separate Sunni bombings at entry points to their holy city.
14818,20/1/2011,Iraq,Baqubah,3,30,33,"Mujahideen detonate a car bomb outside a police station, killing three Iraqis."
14819,20/1/2011,Iraq,Baghdad,1,10,11,A Shia pilgrim on foot is murdered by Sunni bombers.
14820,20/1/2011,Pakistan,Kurram,3,0,3,Three civilians are killed when their farm equipment rolls over a Taliban landmine.
14821,20/1/2011,Pakistan,Karachi,2,0,2,A Shia doctor is among two people killed in targeted sectarian attacks.
14822,20/1/2011,Afghanistan,Kandahar,3,4,7,A child is among three civilians taken down by a Taliban bomb.
14823,20/1/2011,Pakistan,Kohat,6,2,8,Six oil workers are shot to death by Mujahideen.
14824,21/1/2011,Pakistan,Kurram,2,0,2,Islamic militants shoot two villagers to death.
14825,22/1/2011,Thailand,Narathiwat,1,0,1,A man riding a motorcycle is murdered by Muslim gunmen.
14826,22/1/2011,Afghanistan,Ghazni,2,6,8,Two children are crushed to death when Wahhabi militants fire a rocket into their home.
14827,22/1/2011,Afghanistan,Helmand,1,9,10,A local cop is taken down by a roadside bomb.
14828,22/1/2011,Pakistan,Orakzai,3,6,9,Three locals are cut down by a Taliban bomb.
14829,23/1/2011,Iraq,Baghdad,10,30,40,Pilgrims are among ten people killed by a series of Sunni suicide bombings.
14830,23/1/2011,Pakistan,Bahawalpur,1,0,1,A 17-year-old girl is electrocuted by her family for falling in love with the wrong man.
14831,23/1/2011,Pakistan,Hangu,3,4,7,Religious militants ride up to a vehicle and machine-gun three civilians to death.
14832,23/1/2011,Iraq,Taji,2,0,2,Islamic terrorists murder a farmer and son on their way to sell their harvest.
14833,23/1/2011,Iraq,Tarmiyah,2,0,2,Two young boys are killed by a Jihad bomb planted outside a school.
14834,23/1/2011,Nigeria,Maiduguri,1,0,1,A guard outside a church is murdered by Islamic gunmen.
14835,23/1/2011,Nigeria,Jos,8,5,13,A woman and daughter are among six Christian villagers are hacked to death in the middle of the night during two separate Muslim raids.
14836,23/1/2011,Nigeria,Biu,1,2,3,Boko Haram radicals gun down a soldier at a checkpoint.
14837,24/1/2011,Nigeria,Maiduguri,1,0,1,A soldier on sick leave is gunned down by Islamists along a city street.
14838,24/1/2011,Iraq,Karbala,14,164,178,Fourteen Shia pilgrims on foot are shredded by another Sunni car bomb following an earlier blast.
14839,24/1/2011,Iraq,Karbala,12,32,44,Sunnis send a dozen Shia pilgrims to Allah with a car bomb.
14840,24/1/2011,Pakistan,Landikotal,1,2,3,"A suspected Taliban mortar shell lands on a house, killing a young boy."
14841,24/1/2011,Thailand,Pattani,1,1,2,A 48-year-old pickup truck driver is shot several times in the head by Islamic 'separatists' .
14842,24/1/2011,Russia,Moscow,37,150,187,Three dozen innocent people at an airport are cut to shreds by shrapnel from two suicide bombers.
14843,25/1/2011,Afghanistan,Mullah Quli,2,0,2,Video surfaces of a brutal stoning the previous August of two young lovers.
14844,25/1/2011,Philippines,Minila,4,14,18,"Abu Sayyaf militants plant a bomb on a packed bus, killing at least four passengers."
14845,25/1/2011,Thailand,Yala,9,2,11,Nine Buddhists returning from a hunting trip are blown to smithereens by Muslim bombers.
14846,25/1/2011,Pakistan,Lahore,10,70,80,A 16-year-old Sunni suicide bomber from the terror group Fedayeen Islam sends ten Shia pilgrims to Allah.
14847,25/1/2011,Pakistan,Karachi,4,5,9,A motorcycle bomb leaves four people dead.
14848,26/1/2011,Yemen,Hadramout,5,3,8,A vicious al-Qaeda ambush on a post office vehicle leaves five people dead.
14849,26/1/2011,Nigeria,Maiduguri,1,1,2,"Boko Haram extremists fire on a school, killing a guard."
14850,27/1/2011,Thailand,Yala,1,0,1,A Buddhist mother is shot to death in front of her child by Islamic militants.
14851,27/1/2011,Thailand,Pattani,2,0,2,Two men bleed out following an 'insurgent' drive-by.
14852,27/1/2011,Nigeria,Barkin Ladi,14,8,22,Muslim raiders invade four Christian villages and hack fourteen people to death in their own homes.
14853,27/1/2011,Nigeria,Were,2,11,13,Islamic radicals kill two people and burn down several Christian homes.
14854,27/1/2011,Dagestan,Khasavyurt,4,6,10,Four people sitting at a cafe bleed out following an Islamist car bomb blast.
14855,27/1/2011,Iraq,Baghdad,2,7,9,"In the aptly named Jihad neighborhood, a bomb left on a bus kills two passengers."
14856,27/1/2011,Somalia,Lafole,0,10,10,"Ten people are severely thrashed by Islamists for 'anti-Islam' crimes, including watching porn."
14857,27/1/2011,Iraq,Baghdad,48,121,169,Dedicated Sunni suicide bombers take down fifty Shiite mourners at a funeral.
14858,28/1/2011,Thailand,Yala,1,0,1,Muslim 'insurgents' gun down a 35-year-old man in front of his home.
14859,28/1/2011,Afghanistan,Kabul,8,15,23,Four children and their family member are slaughtered at a supermarket by a Shahid suicide bomber.
14860,28/1/2011,Nigeria,Jos,3,0,3,Two university students belonging to a local church are stabbed to death.
14861,28/1/2011,Nigeria,Borno,7,0,7,Boko Haram Islamists take credit for shooting seven people to death outside a mosque.
14862,29/1/2011,Nigeria,Jos,1,0,1,A Muslim soldier deliberately shoots a 6-year-old Christian boy to death before he is taken down by other soldiers.
14863,29/1/2011,Somalia,Mogadishu,5,16,21,al-Shabaab takes responsibility for an attack that leaves five civilians dead.
14864,29/1/2011,Pakistan,Pakhtunkhwa,2,6,8,Two civilians are taken out by Islamic hardliners in an ambush.
14865,29/1/2011,Yemen,Marib,1,4,5,One member of a security patrol is killed by an al-Qaeda sniper.
14866,29/1/2011,Pakistan,Peshawar,4,19,23,Two women are among four civilians incinerated by twin truck bombs targeting a road tunnel.
14867,29/1/2011,Afghanistan,Kandahar,1,3,4,A deputy governor is assassinated by a Fedayeen suicide bomber.
14868,29/1/2011,Thailand,Pattani,0,4,4,A Buddhist monk and three others are injured by a Mujahideen bomb blast while collecting alms.
14869,30/1/2011,Nigeria,Ayaruje,3,0,3,Three Christian villagers are hacked to death by Muslims with machetes.
14870,30/1/2011,Israel,Beersheba,0,1,1,An 18-year-old girl is shot by her brother over Facebook pictures that he felt 'dishonored' the family.
14871,30/1/2011,Egypt,Sharona,11,4,15,Very young children are among eleven members of two Coptic families shot to death in their homes at point-blank range by Islamic radicals.
14872,30/1/2011,Pakistan,Jhanda Masood,2,0,2,Two children are killed by a suspected Tehreek-e-Taliban landmine.
14873,30/1/2011,Nigeria,Maiduguri,1,0,1,A checkpoint guard is shot to death by Islamic snipers.
14874,31/1/2011,Iraq,Baghdad,1,0,1,An engineer is shot to death by Mujahideen.
14875,31/1/2011,India,Sopore,2,0,2,"Two teenage daughters of a poor laborer are pulled out of their home and brutally executed by Lashkar-e-Toiba, reportedly for reading the Bible."
14876,31/1/2011,Ingushetia,Nazran,1,0,1,Islamic snipers shoot an administration official to death in his car near a market.
14877,31/1/2011,Pakistan,Peshawar,5,19,24,Five people are torn to shreds by a suicide bomber on foot.
14878,31/1/2011,Pakistan,Hayat Abad,1,3,4,Terrorists use a remote-controlled bomb to murder a traffic cop.
14879,31/1/2011,Bangladesh,Shariatpur,1,0,1,"A 14-year-old girl is lashed to death on the orders of a Sharia council.  Her ""crime"" was having been raped by a 40-year-old married man."
14880,1/2/2011,Somalia,Mogadishu,1,0,1,"A convert to Christianity suffers deep injuries after being bound and assaulted with metal objects and rocks, then stomped."
14881,1/2/2011,Somalia,Banadir,2,0,2,"Mujahideen set off a bomb near a hospital, killing two civilians."
14882,1/2/2011,Somalia,Mogadishu,3,7,10,Three Somalis are killed by Islamic militia in a roadside attack.
14883,1/2/2011,Pakistan,Kharan,2,0,2,"Militants fire on an oil tanker, killing a driver and helper."
14884,1/2/2011,Somalia,Mogadishu,1,5,6,al-Shabaab bombers take out a local cop.
14885,1/2/2011,Thailand,Yala,4,0,4,"Two Buddhist children, ages 7 and 15, are kidnapped and shot to death by Religion of Peace 'separatists'."
14886,1/2/2011,Nigeria,Maiduguri,1,1,2,Islamic gunmen murder a police officer and critically injure his young daughter.
14887,2/2/2011,Somalia,Mogadishu,3,0,3,Three civilians are murdered by Muslim roadside bombers.
14888,2/2/2011,Pakistan,Peshawar,10,26,36,Women and children are among a dozen innocents slain when Sunnis set off a bomb at a crowded market.
14889,2/2/2011,Russia,Chegem,5,0,5,Islamic radicals burst into a cafe and gun down five traffic cops in cold blood.
14890,2/2/2011,Pakistan,Vehari,1,0,1,A 14-year-old girl is slowly shocked to death by her family for refusing to marry a cousin.
14891,2/2/2011,Pakistan,Anargi,3,4,7,Three local security forces are killed in a Tehreek-e-Taliban attack on their post.
14892,2/2/2011,Iraq,Baghdad,6,18,24,Six Iraqis are killed in a series of Jihad attacks.
14893,3/2/2011,Afghanistan,Kunduz,3,0,3,A man and his two young sons are ripped to shreds by Taliban bombers.
14894,3/2/2011,Pakistan,Lahore,3,27,30,"Islamic militants bomb a rival shrine during food distribution, killing three."
14895,3/2/2011,Iraq,Baghdad,6,24,30,Three Mujahid bombings take down six Iraqis.
14896,3/2/2011,Thailand,Pattani,1,0,1,Muslim radicals slit the throat of a 49-year-old plantation worker.
14897,3/2/2011,Iraq,Ramadi,6,19,25,A Shahid suicide bomber murders six Iraqis.
14898,3/2/2011,Thailand,Pattani,5,2,7,"Muslim militants spray a group of elderly Buddhists at a market with machine-gun fire, killing five."
14899,3/2/2011,Mauritania,Bezoul,1,0,1,A local cop is gunned down by al-Qaeda militants.
14900,4/2/2011,Egypt,Sinai,4,0,4,Four local cops are kidnapped an murdered by Al Tawhid Wal Jihad members.
14901,4/2/2011,Afghanistan,Kandahar,1,0,1,The Taliban gun down a bank guard.
14902,4/2/2011,Thailand,Pattani,1,2,3,"Militant Muslims fire into a Buddhist village, killing one."
14903,4/2/2011,Iraq,Tuz Khormato,3,0,3,Two teenage boys are among three Iraqis blown to bits in a targeted bombing.
14904,4/2/2011,Pakistan,Karachi,1,0,1,A Shia leader dies from wounds suffered in a sectarian attack the night before.
14905,4/2/2011,Somalia,Mudug,1,0,1,A young boy is shot in the back by al-Shabaab for trying to flee forced prayer.
14906,4/2/2011,Thailand,Yala,2,0,2,Two security personnel are murdered by Muslim bombers.
14907,4/2/2011,Afghanistan,Kandahar,1,3,4,Women and children are among the casualties when Jihadi bombers target a market.
14908,5/2/2011,DRC,Kivu,12,0,12,"ADF-NALU terrorists kidnap, torture and murder a dozen villagers."
14909,5/2/2011,Pakistan,Karak,4,0,4,Four civilians are abducted and shot to death.  Notes pinned to their bodies accuse them of being Jewish spies.
14910,5/2/2011,Pakistan,Khyber,3,2,5,Three civilians are ripped to pieces by a car bomb.
14911,5/2/2011,Iraq,Balad,2,3,5,"Sunni bombers target a Shia shrine, killing two pilgrims."
14912,5/2/2011,Philippines,M'lang,2,0,2,Two farmers are shot to death in their field by Moro Islamists.
14913,6/2/2011,Pakistan,Quetta,1,0,1,Muslim radicals are suspected in the shooting death of a Hindu man.
14914,6/2/2011,Pakistan,Nut Kallan,1,0,1,A young Christian is tortured to death by several Muslims.
14915,6/2/2011,Indonesia,Banten,3,6,9,Three members of the Ahmadiyah minority sect are dragged out of their homes and beaten to death by a Sunni mob chanting 'Allah Akbar'.
14916,6/2/2011,Philippines,Kabacan,6,6,12,A 4-year-old boy is among six civilians killed in the crossfire when rival Religion of Peace groups shoot at each other.
14917,7/2/2011,Pakistan,Hangu,2,6,8,"Hardliners fire rockets into a police vehicle, killing two officers."
14918,7/2/2011,Iraq,Iskandariya,2,0,2,A woman is among two Iraqis murdered by Mujahideen bombers.
14919,7/2/2011,Afghanistan,Bak,1,0,1,A local official is assassinated by Sunni fundamentalists.
14920,7/2/2011,Afghanistan,Kandahar,1,5,6,An customs official is taken out by a Fedayeen suicide bomber.
14921,8/2/2011,India,Thakurdwara,1,0,1,A 19-year-old girl is stabbed to death by her brother on suspicion of having sex.
14922,8/2/2011,Thailand,Yala,1,1,2,A 58-year-old Buddhist man and his wife are shot in their pickup truck by Muslim 'insurgents'.
14923,8/2/2011,Afghanistan,Balkh,1,3,4,Islamists attack a bomb to a police vehicle which results in the death of an occupant.
14924,8/2/2011,Philippines,Manila,1,0,1,A cop is hacked to death by a suspected Muslim separatist at a street market.
14925,8/2/2011,Indonesia,Temanggung,0,7,7,A Muslim mob viciously beats a priest trying unsuccessfully to keep them from burning three churches and an orphanage.
14926,8/2/2011,Somalia,Galka'y,1,0,1,A judge is assassinated by al-Shabaab gunmen.
14927,9/2/2011,Pakistan,Pakhtunkhwa,4,6,10,Four security personnel are taken down in two remote-controlled bombings.
14928,9/2/2011,Iraq,Baghdad,2,0,2,A man and his son are forced out of their home by Muslim terrorists and machine-gunned to death.
14929,9/2/2011,Iraq,Kirkuk,11,104,115,Three car bombs leave at least eleven Iraqis dead.
14930,9/2/2011,Pakistan,Charsadda,1,3,4,A civilian at a cattle market is killed by a remote-controlled bomb.
14931,9/2/2011,Dagestan,Makhachkala,2,0,2,Two policemen are gunned down in cold blood by suspected Islamic 'rebels'.
14932,10/2/2011,Nigeria,Alice,2,3,5,A father is among two Christians shot to death by militant Muslims in their homes.
14933,10/2/2011,Thailand,Yala,1,0,1,A 32-year-old is shot to death by Muslim 'separatists'.
14934,10/2/2011,Nigeria,Kuru,5,9,14,A 4-year-old is one of five Christian villagers hacked and shot to death by Islamic raiders.
14935,10/2/2011,Thailand,Pattani,3,0,3,Two women are among three Buddhist civilians viciously murdered and then burned by Muslim extremists.
14936,10/2/2011,Pakistan,North Waziristan,3,0,3,"Sunni hardliners kidnap and execute three people, then throw the bodies into a sack."
14937,10/2/2011,Afghanistan,Kunduz,7,5,12,Seven people lose their lives to a Shahid suicide bomber.
14938,10/2/2011,Pakistan,Mardan,31,50,81,A teenage suicide bomber dressed as a schoolboy 'gives his life to Islam' - and takes thirty-one others with him.
14939,10/2/2011,Iraq,Dujail,9,39,48,"Nine Shia pilgrims on foot, mostly women and children, are brutally blown to bits by Sunni car bombers"
14940,11/2/2011,Pakistan,Mardan,5,0,5,Five civilians are brutally executed in captivity by Taliban militants.
14941,11/2/2011,Thailand,Narathiwat,1,0,1,"Muslim gunmen take down two men in separate attacks, one at a market and the other in front of a mosque."
14942,11/2/2011,Thailand,Pattani,1,0,1,A young mother is shot in the head by Islamists while carrying her 2-year-old daughter.
14943,12/2/2011,Iraq,Samarrah,36,64,100,Three dozen Shia pilgrims on a bus are massacred by Sunni suicide bomber.
14944,12/2/2011,Afghanistan,Kandahar,21,45,66,"Fedayeen gunmen with explosives vests attack a police station, killing at least twenty-one, including civilians."
14945,13/2/2011,Iran,Tehran,1,0,1,A pro-democracy protester is shot to death by the government.
14946,13/2/2011,Thailand,Yala,0,18,18,Eighteen people are injured when Islamic radicals detonate a car bomb outside a bank.
14947,13/2/2011,Somalia,Mogadishu,3,10,13,Three civilians die from shrapnel injuries suffered when Islamists throw a grenade into the street.
14948,14/2/2011,Russia,Gubden,3,26,29,A female suicide bomber murders three people.
14949,14/2/2011,Pakistan,Pakhtunkhwa,4,0,4,Four civilians are abducted and executed by Mujahideen Khurasaan terrorists.
14950,14/2/2011,Afghanistan,Kabul,2,2,4,Two guards at a shopping mall sacrifice themselves stopping a Shahid suicide bomber from entering.
14951,15/2/2011,Nigeria,Maiduguri,2,0,2,Two people are killed when Boko Haram gunmen attack two churches.
14952,15/2/2011,Pakistan,North Waziristan,2,0,2,Sunni hardliners kidnap and publicly execute two civilians.
14953,15/2/2011,Iraq,Baghdad,4,6,10,A woman is among four civilians taken down by a pair of Jihad bomb blasts.
14954,15/2/2011,Iraq,Kut,1,0,1,A Mujahideen sniper kills an Iraqi interpreter.
14955,16/2/2011,Iraq,Khalidiya,2,0,2,Two brothers are murdered in their home by Islamic gunmen.
14956,16/2/2011,Yemen,Hadramout,1,3,4,A top intelligence official is shot to death in his car by al-Qaeda militants.
14957,17/2/2011,Thailand,Pattani,1,1,2,A local soldier is shot in the head and neck by Islamists while riding to work with his wife.
14958,17/2/2011,Iraq,al-Maqdadiyah,13,35,48,Thirteen souls at an auto trade fair are sent to Allah by suicide car bombers.
14959,17/2/2011,Pakistan,Bannu,1,0,1,"One person is killed in two bombings by Islamic militants, one of which was at a girls' school."
14960,17/2/2011,Iraq,Baghdad,3,10,13,Sectarian Jihadis stab three women to death in their home and detonate a bomb that injures ten Iranian pilgrims.
14961,17/2/2011,Iraq,Mosul,1,0,1,Terrorists shoot a journalist to death.
14962,17/2/2011,Iraq,Baghdad,1,0,1,A university professor is lynched in his home by 'insurgents'.
14963,17/2/2011,Afghanistan,Kunduz,2,0,2,The Taliban take down two Afghans with a well-placed bomb.
14964,18/2/2011,India,Bandipora,1,0,1,Islamists gun down a local political activist.
14965,18/2/2011,Afghanistan,Nangarhar,2,0,2,Two bomb disposal team members are murdered by Taliban roadside bombers.
14966,18/2/2011,Afghanistan,Khost,11,40,51,"Women and children are among the dead when a devout Sunni detonates in a commercial district, taking eleven others with him."
14967,18/2/2011,Afghanistan,Nangahar,3,0,3,Three Afghans are shredded by a Taliban roadside bomb.
14968,18/2/2011,Thailand,Narathiwat,1,1,2,A 19-year-old man is shot in the head and neck by Muslim 'separatists'.
14969,18/2/2011,Nigeria,Darazo,2,2,4,A civilian and bank guard are killed in separate attacks by suspected Boko Haram.
14970,18/2/2011,Afghanistan,Baghlan,3,7,10,Three German soldiers working on a vehicle are machine-gunned at close range by a terrorist in a friendly uniform.
14971,18/2/2011,Thailand,Pattani,1,0,1,Muslim gunmen take down a 44-year-old man.
14972,18/2/2011,Tunisia,Tunis,1,0,1,"After receiving death threats from Muslim extremists, a priest is kidnapped and eventually has his throat slit."
14973,19/2/2011,Russia,Zayukovo,4,1,5,Caucasus Emirate terrorists stop a van full of ski tourists and then machine-gun them to death.
14974,19/2/2011,Afghanistan,Jalalabad,42,71,113,Sunni hardliners send suicide bombers and gunmen into a bank to massacre over forty people.
14975,20/2/2011,Thailand,Narathiwat,0,17,17,Children are among the casualties when Muslim militants set off a car bomb a rake a restaurant with gunfire.
14976,20/2/2011,Iraq,Shirqat,2,6,8,"A suicide car bomber cruises into a rival mosque, killing at least two."
14977,20/2/2011,Pakistan,Mosakki,2,0,2,Two villagers are murdered by Islamic militants.
14978,20/2/2011,Iraq,Shirqat,2,6,8,"A suicide bomber detonates at a rival mosque, killing two worshippers."
14979,21/2/2011,Pakistan,Hajano,1,0,1,A 55-year-old woman is murdered in her sleep by her son for having an affair.
14980,21/2/2011,Afghanistan,Kunduz,31,40,71,A Fedayeen suicide bomber sends over thirty civilians to their death as they are lining up for identity cards.
14981,21/2/2011,Thailand,Yala,1,12,13,"Muslim bombers set off a blast in front of a supermarket, killing a local woman."
14982,21/2/2011,Somalia,Mogadishu,14,35,49,"al-Shabaab suicide attackers ram an explosives-laden vehicle into a soccer match, killing over fourteen people."
14983,21/2/2011,Iraq,Samarrah,12,18,30,A dozen police sent to guard Shia pilgrims are blown to bits by a Sunni suicide bomber.
14984,21/2/2011,Yemen,Sanaa,5,6,11,"Five people, including civilians, are killed when al-Qaeda gunmen roll up on a checkpoint."
14985,21/2/2011,Thailand,Narathiwat,1,0,1,A 32-year-old Buddhist is murdered by Islamic gunmen while walking home from a tea shop.
14986,21/2/2011,Thailand,Narathiwat,1,1,2,"A Buddhist couple is targeted by Muslim terrorists, with the husband dying from injuries."
14987,22/2/2011,Thailand,Pattani,1,0,1,A 38-year-old man is murdered in an 'insurgent' drive-by shooting.
14988,22/2/2011,Oman,Coast,4,0,4,A retired missionary couple is among four Americans taken hostage and executed in cold blood by Muslim pirates.
14989,22/2/2011,Nigeria,Borno,18,7,25,Eighteen Christian villagers are massacred during a Muslim raid.
14990,22/2/2011,Iraq,Baqubah,1,0,1,An imam in murdered in his mosque by Religion of Peace rivals.
14991,22/2/2011,Pakistan,Torghundai,6,10,16,"Three children, ages 3, 6 & 8, and two women are among six killed in their homes by a Taliban rocket attack."
14992,23/2/2011,Nigeria,Maiduguri,1,0,1,A cop is gunned down by Boko Haram Islamists.
14993,23/2/2011,Pakistan,Landikotal,5,2,7,Five local security personnel are killed during a Taliban assault on their post.
14994,23/2/2011,Egypt,Assiut,1,0,1,A priest is brutally stabbed to death in his home by killers shouting 'Allah Akbar!'
14995,23/2/2011,Pal. Auth.,Khan Younis,1,2,3,A 10-year-old girl is killed when a Hamas bomb detonates prematurely.
14996,24/2/2011,Pakistan,Peshawar,4,0,4,Four drivers and their assistants are incinerated when Islamists firebomb a group of fuel tankers.
14997,24/2/2011,Iraq,Mahata,4,0,4,A man and his three sons are brutally shot to death by al-Qaeda fundamentalists.
14998,24/2/2011,Iraq,Baghdad,1,0,1,A 70-year-old Christian man is stabbed to death in his home by Muslim radicals.
14999,24/2/2011,Egypt,Wadi el-Natroun,0,19,19,Two monks are among nineteen injured when military forces storm a Coptic monastery with live ammunition.
15000,24/2/2011,Iraq,Ramadi,11,18,29,"A Sunni suicide bomber detonates at a Shia cultural center, shredding eleven innocent lives."
15001,24/2/2011,Afghanistan,Spin Boldak,1,26,27,Two suicide car bombers kill only the guard managing to stop them.
15002,25/2/2011,Iraq,Fallujah,6,1,7,al-Qaeda gunmen storm a home and shoot six residents to death.
15003,25/2/2011,Russia,Nalchik,0,12,12,A dozen guards are injured when Islamists try to stage a grenade attack on a hospital.
15004,26/2/2011,Pakistan,Peshawar,4,17,21,"Mujahideen attack a fuel station, killing four people."
15005,26/2/2011,Iraq,Baghdad,1,0,1,A university professor is assassinated by suspected fundamentalists.
15006,26/2/2011,Iraq,Baiji,4,0,4,Terrorists attack an oil refinery and murder four employees.
15007,26/2/2011,Afghanistan,Faryab,4,30,34,"A teenage suicide bomber detonates at a playing field, killing at least four civilian spectators."
15008,26/2/2011,Afghanistan,Khost,9,0,9,Three children and four women are among nine civilians pulverized by a roadside blast.
15009,27/2/2011,Thailand,Pattani,1,0,1,A 54-year-old salesman is shot to death by Muslim militants.
15010,27/2/2011,Somalia,Mandera,1,10,11,A woman is killed when Islamic militia attack a Red Cross office.
15011,27/2/2011,Afghanistan,Arghandab,8,25,33,Taliban bombers take down eight civilians at a public event.
15012,27/2/2011,Pakistan,Landi Kotal,1,0,1,A tribal elder is abducted and murdered by suspected Lashkar-e-Islam.
15013,27/2/2011,India,Pulwama,1,0,1,Islamic militants shoot a truck driver to death in his home.
15014,28/2/2011,Nigeria,Kaduna,2,0,2,Two guards die from bullet wounds after Boko Haram gunmen roll up on a police station.
15015,28/2/2011,India,Srinagar,1,0,1,An engineer and father of three dies from shrapnel injuries suffered from an Islamist grenade attack at a market.
15016,28/2/2011,India,Baramulla,1,0,1,A shopkeeper is murdered by Mujahideen gunmen.
15017,28/2/2011,Nigeria,Dabwak,5,0,5,A Christian mother and four of her children are slaughtered in their home by Muslim militants..
15018,28/2/2011,Turkey,Mersin,1,0,1,A 19-year-old woman is stabbed to death by her family after running away with her boyfriend.
15019,1/3/2011,Ethiopia,Oma,0,17,17,Seventeen students are beaten with rods and pelted with stones for distributing Bibles.
15020,1/3/2011,Yemen,Abyan,2,11,13,An ambulance driver is among two people slain in an al-Qaeda ambush.
15021,1/3/2011,Pakistan,Bara,1,0,1,Religion of Peace proponents behead a civilian and dump his head and torso in separate areas.
15022,1/3/2011,Pakistan,Miranshah,4,0,4,Four villagers are abducted and executed in captivity by Sunni fundamentalists.
15023,1/3/2011,Pakistan,Mohmand,3,1,4,Three tribesman are killed by a Taliban landmine.
15024,1/3/2011,Pakistan,Pakhtunkhwa,2,0,2,Islamists are suspected of shooting a farmer and one other person to death.
15025,1/3/2011,Pakistan,Mardan,1,19,20,One student is killed when the Taliban throw a grenade into a girl's school.
15026,1/3/2011,Nigeria,Maiduguri,1,0,1,A guard at a church is gunned down in an Islamist drive-by.
15027,1/3/2011,Nigeria,Maiduguri,1,0,1,Boko Haram gunmen murder an off-duty cop in his home.
15028,2/3/2011,Pakistan,Islamabad,1,1,2,A Catholic cabinet minister is brutally shot to death in his car after being accused of blasphemy.
15029,2/3/2011,Pakistan,Karachi,1,0,1,A seminary teacher is shot to death by sectarian rivals.
15030,2/3/2011,Iraq,Ramadi,1,3,4,One victims bleeds out after a suicide bomber attacks a rival mosque.
15031,2/3/2011,Iraq,Baghdad,1,20,21,A sectarian bombing leaves one person dead.
15032,2/3/2011,Iraq,Mosul,1,0,1,"Mujahideen bombers blow up a home, killing a civilian."
15033,2/3/2011,Germany,Frankfurt,2,2,4,"A gunmen yells 'Allah Akbar' and opens fire on unarmed US soldiers on a bus, killing two."
15034,3/3/2011,Pakistan,Khyber,6,3,9,Islamic militants ambush a vehicle and kill six security officers.
15035,3/3/2011,Pakistan,Hangu,9,31,40,Women and children are among the casualties when a suicide car bomber detonates along a city street.
15036,3/3/2011,Iraq,Haditha,8,10,18,A suicide bomber wades into a crowd at a bank and sends eight customers to Allah.
15037,4/3/2011,Pakistan,Danda,1,0,1,Terrorists shoot a man to death outside a cafe for the crime of insulting Islam two years earlier.
15038,4/3/2011,Pakistan,Karachi,1,0,1,A radical Sunni group is thought responsible for the murder of a factory guard.
15039,4/3/2011,Pakistan,Nowshera,10,37,47,"Sunnis detonate a powerful bomb at a Sufi mosque during Friday prayers, taking down ten worshippers."
15040,4/3/2011,Egypt,Sol,2,0,2,"A Muslim mob, angry over a relationship between a Muslim girl and Christian boy, kills the two fathers and burns down a church."
15041,5/3/2011,Pakistan,Mohmand,2,7,9,Two members of a peace committee are taken apart by a Taliban rocket attack.
15042,5/3/2011,Iraq,Khalis,2,2,4,Terrorists burst into a cafe and shoot dead two patrons.
15043,5/3/2011,Iraq,Abu Kamis,1,0,1,Suspected al-Qaeda gunmen murder a civilian.
15044,5/3/2011,Pakistan,Karachi,2,0,2,A cleric and his son are murdered by Religion of Peace rivals.
15045,5/3/2011,Thailand,Pattani,1,2,3,A Buddhist monk is shot through the head in a Muslim drive-by.  Two others are injured.
15046,5/3/2011,Iraq,Hilla,4,0,4,Terrorists take down four Iraqis with a roadside bomb.
15047,6/3/2011,Iraq,Baghdad,2,0,2,Two students die in an 'insurgent' ambush.
15048,6/3/2011,Afghanistan,Paktika,12,5,17,Five children are among a dozen civilians who bleed out following a fundamentalist roadside bombing.
15049,6/3/2011,Thailand,Pattani,1,0,1,Islamists shoot a 23-year-old man to death in front of his mother.
15050,6/3/2011,Thailand,Pattani,1,4,5,"Muslim militants open fire on a market, killing a guard and seriously injuring four patrons."
15051,6/3/2011,Yemen,Zinjibar,2,0,2,"Islamic militia murder two men, one at a vegetable market."
15052,6/3/2011,Yemen,Marib,4,0,4,Four security personnel are taken down by al-Qaeda.
15053,6/3/2011,Iraq,Basra,8,12,20,"'Insurgents' attach a bomb to a passenger bus, killing eight innocents."
15054,6/3/2011,Thailand,Pattani,1,3,4,A 64-year-old man is murdered when Muslim militants fire on a group of teachers.
15055,7/3/2011,Thailand,Pattani,1,1,2,A Buddhist man is killed and his mother seriously wounded in an Islamic drive-by.
15056,7/3/2011,Thailand,Pattani,1,0,1,Islamists murder a 61-year-old man in an attack the leaves his young granddaughter seriously injured.
15057,7/3/2011,Pakistan,Karachi,1,0,1,A sectarian attack leaves one dead.
15058,7/3/2011,Afghanistan,Jalalabad,2,19,21,"Hardliners plant a bomb in front of a rival mosque, killing two people."
15059,7/3/2011,Thailand,Narathiwat,1,0,1,Islamic 'separatists' shoot a man to death as he is returning home from work.
15060,8/3/2011,Iraq,Abu Ghraib,1,0,1,A government employee is dragged out of his home and stabbed to death in front of his family.
15061,8/3/2011,Iraq,Mosul,1,0,1,Mujahideen assassinate a university professor.
15062,8/3/2011,Iraq,Fallujah,1,0,1,A civilian is cut down by sectarian gunmen.
15063,8/3/2011,Pakistan,Faisalabad,32,125,157,"Islamists detonate a massive bomb at a gas station, incinerating over thirty innocents."
15064,8/3/2011,Ethiopia,Asendabo,2,0,2,"Two Christians are killed when angry Muslims rampage through their community, burning churches and homes."
15065,8/3/2011,Thailand,Yala,1,0,1,Muslim 'separatists' knock a man off his motorcycle and then shoot him twice in the head.
15066,8/3/2011,Algeria,Djelfa,5,0,5,"Fundamentalist bombers attack a group of bird hunters, killing five."
15067,9/3/2011,Iraq,al-Makheirja,2,2,4,"Mujahideen toss a grenade into a family home, killing a man and a woman."
15068,9/3/2011,Egypt,Cairo,9,150,159,"Nine Copts, including a child, are killed and over a hundred more injured when a Muslim mob hurls firebombs and shoots into a group protesting a church burning."
15069,9/3/2011,Pakistan,Adezai,43,52,95,"A Shahid suicide bomber detonates at the funeral of the wife of a peace committee member, sending over 40 souls to Allah."
15070,9/3/2011,Iraq,Diyala,1,1,2,"A 3-year-old girl is dismembered, and her father seriously wounded by a targeted al-Qaeda blast outside their house."
15071,10/3/2011,Philippines,Jolo,3,11,14,"Abu Sayyaf militants detonate a shrapnel bomb outside a school, killing three innocents."
15072,10/3/2011,Nigeria,Bauchi,3,5,8,"At least three residents are killed when Fulani raiders sweep their village, shooting and burning homes."
15073,10/3/2011,Afghanistan,Kunduz,3,8,11,A local police chief on patrol is among three people ripped to shreds by a suicide bomber.
15074,10/3/2011,Pakistan,Peshawar,1,1,2,"Mujahideen fire on a car containing a peace committee contingent, killing the driver."
15075,10/3/2011,Iraq,Baghdad,6,3,9,"Islamic terrorists rob a jewelry store to fund their operation, shooting six people to death in the process."
15076,11/3/2011,Pakistan,Nawabshah,1,0,1,A young Ahmadi is murdered for his faith in a market.
15077,11/3/2011,Yemen,al-Deyo,4,5,9,Four security personnel are taken out by an al-Qaeda ambush.
15078,11/3/2011,Pakistan,Karachi,1,0,1,A seminary teacher is assassinated by sectarian rivals.
15079,12/3/2011,Afghanistan,Kandahar,4,0,4,Four civilians are cut to shreds by a roadside bomb.
15080,12/3/2011,Iraq,Baghdad,7,0,7,Seven Iraqi soldiers on their way to work are brutally machine-gunned in their car at point-blank range.
15081,12/3/2011,Iraq,Baghdad,1,6,7,Jihad bombers take down a local.
15082,12/3/2011,Israel,Itamar,5,0,5,"A baby and two young children are slaughtered in their home along with their parents, who fought the Muslims in vain to keep their children from being stabbed to death."
15083,12/3/2011,Pakistan,Hairdin,6,0,6,A married couple and their four young children are turned into debris by an Islamist mortar attack on their home.
15084,13/3/2011,Yemen,Zinjubar,1,2,3,al-Qaeda gunmen murder a local cop.
15085,13/3/2011,Pakistan,Hangu,9,6,15,"Islamic militants fire indiscriminately into a van carrying Shia civilians, killing nine."
15086,13/3/2011,Afghanistan,Helmand,6,0,6,Six civilians are taken down by Taliban roadside bombers.
15087,13/3/2011,Nigeria,Maiduguri,1,0,1,A moderate cleric is shot to death by Islamic radicals in a drive-by attack outside his home..
15088,14/3/2011,Iran,Evin,2,0,2,A Christian man and his Jewish wife are hung in captivity by Iranians.
15089,14/3/2011,Afghanistan,Kunduz,36,42,78,Four children are among three dozen innocents dismembered by a massive suicide blast at a recruitment center.
15090,14/3/2011,Nigeria,Plateau,6,0,6,Five family members are among six Christian villagers slaughtered by Muslim raiders.
15091,14/3/2011,Iraq,Diyala,11,14,25,Eleven Iraqi security personnel are blown to bits by a Fedayeen suicide bomber.
15092,14/3/2011,Somalia,Fiidow,4,9,13,"al-Shabaab militants fire on a public bus, killing four passengers."
15093,15/3/2011,Thailand,Narathiwat,2,0,2,"Religion of Peace gunmen open fire on a tea shop, killing two Buddhist patrons."
15094,15/3/2011,Thailand,Songkhla,1,0,1,A Buddhist teacher is murdered by Mujahideen.
15095,15/3/2011,Thailand,Songkhla,1,1,2,Muslim radicals shoot a Buddhist plantation worker to death an injure his wife.
15096,15/3/2011,Thailand,Yala,1,0,1,Islamists gun down a 69-year-old man.
15097,15/3/2011,Indonesia,Jakarta,0,4,4,"A bomb sent to a moderate scholar, deemed an 'enemy of Islam', injures four."
15098,15/3/2011,Afghanistan,Nangarhar,1,0,1,"The Taliban plant a bomb in a classroom, killing a teacher."
15099,15/3/2011,Afghanistan,Laghman,1,0,1,A civilian is killed in a roadside bombing by Sunni hardliners.
15100,15/3/2011,Thailand,Pattani,3,0,3,Three men sitting outside an auto repair shop are riddled with bullets by Muslim 'insurgents'.
15101,16/3/2011,Somalia,Mogadishu,10,50,60,A pregnant woman is among ten civilians bleeding out following an al-Shabaab mortar attack.
15102,16/3/2011,Iraq,Buhriz,1,1,2,"Suspected al-Qaeda invade a home, murder a man and injure his wife."
15103,16/3/2011,Iraq,Kirkuk,2,35,37,A woman and her newborn baby are taken apart by a Jihad car bomb outside a hospital.
15104,16/3/2011,Thailand,Marib,1,1,2,Muslim terrorists shoot a civilian off the back of a motorbike.
15105,17/3/2011,Yemen,Marib,3,0,3,al-Qaeda take out three policemen at a checkpoint with automatic weapons.
15106,18/3/2011,Dagestan,Makhachkala,2,0,2,Two law enforcement officials are gunned down by Holy Warriors in separate attacks.
15107,18/3/2011,Thailand,Pattani,3,0,3,Three Thais are shot to death by Islamic militants.
15108,18/3/2011,Iraq,Baiji,3,0,3,Three shepherds are taken down by Sunni roadside bombers.
15109,18/3/2011,Iraq,Mussayab,2,0,2,Two brothers are shot to death in their own home by al-Qaeda gunmen.
15110,19/3/2011,Iraq,Mosul,1,1,2,Terrorists open fire on a construction worker and his wife.
15111,19/3/2011,Iraq,Baghdad,3,9,12,A bomb blast leaves three Iraqis dead.
15112,19/3/2011,Thailand,Pattani,1,0,1,A street vendor is cut down by Muslim gunmen.
15113,20/3/2011,Egypt,Qena,0,1,1,A Christian has his ear torn off by Muslims enforcing Sharia law.
15114,20/3/2011,Iraq,Diala,6,0,6,"Six family members, including three children, are cut to shreds by a brutal suicide bombing at their home."
15115,20/3/2011,Iraq,Kirkuk,1,0,1,An 18-year-old woman is abducted and executed by suspected terrorists.
15116,20/3/2011,Iraq,Baghdad,2,0,2,Two oil company employees are shot to death.
15117,20/3/2011,Nigeria,Jos,2,0,2,Muslim extremists kill two worshippers with bombs placed at several churches.
15118,20/3/2011,Nigeria,Jos,1,0,1,A Christian boy is shot to death by Islamic radicals.
15119,21/3/2011,Afghanistan,Kandahar,2,0,2,Two civilians are cut down by Sunni gunmen.
15120,21/3/2011,Afghanistan,Kandahar,4,3,7,Four employees of a security firm are shot to death by the Taliban.
15121,21/3/2011,Iraq,Baghdad,1,2,3,Mujahideen kill a woman and wound her son and husband in a shooting attack.
15122,21/3/2011,Iraq,Mosul,3,2,5,Three people are killed by a Jihad bombing.
15123,21/3/2011,Iraq,Najaf,2,0,2,Two shop owners are gunned down by Muslim terrorists.
15124,21/3/2011,Dagestan,Makhachkala,1,0,1,A court official is murdered by Muslim militants.
15125,21/3/2011,Nigeria,Baten,4,0,4,Two women and two children are hacked and shot to death during a Muslim raid on a Christian village.
15126,21/3/2011,Nigeria,Maiduguri,1,2,3,Boko Haram Islamists shoot a man to death in a drive-by.
15127,21/3/2011,Pakistan,Gwader,11,2,13,"Islamic militants stage a rocket attack on a construction crew, killing eleven."
15128,21/3/2011,Pakistan,Datta Khel,4,0,4,"The Taliban kidnap, execute and mutilate four tribesmen."
15129,22/3/2011,Pakistan,Hyderabad,2,0,2,"After yelling abuse at worshippers outside a church, a Muslim mob opens fire, killing two."
15130,23/3/2011,Pakistan,Peshawar,1,0,1,Islamic bombers kill a man riding in an animal cart.
15131,23/3/2011,Iraq,Baghdad,3,9,12,Three people are injured in a series of Mujahideen bomb blasts.
15132,23/3/2011,Israel,Jerusalem,1,39,40,Palestinian terrorists leave a bomb at a bus stop which kills a female Bible translator and injures thirty others.
15133,23/3/2011,Thailand,Narathiwat,3,0,3,A married couple and a female friend are brutally machine-gunned in their own home by Muslim 'insurgents'.
15134,24/3/2011,Iraq,Hilla,4,0,4,"Mujahideen kidnap, behead and execute four young men."
15135,24/3/2011,Pakistan,Hangu,8,25,33,"A suicide bomber rams an explosives-packed car into a police station, killing two women and six other bystanders."
15136,24/3/2011,Thailand,Yala,1,0,1,A 25-year-old plantation worker is shot in the head by Muslim militants.
15137,24/3/2011,Somalia,Mogadishu,4,7,11,A woman is among four civilians cut down by al-Shabaab gunfire.
15138,25/3/2011,Pakistan,Karachi,1,0,1,A Shia is taken down by Sunni snipers.
15139,25/3/2011,Iraq,Mosul,2,5,7,Islamic militants kill two civilians with a roadside bomb.
15140,25/3/2011,Afghanistan,Nangarhar,2,1,3,Two children are successfully taken out by a Taliban roadside bomb.
15141,25/3/2011,Pakistan,Kurram,13,8,21,A woman and child are among thirteen Shiites machine-gunned at point-blank range by Sunni gunmen.
15142,25/3/2011,Pakistan,Hyderabad,2,0,2,"A Muslim mob invades a Pentecostal church, burns Bibles and kills two worshippers."
15143,26/3/2011,Thailand,Pattani,1,0,1,A man is shot five times by Islamists while riding a motorcycle.
15144,26/3/2011,Iraq,Baghdad,1,2,3,A professor is killed in a Sunni bomb attack.
15145,26/3/2011,Iraq,Abu Ghraib,3,0,3,Three family members are blown to bits by Mujahid bombers.
15146,26/3/2011,Iraq,Muqdadiya,1,1,2,Jihadi bombers take down a farmer and his son.
15147,27/3/2011,Pakistan,Shahidano,4,3,7,A woman is among four people dismembered by a militant rocket on a family vehicle.
15148,27/3/2011,Thailand,Yala,1,1,2,"Religious extremists shoot two villagers at a market, killing one."
15149,27/3/2011,Thailand,Narathiwat,1,0,1,A plantation worker is murdered by Muslim extremists on his way to work.
15150,27/3/2011,Yemen,Marib,6,12,18,An al-Qaeda ambush leaves six local soldiers dead.
15151,28/3/2011,Iraq,Mosul,7,0,7,"Fundamentalists attack a suspected brothel, shooting six women and one man to death."
15152,28/3/2011,Afghanistan,Paktika,23,60,83,"Three holy warriors detonate amid a construction crew, sending at least twenty souls to Allah."
15153,28/3/2011,Pakistan,Khyber,14,0,14,Fourteen security personnel die during a Taliban ambush.
15154,28/3/2011,Yemen,Jaar,150,80,230,"al-Qaeda radicals blow up an ammunitions factory, killing over one-hundred and fifty people, including women and children."
15155,29/3/2011,Iraq,Tikrit,56,98,154,"Islamic militants invade a government building and go room-to-room shooting and blasting unarmed employees, leaving over fifty dead."
15156,29/3/2011,Iraq,Abu Ghraib,2,1,3,"Terrorists attack a family home, killing two brothers."
15157,30/3/2011,Iraq,Baghdad,5,1,6,Five family members are murdered in their own home by suspected al-Qaeda.
15158,30/3/2011,Pakistan,Swabi,13,20,33,At least a dozen innocents are torn to shreds by a Fedayeen suicide bomber.
15159,30/3/2011,Afghanistan,Kandahar,1,2,3,A civilian is crushed to death when a terrorist tries to ram a NATO patrol.
15160,30/3/2011,Somalia,Mogadishu,1,0,1,"Fundamentalists fire randomly at a soccer match, killing a journalist."
15161,30/3/2011,Nigeria,Jos,2,5,7,Fulani raiders attack a college and murder two Christians.
15162,31/3/2011,Iraq,Mosul,1,0,1,A 13-year-old boy is beheaded by Islamic extremists.
15163,31/3/2011,Iraq,Abu Ghraib,1,0,1,"Sunni militants toss a grenade into a home, killing an elderly man."
15164,31/3/2011,Iraq,Diwaniya,1,2,3,A civilian is killed by a Katyusha rocket.
15165,31/3/2011,Pakistan,Khuzdar,1,0,1,Islamic militants flag down a truck and shoot the driver.
15166,31/3/2011,Pakistan,Charsadda,12,42,54,"A Holy Warrior detonates in a crowd of people, sending at least twelve souls to Allah."
15167,1/4/2011,Pakistan,Khyber,3,0,3,Religious extremists capture and cut the throats of three night watchmen
15168,1/4/2011,Iraq,Fallujah,3,7,10,Three Iraqis are taken out by a Shahid suicide bomber.
15169,1/4/2011,Afghanistan,Mazar-e Sharif,12,20,32,Eight UN workers are among a dozen people beheaded or shot to death by a mob enraged over a Quran burning in Florida.
15170,1/4/2011,Pakistan,Dara Adam Khel,1,5,6,A suicide bomber takes out a 12-year-old boy at a market.
15171,2/4/2011,Iraq,Kubisa,6,8,14,Terrorists shoot six security guards to death.
15172,2/4/2011,Iraq,Kut,2,0,2,A merchant and his bodyguard are victims of a targeted sectarian assassination.
15173,2/4/2011,Afghanistan,Kandahar,10,81,91,Ten more people are killed by a rampaging mob protesting a Quran burning.
15174,3/4/2011,Pakistan,Sakhi Sarwar,50,72,122,Fifty Sufi worshippers are sent to Allah by two Sunni suicide bombers at their temple.
15175,3/4/2011,Afghanistan,Kandahar,2,30,32,Two people are killed in an arson attack by a mob protesting a Quran desecration.
15176,3/4/2011,Nigeria,Bogoro,2,1,3,"A Muslim mob, angered over rumor of a local Quran desecration storms a Christian village and kills two people."
15177,3/4/2011,Philippines,Maguindanao,11,3,14,"Moro Islamists ambush a group of villagers with automatic weapons, taking down eleven."
15178,3/4/2011,Iraq,Mosul,1,6,7,"Islamists fire a rocket into a house, killing a woman."
15179,3/4/2011,Iraq,Ramadi,1,14,15,Mujahideen blow up local cop and injure fourteen others.
15180,4/4/2011,Afghanistan,Faryab,2,0,2,Two US soldiers are shot and killed by a terrorist in police uniform whom they were training.
15181,4/4/2011,Ethiopia,Worabe,1,1,2,Muslims beat a Christian evangelist to death and assault his pregnant wife.
15182,4/4/2011,Pakistan,Wana,1,0,1,The body of an abducted tribal elder is found two months after his kidnapping by Mujahideen.
15183,4/4/2011,Iraq,Jurf al-Sakhar,6,0,6,A bomb hidden on a booby-trapped corpse kills six Iraqis.
15184,4/4/2011,Pakistan,Lower Dir,8,26,34,"A suicide bomber detonates at a car showroom, sending eight souls to Allah."
15185,4/4/2011,Pal. Auth.,Jenin,1,0,1,A Israeli-Arab activist is gunned down by Islamic radicals unhappy with the secular character of his work.
15186,5/4/2011,India,Motijil,0,1,1,A female convert to Christianity is stripped naked and beaten by angry Muslims.
15187,5/4/2011,Pakistan,Darra Adam Khel,1,0,1,A farmer bleeds out following a Mujahideen rocket attack.
15188,5/4/2011,Iraq,Baaj,3,7,10,"Islamists bomb another car dealership, taking down three civilians."
15189,5/4/2011,Iraq,Baghdad,6,3,9,"Four young children, ages 4,6,9 and 14 are slaughtered in their own home by Mujahid gunmen.  Their mother, widowed by an earlier attack is seriously wounded."
15190,5/4/2011,Iraq,Mosul,3,2,5,Three civilians at a car dealership are shredded by a suicide bomber.
15191,6/4/2011,Pakistan,Pir Kali,3,0,3,The Taliban kidnap and brutally execute three villagers.
15192,6/4/2011,Pakistan,Mohmand,4,0,4,A woman and three children are crushed to death when a suspected Taliban rocket hits their home.
15193,6/4/2011,Pakistan,Jerma,4,3,7,Four children playing near a pond are taken down by Mujahid bombers.
15194,6/4/2011,Pakistan,Quetta,1,17,18,"A suicide car bomber rams into a house, killing a guard and injuring several children."
15195,6/4/2011,Nigeria,Maiduguri,2,0,2,Boko Haram Islamists gun down two people in a drive-by.
15196,7/4/2011,Iraq,al-Rida,2,4,6,A sectarian blast near a mosque takes down two civilians.
15197,7/4/2011,Somalia,Bosasso,1,0,1,A tribal elder is gunned down by suspected al-Shabaab.
15198,7/4/2011,Somalia,Garowe,1,0,1,A peace activist is shot to death by al-Qaeda linked militants.
15199,7/4/2011,Thailand,Narathiwat,1,0,1,"Muslim 'insurgents' stage a drive-by attack on a veterans office, killing a guard."
15200,7/4/2011,Pakistan,Quetta,1,0,1,"Sunni fundamentalists hurl a grenade into a barbershop, killing one patron."
15201,7/4/2011,Afghanistan,Kandahar,6,10,16,Six Afghans are murdered by a Taliban bomb hidden in an ambulance.
15202,7/4/2011,Israel,Ashkelon,1,1,2,"Hamas successfully hits a school bus with an anti-tank missile, severely injuring a teenage student who dies ten days later."
15203,7/4/2011,Brazil,Rio de Janeiro,12,20,32,"A convert to Islam walks into a school and guns down a dozen children, apparently inspired by fundamentalist websites."
15204,8/4/2011,Thailand,Yala,2,0,2,A Buddhist man and his companion are shot full of holes by Muslim terrorists..
15205,8/4/2011,Thailand,Pattani,1,0,1,"A 52-year-old man is shot to death by Muslim ""separatists."""
15206,8/4/2011,Iraq,Baghdad,2,0,2,A TV network official is among two people murdered by Mujahid gunmen.
15207,8/4/2011,India,Srinagar,1,0,1,A moderate cleric is assassinated by Lashkar-e-Toiba hardliners at his mosque.
15208,8/4/2011,Nigeria,Bogoro,10,0,10,"Muslims armed with machetes attack a Christian village and burn at least ten people to death, including several who were elderly."
15209,8/4/2011,Nigeria,Shani,4,0,4,Four election workers are ambushed and killed by Boko Haram militants.
15210,8/4/2011,Afghanistan,Sari Pul,1,1,2,Religious extremists machine-gun the local police chief to death.
15211,9/4/2011,Iraq,Mosul,2,0,2,Suspected fundamentalists shoot a university professor to death outside his home.
15212,9/4/2011,Iraq,Fallujah,3,0,3,Jihadis take down three Iraqis with a sticky bomb.
15213,9/4/2011,Dagestan,Kizlyar,1,0,1,A local imam who spoke out against Islamic radicalism is gunned down outside his home.
15214,10/4/2011,Afghanistan,Farah,3,0,3,Three tribal elders are dismantled by Taliban bombers.
15215,10/4/2011,India,Baramulla,1,0,1,A young man is shot to death by Islamic militants.
15216,10/4/2011,Pakistan,Mohmand,2,7,9,Two security personnel bleed out following a Taliban ambush.
15217,10/4/2011,Iraq,Baghdad,2,0,2,al-Qaeda is suspected of killing a jeweler and his son at their shop.
15218,11/4/2011,Iraq,Khan Bani Saad,10,2,12,Ten women and children are killed in a home by Jihadi bombers.
15219,11/4/2011,Dagestan,Kidero,3,0,3,Three policemen die when Islamic militants ambush them with machine-guns.
15220,11/4/2011,Iraq,Baghdad,4,11,15,A 10-year-old girl is among four Iraqis murdered in a terrorist blast along a city street.
15221,11/4/2011,Pakistan,Kanrakai,3,13,16,Women and children are among the casualties when religious radicals set off a roadside bomb.
15222,11/4/2011,Iraq,Fallujah,7,19,26,A triple bombing leaves seven dead.
15223,12/4/2011,Dagestan,Tsumadinsky,2,3,5,Two cops die in a brutal ambush by Mujahideen.
15224,12/4/2011,Afghanistan,Faryab,4,4,8,Talibanis gun down three children and their father.
15225,12/4/2011,Iraq,Khan Dhari,5,6,11,A vicious double bombing at a home leaves three family members and two rescue workers dead.
15226,12/4/2011,Iraq,Iskandariya,2,2,4,Two local cops are dismantled by a Jihad bomb blast.
15227,13/4/2011,Iraq,Kirkuk,1,16,17,"Terrorists set off a bomb in a restaurant, killing at least one."
15228,13/4/2011,Afghanistan,Kunar,10,7,17,Ten tribal elders are blown to bits by a Fedayeen suicide bomber who embraced one of his victims.
15229,14/4/2011,Iraq,Yusufiya,2,13,15,Two Iraqis are taken down by a double bombing.
15230,14/4/2011,Pakistan,Quetta,2,2,4,A cleric and his student are shot to death by Religion of Peace rivals.
15231,14/4/2011,Afghanistan,Paktia,3,3,6,"Four Shahid suicide bombers detonate at a police training camp, leaving three recruits dead."
15232,14/4/2011,Thailand,Narathiwat,1,0,1,Islamic militants spray the back of a 45-year old villager's head with automatic weapons fire.
15233,15/4/2011,Pal. Auth.,Mareh Amer,1,0,1,Salafis belonging to Jahafil Al-Tawhid Wal-Jihad fi Filastin kidnap and murder an Italian activist.
15234,15/4/2011,India,Budgam,1,0,1,Islamists drag a female political candidate out of her home and shoot her to death.
15235,15/4/2011,Pakistan,Kurram,2,0,2,"The Taliban ambush a group of police, killing two."
15236,15/4/2011,Iraq,Kut,1,0,1,A young man is shot three times in the head and chest by 'insurgents'.
15237,15/4/2011,Nigeria,Maiduguri,2,5,7,Boko Haram Islamists gun down two innocents.
15238,15/4/2011,Jordan,Zarqa,0,51,51,"A mob of Islamists attack police and accused atheists with bats and knives, leaving at least fifty injured."
15239,15/4/2011,Indonesia,Cirebon,0,29,29,"A suicide bomber blows himself up inside a mosque, injuring nearly thirty."
15240,15/4/2011,Afghanistan,Kandahar,3,2,5,"A religious fundamentalist wearing an explosives vest detonates in a group of policemen, killing three."
15241,16/4/2011,Nigeria,Maiduguri,1,0,1,A cop is gunned down by local Islamists.
15242,16/4/2011,Iraq,Hawija,1,0,1,"An al-Qaeda opponent is kidnapped, tortured and murdered."
15243,16/4/2011,Somalia,Galkayo,3,2,5,A government official is among three people dismantled by a bomb planted by Mujahideen.
15244,16/4/2011,Algeria,Azazga,14,12,26,"al-Qaeda fundamentalists assault a local security post, leaving at least 14 'apostates' dead."
15245,16/4/2011,Afghanistan,Laghman,10,8,18,A Fedayeen suicide bomber kills nine soldiers and a civilian.
15246,17/4/2011,Iraq,Kirkuk,2,1,3,Two bombings take down two Iraqis.
15247,17/4/2011,Pakistan,Gujranwala,0,12,12,Twelve worshippers at a Pentecostal church are pulled out and beaten by a Muslim mob.
15248,17/4/2011,Iraq,Baghdad,4,0,4,"Four members of a Shiite family, including two teens, are viciously shot to death in their home by sectarian rivals."
15249,18/4/2011,Iraq,Baghdad,10,23,33,A pair of suicide bombers send ten other souls to Allah.
15250,18/4/2011,Egypt,Minya,1,11,12,"One Copt is killed by Muslim rioters, who throw a grandmother out of a second story balcony while shouting praises to Allah."
15251,18/4/2011,Somalia,Shalambod,1,0,1,A 21-year-old convert to Christianity is pulled from his home and shot 10 times by Islamists yelling 'Allah Akbar'.
15252,18/4/2011,Afghanistan,Ghazni,6,0,6,No one survives a brutal roadside ambush by fundamentalists on a vehicle carrying six.
15253,18/4/2011,Afghanistan,Kabul,2,7,9,"A Fedayeen bomber attacks a defense ministry building, killing two."
15254,18/4/2011,Thailand,Yala,1,23,24,"Muslim 'insurgents' set off a car bomb, killing a passerby in a pickup truck."
15255,19/4/2011,Dagestan,Khasavyurt,2,0,2,Two cops are gunned down by Muslim militants.
15256,19/4/2011,Thailand,Narathiwat,1,25,26,Jihadis set off a bomb that leaves one dead.
15257,19/4/2011,Thailand,Pattani,5,0,5,Two teens are among five people who die from splinter injuries following an Islamist grenade attack.
15258,19/4/2011,Afghanistan,Kabul,2,0,2,"A Taliban gunmen goes on a shooting spree inside a government building, killing two guards."
15259,19/4/2011,Pakistan,Khyber,1,0,1,Religion of Peace hardliners slit the throat of a tribesman.
15260,19/4/2011,Iraq,Baghdad,1,2,3,Jihadis assassinate an official with the education department.
15261,19/4/2011,Iraq,Kirkuk,3,0,3,A teacher and her two Shia daughters shot to death by Sunni terrorists in their own home.
15262,19/4/2011,Nigeria,Kaduna,321,575,896,"Angry Muslims go on a two-day bender, torching over forty churches and hacking and burning over three hundred Christians to death."
15263,20/4/2011,Nigeria,Maiduguri,1,0,1,Islamists gun down a rival cleric.
15264,20/4/2011,Nigeria,Bauchi,10,17,27,Women are among a group of young Christians murdered by a Muslim mob.
15265,20/4/2011,Pakistan,Mohmand,2,0,2,A rancher and his assistant are brutally murdered at a Taliban roadblock.
15266,20/4/2011,Dagestan,Makhachkala,1,0,1,A cleric is murdered outside his home by Religion of Peace rivals.
15267,20/4/2011,Pakistan,Karachi,3,0,3,Three Shia civilians are gunned down in cold blood by Sunni assassins.
15268,20/4/2011,Pakistan,Kurram,7,0,7,Seven villagers are executed in captivity by the Taliban.
15269,20/4/2011,Iraq,Baghdad,3,10,13,"Sectarian Jihadis detonate a bomb in a Shia area, killing three."
15270,20/4/2011,Iraq,Mosul,4,1,5,A student is among four Iraqis shot to death by Mujahid gunmen.
15271,21/4/2011,Iraq,Samarrah,1,4,5,A child bleeds out following a Jihadi bomb blast.
15272,21/4/2011,Afghanistan,Ghazni,3,5,8,The Taliban take down three civilians with a roadside bomb.
15273,21/4/2011,Thailand,Pattani,1,2,3,Muslim 'insurgents' murder a Buddhist in his home.
15274,21/4/2011,Afghanistan,Jalalabad,3,6,9,Sunni fundamentalists plant a bomb that kills three local cops.
15275,21/4/2011,Pakistan,Peshawar,1,0,1,A man is beheaded by Muslim terrorists.
15276,22/4/2011,Pakistan,Karachi,19,40,59,"A Taliban-trained bomber blows up an illegal gambling den, killing nineteen patrons."
15277,22/4/2011,Pakistan,Sindh,2,0,2,Two men are shot to death in separate militant attacks.
15278,22/4/2011,Iraq,Ramadi,3,3,6,Mujahideen bombers take down three Iraqis.
15279,22/4/2011,Thailand,Yala,1,4,5,One person is killed when Muslim 'insurgents' detonate a bomb hidden in a drainage pipe.
15280,22/4/2011,Afghanistan,Spin Boldak,5,0,5,Five police officers are dismantled by a Taliban bomb.
15281,22/4/2011,Yemen,Mareb,8,4,12,Eight soldiers are shot to death by al-Qaeda extremists.
15282,22/4/2011,Pakistan,Maskini,14,9,23,"Armed religious extremists assault two remote checkpoints, killing fourteen security personnel."
15283,23/4/2011,Pakistan,Hangu,1,1,2,An 8-year-old boy dies from shrapnel injuries suffered during a Mujahid bombing of his home.
15284,23/4/2011,Afghanistan,Kunduz,3,1,4,Three civilians are disassembled by Taliban bombers.
15285,23/4/2011,Pakistan,Salarzai,5,0,5,A Shahid suicide bomber sends five souls to Allah.
15286,23/4/2011,Afghanistan,Helmand,1,0,1,The Taliban assassinate a former government official.
15287,23/4/2011,Iraq,Baghdad,6,4,10,Terrorists shoot six Iraqis to death in separate attacks.
15288,23/4/2011,Iraq,Kirkuk,1,2,3,"A brutal attack on an off-duty copy leaves him dead, his wife injured and his son without legs."
15289,24/4/2011,Libya,Tomina,3,0,3,A father slits his three teenaged daughters throats after learning of their having been raped by Libyan soldiers.
15290,24/4/2011,Somalia,Bosasso,1,2,3,al-Qaeda linked militants assassinate a local elder.
15291,24/4/2011,Iraq,Baghdad,0,7,7,Seven people are injured when Muslim activists detonate a bomb outside a church.
15292,24/4/2011,India,Baramulla,1,0,1,Islamic militants shoot a civilian to death.
15293,24/4/2011,Pakistan,Dir,1,0,1,A local trader is abducted and slain by suspected Islamists.
15294,24/4/2011,Pal. Auth.,Nablus,1,3,4,"A Palestinian cop yells 'Allah Akbar' and opens fire on a group of orthodox Jewish pilgrims, killing one."
15295,25/4/2011,Nigeria,Maiduguri,3,8,11,"Boko Haram members bomb a bus stop and a hotel, killing three people."
15296,25/4/2011,India,Srinagar,2,1,3,Two cops are gunned down along a city street by Muslim terrorists.
15297,25/4/2011,Iraq,Baqubah,2,0,2,A minibus driver is among two people blown to bits by Mujahid bombers.
15298,26/4/2011,Somalia,Luuq,8,13,21,A well-placed al-Shabaab landmine catches a civilian bus and sends at least eight passengers to Allah.
15299,26/4/2011,Pakistan,Karachi,4,56,60,A female doctor is among four people dismantled during two separate bus bombings.
15300,26/4/2011,Iraq,Hawija,2,6,8,Two innocents are leveled in the rubble of their house by Jihadi bombers.
15301,26/4/2011,Iraq,Kirkuk,3,30,33,Mujahid bombers take down three Iraqis.
15302,26/4/2011,Iraq,Baghdad,1,0,1,'Insurgents' assassinate a governor's secretary outside his home.
15303,27/4/2011,Afghanistan,Kabul,9,0,9,"A 'very religious' Afghan pilot suddenly turns on his American trainers, gunning down nine in an attack claimed by the Taliban."
15304,27/4/2011,Iraq,Falluajh,3,0,3,Three Iraqis are kidnapped and brutally tortured to death by suspected al-Qaeda.
15305,27/4/2011,Algeria,Boumelih,2,1,3,Fundamentalists cut two local cops to shreds with a shrapnel bomb.
15306,27/4/2011,Yemen,Zunjibar,2,5,7,al-Qaeda militants attack a checkpoint and kill two soldiers.
15307,27/4/2011,Pakistan,Hamza,0,3,3,"Anti-Christian activists go on a spree, attacking a pastor, severely injuring his son and later raping a woman."
15308,27/4/2011,Thailand,Yala,1,0,1,Muslim 'insurgents' shoot a Buddhist hunter and his dog to death.
15309,28/4/2011,Algeria,Oued Djemaa,5,4,9,Islamic extremists murder five security personnel with a bomb.
15310,28/4/2011,Iraq,Balad Ruz,12,40,52,A Sunni straps explosives to his body and walks into a Shia mosque.  A dozen are killed in the ensuing blast.
15311,28/4/2011,Morocco,Marrakesh,16,23,39,A Holy Warrior walks into a cafe and detonates.  Five women are among the sixteen massacred.
15312,28/4/2011,Pakistan,Karachi,6,7,13,Six innocents bleed out following an Islamist bombing attack on a bus.
15313,28/4/2011,Pakistan,Peshawar,2,0,2,Islamists gun down two local cops.
15314,28/4/2011,Pakistan,Lakki Marwat,2,0,2,Two villagers are abducted and executed by religious militants.
15315,28/4/2011,Iraq,Shahria,5,12,17,Five Iraqis are blown to bits by a Sunni bomb.
15316,29/4/2011,Pakistan,Karachi,1,0,1,An imam is assassinated by Religion of Peace rivals.
15317,29/4/2011,Iraq,Diyala,3,0,3,"A family of three, including a girl, is exterminated in their home by terrorists."
15318,29/4/2011,Iraq,Buhriz,4,0,4,Four Sunni brothers are shot to death in cold blood by sectarian rivals.
15319,30/4/2011,USA,"Warren, MI",1,0,1,A 20-year-old woman is shot in the head by her stepfather for not adhering to Islamic practices.
15320,30/4/2011,Thailand,Yala,2,9,11,Two local soldiers are killed by Muslim roadside bombers.
15321,30/4/2011,Iraq,Taji,3,1,4,A child and woman are among three killed when Islamists bomb a judge's home.
15322,30/4/2011,Pakistan,Gujranwala,0,25,25,"Fueled by rumors of a Quran desecration, a Muslim mob of hundreds attacks a Christian village, burning homes and assaulting the innocent."
15323,30/4/2011,India,Baramulla,1,0,1,Mujahideen shoot a vendor to death.
15324,30/4/2011,Iraq,Mosual,8,19,27,A brutal Fedayeen bombing at a marketplace entrance leaves at least eight dead.
15325,30/4/2011,Iraq,Qadiriya,2,2,4,A man and his daughter are shot to death in their home by Islamic militants.
15326,30/4/2011,Iraq,Kadhimiya,4,0,4,A village defense volunteer and three family members are murdered in their home by suspected al-Qaeda.
15327,30/4/2011,Pakistan,Gujranwala,0,25,25,Twenty-five Christian men and women suffer injury following an attack by an enraged Muslim mob of about 350.
15328,30/4/2011,Bulgaria,Pazardjik,0,1,1,A pastor who converted from Islam is beaten bloody in front of his church by a gang of Muslims.
15329,1/5/2011,Dagestan,Sergokala,1,0,1,Islamic rebels are suspected in the assassination of a police chief.
15330,1/5/2011,Pakistan,Punjab,4,0,4,Four guards are killed when Islamists attack a NATO supply convoy.
15331,1/5/2011,Iraq,Baghdad,7,20,27,A teacher is among seven Iraqis gunned down in various Mujahideen attacks.
15332,1/5/2011,Afghanistan,Paktika,4,12,16,At least four people are killed when a 12-year-old suicide bomber detonates at a crowded market.
15333,1/5/2011,Afghanistan,Ghazni,4,15,19,A Taliban shooting and bombing leave four Afghans dead.
15334,1/5/2011,Yemen,Zinjibar,3,4,7,Three local soldiers are killed by an al-Qaeda ambush.
15335,1/5/2011,Afghanistan,Kunar,1,1,2,A woman is shot to death by Sunni fundamentalists.
15336,1/5/2011,Afghanistan,Logar,2,13,15,Two local cops are dismantled by a Taliban bomb.  Thirteen civilians are injured elsewhere.
15337,2/5/2011,Pakistan,Charsadda,4,5,9,A woman and three children are torn to shreds when religious rivals place a bomb at a mosque.
15338,2/5/2011,India,Birma Pul,1,7,8,Holy Warriors take down a civilian with a roadside bomb.
15339,2/5/2011,Iraq,Baghdad,6,7,13,A Jihad bomb at a hospital garage nearly wipes out an entire family.
15340,2/5/2011,Iraq,Baghdad,3,14,17,A bomb near a coffee shop leaves three people dead.
15341,3/5/2011,Iraq,Baghdad,16,37,53,Sixteen Shiites in a poorer neighborhood are blown to bits by Sunni bombers while watching soccer at a cafe.
15342,3/5/2011,Iraq,Baghdad,2,5,7,A woman is among two who bleed to death in separate bombings.
15343,4/5/2011,Sudan,Khartoum,0,2,2,A husband and wife survive a violent knife attack in their home after converting from Islam to Christianity.
15344,4/5/2011,Pakistan,Bara,1,2,3,Militants kidnap three civilians from a market and execute one.
15345,4/5/2011,Iraq,Halila,2,0,2,Mujahideen stop two trucks and execute the drivers.
15346,4/5/2011,Iraq,Karbala,3,4,7,Three agricultural workers are murdered by Islamic bombers.
15347,4/5/2011,Thailand,Yala,4,13,17,"Muslim militants roll up on a tea shop and machine-gun four people to death, including two teenagers."
15348,4/5/2011,Yemen,Abyan,7,9,16,Seven people at a market are laid out by al-Qaeda bombers.
15349,4/5/2011,Pakistan,Karachi,1,0,1,A 45-year-old Shia man is assassinated by Taliban gunmen.
15350,4/5/2011,Somalia,Baidoa,2,0,2,"al-Shabaab executes two young 'apostates' at a soccer stadium, forcing children to watch."
15351,4/5/2011,Nigeria,Borno,2,0,2,A woman is among two people taken down by Islamist assassins.
15352,4/5/2011,Nigeria,Maiduguri,3,0,3,Three guards are killed in a Boko Haram shooting at a prison.
15353,5/5/2011,Nigeria,Maiduguri,2,0,2,A child is among two people shot to death by Boko Haram Islamists.
15354,5/5/2011,Pakistan,Karachi,2,0,2,An imam is among two people assassinated by Religion of Peace rivals.
15355,5/5/2011,Iraq,Hilla,24,72,96,Two dozen police are sent to Allah by a Holy Warrior in an explosives-packed vehicle.
15356,5/5/2011,Iraq,Mosul,1,1,2,A woman is shot to death in her home by 'insurgents'.
15357,6/5/2011,Sudan,Abu Shouk,0,1,1,"After being spotted with a Bible, a female aid worker is arrested for apostasy and severely beaten."
15358,6/5/2011,Iraq,Fallujah,1,0,1,An accused 'enemy of Allah' is kidnapped and beheaded.
15359,6/5/2011,Nigeria,Kano,17,3,20,"Seventeen residents of a Christian village, including a pastor's wife and three children are massacred in a pre-dawn Muslim attack."
15360,6/5/2011,Pakistan,Quetta,8,15,23,Eight Shiites visiting a cemetery are targeted and killed in a Sunni rocket attack.
15361,6/5/2011,Algeria,Baghlia,1,0,1,Armed fundamentalists gun down a journalist.
15362,7/5/2011,Iraq,Baqubah,6,10,16,"Suspected al-Qaeda gunmen stage a deadly robbery on a market, killing six."
15363,7/5/2011,Afghanistan,Kandahar,4,45,49,At least four people are killed during a sustained Fedayeen assault at a shopping mall.
15364,7/5/2011,Egypt,Cairo,12,232,244,"Fundamentalists assault two churches with firebombs and gunfire, killing five Copt defenders and seven more in an ensuing rampage."
15365,7/5/2011,Thailand,Narathiwat,1,0,1,Religious separatists shoot a farmer to death.
15366,7/5/2011,Thailand,Yala,3,2,5,A roadside bomb planted by Islamic radicals leaves three dead.
15367,7/5/2011,Thailand,Pattani,4,12,16,"Muslim militants detonate a bomb at a soccer field where police are playing a friendly game with villagers, killing four."
15368,7/5/2011,Algeria,El Kennar,5,5,10,Islamic militants murder five security personnel with a roadside bomb.
15369,8/5/2011,Thailand,Pattani,2,0,2,Islamists gun down two Buddhists in front of a mosque.
15370,8/5/2011,Iraq,Baghdad,9,14,23,"al-Qaeda detainees stage a jailhouse revolt, leaving nine guards dead."
15371,8/5/2011,Egypt,Imbaba,1,0,1,Salafists shoot the 16-year-old nephew of a Catholic bishop in the head.
15372,8/5/2011,Dagestan,Makhachkala,2,0,2,A journalist is among two people slain by Jihadi gunmen in separate attacks.
15373,8/5/2011,Egypt,Imbaba,1,0,1,Islamists break into a Catholic church and slit a member's throat.
15374,9/5/2011,Afghanistan,Khost,4,0,4,Four villagers are beheaded by religious hardliners.
15375,9/5/2011,Egypt,Cairo,1,0,1,A 60-year-old Catholic grandfather is beaten to death by enraged Muslims.
15376,9/5/2011,Afghanistan,Laghman,5,3,8,Three children are among five civilians torn to shreds by a Shahid suicide bomber.
15377,9/5/2011,Afghanistan,Ghazni,6,0,6,The Taliban machine-gun a half-dozen policemen at point-blank range.
15378,9/5/2011,Pakistan,Nowshera,4,2,6,"A bombing at a courthouse leaves four dead, including a woman."
15379,9/5/2011,Pakistan,Orakzai,1,0,1,Tehreek-e-Taliban kidnap and brutally execute a tribesman.
15380,9/5/2011,Iraq,Baghdad,3,2,5,A liquor store owner is among the casualties of various Mujahideen blasts.
15381,10/5/2011,Dagestan,Makhachkala,1,1,2,"A suicide bomber detonates at a checkpoint, killing a cop."
15382,10/5/2011,Pakistan,Peshawar,1,0,1,A journalist is disassembled by a car bomb blast.
15383,10/5/2011,Iraq,Tikrit,11,8,19,Jihad car bombers send eleven Iraqis to Allah.
15384,10/5/2011,Somalia,Mogadishu,3,7,10,Islamic militia take out three civilians with a roadside bomb.
15385,11/5/2011,India,Baghpat,2,0,2,Two Muslim mothers strangle their own daughters for marrying Hindu men.
15386,11/5/2011,Pakistan,Karachi,2,0,2,Two cops are gunned down in an Islamist drive-by.
15387,11/5/2011,Iraq,Tikrit,2,1,3,Two Iraqis bleed out following a Mujahideen bombing.
15388,11/5/2011,Somalia,Gal Gala,5,4,9,"Islamists ambush a group of government troops, killing five."
15389,12/5/2011,Nigeria,Borno,1,1,2,Muslim extremists assassinate a local elder.
15390,12/5/2011,Iraq,Hillah,1,0,1,A teenager is tortured and murdered by suspected al-Qaeda.
15391,12/5/2011,Iraq,Mussayab,2,0,2,Two people are abducted and beheaded by Religion of Peace activists.
15392,12/5/2011,Nigeria,Maiduguri,2,0,2,Boko Haram radicals murder a union official and his son.
15393,12/5/2011,Afghanistan,Helmand,2,0,2,"A religious Muslim in police uniform opens up on NATO soldiers eating lunch, killing two."
15394,13/5/2011,Yemen,Marib,5,0,5,Five soldiers are dismantled by an Islamist RPG attack.
15395,13/5/2011,Algeria,Tizrarana,7,2,9,"Armed fundamentalists attack a military barracks, slaying seven dead."
15396,13/5/2011,Pakistan,Bannu,98,124,222,"Two suicide bombers yelling 'Allah Akbar' murder ninety innocent people in ""revenge"" for the bin Laden killing."
15397,13/5/2011,Nigeria,Maiduguri,2,0,2,Two men waiting for a bus are blown to bits by Boko Haram Islamists.
15398,13/5/2011,India,Kupwara,1,0,1,Islamic militants ambush and kill a local soldier.
15399,13/5/2011,Pakistan,Karachi,1,0,1,A Shiite is shot twelve times by Sunni militants while traveling to work.
15400,13/5/2011,Nigeria,Borno,1,0,1,Religious radicals shoot a chauffeur to death.
15401,14/5/2011,Somalia,Bosasso,3,0,3,al-Shabaab is blamed for the murder of three tribal elders along a city street.
15402,14/5/2011,Pakistan,Kharian,7,20,27,Three women and a child are among seven bus passengers torn to shreds by fundamentalist bombers.
15403,14/5/2011,Yemen,Rada'a,6,1,7,Six local soldiers lose their lives to an al-Qaeda ambush.
15404,15/5/2011,Pakistan,Uch Sharif,2,0,2,Two sisters are shot to death in their sleep by their brother on suspicion of being sexually active.
15405,15/5/2011,Thailand,Yala,2,0,2,Two locals are murdered in separate attacks.
15406,15/5/2011,Israel,Tel Aviv,1,17,18,An Israeli is killed when an Arab driver rams him yelling 'Allah Akbar' and 'Death to Jews'.
15407,15/5/2011,Iraq,Baghdad,3,0,3,"A family of three, including a 13-year-old boy, are murdered in their beds by sectarian Jihadis."
15408,15/5/2011,Egypt,Cairo,0,50,50,About fifty Christians are injured when a Muslim mob hurls rocks and homemade bombs into a peaceful protest.
15409,15/5/2011,Pakistan,Datta Khel,2,0,2,Tehreek-e-Taliban kidnap and execute two villagers.
15410,15/5/2011,Iraq,Shirqat,1,0,1,A woman is beheaded by suspected al-Qaeda.
15411,15/5/2011,Egypt,Cairo,2,0,2,Two Copts are gunned down in a Muslim drive-by attack.
15412,16/5/2011,Somalia,Hodan,10,15,25,"al-Shabaab target a rival mosque with mortar shells, killing about ten clerics inside the building."
15413,16/5/2011,Thailand,Yala,2,2,4,Two Buddhist monks are dismantled by Religion of Peace bombers.
15414,16/5/2011,Somalia,Bosasso,2,0,2,A tribal elder and a businessman are assassinated by suspected al-Shabaab gunmen.
15415,16/5/2011,Somalia,Mogadishu,5,0,5,Five AU peacekeepers are killed in their barracks by an al-Shabaab bomb blast.
15416,16/5/2011,Afghanistan,Kunar,3,8,11,A woman and child are among three civilians crushed to death by a Taliban rocket attack.
15417,16/5/2011,India,Kishtwar,1,0,1,Lashkar-e-Toiba militants abduct and execute a 50-year-old civilian.
15418,16/5/2011,Pakistan,Mohmand,2,1,3,Two children are obliterated by a landmine.
15419,16/5/2011,Pakistan,Jawaki,1,0,1,A member of a peace committee is gunned down by Sunni hardliners.
15420,16/5/2011,Iraq,Kirkuk,1,0,1,Muslim kidnappers gouge out the eyes of a Christian victim and then cut off his head.
15421,16/5/2011,Pakistan,Karachi,1,0,1,A Saudi diplomat is shot in the head by Shiite terrorists.
15422,17/5/2011,Yemen,Mukalla,3,0,3,Three people are killed in an al-Qaeda ambush.
15423,17/5/2011,Kazakhstan,Aktobe,0,3,3,A suicide bomber detonates in 'revenge' for the recent arrest of Sunnis.
15424,17/5/2011,India,Sopore,1,0,1,A cop on duty in a town square is gunned down by Islamic terrorists.
15425,17/5/2011,Pakistan,North Waziristan,2,0,2,Two tribesmen are abducted and murdered by Taliban.
15426,17/5/2011,Iraq,Mosul,1,0,1,A college employee is shot to death by 'insurgents'.
15427,18/5/2011,Sudan,El Fasher,10,0,10,Ten fatalities are reported following an air strike by the Islamic republic on two villages.
15428,18/5/2011,Pakistan,Peshawar,2,5,7,"Seventy armed fundamentalists assault a police post, killing two defenders."
15429,18/5/2011,Pakistan,Quetta,6,4,10,Six Shias riding in a van are machine-gunned by Sunni co-religionists.
15430,18/5/2011,Tunisia,Rouhia,1,2,3,A military officer loses his life to an al-Qaeda ambush.
15431,18/5/2011,Afghanistan,Jalalabad,13,20,33,"A holy warrior detonates along a congested city street, killing thirteen innocents."
15432,18/5/2011,Nigeria,Maiduguri,10,6,16,"Boko Haram Islamists assault a police station, shooting ten people to death."
15433,19/5/2011,Afghanistan,Paktia,35,20,55,Thirty-five construction workers and guards are murdered by religious hardliners at a work site.
15434,19/5/2011,Iraq,Kirkuk,27,90,117,"Mujahideen detonate a car bomb in a parking lot, killing almost thirty Iraqis."
15435,19/5/2011,Nigeria,Maiduguri,1,7,8,One person is killed in a Boko Haram bomb blast.
15436,19/5/2011,Pakistan,Khyber,2,17,19,Two bomb blasts take two lives.
15437,19/5/2011,Iraq,Baghdad,1,2,3,A cleric is sent to Allah by Religion of Peace rivals.
15438,19/5/2011,Iraq,Abu Ghraib,1,3,4,A woman and two children are among the casualties when Sunni militants bomb a house.
15439,19/5/2011,Iraq,Kirkuk,4,0,4,Four Iraqis are laid low by a terrorist blast.
15440,19/5/2011,Egypt,Cairo,0,3,3,Three Catholics are severely injured by a rock-throwing Muslim mob intent on preventing a church from opening.
15441,20/5/2011,Somalia,Dharkenley,2,0,2,Two young men are abducted and tortured to death by fundamentalists.
15442,20/5/2011,Pakistan,Khyber,16,11,27,"Islamic militants blow up a fuel tanker on a highway, burning alive sixteen people, including five children."
15443,20/5/2011,Iraq,Baqubah,2,1,3,"Sectarian bombers target a rival imam, killing two people, including his son."
15444,20/5/2011,Iraq,Baghdad,2,0,2,al-Qaeda assassins gun down two Iraqi government employees.
15445,20/5/2011,Pakistan,Peshawar,1,11,12,"The Taliban bomb a car outside the American consulate, killing one person."
15446,20/5/2011,Thailand,Narathiwat,0,12,12,Muslim terrorists detonate a bomb under a truck at a market.
15447,21/5/2011,Iraq,Kirkuk,2,0,2,Religion of Peace militants shoot a factory worker and his 3-year-old daughter to death.
15448,21/5/2011,Iraq,Kirkuk,1,0,1,Suspected terrorists gun down a handicapped man.
15449,21/5/2011,Iraq,Kirkuk,2,0,2,Two brothers are brutally murdered during a Sunni home invasion.
15450,21/5/2011,Afghanistan,Kabul,6,30,36,"Holy Warriors detonate themselves inside a hospital, leaving six medical workers dead."
15451,22/5/2011,Pakistan,Karachi,13,16,29,"Taliban militants assault a navy base for 14 hours, killing at least thirteen."
15452,22/5/2011,Afghanistan,Khost,5,7,12,Three traffic cops and two civilians are taken down by a Fedayeen suicide assault.
15453,22/5/2011,Iraq,Kirkuk,2,0,2,A man and his daughter are shot to death by Muslim terrorists.
15454,22/5/2011,Iraq,Sadr City,2,12,14,"'Insurgents' place a bomb near a hospital, killing two people."
15455,22/5/2011,Iraq,Taji,12,30,42,A dozen Iraqi security personnel are murdered by a Shahid suicide bomber.
15456,22/5/2011,Iraq,Baghdad,5,58,63,A series of bomb blasts leave at least five Iraqis dead.
15457,22/5/2011,Dagestan,Khasavyurt,2,0,2,Islamists gun down two local cops.
15458,23/5/2011,Afghanistan,Laghman,4,14,18,Four tribal elders at a restaurant are disassembled by a Fedayeen suicide bomber.
15459,23/5/2011,Iraq,Kirkuk,2,12,14,A well-placed bomb takes the lives of two Iraqi policemen.
15460,24/5/2011,Thailand,Narathiwat,2,4,6,"Islamic 'separatists' detonate a bomb under a police vehicle, killing two occupants."
15461,24/5/2011,Afghanistan,Panjwaii,10,28,38,Ten road construction workers are cut to pieces by a Taliban roadside bomb.
15462,24/5/2011,Thailand,Narathiwat,2,1,3,Muslim 'separatists' murder two cops with a bomb hidden in a fire extinguisher.
15463,24/5/2011,Iraq,Baghdad,4,15,19,Jihad bombers send four Iraqis to Allah.
15464,24/5/2011,Nigeria,Maiduguri,1,0,1,Islamists murder a guard outside a Catholic church.
15465,25/5/2011,Indonesia,Sulawesi,2,1,3,Islamists on a motorbike gun down two policemen.
15466,25/5/2011,Pakistan,Peshawar,9,39,48,"Suicide truck bombers plow into a police station, killing at least nine."
15467,25/5/2011,Thailand,Yala,1,0,1,Thai Islamists ambush and kill a local soldier who was guarding teachers.
15468,25/5/2011,Pakistan,Balishkhel,4,18,22,A clash between Sunni and Shia leaves four dead.
15469,25/5/2011,Somalia,Mogadishu,7,17,24,al-Shabaab Islamists take down seven civilians with a vicious mortar attack.
15470,26/5/2011,Russia,Vladikavkaz,1,0,1,Muslim extremists murder a poet for offending Islam.
15471,26/5/2011,Iraq,Abu Ghraib,4,11,15,A Shahid suicide bomber sends four Iraqis to Allah.
15472,26/5/2011,Iraq,Baghdad,1,0,1,Sunnis gun down a Shia official.
15473,26/5/2011,Pakistan,Hangu,39,60,99,"At least three dozen people are massacred by Holy Warriors, who detonate themselves outside a police station."
15474,26/5/2011,Somalia,Luq,1,0,1,A villager and his donkey are taken apart by an al-Shabaab IED.
15475,27/5/2011,Afghanistan,Balkh,2,0,2,"Two people are kidnapped, beaten and burned alive by the Taliban."
15476,27/5/2011,Nigeria,Damboa,13,24,37,At least thirteen people are killed when Muslim fundamentalists assault a bank building.
15477,27/5/2011,Lebanon,Sidon,1,4,5,Islamic militants are suspected in a blast that leaves a UN peacekeeper dead.
15478,27/5/2011,Thailand,Narathiwat,1,2,3,"Muslim terrorists open fire on a civilian truck, killing the driver instantly."
15479,27/5/2011,Afghanistan,Takhar,7,9,16,"A Fedayeen suicide bomber detonates at a local governor's office, killing seven."
15480,27/5/2011,Yemen,Zinjibar,5,0,5,Five local cops are executed in cold blood by al-Qaeda.
15481,28/5/2011,Switzerland,Einsiedeln,1,0,1,A 24-year-old woman is shot to death by her strict Muslim father for leading an 'independent life'.
15482,28/5/2011,India,Kupwara,2,0,2,Mujahideen barge into a home and shoot a father and son to death.
15483,28/5/2011,Pakistan,Bajour,8,12,20,"Sunni fundamentalists send a suicide bomber into a restaurant, slaughtering eight innocents."
15484,29/5/2011,Pakistan,Quetta,2,3,5,Lashkar-e-Jhangvi terrorists assassinate two Shia policemen.
15485,29/5/2011,Iraq,Abu Ghraib,2,11,13,"Fundamentalists blow up a liquor store, killing two inside."
15486,29/5/2011,Nigeria,Maiduguri,1,0,1,A civilian is killed in the crossfire when Boko Haram Islamists shoot at police.
15487,30/5/2011,Thailand,Yala,0,7,7,Two civilians and five members of a Buddhist monk protection patrol are wounded during a Muslim drive-by.
15488,30/5/2011,Nigeria,Bauchi,10,13,23,Ten people are torn to shreds by an Islamist bomb planted in a bar.
15489,30/5/2011,Afghanistan,Herat,5,45,50,At least five Afghans lose their lives to a series of suicide bombers.
15490,30/5/2011,Somalia,Mogadishu,2,4,6,Two African peacekeepers are killed by a Shahid suicide bomber.
15491,30/5/2011,Iraq,Mosul,2,1,3,A Christian father of four is murdered by Jihadi gunmen along with a bystander.
15492,30/5/2011,Pakistan,Miranshah,1,11,12,A young girl dies of injuries suffered from a Religion of Peace bomb blast at a hotel.
15493,30/5/2011,Iraq,Baghdad,1,5,6,"Terrorists bomb a minibus, killing at least one passenger."
15494,30/5/2011,Iraq,Saqlawaiya,2,0,2,Islamists are thought to be behind the shooting death of two civilians.
15495,30/5/2011,Iraq,Abu Ghraib,2,6,8,Two Iraqis are wiped out by a Mujahideen bomb blast.
15496,31/5/2011,Yemen,Zinjibar,13,21,34,Thirteen local soldiers are slain by al-Qaeda militants.
15497,31/5/2011,Thailand,Narathiwat,0,0,0,Two Muslims accidentally blow themselves up trying to exterminate a passing convoy of teachers.
15498,31/5/2011,Thailand,Pattani,1,0,1,A 48-year-old Buddhist woman is shot to death by Muslim terrorists.
15499,31/5/2011,Thailand,Pattani,1,0,1,A 27-year-old man is murdered by Muslim gunmen.
15500,1/6/2011,Pakistan,Shaltalo,8,3,11,At least eight innocents are killed when Taliban militants blow up two girls' schools and attack a police post.
15501,1/6/2011,Thailand,Yala,2,4,6,Two Thais are blown up by Islamic 'separatists'.
15502,1/6/2011,Iraq,Mussayab,7,12,19,"Militants plant a bomb at a wedding, killing seven celebrants."
15503,1/6/2011,Iraq,Tikrit,3,0,3,Three brothers are executed by al-Qaeda gunmen.
15504,2/6/2011,Pakistan,Orangi,1,0,1,A Shia is shot to death by sectarian Jihadis.
15505,2/6/2011,Iraq,Ramadi,10,21,31,A series of well-place bombs take the lives of ten Iraqis.
15506,2/6/2011,Afghanistan,Uruzgan,3,1,4,Three guards are slain when the Taliban attack a road construction crew.
15507,2/6/2011,Somalia,Mogadishu,17,46,63,Seventeen civilians are killed in the crossfire when al-Shabaab stages an attack from a market.
15508,2/6/2011,Pakistan,Shaltalo,20,80,100,The second day of a sustained Taliban assault leaves twenty more dead.
15509,3/6/2011,Pakistan,Karachi,6,31,37,Six people are killed and thirty-one injured when Islamic militants target security personnel and a hotel hosting a casino.
15510,3/6/2011,Iraq,Tikrit,17,24,41,Suicide bombers attack a hospital treating victims of an earlier attack.  Seventeen innocents are slaughtered.
15511,3/6/2011,Iraq,Tikrit,19,52,71,Nineteen people leaving Friday prayers are shredded by a bomb place outside their mosque.
15512,4/6/2011,Philippines,Sulu,1,0,1,A 42-year-old police officer is killed by Abu Sayyaf militants while searching for a kidnap victim.
15513,4/6/2011,Pakistan,Peshawar,6,11,17,Three women and a child are among six passengers ripped apart by an Islamist bomb blast on their bus.
15514,4/6/2011,Iraq,Baghdad,2,0,2,A pharmacist is among two people shot to death by terrorists.
15515,4/6/2011,Afghanistan,Kunar,3,0,3,Three Afghans bleed to death following a detonation by a female suicide bomber.
15516,4/6/2011,Algeria,Bordj Menaiel,4,1,5,Fundamentalists murder four police officers with a roadside bomb.
15517,4/6/2011,Afghanistan,Kandahar,2,0,2,Fundamentalist bombers take down two university students on campus.
15518,5/6/2011,Pakistan,Kohat,1,0,1,Islamic militants slay an off-duty cop shopping at a market.
15519,5/6/2011,Iraq,Baghdad,5,18,23,Holy Warriors take down five Iraqis in various attacks.
15520,5/6/2011,Chechnya,Alkhazurovo,1,2,3,"Islamic militants detonate a bomb next to a passing police patrol, killing at least one."
15521,5/6/2011,Pakistan,Nowshera,19,45,64,Nineteen innocents at a bakery are massacred by Mujahideen bombers.
15522,5/6/2011,Afghanistan,Logar,13,0,13,A tailor and a beheaded soldier are among thirteen Taliban kidnap victims discovered in a mass grave.
15523,5/6/2011,Afghanistan,Nimroz,2,5,7,Two Afghan cops are ambushed and killed by religious hardliners.
15524,5/6/2011,Afghanistan,Maydan Shahr,2,5,7,Two security guards are killed by a Taliban bombing at a bank.
15525,6/6/2011,Iraq,Baghdad,5,8,13,"Iranian-backed Shiites fire several rockets into a compound, killing five Americans."
15526,6/6/2011,Nigeria,Biu,1,0,1,A cleric is shot to death by Religion of Peace rivals at his home.
15527,6/6/2011,India,Srinagar,1,0,1,Islamic terrorists gun down a civilian outside his home.
15528,6/6/2011,Pakistan,Bannu,1,2,3,Fundamentalists shoot a security officer to death.
15529,6/6/2011,Iraq,Hamdhiyah,4,1,5,Four family members are murdered when Mujahideen bomb their home.
15530,6/6/2011,Iraq,Baghdad,5,26,31,Five Iraqis are taken down by militant Muslims in two attacks.
15531,6/6/2011,Algeria,Sidi Abdelaziz,3,2,5,"Jihadis murder a soldier with a shotgun, then booby-trap his body with a bomb that kills two comrades."
15532,6/6/2011,Iraq,Tikrit,12,20,32,A suicide car bomber screams 'Allah Akbar' before ending the lives of a dozen others.
15533,7/6/2011,Iraq,Mosul,2,0,2,Muslim extremists successfully take out two shepherds with a roadside bomb.
15534,7/6/2011,Iraq,Baghdad,3,3,6,A family of three is among several Iraqis targeted by gunmen in two attacks.
15535,7/6/2011,Nigeria,Borno,5,5,10,"Boko Haram Islamists assault two police stations with bombs and bullets, killing five officers."
15536,7/6/2011,Nigeria,Maiduguri,2,14,16,Two innocents bleed to death after Islamists detonate a bomb outside a church.
15537,7/6/2011,Dagestan,Makhachkala,2,1,3,A religious teacher and his nephew are brutally murdered in their own backyard by radicals.
15538,8/6/2011,Thailand,Pattani,4,12,16,Four Buddhist policemen bleed to death following an 'insurgent'  bombing at a friendly soccer game.
15539,8/6/2011,Thailand,Narathiwat,1,0,1,A man is murdered by Mujahid gunmen while sitting in his pickup truck.
15540,8/6/2011,Thailand,Yala,3,2,5,Three local soldiers are killed in their vehicle by Islamic bombers.
15541,8/6/2011,Somalia,Mogadishu,3,0,3,Three civilians are kidnapped and shot to death by suspected al-Shabaab.
15542,8/6/2011,Yemen,Lahj,4,2,6,"al-Qaeda militants fire heavy weapons into a security checkpoint, killing four officers."
15543,8/6/2011,India,Sopore,1,0,1,A guard at a market is executed in cold blood by Muslim gunmen.
15544,8/6/2011,Nigeria,Bauchi,1,0,1,A man is lured out of his home and then murdered by Boko Haram gunmen.
15545,8/6/2011,Afghanistan,Uruzgan,2,0,2,A man and his son are murdered by Taliban militants as they leave a party.
15546,8/6/2011,Thailand,Narathiwat,2,0,2,Two elderly grocers are brought down in their stores by Muslim gunmen in separate attacks.
15547,8/6/2011,Sudan,Kadugli,1,0,1,A young Christian man is dragged to a market and slaughtered by the sword by men yelling 'Allah Akbar'.
15548,8/6/2011,Sudan,al Shaeer,1,0,1,A Christian seminary student is shot to death in front of bystanders by agents of the Islamic government.
15549,9/6/2011,Thailand,Yala,1,1,2,Islamic terrorists shoot a 27-year-old man to death in his car.
15550,9/6/2011,Pakistan,Darawar,4,3,7,"Islamic militants blow up a van carrying members of a peace committee, killing four."
15551,9/6/2011,Pakistan,Landhi,1,0,1,A Christian civilian is shot to death by Muslim gunmen.
15552,9/6/2011,Iraq,Baghdad,3,2,5,A judge is among three Iraqis killed in a series of shooting attacks and a bombing at a liquor store.
15553,9/6/2011,Nigeria,Maiduguri,2,0,2,A pastor at a Church of Christ and his secretary are brutally gunned down by Religion of Peace loyalists.
15554,9/6/2011,Somalia,Mogadishu,2,3,5,Suicide bombers kill two people at a harbor.
15555,9/6/2011,Afghanistan,Dur Baba,9,5,14,"Sunni terrorists shoot nine members of a wedding party to death, including the groom and his father."
15556,9/6/2011,Iraq,Hatra,1,0,1,A taxi driver is kidnapped and shot in the head and chest by 'insurgents'.
15557,10/6/2011,Pakistan,Farmwala,0,1,1,A Christian boy is beaten for refusing to embrace Islam.
15558,10/6/2011,Afghanistan,Kunduz,4,18,22,A Shahid suicide bomber takes down four police officers saying prayers at a mosque.
15559,10/6/2011,Somalia,Mogadishu,1,1,2,al-Shabaab gunmen shoot vendors at a market who ignore their orders to stop selling khat.
15560,10/6/2011,Pakistan,Balochistan,1,0,1,An oil tanker driver dies of bullet wounds from a Mujahideen attack.
15561,10/6/2011,Somalia,Mogadishu,1,2,3,A local official is murdered by a suicide bomber who was his niece.
15562,10/6/2011,Sudan,Kadugli,0,1,1,Islamists kidnap a pastor and torture him for two days.
15563,10/6/2011,Iraq,Salman Pak,10,15,25,Ten Iraqis are taken out by a roadside bomb.
15564,11/6/2011,Indonesia,East Java,0,1,1,"A young woman is kidnapped by Islamic hardliners on her way home from church, beaten, slashed, and held for two days."
15565,11/6/2011,Iraq,Al-Dour,5,0,5,"A teacher's family of five, including three children, are brutally slain in an overnight sectarian home invasion."
15566,11/6/2011,Pakistan,Khyber,39,88,127,Nearly forty shoppers and vendors are obliterated by two terror blasts at a market.
15567,11/6/2011,Iraq,Mosul,18,47,65,Eighteen innocents lose their lives to two Mujahid car bombers.
15568,11/6/2011,Iraq,Samarra,4,0,4,Four brothers are executed in cold blood by al-Qaeda.
15569,11/6/2011,Iraq,Abu Ghraib,2,0,2,Sunni militants shoot one civilian to death and behead another.
15570,11/6/2011,Afghanistan,Kandahar,15,1,16,Eight children and four women are among those ripped apart by a Taliban bombing of their minivan.
15571,11/6/2011,Afghanistan,Khost,3,8,11,A 12-year-old boy is among three people murdered by a Fedayeen suicide bomber.
15572,12/6/2011,India,Chikkaballapur,2,0,2,Two young Hindu students are kidnapped and brutally stabbed to death by the Student Islamic Movement of India.
15573,12/6/2011,Iraq,Hillah,2,0,2,A man and his wife are shot to death by Religion of Peace terrorists.
15574,12/6/2011,Iraq,Baqubah,3,4,7,Three Iraqis are taken out by Jihadi gunmen at a checkpoint.
15575,12/6/2011,Iraq,Baghdad,3,14,17,Jihadis take out three soccer-playing youth with two roadside bombs.
15576,12/6/2011,Yemen,Zinjibar,3,5,8,al-Qaeda militants attack a checkpoint and kill four defenders.
15577,13/6/2011,Nigeria,Bulunkutu,4,0,4,Four drinkers at a beer garden are taken out by religious radicals.
15578,13/6/2011,Pakistan,Islamabad,1,3,4,A suicide bomber kills a guard at a bank.
15579,13/6/2011,Pakistan,South Waziristan,4,8,12,Four local cops are cut down in separate attacks by radical Sunnis.
15580,13/6/2011,Iraq,Basra,5,29,34,Five Iraqis are ripped to pieces by a suicide bomber.
15581,13/6/2011,Iraq,Baaj,2,0,2,Two people are kidnapped and beheaded by sectarian terrorists.
15582,14/6/2011,Iraq,Dujail,4,1,5,Four family members are killed in their own home by sectarian Jihadis.
15583,14/6/2011,Iraq,Baqubah,8,27,35,Eight people are killed in a multi-pronged Fedayeen assault on government office building.
15584,14/6/2011,Dagestan,Mikheyevka,1,0,1,Islamic extremists shoot dead a rival imam at his mosque.
15585,14/6/2011,Sudan,South Kordofan,2,5,7,At least two church workers are killed when the Islamic republic bombs a village.
15586,15/6/2011,India,Shopian,1,0,1,Mujahideen gunmen take out a local youth.
15587,15/6/2011,Iraq,Mussayab,1,6,7,"Terrorists plant a bomb at a marketplace, killing a patron."
15588,15/6/2011,Somalia,Mataban,15,24,39,Fifteen people are killed in a sectarian clash between Sufis and Sunnis.
15589,15/6/2011,Yemen,Houta,3,2,5,"al-Qaeda militants assault a village, killing at least three defenders."
15590,15/6/2011,Afghanistan,Mahmud Raqi,7,4,11,"A Shahid car bomber detonates himself along a city street, leaving seven innocents dead."
15591,15/6/2011,Afghanistan,Paktia,3,0,3,A 13-year-old boy is among three others sent to Allah by a suicide bomber.
15592,16/6/2011,Afghanistan,Maruf,4,0,4,Three women are among four members of a family murdered by Taliban bombers.
15593,16/6/2011,Iraq,Hilla,3,0,3,A suspected al-Qaeda home invasion leaves three people dead.
15594,16/6/2011,Thailand,Pattani,4,2,6,Four local soldiers are slain by an Islamist ambush near a market.
15595,16/6/2011,Pakistan,Quetta,1,0,1,Sunnis shoot a Shia to death as he is riding a motorcycle.
15596,16/6/2011,Nigeria,Damboa,4,1,5,Four children leaving a church are brutally taken out by a Boko Haram blast.
15597,16/6/2011,Nigeria,Abuja,2,0,2,A suicide bomber at a police station kills two officers.
15598,16/6/2011,Pakistan,Bajaur,6,27,33,Two women are among six people murdered when the Taliban storm a village.
15599,17/6/2011,Afghanistan,Sirkanay,4,0,4,Four children are killed when Pakistani militants fire a rocket across the border.
15600,17/6/2011,Pakistan,Quetta,1,0,1,"Talibanis open fire on a fuel tanker, killing the driver."
15601,17/6/2011,Pakistan,Bara,1,0,1,Islamists abduct and slit the throat of a telephone company employee.
15602,17/6/2011,Pakistan,Tirah,3,2,5,"Three women are killed, and two children injured, when Islamic militants shell their home."
15603,17/6/2011,Iraq,Baghdad,3,8,11,"Jihadis set off a blast in a Shiite neighborhood, ending the lives of three residents."
15604,18/6/2011,Iraq,Baqubah,3,2,5,Three Iraqis are taken apart by Jihadi bombers.
15605,18/6/2011,Iraq,Baghdad,2,0,2,A grocer and a city worker are gunned down in separate terror attacks.
15606,18/6/2011,Somalia,Daynile,2,0,2,Two young men are publicly executed by al-Shabaab Islamists.
15607,18/6/2011,Pakistan,Quetta,4,28,32,Two children are among four dismantled by Lashkar bombers.
15608,18/6/2011,Afghanistan,Ander,4,2,6,Four private security guards are blown to bits by Taliban bombers.
15609,18/6/2011,Afghanistan,Kabul,9,12,21,Five civilians are among nine dead when several suicide bombers attack a police station.
15610,19/6/2011,Iraq,Kirkuk,1,0,1,al-Qaeda gunmen murder an Iraqi.
15611,19/6/2011,Yemen,Zinjibar,7,21,28,A group calling itself 'Supporters of Sharia' kills seven government soldiers over the course of two days.
15612,19/6/2011,Nigeria,Maiduguri,2,5,7,"Boko Haram Islamists fire indiscriminately into a group of poker players, killing two."
15613,19/6/2011,Afghanistan,Kunduz,3,11,14,A Shahid suicide bomber sends three Afghan civilians to Allah.
15614,19/6/2011,Pakistan,Hayatabad,2,4,6,A 12-year-old girl and a woman are murdered in their home by Islamic militants.
15615,19/6/2011,Iraq,Mosul,1,0,1,Mujahideen gun down a teenager outside his home.
15616,20/6/2011,Iraq,Baghdad,2,8,10,A terrorist blast takes down two civilians.
15617,20/6/2011,Thailand,Yala,1,1,2,Islamists murder a 55-year-old Buddhist outside a wedding reception - also severely injuring his wife.
15618,20/6/2011,Thailand,Pattani,2,0,2,A Buddhist is among two killed in separate Muslim sniper attacks.
15619,20/6/2011,Thailand,Pattani,2,0,2,Two off-duty cops are murdered on their way to work by Islamic militants.
15620,20/6/2011,Dagestan,Makhachkala,2,0,2,Two men are shot to death by Islamic militants.
15621,20/6/2011,Pakistan,Matni,4,5,9,Four people are cut to pieces by a suicide bomb attack on a house hosting a peace committee.
15622,20/6/2011,Pakistan,Masood,6,4,10,A child is among six people killed when religious extremists roll hand grenades into two family homes.
15623,20/6/2011,Nigeria,Kankara,7,0,7,Seven people are gunned down at a local bank by 'robbers' chanting Islamic slogans.
15624,20/6/2011,Nigeria,Maiduguri,1,0,1,A local cop is stalked and murdered by Boko Haram gunmen.
15625,20/6/2011,Iraq,Mosul,2,3,5,Two boys are blown to bits in a bombing attack on their family vehicle.
15626,21/6/2011,Pakistan,Lahore,1,0,1,A Christian father of four who worked as a garbage collector is stabbed to death by an angry Muslim.
15627,21/6/2011,Somalia,Mogadishu,4,6,10,Four civilians in a minivan are pulverized by a Religion of Peace bomb blast.
15628,21/6/2011,Afghanistan,Charikar,2,2,4,A woman is among two people who bleed to death from shrapnel injuries following a Shahid suicide blast.
15629,21/6/2011,Iraq,Diwaniya,27,57,84,A Holy Warrior earns his spot in heaven with a suicide attack that leaves over two dozen Iraqis dead.
15630,21/6/2011,Iraq,Mussayab,5,9,14,A coffee shop is the target of a Sunni bomb blast that sends five souls to Allah.
15631,21/6/2011,Iraq,Mansouriya,1,0,1,"Terrorists bomb a bus, killing a passenger."
15632,21/6/2011,Thailand,Narathiwat,1,0,1,Muslims lay out a 48-year-old cook with a pair of shotgun blasts.
15633,22/6/2011,Pakistan,Quetta,4,11,15,"Sunni gunmen fire into a bus carrying Shia pilgrims, killing four."
15634,22/6/2011,Afghanistan,Ghazni,4,0,4,Four local cops are blown up by a Taliban roadside bomb while rushing to help their own caught in an ambush.
15635,22/6/2011,Afghanistan,Ghazni,8,0,8,Eight police officers are slain in an ambush after being betrayed by a fundamentalist in uniform.
15636,22/6/2011,Pakistan,Hangu,2,5,7,Two people riding in a van are shot to death in a suspected sectarian attack.
15637,22/6/2011,Iraq,Baghdad,13,43,56,Thirteen Iraqis are brought down by a series of Mujahideen attacks.
15638,22/6/2011,Thailand,Yala,1,0,1,A 37-year-old Buddhist is shot in the head by Muslim militants while riding to work.
15639,23/6/2011,Afghanistan,Dhaddar,2,0,2,Two civilians are shot to death by religious hardliners.
15640,23/6/2011,Pakistan,Mastung,3,4,7,"Suspected fundamentalists toss a grenade into a drug den, killing three."
15641,23/6/2011,Iraq,Baghdad,6,6,12,Six Iraqis are torn to shreds by a Mujahideen bomb blast.
15642,23/6/2011,Algeria,Kabylie,1,1,2,Fundamentalists kill a local soldier with a bomb.
15643,23/6/2011,Iraq,Baghdad,35,95,130,Almost three dozen shoppers are massacred by a brutal triple bombing at a Baghdad market.
15644,24/6/2011,Thailand,Yala,1,0,1,A 35-year-old man is shot in the head by Religion of Peace gunmen.
15645,24/6/2011,Thailand,Narathiwat,2,13,15,Two Buddhist road construction workers are blown to bits by Muslim 'insurgents'.
15646,24/6/2011,Afghanistan,Kunduz,6,22,28,"Islamists detonate a bicycle bomb at a market, killing six patrons."
15647,24/6/2011,Yemen,Aden,3,10,13,Three security personnel are killed by an al-Qaeda car bomb blast.
15648,24/6/2011,Iraq,Tikrit,2,0,2,A police officer and his wife are murdered in their home by 'insurgents'.
15649,24/6/2011,Sri Lanka,Kattankudi,0,2,2,A group of radical Islamists severely beat two teen girls for hours over allegations that they watched pornography.
15650,25/6/2011,Pakistan,Pak Colony,4,0,4,Members of a religious party are thought responsible for the horrific torture and murder of four youth.
15651,25/6/2011,Philippines,Isabela City,2,8,10,Muslim militants are suspected of detonating a bomb outside a Catholic church that leaves two people dead.
15652,25/6/2011,Afghanistan,Logar,38,53,91,A huge car bomb at a hospital ends the lives of at least three dozen innocents and de-limbs many others.
15653,25/6/2011,Pakistan,Kolachi,10,5,15,Ten defenders are killed when two suicide bombers attack a police station.
15654,25/6/2011,Iraq,Abu Ghraib,2,0,2,Islamists shoot a councilman and his nephew to death in their home.
15655,26/6/2011,Algeria,Legata,2,5,7,Islamists hide a bomb in a phone book that kills two people.
15656,26/6/2011,Iraq,Tarmiya,3,18,21,A suicide bomber hides his weapon in a wheelchair.  Three others are killed.
15657,26/6/2011,Iraq,Mosul,6,4,10,Mujahid car bombers successfully kill six Iraqis.
15658,26/6/2011,Iraq,Riyadh,2,5,7,Two people are taken out by Islamic bombers.
15659,26/6/2011,Egypt,Awlad Khalaf,0,3,3,Three Christians are injured when a Muslim mob torches eight homes on a rumor that one was to become a church.
15660,26/6/2011,Italy,Padua,1,0,1,A Moroccan immigrant kills his wife for becoming 'too Western'.  Others support his right to 'stone the adulteress'.
15661,26/6/2011,Sudan,Meiram,1,4,5,"Arab militiamen attack a train carrying Southerners, killing one."
15662,26/6/2011,Nigeria,Maiduguri,30,25,55,Islamists massacre about thirty patrons at a tavern serving alcohol by tossing in bombs and firing into the building.
15663,26/6/2011,Afghanistan,Char Chino,1,0,1,The Taliban detonate an 8-year-old girl near a checkpoint.
15664,26/6/2011,Senegal,Dakar,0,24,24,About two dozen Christians are severely injured when a Muslim mob sets fire to their church during a service under orders from a local imam.
15665,27/6/2011,Nigeria,Maiduguri,2,3,5,Two young girls are blown to bits by Islamic bombers.
15666,27/6/2011,Afghanistan,Ghazni,7,0,7,Two children and a woman are among seven civilians torn apart by two Taliban roadside blasts.
15667,27/6/2011,Pakistan,Dera Ismail Khan,12,20,32,A dozen police are taken hostage and then slaughtered by a husband and wife suicide team.
15668,27/6/2011,India,Ganderbal,1,0,1,A civilian is gunned down by Mujahideen.
15669,27/6/2011,Pakistan,Darra Adamkhel,2,0,2,A woman is among two killed when Islamic militants send a shell into a home.
15670,27/6/2011,Iraq,Jabalah,1,7,8,Sunni bombers take out one mourner at a Shia funeral.
15671,27/6/2011,Iraq,Bazawia,3,4,7,Three Iraqis are murdered by an 'insurgent' bomb blast.
15672,28/6/2011,Tunisia,Tunis,0,2,2,Islamic fundamentalists attack a group of lawyers over a film festival showing unIslamic material.
15673,28/6/2011,Somalia,Mogadishu,2,4,6,Two Somalis die from shrapnel injuries following an al-Shabaab bomb blast.
15674,28/6/2011,Pakistan,Upper Dir,1,3,4,"Hardliners fire a shell into a family home, killing a boy and seriously injuring a woman."
15675,28/6/2011,Pakistan,Peshawar,1,2,3,Islamists shoot a rival as he is on his way to a funeral.
15676,28/6/2011,Iraq,Mosul,1,0,1,Sunnis gun down a young student for belonging to the Shabak religious minority.
15677,28/6/2011,Iraq,Mosul,3,2,5,Terrorists kill two Iraqis with a bomb attack.
15678,28/6/2011,Afghanistan,Kabul,11,50,61,At least eleven innocents lose their lives to a coordinated Fedayeen attack on their luxury hotel.
15679,28/6/2011,Afghanistan,Panjwai,2,1,3,"Two women are killed, and a child injured, by Taliban roadside bombers."
15680,29/6/2011,Pakistan,Rawalpindi,2,0,2,Two abductees are executed in captivity by al-Qaeda.
15681,29/6/2011,Yemen,Zinjibar,26,16,42,"al-Qaeda fighters assault a stadium, killing at least twenty-six guards."
15682,29/6/2011,India,Srinagar,1,0,1,Mujahideen gun down a local cop.
15683,30/6/2011,Indonesia,Bima,1,1,2,"A madrassah student stabs a police officer to death for being an ""enemy of Islam."""
15684,30/6/2011,Afghanistan,Lashkar Gah,6,0,6,"A mother, father and four children are torn to pieces by a bomb planted by Islamic extremists."
15685,30/6/2011,Afghanistan,Nimroz,20,36,56,Twenty civilians riding on a passenger bus are ripped to shreds by a Taliban bomb.
15686,30/6/2011,Pakistan,Peshawar,2,13,15,Two people bleed to death after Islamists detonate a car bomb outside a hotel.
15687,30/6/2011,Pakistan,Karachi,3,12,15,"Three people, including a woman, are killed when religious groups clash over a sectarian issue."
15688,30/6/2011,Yemen,Abyan,6,17,23,A half-dozen civilians are killed during an al-Qaeda assault.
15689,1/7/2011,Pakistan,Peshawar,2,0,2,Two civilians are abducted and executed by Islamic militants.
15690,1/7/2011,Pakistan,Karachi,7,7,14,A second day of clashes between two religious groups leaves seven more dead.
15691,1/7/2011,Philippines,Maguindanao,1,0,1,Muslim rebels are suspected of aerating a local mosque caretaker with shrapnel.
15692,1/7/2011,Afghanistan,Maruf,6,6,12,Islamists blow up two people riding a donkey and then two more rushing to their aid.
15693,1/7/2011,Algeria,Nacira,1,2,3,Fundamentalists kill one Algerian with a planted bomb.
15694,2/7/2011,Sudan,Pariang,3,17,20,"The Islamic Republic bombs a village in the south, killing three civilians."
15695,2/7/2011,Nigeria,Maiduguri,9,0,9,"Boko Haram go house to house, shooting victims.  At least nine die."
15696,3/7/2011,Algeria,Chebilia,0,24,24,"Dozens of innocent people, including children, choke on smoke or are beaten by fundamentalists who attack an apartment building suspected of housing prostitutes."
15697,3/7/2011,Yemen,Zinjibar,10,24,34,Ten local soldiers are killed during an al-Qaeda ambush.
15698,3/7/2011,Pakistan,Sindh,1,0,1,An imam is murdered in a sectarian attack.
15699,3/7/2011,Iraq,Rutba,10,1,11,Ten Iraqi cops are killed in separate terror attacks.
15700,3/7/2011,Afghanistan,Maimana,0,17,17,"A terrorist on a motorbike tosses a grenade at a school, injuring seventeen children."
15701,3/7/2011,India,Mubarikpur,1,1,2,A young couple is dragged out of a mosque and beaten by their enraged families.  The woman dies.
15702,3/7/2011,India,Saharanpur,2,0,2,Two sisters are shot to death by their brother on suspicion of immoral activities.
15703,3/7/2011,Afghanistan,Logar,19,0,19,Nineteen road construction laborers are machine-gunned by the Taliban.
15704,3/7/2011,Pakistan,Lindhi,1,13,14,One person is killed during a violent dispute between two group of members over control of a mosque.
15705,3/7/2011,Pakistan,Shangla,3,1,4,Three defenders are killed when Muslim radicals attack a police post.
15706,3/7/2011,Nigeria,Maiduguri,10,13,23,Thirteen people at a tavern are sent to Allah by Islamist bombers.
15707,3/7/2011,Afghanistan,Zabul,13,33,46,Four women and two children are among thirteen cut to shreds by a Taliban bomb blast.
15708,3/7/2011,Pakistan,Pakhtunkhwa,1,3,4,"One person is killed in two attacks by fundamentalists, one on the house of a faith healer."
15709,4/7/2011,Iraq,Baghdad,26,9,35,Over two dozen Iraqis are taken down by Mujahid in various attacks around the country.
15710,4/7/2011,Afghanistan,Helmand,1,0,1,A British soldier is snatched by the Taliban and murdered in captivity.
15711,4/7/2011,Pakistan,Mamond,1,1,2,"Sunni militants attack a checkpoint, killing a local soldier."
15712,4/7/2011,Algeria,Kabylie,1,1,2,"Armed fundamentalists fire on two traffic cops, killing one."
15713,5/7/2011,Pakistan,Mamond,1,0,1,Hardliners send a peace committee member to Allah by planting a bomb outside his house.
15714,5/7/2011,Pakistan,Miranshah,3,14,17,Islamists kill three security personnel with a landmine attack.
15715,5/7/2011,Pakistan,Karachi,2,0,2,Two people are kidnapped and beheaded by sectarian rivals.
15716,5/7/2011,Iraq,Kirkuk,3,0,3,Three Iraqis are gunned down by al-Qaeda.
15717,5/7/2011,Iraq,Taji,35,54,89,Two Fedayeen suicide bombers blast three dozen Iraqis to bits as the victims are waiting in line for ID cards.
15718,5/7/2011,Nigeria,Maiduguri,2,0,2,Two local cops are shot to death by Boko Haram cadres.
15719,5/7/2011,Pakistan,Quetta,9,20,29,The Taliban is suspected of staging three attacks on local security personnel that leaves nine dead.
15720,6/7/2011,India,Sopore,1,6,7,"Islamists set off a bomb outside a police station, killing an officer."
15721,6/7/2011,Dagestan,Makhachkala,3,6,9,Two civilians are among three killed when Islamic snipers fire on a police vehicle.
15722,6/7/2011,Iraq,Baqubah,2,19,21,A Shahid suicide bomber takes out two Iraqis.
15723,6/7/2011,Afghanistan,Kamdesh,38,7,45,Women are among three dozen Afghans who lose their lives to a vicious Taliban assault on two police posts.
15724,6/7/2011,Yemen,Loder,10,0,10,al-Qaeda militants ambush and execute ten local soldiers in cold blood.
15725,6/7/2011,Pakistan,Karachi,10,20,30,"Sectarian Jihadis pump machine-gun fire into a couple of buses, ending the lives of ten innocents."
15726,7/7/2011,Iraq,Fallujah,3,6,9,Mujahideen take down three civilians with a car bomb.
15727,7/7/2011,Iraq,Baqubah,1,1,2,An Islamic drive-by shooting in front of their house leaves a woman dead and her husband injured.
15728,8/7/2011,Iraq,Jurf al-Sakhar,2,0,2,Two civilians are killed by suspected al-Qaeda gunmen.
15729,9/7/2011,Pakistan,Mastung,1,0,1,A truck driver is murdered by Talibanis.
15730,9/7/2011,Pakistan,Jawakai,5,11,16,"Islamic militants fire on civilian vehicles, killing five passengers including a father and son."
15731,9/7/2011,Iraq,Baqubah,2,17,19,Planted bombs leave two Iraqis dead.
15732,9/7/2011,Thailand,Yala,1,0,1,A 47-year-old schoolteacher is shot to death by Islamic 'insurgents'.
15733,9/7/2011,Dagestan,Sovetskoye,1,0,1,"A school principal is labeled an ""adversary of Islam"" and murdered for opposing hijabs in school."
15734,9/7/2011,Dagestan,Karamakhi,1,0,1,A moderate cleric is gunned down during evening prayer by radicals.
15735,10/7/2011,Pakistan,Peshawar,2,4,6,Two policemen are killed by Taliban bombers.
15736,10/7/2011,Pakistan,Karachi,2,0,2,A youth and woman are kidnapped and tortured to death by suspected sectarian rivals.
15737,10/7/2011,Pakistan,Quetta,3,0,3,Three Shias are gunned down by Sunni extremists.
15738,10/7/2011,Nigeria,Suleija,3,0,3,At least two women are among three Christians killed by a Boko Haram bomb detonated outside a church.
15739,11/7/2011,Indonesia,West Nusa Tenggara,0,0,0,"A bomb explodes at an Islamic boarding school, apparently killing the trainer."
15740,11/7/2011,Pakistan,Battagram,7,19,26,Children are among seven people disassembled by a Shahid suicide bomber at a political rally.
15741,11/7/2011,Pakistan,Quetta,2,0,2,Two truck drivers are murdered by Taliban snipers.
15742,11/7/2011,Pakistan,Bara,1,2,3,"Muslim militants roll a hand grenade into a house, killing at least one occupant."
15743,11/7/2011,Pakistan,Khyber,2,0,2,Two men are killed when Islamists riddle their car with bullets.
15744,11/7/2011,Iraq,Rutba,3,0,3,A Sunni imam and his two brothers are beheaded by Religion of Peace rivals.
15745,11/7/2011,Thailand,Narathiwat,2,0,2,Husband and wife laborers are brutally shot to death in their car by Muslim 'insurgents.'
15746,11/7/2011,Nigeria,Maiduguri,3,0,3,"Hardliners detonate a bomb under a van, killing three occupants."
15747,11/7/2011,Thailand,Pattani,1,0,1,A teacher is gunned down by Islamic 'insurgents' while drinking tea at a shop.
15748,11/7/2011,Thailand,Pattani,1,0,1,A 62-year-old man is murdered by Muslim terrorists while on a cigarette run.
15749,12/7/2011,Pakistan,Bajaur,2,9,11,Women and children are among the casualties when radicals send a shell into a family home.
15750,12/7/2011,Iraq,Karbalah,2,19,21,Terror blasts at two gas stations leaves two dead.
15751,12/7/2011,Iraq,Abu Ghraib,2,4,6,A Fedayeen suicide bomber takes out two Iraqis.
15752,12/7/2011,Afghanistan,Kandahar,1,0,1,The Taliban take credit for the assassination of the president's brother by a trusted bodyguard.
15753,13/7/2011,Iraq,Mosul,3,1,4,A woman and taxi driver are killed in separate bomb attacks while Mujahideen also gun down a farmer.
15754,13/7/2011,Thailand,Pattani,2,0,2,Two Buddhist brothers working as construction workers are brutally murdered by Muslim gunmen.
15755,13/7/2011,India,Mumbai,26,126,152,An opera house and two other commercial areas are targeted by Religion of Peace bombers.  Twenty-six are killed and over a hundred more maimed.
15756,13/7/2011,Afghanistan,Tagab,6,7,13,Five French soldiers guarding a local council meeting are among six killed by a Shahid suicide bomber.
15757,14/7/2011,Afghanistan,Kandahar,6,15,21,"A suicide bomber detonates at a memorial service at a mosque, killing six mourners, including a child."
15758,14/7/2011,Pakistan,Zengara,3,3,6,Islamists execute a person for stealing and blow up two security personnel in a separate attack.
15759,14/7/2011,Iraq,Kirkuk,1,0,1,Sunni gunmen murder a civilian outside his home.
15760,14/7/2011,Pakistan,Chaman,4,9,13,Three children are among four killed when a hidden cache of terrorist explosives detonates near their home.
15761,15/7/2011,Iraq,Karbalah,6,20,26,Women are among six Shiite pilgrims sent to Allah by Sunni bombers.
15762,15/7/2011,Iran,Tehran,1,0,1,A prominent athlete is stabbed to death after 'insulting' the country's religious leader.
15763,15/7/2011,Thailand,Pattani,1,2,3,'Insurgents' shoot a Buddhist teen to death in front of his mother at a supermarket.
15764,16/7/2011,Afghanistan,Sangin,5,1,6,Two children are blown to bits in their mini-bus along with three members of the family by religious hardliners.
15765,16/7/2011,Pakistan,Peshawar,3,16,19,Taliban militants incinerate three workers in the process of blowing up an oil tanker.
15766,16/7/2011,Pakistan,Boshehra,11,0,11,Three women and a baby are among ten Sunnis shot at point blank range while sitting in a family van by suspected Shias.
15767,16/7/2011,Afghanistan,Lashkar Gah,1,0,1,A NATO soldier is shot in the back by a terrorist in an Afghan uniform.
15768,16/7/2011,Algeria,Bordi Menaiel,4,15,19,"A pair of al-Qaeda suicide bombers kill four people, including rescue personnel rushing to help victims of the first blast."
15769,16/7/2011,Iraq,Karbalah,2,26,28,Sunni motorcycle bombers murder two Shia pilgrims.
15770,16/7/2011,Dagestan,Makhachkala,0,2,2,Two moderate imams are seriously injured by their radical co-religionists.
15771,16/7/2011,Dagestan,Gedzhukh,1,0,1,A village head dies from injuries suffered from a Muslim shooting attack.
15772,16/7/2011,Iraq,Baghdad,2,8,10,Mujahid bombers take out two Iraqis riding a bus.
15773,17/7/2011,Iraq,Mosul,3,0,3,"Mujahideen murder a man, his wife, and their child with grenade shrapnel."
15774,17/7/2011,Pakistan,Mann Talab,1,0,1,A peace committee volunteer is tied to the back of a car and dragged to death by Lashkar-e-Islam.
15775,17/7/2011,Iraq,Mosul,3,0,3,A woman is among three people machine-gunned to death at a police checkpoint.
15776,17/7/2011,Thailand,Yala,3,0,3,"'Insurgents' pull up in a truck and open fire at point blank range on three vendors waiting to buy materials, killing all three."
15777,17/7/2011,Afghanistan,Kabul,2,0,2,Taliban terrorists break into a home and shoot two people to death.
15778,17/7/2011,Afghanistan,Baghlani Jadid,2,7,9,"Islamic militants open fire on a wedding party, killing two guests."
15779,18/7/2011,Chechnya,Vedono,2,7,9,Two Russians are blown to bits by Jihadi bombers.
15780,18/7/2011,China,Xingjian,4,1,5,"Muslim separatists, chanting 'Allah is the only god', attack a police station, hack two officers to death and two murder two others, including a woman and a teenage girl."
15781,18/7/2011,Pakistan,Upper Dir,16,0,16,"Video surfaces of sixteen police hostages brutally executed for ""having left Islam."""
15782,18/7/2011,Afghanistan,Farah,2,0,2,The Taliban send the beheaded bodies of two hostages to their families.
15783,18/7/2011,Afghanistan,Lashkar Gah,7,0,7,Seven local cops are poisoned by a Taliban operative in uniform and then shot point-blank while immobilized.
15784,18/7/2011,Afghanistan,Registan,4,0,4,Four police officers are murdered by Religion of Peace bombers.
15785,18/7/2011,Thailand,Pattani,1,0,1,A 64-year-old man is gunned down by 'insurgents' in front of his wife.
15786,19/7/2011,Thailand,Pattani,2,2,4,"Islamists bomb a group of men trying to protect teachers, killing two of the guards."
15787,19/7/2011,Thailand,Yala,1,15,16,Sixteen Thais are injured when terrorists set off a motorcycle bomb next to a school. One later dies of injuries.
15788,19/7/2011,Pakistan,Karachi,1,0,1,A shopkeeper is killed when two religious groups shoot at each other following a funeral.
15789,19/7/2011,Ghana,Yamata,1,0,1,"Calling the child ""haram"", a devout Muslim woman strangles a baby to death after finding out that it is illegitimate"
15790,19/7/2011,Pakistan,Landi Kotal,0,9,9,"Islamic militants lob mortars into a town, injuring nine children playing cricket."
15791,19/7/2011,Pakistan,Charkhel,2,0,2,"Religious radicals kill two hostages, burning a student and shooting the other civilian to death."
15792,19/7/2011,Somalia,Mogadishu,1,2,3,A guard loses his life to a Mujahid attack on the president's villa.
15793,20/7/2011,Iraq,Zarkush,2,1,3,Two Iraqis are dismantled by a roadside bomb.
15794,20/7/2011,Afghanistan,Kandahar,3,0,3,"Mujahideen attack a government building, killing at least three guards."
15795,20/7/2011,Yemen,Aden,1,0,1,A British businessman is killed in a targeted car bombing.
15796,21/7/2011,Iraq,Riyadh,1,2,3,A bomb intended for first responders to an earlier attack kills a civilian.
15797,21/7/2011,India,Alwar,1,0,1,A Hindu girl is gang-raped and murdered by a Muslim gang.
15798,22/7/2011,Canada,"Toronto, ON",1,0,1,A woman is 'honor killed' by her husband for seeking her independence (strangled in front of her child).
15799,22/7/2011,Iraq,Baqubah,4,0,4,Four policemen are assassinated at point-blank range by terrorists with silencers.
15800,22/7/2011,Iraq,Baghdad,2,8,10,Two people are killed by shrapnel when fundamentalists bomb a liquor store.
15801,22/7/2011,Iraq,Baghdad,3,9,12,A Jihadi bomb targeting medical responders leaves three people dead.
15802,22/7/2011,Pakistan,Surjani,1,0,1,A Shiite doctor is shot to death by Sipah-e-Sahaba Wahhabis.
15803,22/7/2011,Dagestan,Makhachkala,2,0,2,"Islamic radicals murder two ""non-believers"" in a shooting attack."
15804,22/7/2011,Afghanistan,Greshk,1,0,1,Religious fundamentalists kidnap and hang the 8-year-old son of a local policeman.
15805,23/7/2011,Nigeria,Maiduguri,8,28,36,At least eight people are blown to bits by Boko Haram bombers at a market.
15806,23/7/2011,Pakistan,Kohat,1,2,3,An 8-year-old girl is taken apart by a mortar fired by Islamic militants at a village hosting a peace committee.
15807,23/7/2011,Iraq,Baqubah,1,7,8,A civilian is murdered by a suicide car bomber.
15808,24/7/2011,Indonesia,Pandajaya,0,2,2,"Two tour buses carrying foreigners is fired on by Jihadi snipers, badly injuring the drivers"
15809,24/7/2011,Afghanistan,Kandahar,1,0,1,A young local woman is brutally shot to death on grounds that she worked for a Western humanitarian organization.
15810,24/7/2011,Pakistan,Naushki,5,0,5,"Sectarian Jihadis open fire outside a mosque, taking down five laborers."
15811,24/7/2011,India,Sopore,1,0,1,A civilian is shot to death outside his home by Islamic militants.
15812,24/7/2011,Pakistan,North Waziristan,1,0,1,The Taliban kidnap and execute an Afghan civilian.
15813,24/7/2011,Pakistan,Chak Malai,1,7,8,A Fedayeen bomber takes out a Pakistani at a checkpoint.
15814,24/7/2011,Yemen,Aden,9,21,30,An al-Qaeda suicide car bomber sends nine local security personnel to Allah.
15815,24/7/2011,Jordan,Zarqa,1,0,1,A 35-year-old woman is murdered by her brother for having sex outside of marriage.
15816,25/7/2011,Iraq,Muqdadiya,5,12,17,"Terrorists plant a bomb near a hospital which leaves five dead, including a child."
15817,25/7/2011,Iraq,Kirkuk,2,22,24,Two people bleed to death following a Mujahideen bomb blast at a restaurant.
15818,25/7/2011,Afghanistan,Helmand,2,0,2,"Two young boys, ages 9 and 13, are taken out by a Taliban landmine."
15819,25/7/2011,Thailand,Yala,0,7,7,Teachers are the targets of a bomb attack by Muslim 'insurgents'.
15820,25/7/2011,Egypt,Samalout,0,6,6,A pregnant woman is among six Christians brutally assaulted with iron rods by a Muslim mob angered over a church bell.
15821,26/7/2011,Pakistan,Faisalabad,6,0,6,A conservative Muslim father murders his six teenage daughters as punishment for illicit relationships.
15822,26/7/2011,Iraq,Kirkuk,2,0,2,A young boy and his father are murdered by suspected al-Qaeda.
15823,26/7/2011,Iraq,Mosul,3,4,7,A female Shiite doctor is among three Iraqis killed by sectarian Jihadis.
15824,26/7/2011,Thailand,Yala,1,0,1,Muslim 'insurgents' shoot a civilian to death in front of his 6-year-old daughter.
15825,26/7/2011,Afghanistan,Musazai,2,3,5,Two locals are killed when Taliban extremists assault a police post.
15826,26/7/2011,Pakistan,Mohmand,1,0,1,A teenage shepherd loses his life to an Islamist landmine.
15827,26/7/2011,Iraq,Diyala,6,27,33,Islamic terrorists invade an office building and shoot at least six people indiscriminately before fleeing.
15828,26/7/2011,Iraq,Hawija,2,0,2,A terrorist accidentally kills his own children with a premature car bomb blast.
15829,27/7/2011,Kenya,Mandera,1,3,4,al-Shabaab militants kill a local cop with a remote-controlled bomb.
15830,27/7/2011,Afghanistan,Kandahar,2,1,3,"A suicide bomber embraces his target as he detonates, killing one other victim as well."
15831,27/7/2011,India,Hyhama,1,2,3,An Indian officer is killed while defending an infiltration attempt by Pakistani-backed militants
15832,27/7/2011,Thailand,Pattani,2,0,2,Two guards are shot to death outside a singing competition.
15833,27/7/2011,Afghanistan,Kunduz,3,4,7,Three children are blown to bits by a Taliban rocket.  Four others are injured.
15834,28/7/2011,Pakistan,Quetta,1,0,1,A prayer leader is gunned down by Religion of Peace rivals.
15835,28/7/2011,India,Sopore,1,0,1,A civilian is shot to death by Islamic militants.
15836,28/7/2011,Iraq,Baghdad,1,8,9,"Fundamentalists car bomb a liquor store, killing one."
15837,28/7/2011,Afghanistan,Oruzgan,19,37,56,Ten children and two women are among nineteen people slaughtered during a coordinated Taliban attack.
15838,28/7/2011,Iraq,Tikrit,15,38,53,"Two suicide bombers detonate amid a line of Iraqis waiting for paychecks, killing at least fifteen."
15839,28/7/2011,Dagestan,Makhachkala,2,0,2,An elderly couple is stabbed to death in their home by an Islamic terrorist.
15840,28/7/2011,Dagestan,Makhachkala,1,0,1,A village chief is machine-gunned in his home by a Muslim 'insurgent'.
15841,28/7/2011,Philippines,Sulu,7,21,28,Abu Sayyaf cadres kill and barbarically mutilate seven local soldiers.
15842,28/7/2011,Afghanistan,Gereshk,5,2,7,Five people are killed when Sunni radicals ambush a police vehicle with civilians.
15843,29/7/2011,Egypt,Minya,2,2,4,Two Christians are taken out by snipers while riding in a car.
15844,29/7/2011,Afghanistan,Nahr-e-Saraj,19,3,22,Women and children are among nineteen torn to shreds by a Taliban bomb attack on their minibus.
15845,29/7/2011,Pakistan,Saryab,7,0,7,Seven Shia pilgrims waiting at a bus stop are shot like ducks in a row by determined Sunnis.
15846,29/7/2011,Yemen,Shaqra,9,20,29,Nine tribesmen are forced into a building by al-Qaeda gunmen and killed.
15847,29/7/2011,Yemen,Dofas,6,9,15,An al-Qaeda ambush leave six dead.
15848,30/7/2011,Pakistan,Quetta,11,3,14,"Lashkar-e-Jhangvi militants fire into a van carrying Shiite pilgrims, taking out eleven."
15849,30/7/2011,Egypt,Al Arish,5,19,24,Children are among the casualties when fundamentalists on motorbikes go on a shooting spree while shouting Islamic slogans.
15850,30/7/2011,India,Kupwara,3,0,3,Three more security personnel die during an attack by Pakistani-backed terrorists.
15851,30/7/2011,Iraq,Taji,2,5,7,Jihad bombers take down a pair of Iraqis.
15852,30/7/2011,Afghanistan,Muqur,10,6,16,Ten private security guards lose their lives to Taliban attackers shouting 'Allah Akbar'.
15853,31/7/2011,Somalia,Mogadishu,1,0,1,al-Shabaab gunmen assassinate a lawmaker outside a hotel.
15854,31/7/2011,Thailand,Narathiwat,1,0,1,A juice trader is shot to death at a market by Islamic terrorists.
15855,31/7/2011,Afghanistan,Lashkar Gah,13,12,25,A 10-year-old boy is among those killed in a suicide car bomb attack claimed by Sunni radicals.
15856,31/7/2011,China,Kashgar,8,22,30,"Muslim radicals hijack a truck and ram it into a crowd of Han (non-Muslims), then begin a stabbing spree that leaves eight dead."
15857,31/7/2011,China,Kashgar,3,0,3,Three people are killed by a Muslim bomb blast in a downtown district.
15858,31/7/2011,Algeria,Tissemsilt,3,6,9,"Fundamentalists bomb a vehicle carrying local soldiers, killing three."
15859,31/7/2011,Pakistan,Tank,1,0,1,A tribal elder is assassinated at a market by religious extremists.
15860,31/7/2011,Iraq,Baghdad,2,0,2,An education official and his son are executed by Muslim 'insurgents'.
15861,31/7/2011,China,Kashgar,6,0,6,"Members of the East Turkistan Islamic Movement kill a restaurant owner and waiter, then hack four others to death."
15862,1/8/2011,Pakistan,Dera Ismail Khan,1,2,3,A prayer leader is shot and killed by Religion of Peace rivals.
15863,1/8/2011,Pakistan,Atariwal,1,1,2,A woman dies from injuries when Taliban militants fire a rocket into her home.
15864,1/8/2011,Pakistan,Munda,3,0,3,Three civilians are cut down by Mujahid gunmen while gathering wood.
15865,1/8/2011,Iraq,Baghdad,0,1,1,Terrorists wound two children with a sticky bomb.
15866,1/8/2011,Somalia,Mogadishu,2,5,7,Two African peacekeepers are blown to bits by a Fedayeen suicide bomber.
15867,1/8/2011,Pakistan,Quetta,2,3,5,al-Qaeda militants are suspected of planting a bomb at a garbage dump that leaves two children dead.
15868,1/8/2011,Afghanistan,Nimroz,3,3,6,Three Afghans are dismantled by a Taliban roadside bomb.
15869,2/8/2011,Pakistan,South Waziristan,4,1,5,Tehreek-e-Taliban militants kill four local soldiers in two ambushes.
15870,2/8/2011,Iraq,Abu Ghraib,2,16,18,A liquor store is among the targets of two separate bombings in which two people are killed.
15871,2/8/2011,Dagestan,Buynaksk,2,1,3,An Islamist bomb attack leaves two dead.
15872,2/8/2011,Afghanistan,Kunduz,4,10,14,Four are killed when Muslim extremists stage a Shahid attack on a guesthouse used by foreigners.
15873,2/8/2011,Philippines,Cotabato,2,9,11,A 7-year-old child is among two killed by a Jemaah Islamiyah bomb blast.
15874,2/8/2011,Iraq,Kirkuk,0,23,23,Two dozen are injured when radicals bomb a Catholic church.
15875,3/8/2011,Somalia,Sar-Kuusta,4,8,12,Four people lose their lives to an al-Shabaab attack.
15876,3/8/2011,Iraq,Rasala,4,14,18,Four Iraqis are killed when fundamentalists bomb a liquor store.
15877,3/8/2011,Afghanistan,Kandahar,3,0,3,Sunni bomb makers take down a child and two others.
15878,3/8/2011,Pakistan,Darra Adamkhel,1,7,8,One person is killed when Islamic militants send dozens of mortar shells into a village.
15879,3/8/2011,Iraq,Ramadi,9,13,22,A brutal double bomb attack in a commercial district leaves nine dead.
15880,3/8/2011,Iraq,Baghdad,1,0,1,Holy warriors stab an army officer to death in his home.
15881,3/8/2011,Thailand,Pattani,1,0,1,A Buddhist teacher is shot twice in the head by warriors of Islam.
15882,4/8/2011,Thailand,Pattani,2,0,2,Muslim terrorists are suspected of murdering a married couple driving home from their job as laborers.
15883,4/8/2011,Thailand,Yala,1,0,1,A 38-year-old man is shot to death by Jihadi gunmen.
15884,4/8/2011,Afghanistan,Kunduz,1,3,4,Three young girls are among the casualties of a Taliban car bomb.
15885,4/8/2011,Ingushetia,Nazran,2,2,4,Islamic militants shoot two police officers to death as they are sitting in their car.
15886,4/8/2011,Afghanistan,Ghazni,2,0,2,Two civilians bleed to death following a Taliban bomb attack.
15887,4/8/2011,Pakistan,Kukikhel,1,0,1,A passerby is caught in the cross-fire when two Islamist groups clash at a market.
15888,4/8/2011,Iraq,Baghdad,1,13,14,Holy Warriors take down a child with a car bomb.
15889,5/8/2011,Pakistan,Adezai,1,0,1,Islamists drag an infidel out of a mosque and execute him.
15890,5/8/2011,Iraq,Khalis,3,2,5,A sectarian mortar attack leaves three Iraqis dead.
15891,5/8/2011,Thailand,Pattani,3,1,4,Three Buddhists are shot point blank by Muslim radicals.
15892,5/8/2011,Pakistan,Drigh Road,1,0,1,A Catholic man with children is the target of an attack that leaves his driver dead.
15893,6/8/2011,Pakistan,Karachi,2,0,2,Two Shias are gunned down in separate sectarian attacks.
15894,6/8/2011,Iraq,Ramadi,2,7,9,"Terrorists target a sports stadium with coordinated blasts, killing two Iraqis."
15895,6/8/2011,Iraq,Baghdad,2,0,2,A shop owner and his son are shot to death by Islamic 'insurgents'.
15896,6/8/2011,Pakistan,Mohmand,1,0,1,A suicide bomber kills an innocent person at a market.
15897,7/8/2011,Pakistan,Shalobar,2,0,2,Two tribesmen are executed by religious extremists.
15898,7/8/2011,Iraq,Abu Ghraib,2,2,4,A father and son are taken out by a Jihad bomb attack on their home.
15899,7/8/2011,Iraq,Iskandariyah,6,14,20,Two children are among six Shia family members bleeding to death following a bombing of their home.
15900,8/8/2011,Dagestan,Karamakhi,1,0,1,A local cop is gunned down by Islamists.
15901,8/8/2011,Nigeria,Maiduguri,1,0,1,A teacher is shot to death by Boko Haram Islamists.
15902,8/8/2011,Nigeria,Maiduguri,1,0,1,Boko Haram cadres assassinate a prison comptroller.
15903,8/8/2011,Iraq,Mosul,4,1,5,A child and woman are among the dead victims of two Jihad bombings.
15904,8/8/2011,Egypt,Minya,1,1,2,"A Christian farmer has his throat slit in front of his son by a Muslim mob, who attack Christian homes and also severely beat a pastor."
15905,9/8/2011,Thailand,Pattani,1,0,1,A 52-year-old man is shot several times in the head and chest by 'insurgents'.
15906,9/8/2011,Dagestan,Kadar,1,0,1,A policeman is murdered on the doorstep of his home by Islamic 'insurgents'.
15907,9/8/2011,Afghanistan,Bala Bulok,4,0,4,Four civilians are kidnapped and beheaded by Sunni hardliners.
15908,9/8/2011,Afghanistan,Dehrawod,5,1,6,Taliban bombers take down five Afghans at a crowded market.
15909,9/8/2011,Pakistan,Manshera,1,0,1,Islamic radicals shoot a tribesman to death.
15910,10/8/2011,Pakistan,Shadman,1,0,1,The caretaker of a shrine is shot to death by Muslim terrorists.
15911,11/8/2011,Pakistan,Peshawar,1,20,21,"A female Shahid suicide bomber tosses grenades before detonating, killing another woman."
15912,11/8/2011,Pakistan,Peshawar,6,17,23,A child is among six innocents blown to bits by Islamist bombers.
15913,11/8/2011,Pakistan,Tirah Valley,5,1,6,Three women and two children are dismantled by a militant bomb attack on their home.
15914,11/8/2011,Pakistan,Chapperi,2,0,2,Two tribesmen are shot to death by terrorists.
15915,11/8/2011,Iraq,Ramadi,3,24,27,'Insurgents' kill three Iraqis in their home with two bombs.
15916,11/8/2011,Nigeria,Ratsa Foron,6,0,6,Six Christians are hacked to death in the middle of the night by Muslim raiders.
15917,11/8/2011,Indonesia,Malei,1,0,1,A Christian is killed while trying to salvage items from his home after it is destroyed by a Muslim mob.
15918,12/8/2011,Indonesia,Sepe,5,2,7,"Jihad warriors attack a Christian village with bombs and knives, killing at least five residents and burning homes and churches."
15919,12/8/2011,Pakistan,Bilal,0,12,12,A small group of Catholics are beaten by fundamentalists after gathering to watch a religious film.
15920,12/8/2011,Pakistan,Haridasnagar,1,1,2,A man is beaten to death after being accused of sorcery.
15921,12/8/2011,Dagestan,Khasavyurt,2,0,2,Two policemen standing outside a mosque are murdered by angry Muslims.
15922,12/8/2011,Nigeria,Ngala,1,0,1,A 65-year-old cleric is shot to death by Islamic radicals.
15923,12/8/2011,Afghanistan,Wardak,8,0,8,Eight local security personnel are abducted and murdered by Sunni fundamentalists.
15924,12/8/2011,Pakistan,Peshawar,3,3,6,Three guards escorting prisoners for medical attention are cut down by Taliban gunmen.
15925,12/8/2011,Iraq,Baghdad,2,13,15,"Terrorists bomb a cafe, killing two Iraqis."
15926,12/8/2011,Dagestan,Kurush,2,0,2,Two civilians are murdered by Muslim 'separatists' wielding machine-guns.
15927,13/8/2011,Iraq,Baghdad,1,0,1,A Shiite cleric is gunned down by Religion of Peace rivals.
15928,13/8/2011,Dagestan,Khasavyurt,1,1,2,A fireman is shot to death by suspected Islamic militants.
15929,13/8/2011,Afghanistan,Helmand,5,0,5,Three women are among five civilians taken apart by a Taliban bomb.
15930,13/8/2011,Dagestan,Boatshyurt,4,0,4,Four victims of Muslim 'insurgents' are found bound and shot to death.
15931,13/8/2011,Dagestan,Makhachkala,2,0,2,Suspected Islamists shoot two civilians to death in front of their home.
15932,13/8/2011,India,Kerala,1,0,1,"A Hindu woman is kidnapped, gang-raped and killed by Muslim militants."
15933,13/8/2011,Pakistan,Lahore,1,0,1,A grown woman is shot to death by her nephew on suspicion of 'illicit relations'.
15934,14/8/2011,Pakistan,Karachi,0,2,2,Two Christians are beaten to unconsciousness with iron rods after refusing an offer to embrace Islam.
15935,14/8/2011,Pakistan,Karachi,0,1,1,A Christian is beaten with iron rods after declining an offer to embrace Islam.
15936,14/8/2011,Ingushetia,Dattykh,4,7,11,Four security personnel are executed by Muslim gunmen.
15937,14/8/2011,Iraq,Baghdad,8,13,21,Separate bombings targeting security personnel leave at least eight dead.
15938,14/8/2011,Algeria,Tizi Ouzou,0,33,33,"'Thanks to Allah' an al-Qaeda suicide bomber injures at least thirty-three people, including foreigners."
15939,14/8/2011,Afghanistan,Charikar,22,34,56,"Five Fedayeen stage a suicide assault on a government compound, shooting and blasting at least twenty-two others to death."
15940,14/8/2011,Pakistan,Miramshah,3,25,28,Three local soldiers are killed when Islamic militants fire rockets into their camp during a celebration.
15941,14/8/2011,Thailand,Pattani,1,0,1,'Insurgents' shoot a man to death outside a mosque.
15942,15/8/2011,Iraq,Kirkuk,0,14,14,Fourteen are injured when Muslims bomb a church.
15943,15/8/2011,Iraq,Kut,42,75,117,Over three dozen shoppers at a market are snuffed out by al-Qaeda bombers.  The dead include twelve children.
15944,15/8/2011,Yemen,al-Jouf,14,5,19,An al-Qaeda suicide attack leaves fourteen Shiite tribesmen dead.
15945,15/8/2011,Iraq,Najaf,11,74,85,Seven Shias are left dead after a brutal bombing by Sunni militants.
15946,15/8/2011,Iraq,Tikrit,6,10,16,Suicide bombers send six Iraqis to Allah.
15947,15/8/2011,Iraq,Karbala,3,41,44,Three Iraqis are taken down by Mujahid car bombers.
15948,15/8/2011,Iraq,Bani Sa'ad,12,33,45,Sunni car bombers take down eight Shia.  Four other Iraqis are gunned down in a separate attack.
15949,15/8/2011,Iraq,Karbala,3,41,44,A Jihad car bomb leaves at least three dead.
15950,15/8/2011,Iraq,Yusufiya,7,0,7,al-Qaeda kidnap seven Sahwa members from a mosque and execute them in cold blood.
15951,15/8/2011,Nigeria,Sokoto,6,0,6,A half-dozen Nigerians are taken out by Boko Haram terrorists.
15952,15/8/2011,Nigeria,Foron,3,0,3,Three people are hacked to death by angry Muslims with machetes
15953,15/8/2011,Nigeria,Heipang,9,1,10,Seven children are among a Christian family of nine brutally murdered in their home by Muslim raiders.
15954,15/8/2011,Afghanistan,Spin Boldak,4,8,12,Four guards at a fuel depot die during a Fedayeen assault.
15955,16/8/2011,Afghanistan,Uruzgan,8,8,16,Eight innocents are dismantled by a Taliban motorcycle bomb at a market.
15956,16/8/2011,Afghanistan,Kandahar,1,0,1,Fundamentalist gunmen murder an 18-year-old teenager as she is getting into her car.
15957,16/8/2011,Iraq,Buhriz,2,0,2,Two boys are shot to death in their own home by 'insurgents'.
15958,16/8/2011,Iraq,Mosul,8,12,20,Eight local police are murdered in two separate bombings.
15959,16/8/2011,Pakistan,Karachi,1,0,1,Nasabi-Wahhabi terrorists gun down a Shia shopkeeper.
15960,17/8/2011,Pakistan,Chamarkand,2,0,2,A man and his son are gunned down by Muslim terrorists.
15961,17/8/2011,Iraq,Tarmiya,2,7,9,A suicide bomber takes down two family members in their own home.
15962,17/8/2011,Iraq,Baghdad,2,3,5,Jihad gunmen kill a cafe owner and marketplace patron in separate attacks.
15963,17/8/2011,Thailand,Pattani,1,0,1,An elderly Buddhist school bus driver is murdered by Islamic snipers.
15964,17/8/2011,Thailand,Narathiwat,3,0,3,A rubber tapper is among three civilians shot to death by Muslim gunmen in separate attacks.
15965,17/8/2011,Algeria,Beni Aissa,2,1,3,A bus driver is among two people who lose their lives to a fundamentalist ambush.
15966,18/8/2011,Ingushetia,Nazran,1,0,1,Three Muslim extremists shoot a cop to death in his home.
15967,18/8/2011,Egypt,Sinai,6,0,6,"Terrorists fire on Egyptian police, killing six."
15968,18/8/2011,Afghanistan,Herat,24,9,33,Seven children are among two dozen bus passengers torn to shreds by Taliban bombers.
15969,18/8/2011,Afghanistan,Gardez,2,0,2,A Shahid suicide bomber kills two guards trying to stop him.
15970,18/8/2011,Israel,Eilat,8,30,38,"Eight Israelis, including four family members, die when Arab snipers open fire on buses and cars."
15971,18/8/2011,Pakistan,Tirah,1,0,1,The Taliban behead a man for 'crimes against Islam'.
15972,18/8/2011,Pakistan,Quetta,1,0,1,A mosque official is gunned down by rivals.
15973,18/8/2011,Pakistan,Karachi,3,0,3,"Three people are kidnapped, executed and dumped outside a mosque in a suspected sectarian attack."
15974,19/8/2011,Somalia,Mogadishu,7,0,7,Seven youth are beheaded by al-Shabaab fundamentalists.
15975,19/8/2011,Afghanistan,Kabul,9,16,25,"Two Holy Warriors detonate themselves in front of the British council, killing nine innocents."
15976,19/8/2011,Pakistan,Kurram,3,3,6,A Taliban landmine takes out three locals.
15977,19/8/2011,Israel,Ashdod,0,10,10,"Gaza militants send rockets into an Israeli seminary, injuring ten."
15978,19/8/2011,Pakistan,Jamrud,56,123,179,"A devout Shahid detonates a ball-bearing packed suicide vest at a crowded mosque, slaughtering over fifty others."
15979,19/8/2011,Thailand,Pattani,2,0,2,"Two Buddhist mattress salesmen, father and son, are shot in the head by Muslim 'activists'."
15980,20/8/2011,Nigeria,Borno,4,0,4,Islamists burst into a home and murder four people watching television.
15981,20/8/2011,Afghanistan,Ghazni,3,2,5,Religious extremists take out three civilians with a roadside bomb.
15982,20/8/2011,Afghanistan,Herat,2,8,10,Two Afghan security personnel are killed by fundamentalist bombers.
15983,20/8/2011,Iraq,Hadid,3,0,3,Three family members are killed by Mujahideen bombers.
15984,20/8/2011,India,Gurez,1,2,3,A local defender loses his life to an attack by Pakistani-backed militants.
15985,20/8/2011,Israel,Beersheba,1,8,9,Children are among the casualties when Hamas sends rockets into an Israeli town.
15986,20/8/2011,Afghanistan,Kunar,2,0,2,"Two Afghan soldiers returning home leave are stoned, hanged and shot by the Taliban."
15987,21/8/2011,Afghanistan,Trekh Zaber,1,0,1,Religious extremists murder a 60-year-old Afghan farmer in front of his sons.
15988,21/8/2011,Nigeria,Bajju,2,3,5,"Suspected Muslim radicals shoot two Christians to death in their homes, including a 10-year-old boy."
15989,21/8/2011,Thailand,Yala,1,0,1,Islamic gunmen murder a 23-year-old man outside a shop.
15990,21/8/2011,Yemen,Arqoup,9,20,29,Nine members of a tribal gathering are sent to Allah by a Shahid suicide bomber.
15991,21/8/2011,Yemen,Moudia,4,0,4,Four people are torn to pieces by an al-Qaeda suicide bomber with a ball-bearing packed belt.
15992,21/8/2011,Afghanistan,Helmand,1,0,1,Taliban gunmen assassinate a court official on his way to work.
15993,21/8/2011,Pakistan,South Waziristan,3,6,9,Three defenders are killed during an assault by Islamic militants on their police post.
15994,21/8/2011,Dagestan,Makhachkala,0,17,17,Children are among the casualties when Islamic 'separatists' set off two bombs at a grocery store.
15995,21/8/2011,Nigeria,Riyom,6,0,6,"Fulani raiders attack a Christian village, hacking six to death, including women and children."
15996,22/8/2011,Afghanistan,Gereshk,2,4,6,A child and a shop owner are successfully killed by Mujahideen bombers at a market.
15997,22/8/2011,India,Handwara,1,1,2,A housewife is killed when Muslim terrorists open fire on security forces at a village.
15998,22/8/2011,Pakistan,Khyber,2,0,2,"Tahreek-e-Taliban militants kidnap, bind and then shoot two rivals."
15999,22/8/2011,Iraq,Baqubah,2,0,2,A 3-year-old girl and her father are shot to death by Islamic 'insurgents' in their home.
16000,22/8/2011,Iraq,Mosul,4,3,7,"A car-bombing and separate shooting attack leave four Iraqis dead, including a teenager."
16001,22/8/2011,Thailand,Narathiwat,1,0,1,A man is shot to death by Muslim terrorists while working a rubber plantation.
16002,23/8/2011,Algeria,Taouarga,1,2,3,Fundamentalists machine-gun a local soldier to death at a checkpoint.
16003,23/8/2011,Thailand,Pattani,2,14,16,Buddhist monks are among the casualties of two bombings that claim two lives.
16004,23/8/2011,Nigeria,Maiduguri,1,1,2,Boko Haram gunmen shoot a woman 7-months pregnant to death in her home.
16005,23/8/2011,Afghanistan,Balkh,2,3,5,Sunni radicals kill two cops with a roadside bomb.
16006,23/8/2011,Pakistan,Datta Khel,1,0,1,The Taliban shoot a refugee to death.
16007,23/8/2011,Yemen,Abyan,8,28,36,Eight security personnel are killed during an al-Qaeda ambush.
16008,24/8/2011,Thailand,Pattani,1,0,1,Mujahideen gun down a school guard.
16009,24/8/2011,Thailand,Songkhla,2,0,2,Two security personnel die during an Islamist ambush.
16010,24/8/2011,India,Avdesh,2,0,2,Two brothers are abducted and murdered by Hizb-ul-Mujahideen.
16011,24/8/2011,Iraq,Ramadi,2,7,9,"Sunni snipers fire on a car carrying civilians, killing two."
16012,24/8/2011,Iraq,Ramadi,6,8,14,A suicide car bomber takes out a half dozen Iraqis.
16013,24/8/2011,Afghanistan,Paktia,3,9,12,"Islamists send rockets into a market, taking out at least three patrons, including a child."
16014,24/8/2011,Iraq,Diyala,5,9,14,A woman and child are among five innocents exterminated by Jihadi bombers.
16015,24/8/2011,Thailand,Pattani,1,0,1,A 60-year-old man is shot in the head by Muslim 'insurgents' while walking home.
16016,25/8/2011,Nigeria,Gombi,16,12,28,"Two banks and a police station are the target of 'Allah Akbar' screaming Islamists, who leave at least sixteen innocents dead."
16017,25/8/2011,Iraq,Jbela,3,1,4,"Islamic militants fire on a vehicle, killing a boy, his father and an uncle."
16018,25/8/2011,Somalia,Mogadishu,1,0,1,A 19-year-old man is beheaded by al-Shabaab.
16019,25/8/2011,Thailand,Yala,2,9,11,A 3-year-old girl and her father are shot to death by Holy Warriors.
16020,25/8/2011,Pakistan,Nowshera,12,17,29,A dozen people at a restaurant are sent to Allah by bombers who hid their device on a child's tricycle.
16021,25/8/2011,Iraq,Basra,3,50,53,"Holy Warriors detonate a car bomb outside a rival mosque, killing at least three."
16022,25/8/2011,India,Baramulla,2,15,17,Two people die from splinter injuries after an Islamist tosses a grenade into a market.
16023,25/8/2011,Iraq,Fallujah,9,34,43,A series of Jihad car bombings leaves at least nine dead.
16024,26/8/2011,Thailand,Narathiwat,5,1,6,Five rescue workers are blown apart by a bomb placed under their car.
16025,26/8/2011,Somalia,Mogadishu,2,0,2,Two young boys are beheaded by Islamic radicals.
16026,26/8/2011,Algeria,Cherchell,18,26,44,Two al-Qaeda suicide bombers murder eighteen soldiers and civilians following the break of daily Ramadan fasting.
16027,26/8/2011,Thailand,Narathiwat,1,0,1,Muslim 'insurgents' shoot a Buddhist laborer to death.
16028,26/8/2011,Afghanistan,Herat,1,10,11,A woman is blown to bits by a Taliban bomb hidden in a handcart.
16029,26/8/2011,Nigeria,Abuja,23,68,91,Over two dozen people at a UN building housing humanitarian agencies are crushed to death by a suicide car bomber.
16030,26/8/2011,Norway,Jaeren,0,1,1,A Christian convert from Islam is scalded with boiling water and acid at a refugee center.
16031,27/8/2011,Nigeria,Maiduguri,1,0,1,A Protestant evangelist is assassinated in his own home by Religion of Peace enthusiasts.
16032,27/8/2011,Iraq,Fallujah,2,0,2,Two Sunni leaders are gunned down by Muslim rivals.
16033,27/8/2011,Algeria,Ataq,2,3,5,Two guards at an oil facility are shot to death by al-Qaeda militants.
16034,27/8/2011,Iraq,Baghdad,8,15,23,Sunni bombers take down eight Iraqis in three attacks.
16035,27/8/2011,Afghanistan,Kandahar,4,19,23,A suicide bomber manages to kill an Afghan child and three others.
16036,27/8/2011,Afghanistan,Lashkar Gah,4,21,25,Three children are among four civilians torn to shreds by a suicide bombing outside a bank.
16037,27/8/2011,Pakistan,Kohat,1,0,1,A retired man is abducted by Muslim radicals and executed.
16038,27/8/2011,Pakistan,Chitral,32,9,41,A massive Taliban assault across the border leaves dozens of security personnel and civilians dead.
16039,27/8/2011,Somalia,Mogadishu,1,1,2,A woman dies from injuries suffered from an Islamic bomb attack.
16040,27/8/2011,Thailand,Yala,1,0,1,A 24-year-old civilian is shot to death by Muslim gunmen.
16041,28/8/2011,Iraq,Baghdad,29,37,66,A Holy Warrior praises Allah before detonating at a Sunni mosque and laying out two dozen worshippers.
16042,28/8/2011,Afghanistan,Takhar,2,0,2,A doctor and medical worker are murdered by Taliban bombers.
16043,28/8/2011,Pakistan,Faisalabad,0,1,1,A 64-year-old maid is beaten by madrassah students for hosting a Christian prayer meeting in her home.
16044,28/8/2011,Thailand,Pattani,1,0,1,Muslim 'rebels' kill a plantation worker with a bomb.
16045,28/8/2011,Yemen,Dofas,17,45,62,Seventeen local soldiers die during the aftermath of an al-Qaeda ambush.
16046,28/8/2011,Pakistan,Punjab,3,6,9,Sectarian Jihadis take down three rivals.
16047,28/8/2011,Iraq,Salman Pak,1,4,5,'Insurgents' shoot a woman to death at a checkpoint.
16048,29/8/2011,Iraq,Mosul,2,9,11,A Shahid suicide bomber sends two other souls to Allah.
16049,29/8/2011,Iraq,Baqubah,3,2,5,Three Iraqis are gunned down by Mujahideen.
16050,29/8/2011,Israel,Tel Aviv,0,8,8,A Palestinian shouting 'Allah Akbar' stabs eight nearby Israelis.
16051,29/8/2011,Nigeria,Jos,2,1,3,A pastor who preached religious tolerance is hacked to death by Islamic extremists along with his son at their church.
16052,30/8/2011,Chechnya,Grozny,9,22,31,"Three suicide bombers detonate among bustling street crowd, killing nine."
16053,31/8/2011,Ingushetia,Nazran,2,0,2,Salafi bomber kill two people with a car bomb.
16054,31/8/2011,Iraq,Baghdad,5,22,27,Five shoppers at a mall are taken down by Jihadi bombers.
16055,31/8/2011,Pakistan,Quetta,11,22,33,Children are among the victims of a Sunni suicide blast at a Shia mosque during worship.
16056,1/9/2011,Pakistan,Kurram,7,1,8,Seven Shias riding a minibus are machine-gunned to death by Sunni rivals.
16057,1/9/2011,Dagestan,Khasavyurt,1,3,4,Women are among the casualties of an Islamist car bombing.
16058,1/9/2011,Pakistan,Lakki Marwat,5,35,40,Five civilians are crushed under collapsing buildings during by a Fedayeen suicide car bombing.
16059,2/9/2011,Somalia,Hudur,1,0,1,A convert to Christianity is kidnapped and beheaded by Muslim activists.
16060,2/9/2011,Iraq,Baghdad,1,0,1,A government official is assassinated by Islamic terrorists.
16061,2/9/2011,Ingushetia,Nesterovskaya,1,0,1,A local religious figure is shot to death by suspected Muslim militants.
16062,3/9/2011,Yemen,Aden,3,7,10,A Shahid suicide bomber kills three local cops.
16063,3/9/2011,Kenya,Madera,1,3,4,Somali Islamists are suspected of a bomb attack that leaves a Kenyan dead.
16064,4/9/2011,Pakistan,Mariamabad,1,0,1,A Catholic pilgrim is kidnapped and murdered while walking to a shrine.
16065,4/9/2011,Pakistan,Godhra,5,7,12,Five people are killed when two rival Islamic groups work out their differences.
16066,4/9/2011,Afghanistan,Kandahar,3,21,24,"A Holy Warrior detonates in the prayer area of a security office, killing three others."
16067,4/9/2011,Iraq,Mosul,1,1,2,A man is shot to death in his home by Mujahideen.
16068,4/9/2011,Nigeria,Zannari,1,0,1,Boko Haram Islamists assassinate a local scholar.
16069,4/9/2011,Iran,Ahvaz,3,0,3,Three people are hung for 'forbidden acts against religion'.
16070,5/9/2011,Nigeria,Zakalio,7,0,7,Seven Christian villagers are murdered by Muslim extremists.
16071,5/9/2011,Iraq,Kirkuk,2,0,2,Jihadis shoot a skilled neurologist to death along with his brother.
16072,5/9/2011,Pakistan,Faisalabad,1,0,1,Islamic seminary students shoot an innocent member of the Ahmadi sect to death.
16073,5/9/2011,Thailand,Pattani,2,1,3,Muslim prisoners target and murder two Buddhist inmates.
16074,5/9/2011,Afghanistan,Qaisar,5,0,5,Sunni militants take out five civilians with a well-placed roadside bomb.
16075,5/9/2011,Afghanistan,Parwan,2,0,2,The bodies of two German hikers are found three weeks after they were abducted and shot to death.
16076,5/9/2011,Nigeria,Tatu,8,0,8,A Christian family of eight including the parents and six children are hacked to death by Muslim militants in their home.
16077,5/9/2011,Nigeria,Dabwak,4,0,4,An elderly Christian couple and their two grandchildren are shot to death in their home by Muslim raiders.
16078,5/9/2011,Pakistan,Humrang Beebak,2,0,2,Two brothers are abducted and murdered by Islamic terrorists.
16079,6/9/2011,Iraq,Anbar,9,0,9,"Terrorists machine-gun a bus carrying Iraqi soldiers at point-blank range, killing all eight passengers and their driver."
16080,6/9/2011,Nigeria,Zakaleo,4,0,4,Four Christians are burned alive when militant Muslims set fire to their house.
16081,6/9/2011,Nigeria,Kuru,14,13,27,Fourteen residents of a Christian village are hacked and shot to death in an orgy of Islamic violence that lasts an hour.
16082,6/9/2011,Yemen,Abyan,5,3,8,An al-Qaeda attack leaves five local soldiers dead.
16083,6/9/2011,Thailand,Yala,1,0,1,"Islamists kill a 38-year-old Buddhist teacher, then set his body on fire."
16084,6/9/2011,Thailand,Narathiwat,2,5,7,"A 9-year-old boy is among the victims of two attacks by Muslim gunmen, one at a teahouse."
16085,6/9/2011,Afghanistan,Kabul,1,0,1,The Taliban are suspected of killing a U.S. citizen.
16086,7/9/2011,India,New Delhi,15,89,104,Harkat-ul-Jihad-al-Islami cadres use a suitcase bomb to murder fifteen others outside a packed courtroom.
16087,7/9/2011,Pakistan,Quetta,26,80,106,Twin suicide bombers send over two dozen souls to Allah including a woman and three children.
16088,7/9/2011,Iraq,Dujail,1,0,1,Terrorists enter a home and shoot a man to death in front of his wife.
16089,7/9/2011,Iraq,Baghdad,1,6,7,One Iraqi is killed when Jihadis bomb a marketplace.
16090,8/9/2011,Nigeria,Tsohon Foron,10,0,10,Muslim extremists murder a family of ten Christians.
16091,8/9/2011,Afghanistan,Herat,3,0,3,Sunni bombers take down an engineer and two other employees at a construction company.
16092,8/9/2011,Thailand,Narathiwat,1,0,1,A man driving a pickup truck is shot in the head by Muslim 'insurgents'.
16093,8/9/2011,Afghanistan,Khost,5,0,5,Five Afghans lose their lives to roadside bombers.
16094,8/9/2011,Somalia,Coast,1,2,3,Muslim 'pirates' shoot an unarmed French sailor on his own yacht.
16095,8/9/2011,Afghanistan,Sangin,7,5,12,A Shahid suicide bomber takes out seven Afghans with a nail-packed car bomb.
16096,9/9/2011,Thailand,Narathiwat,1,0,1,A 26-year-old policeman is shot to death by Muslim terrorists.
16097,9/9/2011,Pakistan,Islamabad,1,0,1,A Christian imprisoned for 'offending the Quran' dies after being denied medical treatment by prison officials.
16098,9/9/2011,Nigeria,Kunsen Gashish,3,0,3,Three Protestant farmers are hacked to death by machete-wielding Muslims.
16099,9/9/2011,Nigeria,Barkin Ladi,9,0,9,A Christian father and his seven young children are among nine shot to death in a Fulani raid on their home.
16100,9/9/2011,Afghanistan,Manogai,4,0,4,Four local security personnel are killed by Taliban bombers.
16101,9/9/2011,Somalia,Mogadishu,5,10,15,An al-Shabaab bomb left on the street sends five souls to Allah.
16102,10/9/2011,Yemen,Zinjibar,2,4,6,An al-Qaeda mine takes out two local soldiers.
16103,10/9/2011,Nigeria,Vwang Fwil,14,6,20,"Fourteen Christian villagers from the same family, including a woman in labor, are hacked to death during a midnight Muslim raid."
16104,10/9/2011,Afghanistan,Ghazni,1,0,1,Religious radicals assassinate a police chief.
16105,10/9/2011,Afghanistan,Bagram,2,0,2,Two security guards are killed by a Taliban rocket.
16106,11/9/2011,USA,"Waltham, MA",3,0,3,Three Jewish men have their throats slashed by Muslim terrorists.
16107,11/9/2011,England,London,0,2,2,Two activists are stabbed by Muslims after disparaging Islam.
16108,11/9/2011,Afghanistan,Herat,3,0,3,Three policemen are shot to death by Religion of Peace hardliners.
16109,11/9/2011,Afghanistan,Gortepa,5,0,5,Three children are among five civilians disassembled by a homemade Sunni bomb.
16110,11/9/2011,Afghanistan,Bermel,6,9,15,"The Taliban take out six civilians, including two women, with a roadside bomb."
16111,11/9/2011,Afghanistan,Wardak,5,94,99,Children are among the casualties when Fedayeen detonate a truck bomb.
16112,11/9/2011,Kenya,Lamu,1,1,2,al-Shabaab radicals are suspected of shooting an unarmed man on his honeymoon and kidnapping his wife.
16113,11/9/2011,Iraq,Taji,3,0,3,Three civilians are shredded by a roadside bomb.
16114,11/9/2011,Iraq,Baquba,1,7,8,A journalist at a cafe bleeds to death following a Mujahid bombing.
16115,11/9/2011,Afghanistan,Charkh,6,0,6,The bodies of six civilian contract workers are found five days after being abducted by Sunni militants.
16116,12/9/2011,Iraq,Mosul,1,0,1,Mujahideen behead a man in his own home.
16117,12/9/2011,Yemen,Aden,1,0,1,Suspected al-Qaeda gunmen assassinate a security official.
16118,12/9/2011,Iraq,Anbar,22,0,22,Sunnis stop a bus carrying Shiite pilgrims and shoot twenty-two of them in the back of the head.
16119,12/9/2011,Nigeria,Misau,7,7,14,A suspected Boko Haram assault on a bank leaves seven dead.
16120,12/9/2011,Indonesia,Maluku,6,80,86,Six people are killed when machete-wielding Muslims attack a Christian village on a false rumor.
16121,12/9/2011,Nigeria,Maiduguri,4,0,4,Boko Haram Islamists shoot two bar workers and two patrons.
16122,13/9/2011,Somalia,Dhusamareb,2,6,8,Two people are killed during an al-Shabaab attack.
16123,13/9/2011,Pakistan,Matani,5,19,24,"Sunni militants blast a school bus full of children with machine-gun fire, killing four kids and the driver."
16124,13/9/2011,Afghanistan,Kabul,21,31,52,Over twenty people are killed when a wave of Fedayeen assault the US embassy.
16125,13/9/2011,Iraq,Taji,1,9,10,A Shahid suicide bomber kills a civilian.
16126,13/9/2011,Pakistan,Khyber,3,3,6,Three tribal elders are executed by radical Muslims.
16127,13/9/2011,Pakistan,Lakki,2,0,2,The Taliban kidnap and murder two villagers.
16128,14/9/2011,Pakistan,Tirah,1,0,1,Islamists behead a civilian.
16129,14/9/2011,Pakistan,Lahore,1,0,1,A 15-year-old girl is strangled to death by her uncle for a suspected affair with a Christian boy.
16130,14/9/2011,Afghanistan,Helmand,2,8,10,Women are among the casualties of a Sunni car bomb.
16131,14/9/2011,Pakistan,Bannu,3,1,4,The Taliban intercept a car carrying security officials and machine-gun them.
16132,14/9/2011,Iraq,Hillah,17,46,63,"Seventeen people die in a car bomb blast outside a restaurant, including three children."
16133,14/9/2011,Thailand,Narathiwat,2,2,4,A Muslim soldier murders two Buddhists in a suicide attack.
16134,14/9/2011,Iraq,Ramadai,6,10,16,Six Iraqis at an airport are sent to Allah by Jihad bombers.
16135,15/9/2011,Thailand,Pattani,5,1,6,"'Islamic separatists' set off a landmine under a vehicle, then drag out five injured soldiers and shoot them in the head."
16136,15/9/2011,Pakistan,Lower Dir,45,62,107,"A suicide bomber detonates in the middle of a packed funeral, killing at least forty-five mourners."
16137,15/9/2011,Dagestan,Kadar,1,0,1,Muslim radicals enter an imam's home and shoot him 57 times.
16138,16/9/2011,Nigeria,Maiduguri,1,0,1,Boko Haram radicals kill one of their own for holding peace talks.
16139,16/9/2011,Thailand,Yala,2,3,5,Islamists gun down two persons at a mosque.
16140,16/9/2011,Thailand,Narathiwat,6,118,124,"Four tourists, including a 3-year-old child and his grandparents, are among six people blown apart when Islamist place a bomb outside a brothel,"
16141,16/9/2011,Iraq,Baghdad,4,2,6,Four people are shot to death by Muslim terrorists.
16142,17/9/2011,Pakistan,Akka Khel,5,3,8,Four members of a peace committee are among five killed at point-blank range by Jihadi gunmen.
16143,17/9/2011,Iraq,Mosul,3,0,3,Three children are killed by a homemade bomb found in their yard.
16144,17/9/2011,Afghanistan,Faryab,9,1,10,Five children are among nine civilians ripped to pieces by a Taliban bomb.
16145,18/9/2011,Pakistan,Haider Khan,3,0,3,Three are killed when terrorists open up on a passenger bus with automatic weapons.
16146,18/9/2011,Dagestan,Makhachkala,1,0,1,A local security official is gunned down by Muslim assassins.
16147,18/9/2011,Nigeria,Bitaro,3,8,11,"Muslim activists raid a village, pull members of a Christian family from their home and then hack and shoot them to death.  The victims included children."
16148,19/9/2011,Pakistan,Miranshah,1,0,1,A man is taken from a marketplace by local Islamists and executed in captivity.
16149,19/9/2011,Pakistan,Karachi,8,9,17,A teacher and her 8-year-old child are among eight who lose their lives to a Tehreek-e-Taliban suicide bombing outside a house.
16150,19/9/2011,Pakistan,Peshawar,5,33,38,Five people are killed when fundamentalists set off a bomb at a market selling DVDs and music.
16151,19/9/2011,Afghanistan,Jowzjan,5,0,5,The Taliban take down five local policemen with roadside bombs.
16152,19/9/2011,Afghanistan,Aqcha,4,9,13,"A brutal suicide attack leaves four dead, including a woman and her child."
16153,19/9/2011,Pakistan,Bajaur,1,0,1,Islamic militants abduct and execute a tribal elder and member of a peace committee.
16154,19/9/2011,Pakistan,Khyber,1,1,2,A truck driver is riddled with bullets during an Islamist drive-by.
16155,20/9/2011,India,Samba,1,1,2,"Pakistani backed militants fire on a security-patrol, killing one member."
16156,20/9/2011,Iraq,Baghdad,3,0,3,Terrorists gun down three policemen at point-blank range.
16157,20/9/2011,Iraq,Ramadi,4,17,21,Three Fedayeen suicide bombers murder four Iraqis at a government complex.
16158,20/9/2011,Afghanistan,Kabul,1,3,4,The head of a peace council is killed by a Shahid who hid the bomb in his turban.
16159,20/9/2011,Pakistan,Quetta,3,1,4,"Three mourners, traveling to pick up bodies from an earlier Sunni ambush, are gunned down in route."
16160,20/9/2011,Pakistan,Mastung,26,6,32,"Twenty-six Shia pilgrims are pulled off a bus, lined up and executed by Lashkar-e-Jhangvi Sunnis.."
16161,21/9/2011,Israel,Samaria,0,1,1,Palestinian stone-throwers hit a 20-month-old Jewish baby girl in the face.
16162,21/9/2011,Pakistan,Khwezai,3,0,3,The bodies of three abducted tribesman are found a month later - sans heads.
16163,21/9/2011,Nigeria,Maiduguri,2,0,2,Boko Haram gunmen riddle two men with bullets in their home.
16164,21/9/2011,Dagestan,Makhachkala,6,50,56,A triple car-bomb attack by Muslim extremists leaves six dead and over fifty injured.
16165,22/9/2011,Pakistan,Landikotal,2,1,3,"Islamic radicals ambush a truck, killing the driver and a passenger."
16166,22/9/2011,Iraq,Iskandariyah,2,20,22,"Two Shiite pilgrims, a 5-year-old girl and her father, are murdered by Sunni bombers outside a restaurant."
16167,22/9/2011,Thailand,Narathiwat,1,0,1,'Insurgents' shoot a man twice in the head and then set his body on fire.
16168,22/9/2011,Pakistan,Chamarkand,5,8,13,A 10-year-old boy is among five people blown to bit by a Taliban bomb.
16169,22/9/2011,Nigeria,Madala,5,0,5,Five Christian traders are executed by Boko Haram gunmen when they are unable to recite Quran verses as ordered.
16170,22/9/2011,Thailand,Pattani,1,0,1,A young nurse is machine-gunned while riding to work at a hospital.
16171,23/9/2011,Israel,Kiryat Arba,2,0,2,An infant and his father are killed when their car crashes after Palestinians throw a rock through the windshield.
16172,23/9/2011,Pakistan,Peshawar,2,0,2,Two policemen on guard duty are shot to death by Tehreek-e-Taliban.
16173,23/9/2011,Iraq,Husseiniya,4,17,21,Four people are taken apart by a Shahid suicide car bomber.
16174,23/9/2011,Iraq,Baghdad,5,12,17,Sectarian Jihadis take down five Iraqis in a Sunni neighborhood.
16175,23/9/2011,Dagestan,Makhachkala,4,0,4,Two children are among four people shot to death by Islamic 'separatists' in a targeted killing.
16176,23/9/2011,Pakistan,Quetta,3,2,5,Sunni gunmen identify and execute three Shia laborers after forcing them off a bus.
16177,24/9/2011,Somalia,Mogadishu,1,0,1,Bombers kill a security guard outside a UN building.
16178,24/9/2011,Afghanistan,Maywand,7,4,11,Two women and three children are among seven civilians disassembled by Mujahid bombers.
16179,25/9/2011,Somalia,Deynile,1,0,1,Islamists behead a 17-year-old whose family held secret Bible studies in their home.
16180,25/9/2011,Afghanistan,Yahya Khel,2,2,4,A suicide bomber sends two local souls to Allah.
16181,25/9/2011,Indonesia,Solo,2,20,22,A teenage girl is among two worshippers cut to pieces by a Shahid who wanders into a church service and detonates a bomb packed with nails and bolts.
16182,25/9/2011,Philippines,Talipao,3,8,11,A villager is among three people killed in an Abu Sayyaf ambush.
16183,25/9/2011,Iraq,Karbala,17,113,130,al-Qaeda devotees target Shiites with four bomb blasts that leave nearly twenty dead.
16184,25/9/2011,Iraq,Khalidiya,2,6,8,Women and children are among the casualties when Mujahideen detonate a bomb outside a house.
16185,26/9/2011,Iraq,Kirkuk,3,1,4,Holy Warriors take down three civilians traveling in a car.
16186,26/9/2011,Iraq,Diwaniya,1,1,2,"An imam nearly loses his life to Religion of Peace rivals, who do manage to kill his companion."
16187,26/9/2011,Afghanistan,Kabul,1,1,2,An American security analyst is gunned down by a Fedayeen working as a trusted employee.
16188,26/9/2011,Mali,Bamako,0,7,7,Several people are hurt when fundamentalists armed with Molotov cocktails destroy a bar located too close to a mosque.
16189,27/9/2011,Pakistan,Salarzai,2,6,8,Two members of a peace committee are shot to death by Sunni hardliners.
16190,27/9/2011,Afghanistan,Lashkar Gah,2,26,28,A man and boy are torn apart by a Shahid suicide bomber.
16191,27/9/2011,Afghanistan,Shindand,16,4,20,Eleven children and four women are among a family of sixteen shredded by Mujahideen bombers.
16192,27/9/2011,Philippines,Sumisip,6,5,11,"Abu Sayyaf members assault a village, killing six, including several residents."
16193,27/9/2011,Yemen,Aden,2,10,12,A suicide bombing near a hotel leaves two people dead.
16194,27/9/2011,Pakistan,Islamabad,2,0,2,A woman seeking a divorce is shot to death along with her daughter in an 'honor killing'.
16195,27/9/2011,Pakistan,Swat,2,0,2,Islamic radicals are suspected of making a bomb shaped like a toy that takes the lives of a young child and his grandfather.
16196,27/9/2011,Iraq,Baghdad,3,10,13,"Sunni terrorists detonate a bomb outside a popular Shia restaurant, killing three members of the night crowd."
16197,28/9/2011,Dagestan,Izberbash,2,0,2,Two opponents of extremism are assassinated by Religion of Peace gunmen.
16198,28/9/2011,Afghanistan,Lashkar Gah,8,3,11,Sunni hardliners roll up on a local police checkpoint and machine-gun eight officers.
16199,28/9/2011,Thailand,Narathiwat,4,3,7,A 6-year-old boy is among the casualties when Islamic terrorists open fire on guards outside a school.
16200,28/9/2011,Thailand,Pattani,1,0,1,A 48-year-old trader is shot to death at a market by Muslim 'insurgents'.
16201,28/9/2011,India,Batmaloo,1,0,1,An Islamist shoots a police officer to death in cold blood.
16202,28/9/2011,Dagestan,Hajjalmakhi,8,4,12,An 11-year-old girl is among eight killed in a violent car bombing by Muslim extremists.
16203,28/9/2011,Iraq,Abu Ghraib,5,7,12,Three children are among five family members brutally shot to death in their home by al-Qaeda intruders.
16204,29/9/2011,Egypt,Tamia,1,2,3,A guard at a church is taken out by a Muslim drive-by.
16205,29/9/2011,Iraq,Kirkuk,3,76,79,Jihadis detonate a massive truck bomb outside a bank.  Two women are among the dead.
16206,29/9/2011,Afghanistan,Herat,3,2,5,Two women are among three killed in a Taliban bomb blast.
16207,29/9/2011,Pakistan,Chora,1,0,1,The beheaded body of a young man is found three days after his abduction.
16208,30/9/2011,Iraq,al-Khafaji,17,30,47,"Sunni car bombers blast a funeral procession for a Shia sheikh, killing at least seventeen mourners."
16209,1/10/2011,Kenya,Manda Bay,1,0,1,An elderly Frenchwoman in a wheelchair is kidnapped by al-Shabaab and later dies in captivity.
16210,1/10/2011,Pakistan,Sheikhupura,1,0,1,A schoolteacher is quickly murdered in front of students after being labeled 'liable to be killed' by local clerics for embracing the Ahmadi faith.
16211,1/10/2011,Philippines,Patikul,3,0,3,Abu Sayyaf militants claim credit for shooting down a helicopter and killing three people.
16212,1/10/2011,Thailand,Pattani,1,0,1,Terrorists shoot a truck driver to death near a tea shop.
16213,1/10/2011,Thailand,Narathiwat,1,0,1,Muslim gunmen assassinate a 50-year-old man outside a mosque.
16214,1/10/2011,Pakistan,Torghar,4,15,19,Four police trainees are sent to Allah by Taliban bombers.
16215,1/10/2011,Nigeria,Maiduguri,2,0,2,Two civilians at a wedding are taken down by a Boko Haram bomb.
16216,1/10/2011,Iraq,Kirkuk,1,0,1,A 60-year-old Christian is shot to death by Muslim assassins.
16217,1/10/2011,Iraq,Buhriz,3,5,8,Two family members are among three killed during an al-Qaeda home invasion.
16218,1/10/2011,Somalia,Dharkenley,11,24,35,Eleven civilians are killed during an al-Shabaab attack.
16219,2/10/2011,Dagestan,Kizilyurt,2,1,3,A Shahid suicide bomber kill two local police officers.
16220,2/10/2011,Iraq,Mishahda,4,3,7,al-Qaeda bombers take down four Iraqis.
16221,2/10/2011,Afghanistan,Gardez,9,4,13,Nine Afghan soldiers are torn to shreds by Sunni fundamentalist roadside bombers.
16222,2/10/2011,Syria,Damascus,1,0,1,The son of a prominent cleric is gunned down in a suspected sectarian attack.
16223,2/10/2011,Somalia,Mogadishu,2,3,5,An al-Shabaab roadside bomb takes out two civilians.
16224,2/10/2011,Iraq,Mosul,1,0,1,Islamists murder a 30-year-old restaurant employee in a targeted attack against Christians.
16225,2/10/2011,Nigeria,Maiduguri,1,0,1,A pharmacist is murdered in his store by Boko Haram Islamists.
16226,3/10/2011,Nigeria,Maiduguri,2,0,2,A tea seller and customer are shot at point blank range by local Islamists.
16227,3/10/2011,Pakistan,Khuzdar,1,1,2,A schoolteacher is shot to death in a suspected sectarian attack.
16228,3/10/2011,Iraq,Anbar,6,13,19,At least six people are killed in a bank siege by a suicide squad from the 'Islamic State of Iraq'.
16229,3/10/2011,Iraq,Arab Jobour,1,2,3,"Hardliners open fire on a schoolteacher, killing him and injuring his wife and young son."
16230,3/10/2011,Iraq,Baghdad,1,5,6,Terrorists kill a child with a bomb.
16231,3/10/2011,Afghanistan,Kandahar,2,19,21,"A Shahid suicide bomber takes two civilians with him, including a child."
16232,4/10/2011,Nigeria,Tanjol,1,1,2,Muslim militants gun down two Christian villagers.
16233,4/10/2011,Somalia,Mogadishu,101,122,223,Over one-hundred people are blown to bits in a powerful truck bombing by Islamic fundamentalists.  Many victims were students.
16234,4/10/2011,Pakistan,Quetta,14,6,20,"Fourteen Shia pilgrims are pulled off of a bus by Sunni gunmen, lined up and mowed down."
16235,5/10/2011,Somalia,Belet Hawo,1,0,1,A man sitting at a tea shop is shot to death by Islamic assassins.
16236,5/10/2011,Yemen,Abyan,2,0,2,Two people are dismantled by terrorist bombers.
16237,5/10/2011,Thailand,Narathiwat,1,5,6,A Buddhist woman is shot to death in her own house by Muslim militants.
16238,5/10/2011,Pakistan,Mian Channu,1,38,39,"A Christian trying to build a church orphanage is murdered by Muslims in a ""land dispute."""
16239,6/10/2011,Afghanistan,Gereshk,1,16,17,Taliban snipers pick off a child riding a bus.  Sixteen other civilians survive with injuries.
16240,6/10/2011,Pakistan,Faisalabad,3,0,3,Three women are dragged out of a house and shot by a relative in an honor attack.
16241,6/10/2011,Thailand,Narathiwat,1,1,2,"Islamic gunmen fire on a Buddhist couple sitting in their truck, killing the wife."
16242,7/10/2011,Iraq,Itafiyah,5,20,25,"Mujahideen set off a bomb along a crowded street, killing five Iraqis."
16243,7/10/2011,Pakistan,Malik Garhi,2,0,2,"A man and boy are tortured, thrown off a 30-foot bluff, and then shot to death for engaging in homosexual sex."
16244,7/10/2011,Pakistan,Rawalpindi,0,24,24,"About two dozen students and teachers at a girls school are thrashed with iron rods by fundamentalists for dressing ""immodestly."""
16245,8/10/2011,Iraq,Kirkuk,1,1,2,Muslim gunmen shoot an elderly Christian and a woman.
16246,8/10/2011,Yemen,Aden,1,7,8,A local soldier is killed in a bombing by Islamic extremists.
16247,9/10/2011,Somalia,Mogadishu,12,40,52,At least a dozen civilians are killed during an al-Shabaab mortar attack on a residential area.
16248,9/10/2011,Egypt,Cairo,27,329,356,Military and Islamist gunmen massacre over two dozen Christians peacefully protesting a church burning.
16249,9/10/2011,Philippines,Zamboanga,0,13,13,Abu Sayyaf bombers injured thirteen people in separate attacks targeting Christians.
16250,9/10/2011,Pakistan,Maidan,2,0,2,The Taliban kidnap and murder two young men.
16251,10/10/2011,Iraq,Baghdad,13,22,35,"Jihadi bombers murder thirteen Iraqis, including first responders, in a string of bombings."
16252,10/10/2011,Nigeria,Maiduguri,2,2,4,Two Nigerians are killed by a Boko Haram bomb.
16253,10/10/2011,Pakistan,Chadrarh,2,0,2,Two former members of a peace committee are shot to death by militant Muslims.
16254,10/10/2011,Afghanistan,Dangam,6,2,8,A road construction crew is the target of a vicious double bombing that leaves six dead.
16255,11/10/2011,Dagestan,Makhachkala,1,2,3,Suspected Islamic 'rebels' murder one person in a drive-by attack.
16256,11/10/2011,Pakistan,Dasht,2,0,2,"The Taliban set fire to an oil tanker, burning the driver and helper to death."
16257,11/10/2011,Pakistan,Kalaya,1,9,10,"A mortar round fired by the Taliban reportedly slams into a home, killing one occupant."
16258,11/10/2011,Somalia,Mogadishu,1,0,1,"Islamists send a mortar round into the maternity ward of a hospital, crushing a staff member."
16259,11/10/2011,Iraq,Garma,1,0,1,al-Qaeda gunmen murder a man outside his home.
16260,12/10/2011,Pakistan,Korangi,1,0,1,A Muslim slashes a Christian mother's throat after raping her.
16261,12/10/2011,Iraq,Illam,6,28,34,Three Jihadi car bomb kill six Iraqis.
16262,12/10/2011,Thailand,Yala,1,0,1,A civilian is shot to death on his way home by 'insurgents'.
16263,12/10/2011,Pakistan,Khyber Pakhtunkhwa,1,4,5,Children are among the casualties of an Islamist drive-by and mortar attack.
16264,12/10/2011,Iraq,Baghdad,14,28,42,A powerful Shahid car bomb blast leaves at least fourteen Iraqis dead.
16265,12/10/2011,Iraq,Baghdad,9,27,36,Nine people are reported dead after a Sunni suicide bombing in a Shia neighborhood.
16266,13/10/2011,Thailand,Pattani,3,0,3,A married couple and their relative are brutally cut to pieces in their own shop by Islamic gunmen.
16267,13/10/2011,Thailand,Pattani,3,0,3,Two people riding in a pickup truck and a teenager standing nearby are machine-gunned by Muslim militants.
16268,13/10/2011,Iraq,Kirkuk,1,42,43,A Shahid suicide bomber kills one other person near a bank.
16269,13/10/2011,Nigeria,Maiduguri,1,0,1,Boko Haram gunmen assassinate a man in his home.
16270,13/10/2011,Iraq,Sadr City,18,43,61,Eighteen people at a market are torn to shreds by Ansar al-Islam bombers.
16271,14/10/2011,Pakistan,Islamabad,1,1,2,Terrorists gun down a neighborhood cop.
16272,14/10/2011,Afghanistan,Spin Boldak,3,5,8,A Fedayeen suicide bomber murders three local police officers.
16273,14/10/2011,Iraq,Hilla,10,40,50,"Sunni bombers target a Shia funeral procession near a mosque, killing at least ten mourners."
16274,14/10/2011,Pakistan,Kharkai,2,6,8,Islamic militants kill two civilians with a mortar attack on their village.
16275,15/10/2011,Iraq,Baghdad,1,0,1,An interior minister is assassinated by suspected al-Qaeda.
16276,15/10/2011,Afghanistan,Panjshir,2,2,4,Two civilians are taken out by Islamic Movement of Uzbekistan suicide bombers.
16277,15/10/2011,Nigeria,Maiduguri,1,0,1,A local official is shot to death by Boko Haram.
16278,15/10/2011,Thailand,Narathiwat,1,0,1,A 48-year-old woman is stalked and murdered by Muslim 'insurgents'.
16279,16/10/2011,Egypt,Mallawy,1,0,1,A Coptic high school student is beaten to death after refusing to take off his cross.
16280,16/10/2011,Nigeria,Jos,1,0,1,Militant Muslims hack a local soldier to death with machetes.
16281,16/10/2011,Afghanistan,Faryab,1,4,5,A child of about 3 bleeds to death following a suicide blast.
16282,16/10/2011,Nigeria,Maiduguri,1,0,1,A lawmaker is assassinated by Islamic gunmen while standing outside his home.
16283,16/10/2011,Nigeria,Gombe,4,0,4,Boko Haram bombers set off a blast that kills three civilians and a cop.
16284,16/10/2011,Afghanistan,Gardez,1,0,1,A city worker is killed by a car bomb.
16285,17/10/2011,Pakistan,Orakzai,1,0,1,The chief of a local peace committee is murdered by Islamists while on his way to a funeral.
16286,17/10/2011,Pakistan,Bara,9,3,12,Sunni extremists ambush a group of local soldiers and gun down at least nine.
16287,17/10/2011,Iraq,Baghdad,7,18,25,"Fundamentalists set off a bomb near a liquor store, exterminating seven."
16288,17/10/2011,Pakistan,Karachi,1,0,1,A 45-year-old Shiite man is gunned down by Wahhabi terrorists.
16289,17/10/2011,Algeria,Boumerdes,1,2,3,A 7-year-old barely survives a fundamentalist bombing that leaves his mother dead.
16290,18/10/2011,Afghanistan,Gozara,2,0,2,Two women accused of 'immoral' activity are shot to death.
16291,18/10/2011,Pakistan,Bara,3,3,6,"Islamic militants are thought responsible for shelling that kills a doctor and two others, including a child."
16292,18/10/2011,Thailand,Pattani,1,2,3,Muslim militants open fire on a group of investigators looking into an earlier murder.
16293,18/10/2011,Thailand,Narathiwat,1,0,1,Islamic 'separatists' put four bullets into the back of a wood trader.
16294,18/10/2011,Somalia,Mogadishu,4,6,10,"A Holy Warrior detonates himself along a city street, cutting down four innocents."
16295,18/10/2011,Pakistan,Karachi,1,0,1,A 32-year-old Shiite is murdered by Sipah-e-Sahaba assassins.
16296,18/10/2011,Philippines,Basilan,19,14,33,Nineteen local soldiers are killed during an ambush by Moro Islamists.
16297,18/10/2011,Pakistan,Buner,3,2,5,"Fundamentalists open fire on a party hosting transvestites, killing three."
16298,18/10/2011,Pakistan,Karachi,3,0,3,Three seminary students are shot dead in a suspected sectarian attack.
16299,18/10/2011,Iraq,Mosul,1,0,1,A Shiite baker is murdered by Sunni hardliners.
16300,18/10/2011,Pakistan,Marot,2,0,2,A woman seeking a divorce is butchered along with her daughter by her husband's family in an honor killing.
16301,19/10/2011,Afghanistan,Zarghun,5,0,5,Five Afghan troops are blown to bits by Taliban bombers while returning to their base.
16302,19/10/2011,Nigeria,Maiduguri,2,0,2,The owner and a patron are shot to death at a barber shop by Islamic terrorists.
16303,19/10/2011,Yemen,Lahj,2,12,14,"An al-Qaeda militant throws a grenade into a packed market, killing two civilians."
16304,19/10/2011,Afghanistan,Badghis,3,2,5,A father and son are among three civilians ripped apart by a suicide bomber.
16305,19/10/2011,Pakistan,Karachi,1,0,1,A Sunni activist is gunned down by sectarian Jihadis.
16306,19/10/2011,Iraq,Mosul,2,0,2,A judge and his driver are assassinated by Mujahideen.
16307,19/10/2011,Iraq,Ramadi,2,5,7,"'Insurgents' bomb a health office, killing two innocents."
16308,19/10/2011,Nigeria,Maiduguri,2,0,2,Boko Haram gunmen murder two civilians in separate attacks.
16309,20/10/2011,Nigeria,Yelwa,1,0,1,Three Muslim soldiers break into a home and shoot a Christian mother of five to death.
16310,20/10/2011,Nigeria,Bauchi,0,1,1,A Christian boy is shot at a soccer match by armed Muslims.
16311,20/10/2011,Pakistan,Karachi,1,0,1,A 22-year-old Shiite is shot to death outside his home by Wahhabis.
16312,20/10/2011,Pakistan,Khyber,4,3,7,A brutal Lashkar-e-Islam attack leaves four dead.
16313,20/10/2011,Somalia,Mogadishu,10,2,12,Ten African peacekeepers are murdered by al-Shabaab terrorists - some by beheading.
16314,20/10/2011,Philippines,Alicia,4,6,10,Four local soldiers are ambushed and murdered by Moro Islamists.
16315,21/10/2011,Philippines,Kabasalan,3,8,11,Moro Islamists gun down three local cops.
16316,21/10/2011,Pakistan,Bazai,3,1,4,"Muslim extremists throw grenades into a home, killing three family members including a woman."
16317,21/10/2011,Iraq,Mosul,1,0,1,'Insurgents' murder a woman inside her home.
16318,22/10/2011,Israel,Kfar Iksa,0,1,1,A Jewish teenager is left with serious injuries after a stabbing attack by a Palestinian.
16319,22/10/2011,Nigeria,Maiduguri,1,0,1,A popular TV journalist is murdered in front of his home by Boko Haram assassins.
16320,22/10/2011,Iraq,Ameriyat,1,1,2,A civilian is cut down by automatic weapons fire from 'insurgents' in a passing car.
16321,22/10/2011,India,Anantapur,0,1,1,A school headmaster is severely beaten by Muslim activists after asking that women remove veils.
16322,22/10/2011,Nigeria,Saminaka,2,0,2,"Radicals bomb and shoot up a bank, killing two, while yelling 'Allah Akbar'."
16323,23/10/2011,Iraq,Tikrit,2,0,2,A teacher and his daughter are brutally murdered by Mujahideen gunmen.
16324,23/10/2011,Philippines,Cabengbeng,5,8,13,Five Catholic plantation workers are massacred by Moro Islamists in a pre-dawn attack on their village.
16325,23/10/2011,Philippines,Lanao del Norte,3,3,6,Three members of a security patrol are killed by a Moro Islamist ambush.
16326,23/10/2011,Afghanistan,Zarghon,4,2,6,A Taliban bomb takes out four civilians.
16327,23/10/2011,Afghanistan,Shindand,2,0,2,Two local cops are obliterated by a Taliban roadside bomb.
16328,23/10/2011,Thailand,Narathiwat,5,8,13,A child and his parents are among five people torn to pieces by two Muslim bombs at a grocery.
16329,23/10/2011,Thailand,Narathiwat,2,1,3,"Terrorists dressed as women open fire on a civilian defense patrol, killing two members before fleeing."
16330,24/10/2011,Nigeria,Damaturu,1,0,1,"Muslim gunmen knock on the door of an off-duty cop, then blow him away when he answers."
16331,24/10/2011,Kenya,Nairobi,0,14,14,Fourteen people suffer horrific burns and shrapnel injuries when Islamists throw a grenade into a nightclub.
16332,24/10/2011,Yemen,Aden,2,0,2,Two Yemeni soldiers are machine-gunned by suspected Ansar al-Sharia.
16333,24/10/2011,Kenya,Nairobi,1,10,11,"Islamists throw a grenade into a bus stop, killing one person."
16334,24/10/2011,Afghanistan,Maymanah,1,6,7,A suicide bomber successfully takes out a child.
16335,24/10/2011,Pakistan,Khyber Pakhtunkhwa,2,2,4,A cab driver and member of a peace committee are gunned down by terrorists in separate attacks.
16336,24/10/2011,Pakistan,Korangi,2,1,3,Islamic militants are suspected of shooting a 12-year-old and one other person to death.
16337,24/10/2011,Iraq,Abu Ghraib,1,3,4,'Insurgents' murder a woman inside her home.
16338,24/10/2011,Iraq,Baghdad,1,7,8,A civilian is taken out by a Fedayeen suicide bomber.
16339,25/10/2011,Iraq,Baghdad,5,13,18,Three Iraqis are killed in a two-day spree of bombings targeting traffic cops.
16340,25/10/2011,Pakistan,Lower Dir,4,3,7,"Sunni fundamentalists take down four people with a roadside bomb, including a 12-year-old boy."
16341,25/10/2011,Thailand,Yala,3,34,37,"Muslim 'rebels' set off a series of bombs in populated areas, killing at least three civilians."
16342,25/10/2011,Pakistan,Bara,1,0,1,Tahreek-e-Taliban militants murder a member of a peace committee.
16343,26/10/2011,Pakistan,Bara,1,0,1,Lashkar-e-Islam abduct and behead a defense volunteer.
16344,26/10/2011,Afghanistan,Parwan,6,50,56,Six locals are killed when Sunni fundamentalists detonate a fuel tanker.
16345,26/10/2011,Pakistan,Tank,2,0,2,Two members of a peace committee are machine-gunned in their sleep by Islamists.
16346,26/10/2011,Pakistan,Faqir Kalay,0,12,12,Young children are among the casualties when religious extremists bomb a clothing market.
16347,26/10/2011,Pakistan,Bajaur,1,4,5,Four children are among the casualties when Muslim radicals shell their home.
16348,26/10/2011,Iraq,Hilla,2,0,2,A woman and her daughter are killed when terrorists blow up their home.
16349,26/10/2011,Iraq,Khanaqin,0,7,7,Seven Shia pilgrims are injured when Sunni radicals bomb their bus.
16350,26/10/2011,Iraq,Iskandiriyah,2,2,4,Sunnis enter the home of a Shiite cleric and brutally shoot his wife and daughter to death.
16351,26/10/2011,Iraq,Mosul,9,16,25,Two car bombs in the same neighborhood take down nine Iraqis.
16352,26/10/2011,Philippines,Sangali,1,8,9,Muslim terrorists are suspected of planting a bomb outside a lottery office.
16353,26/10/2011,Pakistan,Mohmand,3,0,3,Three local soldiers are kidnapped and executed by Religion of Peace proponents.
16354,27/10/2011,Kenya,Nairobi,0,1,1,A young convert from Islam is left for dead after being severely beaten with iron rods in front of his church.
16355,27/10/2011,Iraq,Baghdad,36,78,114,"Fundamentalists target a music store with twin blasts, slaughtering at least thirty innocents."
16356,27/10/2011,Kenya,Mandera,4,4,8,A school principal is one of four killed when Islamists rocket a vehicle carrying student exam papers.
16357,27/10/2011,Iraq,Iskandariya,2,2,4,A child is among two Iraqis obliterated by 'insurgent' bombers.
16358,27/10/2011,Iraq,Amiriya,1,2,3,al-Qaeda bombers take down an opponent.
16359,27/10/2011,Dagestan,Tabasaransky,1,0,1,A moderate cleric is shot to death by extremists.
16360,28/10/2011,Bosnia,Sarajevo,0,1,1,A radical Islamist fires on the US embassy for 30 minutes with an assault rifle.
16361,28/10/2011,Iraq,Baqubah,2,2,4,"Holy Warriors machine-gun a family, killing the two male members and leaving a child and mother with serious injuries."
16362,28/10/2011,Yemen,Aden,1,3,4,Children are among the casualties of an al-Qaeda car bombing.
16363,28/10/2011,Dagestan,Bairamaul,1,1,2,"Islamic 'separatists' fire on a group of policemen, killing one."
16364,28/10/2011,Iraq,Saadiyah,3,1,4,Three family members are executed at point-blank range by Muslim terrorists.
16365,28/10/2011,Pakistan,Nowshera,2,7,9,Two local cops are murdered by a Fedayeen suicide bomber.
16366,28/10/2011,Pakistan,Shindhand,2,0,2,Two brothers are killed when religious militants fire a rocket into their car.
16367,28/10/2011,Pakistan,Karachi,1,1,2,A Shia is shot in the head and neck by sectarian Jihadis in front of his wife.
16368,28/10/2011,Afghanistan,Khost,4,0,4,Four people riding in a car are exterminated by Sunni gunmen.
16369,29/10/2011,Afghanistan,Kabul,17,8,25,"Women and children are among the dead as suicide bombers target a NATO bus, killing at least seventeen."
16370,29/10/2011,Pakistan,Tank,1,0,1,Islamic radicals murder a member of a local peace committee.
16371,29/10/2011,Iraq,Mosul,1,0,1,A woman shopping at a market is gunned down by terrorists.
16372,29/10/2011,Iraq,Khalis,1,2,3,Jihadis take down a teenage girl riding in a family car.
16373,29/10/2011,Iraq,Deli Abbas,1,0,1,Fundamentalists shoot a liquor store owner to death in his home.
16374,29/10/2011,Pakistan,Changa Manga,1,0,1,Religious extremists are suspected of binding a local official and then burning him alive.
16375,29/10/2011,Afghanistan,Kandahar,4,9,13,A Taliban in uniform shoots three Australian police trainers and an interpreter to death.
16376,29/10/2011,Iraq,Baghdad,1,0,1,A technology worker is blown up 'insurgent' bombers.
16377,29/10/2011,Somalia,Mogadishu,10,0,10,At least ten people are killed during a Fedayeen assault on an African Union base.
16378,29/10/2011,Nigeria,Borno,1,0,1,Islamists gun down a rival cleric in front of his home.
16379,30/10/2011,Pakistan,Jahlum,2,0,2,An Ahmadi doctor and his 11-year-old son are kidnapped and presumed murdered by Islamic fundamentalists.
16380,30/10/2011,Pakistan,Malir,1,0,1,Sectarian gunmen take down a civilian.
16381,30/10/2011,Iraq,Bani Saad,2,1,3,Terrorists shoot two brothers to death in their home.
16382,30/10/2011,Iraq,Mosul,5,0,5,Five Iraqis are sent to Allah by Mujahideen bombers.
16383,30/10/2011,Thailand,Narathiwat,3,0,3,"Three Buddhists are gunned down in brutal fashion by Muslims at a grocery, including a woman and an elderly man."
16384,30/10/2011,Israel,Ashkelon,1,4,5,A 56-year-old father of four bleeds to death after Palestinians fire a rocket into an apartment building.
16385,30/10/2011,Thailand,Songkla,1,0,1,Muslims gun down a civilian in a drive-by attack.
16386,31/10/2011,Thailand,Sri Sakhon,0,2,2,A child loses a foot and another suffers deep shrapnel injuries following an Islamist bombing.
16387,31/10/2011,Pakistan,Pakhtunkhwa,3,0,3,Religious militants abduct and behead three locals.
16388,31/10/2011,Afghanistan,Kandahar,6,5,11,Suicide bombers kill three people outside a humanitarian aid office.
16389,1/11/2011,Pakistan,Gilgit City,1,0,1,A Shiite is shot to death by Sunnis.
16390,1/11/2011,Pakistan,Sira Karpai,2,2,4,"Religious extremists attack a police checkpoint, killing two officers."
16391,2/11/2011,Pakistan,Peshawar,1,10,11,Jihadis detonate a bomb in a packed marketplace.
16392,2/11/2011,Iraq,Basra,12,62,74,A dozen Iraqis are torn to shreds by motorcycle bombs placed outside three cafes.
16393,2/11/2011,Pakistan,Nasirabad,2,6,8,"Sunni terrorists detonate a roadside bomb under a passing vehicle, killing two occupants."
16394,2/11/2011,Thailand,Narathiwat,6,2,8,Six Buddhist civilians are blown apart and then raked with gunfire by militant Muslims.
16395,2/11/2011,Dagestan,Babayurt,2,3,5,Two local cops are shot to death by Islamic extremists.
16396,2/11/2011,Nigeria,Maiduguri,1,0,1,A robed fundamentalist pulls out an automatic weapon and murders a guard at a market.
16397,2/11/2011,Iraq,Kirkuk,1,1,2,Islamists are suspected of killing a vegetable vendor and injuring his daughter.
16398,2/11/2011,Iraq,Mosul,2,0,2,Two civilians bleed to death following a Sunni roadside bombing.
16399,2/11/2011,Pakistan,Gilgit City,1,0,1,A second Shiite dies from a Sunni shooting attack.
16400,3/11/2011,Nigeria,Zonkwa,2,12,14,
16401,3/11/2011,Afghanistan,Ghazni,1,0,1,A child is taken out by a Taliban rocket.
16402,3/11/2011,Afghanistan,Herat,2,4,6,A Shahid suicide attack on a construction company leaves two guards dead.
16403,3/11/2011,Nigeria,Kaduna,2,14,16,"Mujahideen gunmen attack a church, shooting two female worshippers to death."
16404,3/11/2011,Pakistan,Quetta,1,0,1,A prayer leader is murdered by suspected sectarian rivals.
16405,3/11/2011,Iraq,Karradah,4,7,11,Sunni bombers take out four Shiites in a residential neighborhood.
16406,3/11/2011,Iraq,Baqubah,10,40,50,A double suicide attack leaves ten Iraqis dead.  The second blast was intended to kill victims fleeing the first.
16407,4/11/2011,Philippines,Malabang,2,0,2,Suspected Moro Islamists murder two Catholic roadside vendors.
16408,4/11/2011,Nigeria,Potiskum,150,200,350,Two-hundred militants shout 'Allah Akbar' as they slaughter one-hundred and fifty in a bombing and shooting rampage that targeted six churches and a police station.  At least one-hundred and thirty of their victims were Christian.
16409,4/11/2011,Nigeria,Potiskum,2,0,2,At least two villagers are gunned down by Muslim raiders.
16410,4/11/2011,Nigeria,Maiduguri,4,6,10,"At least four people are killed by coordinated Fedayeen attacks, one at a college."
16411,4/11/2011,Thailand,Pattani,2,0,2,Two men on motorcycles are murdered in separate 'insurgent' drive-by shootings.
16412,4/11/2011,Nigeria,Zonkwa,1,1,2,Nigerian Islamists shoot another Christian to death in a village raid.
16413,5/11/2011,Kenya,Garissa,2,3,5,A member of the choir is killed along with an 8-year-old girls when al-Shabaab terrorists toss a grenade into a church.
16414,5/11/2011,Iraq,Taji,4,11,15,A woman is among four family members machine-gunned in their home by al-Qaeda.
16415,5/11/2011,Pakistan,Speen Mella,3,7,10,Three bomb disposal personnel are ambushed and murdered by Sunni hardliners.
16416,5/11/2011,Pakistan,Razmak,5,3,8,Talibanis massacre five members of a security patrol.
16417,6/11/2011,Nigeria,Maiduguri,1,0,1,Islamists shoot a man to death in front of his family.
16418,6/11/2011,Afghanistan,Hassin Tal,7,18,25,A suicide bomber on foot takes out seven people leaving a mosque.
16419,6/11/2011,Iraq,Baghdad,10,29,39,"Islamic militants detonate several bombs at a shopping mall, killing ten patrons."
16420,6/11/2011,Pakistan,Bara Kaman Gara,1,3,4,A woman is shot to death by Mujahideen inside her home.
16421,6/11/2011,Pakistan,Azam Warsak,3,3,6,"Muslim militants open fire in a bazaar, killing three people."
16422,6/11/2011,Pal. Auth.,Qalqiliya,1,0,1,Islamic terrorists gun down a man outside a mosque.
16423,6/11/2011,Pakistan,Abbottabad,0,1,1,A pregnant Christian woman is tortured for three hours by police.
16424,6/11/2011,Yemen,Zinjibar,2,0,2,al-Qaeda snipers take down a local patrol.
16425,6/11/2011,Pakistan,Gilgit City,1,0,1,Sunni gunmen pick off a Shiite.
16426,7/11/2011,Pakistan,Sindh,1,0,1,A Shiite is shot to death by Sunnis.
16427,7/11/2011,South Sudan,Guffa,7,12,19,Seven die when a refugee camp is bombed by the Islamic Republic of Sudan.
16428,7/11/2011,Afghanistan,Garm Ser,3,0,3,The Taliban end the lives of three Afghans with a roadside bomb.
16429,7/11/2011,Pakistan,Taluka Chak,3,1,4,A doctor is among three Hindus gunned down by Muslims at a village clinic.
16430,7/11/2011,Pakistan,Swabi,3,9,12,A secular politician and his son are among three dismantled by a Fedayeen suicide bomber.
16431,8/11/2011,Russia,Yaroslavl,1,0,1,Suspected Islamists shoot a rival imam several times in the head.
16432,8/11/2011,Iraq,Samarrah,3,7,10,Three Shiite pilgrims are sent to Allah by Sunni bombers.
16433,8/11/2011,Somalia,Mogadishu,2,5,7,Two person are killed when al-Shabaab militants throw a grenade at a house.
16434,8/11/2011,Afghanistan,Sar Howza,2,4,6,Fundamentalist bombers kill a government official and his bodyguard.
16435,8/11/2011,Afghanistan,Badghis,11,3,14,Six children are among eleven lives brutally ended by a Taliban bomb on Eid al-Adha.
16436,9/11/2011,Indonesia,Jakarta,0,1,1,A deaf and disabled man is brutally attacked with a machete by Sunni fundamentalists for being Ahmadi.
16437,9/11/2011,Pakistan,Mardan,2,0,2,Two girls are 'honor killed' and dumped into a field.
16438,9/11/2011,Yemen,Zinjibar,2,0,2,Two local soldiers are killed by an al-Qaeda bomb.
16439,10/11/2011,Philippines,Carmen,1,0,1,A church elder and father of thirteen is beheaded by Religion of Peace activists at his farm.
16440,10/11/2011,South Sudan,Yida,12,20,32,"The Islamic Republic of Sudan bombs a refugee camp from the air, killing about a dozen."
16441,10/11/2011,Afghanistan,Lashkar Gah,2,1,3,Two civilians are incinerated by a suicide bomber.  A child is badly burned.
16442,10/11/2011,Kosovo,Mitrovica,1,2,3,"Muslim snipers shoot a Serb twice in the back, killing him."
16443,10/11/2011,Afghanistan,Chamkani,3,3,6,"Fedayeen stage a suicide bombing, with supporting fire from a mosque, which leaves three locals dead."
16444,10/11/2011,Pakistan,Akakhel,4,0,4,Four members of a local peace committee are ambushed and killed by Lashkar-e-Islam (Army of Islam).  One is beheaded.
16445,10/11/2011,Iraq,Baghdad,2,4,6,A doctor and his son are dismantled by Mujahid bombers.
16446,10/11/2011,Afghanistan,Ghazni,2,0,2,A mother and daughter are stoned to death for adultery following a fatwa.
16447,10/11/2011,Nigeria,Kafanchan,2,0,2,Islamic raiders murder a village chief and his wife.
16448,11/11/2011,Iraq,Hillah,2,6,8,A 6-year-old boy is among the casualties of a series of Jihad bombings.
16449,12/11/2011,Pakistan,Karachi,1,0,1,A Shiite man is murdered by Sunni gunmen.
16450,12/11/2011,Kazakhstan,Taraz,7,0,7,An orthodox Muslim kills seven people before blowing himself up.
16451,12/11/2011,Afghanistan,Khash Rod,1,0,1,Holy Warriors shoot a village elder to death.
16452,12/11/2011,Pakistan,Charsadda,1,1,2,A local cop bleeds to death following a Sunni bomb attack.
16453,12/11/2011,Afghanistan,Mitram,9,0,9,A woman and child are among eight civilians torn to shreds by a Taliban bomb.
16454,13/11/2011,Iraq,Kadhimiya,1,4,5,A Shiite pilgrim bleeds to death following a bomb attack on his bus by Sunni radicals.
16455,13/11/2011,Pakistan,Spah Darri,6,0,6,Four children and two women are crushed to death by a mortar attack on their home by Religion of Peace militants.
16456,13/11/2011,Pakistan,Mastak,9,6,15,Six people are sent to Allah when terrorists detonate a bomb at a marketplace.
16457,13/11/2011,Iraq,Tikrit,3,11,14,'Insurgents' murder three Iraqis with a roadside bomb.
16458,13/11/2011,Dagestan,Mutsalaul,1,0,1,An imam's assistant is shot to death by suspected extremists.
16459,13/11/2011,India,Kerala,1,0,1,Fundamentalists tie a man to a tree and torture him to death over sexual indiscretion.
16460,14/11/2011,Pakistan,Chowrangi,1,1,2,A prayer leader is gunned down by Religion of Peace rivals.
16461,14/11/2011,Pakistan,Landhi,1,0,1,A father of four is shot to death in a sectarian attack.
16462,14/11/2011,Pakistan,Kohat,1,8,9,"Terrorists fire mortar shells into a residential neighborhood, killing a woman."
16463,14/11/2011,Pakistan,Nala,4,5,9,An Islamic drive-by leaves four local soldiers dead.
16464,14/11/2011,Thailand,Narathiwat,1,0,1,Islamic gunmen aerate an innocent plantation worker.
16465,14/11/2011,Pakistan,Gharyal,2,0,2,Bodies are found of a woman and her husband who were stabbed to death by her family after eloping against their will.
16466,14/11/2011,Iraq,Mosul,2,3,5,Two civilians are murdered by 'insurgents'.
16467,15/11/2011,Israel,Haifa,0,1,1,"An 82-year-old nun is tied up and severely beaten by a gang of four Muslims, including a father and son."
16468,15/11/2011,Somalia,Mogadishu,1,9,10,A child is dies from splinter injuries after fundamentalists toss a grenade into a house hosting a television soccer match.
16469,15/11/2011,India,Kishtwar,1,0,1,"Hizb-ul-Mujahideen members open fire on a group of policemen, leaving one dead."
16470,15/11/2011,Afghanistan,Ghormach,1,15,16,One Afghan is killed by Taliban bombers.
16471,15/11/2011,Pakistan,Bahawalpur,1,0,1,A woman is hacked to death by her three brothers for having a sexual affair.
16472,16/11/2011,Thailand,Pattani,2,0,2,Two men are machine-gunned by Islamic 'insurgents' while in their car.
16473,16/11/2011,Iraq,Baghdad,2,18,20,Two Shiite pilgrims die following a bomb attack on their bus by militant Sunnis.
16474,16/11/2011,Pakistan,Karachi,1,0,1,A pastor is shot in the neck and face in a targeted ambush.
16475,16/11/2011,Jordan,Tafilah,1,0,1,An 18-year-old woman has her throat slit at a bus station by her brother for being sexually 'impure'.
16476,16/11/2011,Pakistan,Spori,6,2,8,Six villagers are disassembled by a Taliban landmine.
16477,16/11/2011,Pakistan,Karachi,2,0,2,Two hero cops die from injuries suffered while stopping four Shahid suicide bombers.
16478,16/11/2011,Russia,Moscow,1,0,1,A poet is shot five times in the head after 'angering' Islamic separatists in Chechnya.
16479,17/11/2011,Pakistan,Qamber,2,0,2,Two Sikhs are crushed to death by a Muslim militant rocket attack on their shop.
16480,17/11/2011,Nigeria,Gargari,4,6,10,Three young girls are among four Christians murdered by Muslim extremists in their own homes.
16481,17/11/2011,Egypt,Cairo,0,32,32,"Islamic radicals violently attack a group of Copts, marching to a memorial for slain victims of another massacre."
16482,17/11/2011,Iraq,Mahmoudiya,4,8,12,Jihadi car bombers take down four Iraqis.
16483,17/11/2011,Yemen,Aden,1,0,1,al-Qaeda cadres shoot a Yemeni to death.
16484,17/11/2011,Somalia,Mogadishu,4,12,16,Children are among the casualties when al-Shabaab militants send mortars into a home.
16485,17/11/2011,Thailand,Narathiwat,0,5,5,Five Buddhist teachers are shot point-blank by Islamic 'insurgents'.
16486,18/11/2011,Nigeria,Maiduguri,3,0,3,A child is among three people killed in a Boko Haram ambush.
16487,18/11/2011,Thailand,Pattani,1,1,2,A 43-year-old Buddhist is taken down by Muslim bombers.
16488,18/11/2011,Afghanistan,Nangarhar,4,6,10,Four children are reportedly killed by a Taliban bomb at a playground.
16489,18/11/2011,Iraq,Fallujah,5,2,7,A 55-year-old woman and children are among five members of a family blown apart by a Jihad bomb attack on their home.
16490,18/11/2011,Iraq,Abu Ghraib,4,13,17,Four people are killed when Muslim rivals bomb their mosque.
16491,19/11/2011,Iraq,Ramadi,5,4,9,"Terrorists attack a police checkpoint, shooing five officers to death."
16492,19/11/2011,Iraq,Mussayab,2,0,2,'Insurgents' kidnap and behead two civilians.
16493,19/11/2011,Azerbaijan,Baku,1,0,1,A journalist is beaten and stabbed five times over an article deemed critical of Muhammad.
16494,19/11/2011,Pakistan,Shaidu,1,1,2,A moderate cleric is shot to death in a mosque after telling radicals not to preach there.
16495,19/11/2011,Yemen,al-Mukalla,1,0,1,al-Qaeda assassins are suspected in a deadly shooting.
16496,20/11/2011,Pakistan,Sindh,1,0,1,Sunnis set up a fake roadblock and kill a Shiite driver.
16497,20/11/2011,Nigeria,Razat,3,1,4,Muslims hack three young Christians to death at an illegal roadblock.
16498,20/11/2011,Iraq,Hillah,4,0,4,Three women are among four Iraqis executed at point-blank range by Mujahid gunmen.
16499,20/11/2011,Pakistan,Karachi,0,5,5,Fundamentalists bomb a cinema.
16500,21/11/2011,Thailand,Yala,1,0,1,A 55-year-old businessman is torn to shreds by a Muslim bomb.
16501,21/11/2011,Iraq,Abbarah,1,3,4,A civilian is taken out by Jihadi bombers.
16502,21/11/2011,Pakistan,Orakzai,2,11,13,Tehrik-e-Taliban kill two local security personnel in a sustained assault on their post.
16503,21/11/2011,Thailand,Pattani,0,9,9,Three Buddhist monks and three elderly men are among nine injured by a Muslim bomb hidden in a flower pot.
16504,21/11/2011,Nigeria,Barkin Ladi,1,0,1,Islamic extremists behead a young Christian.
16505,22/11/2011,Somalia,Mogadishu,11,4,15,Three children are among eleven civilians disassembled by an al-Shabaab bomb.
16506,22/11/2011,Afghanistan,Alingar,4,2,6,A woman and child are among four civilians murdered during a Taliban roadside attack.
16507,22/11/2011,Pakistan,Dera Bugti,5,11,16,Islamic militants are thought responsible for an attack on a group of Chinese engineers that leaves five dead.
16508,22/11/2011,Pakistan,Mardan,2,7,9,A guard and passerby are killed when religious radicals bomb a girl's school.
16509,22/11/2011,Pakistan,Quetta,1,0,1,A mosque imam is gunned down after prayer by Religion of Peace rivals.
16510,22/11/2011,Pakistan,Pasni,2,0,2,"Two members of a peace committee are abducted by Islamic militants, slaughtered and then dumped in a market."
16511,22/11/2011,Pakistan,Karachi,1,0,1,A father of three is shot to death by sectarian rivals.
16512,23/11/2011,Pakistan,Darbaan Kalan,2,7,9,Two local cops are exterminated by a Sunni rocket attack on their station.
16513,23/11/2011,Nigeria,Sabon Layi,4,0,4,A Bible teacher is among four worshipers slaughtered at a church by Muslim radicals.
16514,23/11/2011,Pakistan,Khurda Renala,1,0,1,Muslims torture and shoot to death a Catholic father of four.
16515,23/11/2011,Afghanistan,Grishk,1,1,2,A civilian is murdered by armed Sunni fundamentalists.
16516,23/11/2011,Nigeria,Yobe,2,0,2,Militants kidnap and kill two children to punish their father for being 'disloyal to Islam' by converting to Christianity.
16517,23/11/2011,Iraq,Diyala,9,0,9,Nine torture victims of al-Qaeda are found buried together.
16518,24/11/2011,Saudi Arabia,Qatif,4,9,13,"Sunni gunmen fire into a Shiite funeral, killing four mourners."
16519,24/11/2011,Pakistan,Gujrat,2,0,2,A young couple is shot to death by the wife's family for marrying for love.
16520,24/11/2011,Afghanistan,Bakwah,10,7,17,At least ten security guards are slaughtered by Taliban gunmen.
16521,24/11/2011,Thailand,Narathiwat,3,0,3,Three plantation workers are shot to death by suspected Muslim radicals while riding in a pickup truck.
16522,24/11/2011,Kenya,Mandera,1,4,5,A Kenyan soldier loses his life to a cross-border IED attack by Islamic terrorists.
16523,24/11/2011,Thailand,Pattani,2,0,2,Two drug manufacturers are gunned down by suspected Islamists.
16524,24/11/2011,Iraq,Basra,25,71,96,Two dozen people are sent to Allah by Mujahid bombers at an outdoor market.
16525,24/11/2011,Iraq,Baghdad,1,2,3,A woman is murdered in her home by Islamic terrorists.
16526,24/11/2011,Nigeria,Barkin Ladi,18,1,19,"A Christian family of sixteen, including children, is burned alive by Fulanis."
16527,24/11/2011,Nigeria,Kwok,26,0,26,Twenty-six Christian villagers are shot and hacked to death by Fulani herdsmen screaming 'Allah Akbar'.
16528,25/11/2011,Pakistan,Muzaffargarh,0,2,2,Two Christian women are beaten on their own land with clubs by a group of Muslim 'men'.
16529,25/11/2011,Afghanistan,Gereshk,2,0,2,Two police officers are gunned down in cold blood by religious radicals.
16530,25/11/2011,Kenya,Garissa,1,0,1,One person is murdered outside of a church by Muslim radicals.
16531,25/11/2011,Kenya,Garissa,2,27,29,"Islamists toss grenades into a restaurant, killing two patrons."
16532,25/11/2011,Pakistan,Karachi,1,0,1,A 70-year-old Shia man is shot through the head in his shop by sectarian Jihadis.
16533,25/11/2011,Mali,Timbuktu,1,0,1,A German tourist is shot to death at a restaurant by al-Qaeda.
16534,26/11/2011,Iraq,Abu Ghraib,8,13,21,Eight construction workers are permanently demolished by a Mujahid bombing attack.
16535,26/11/2011,Iraq,Baghdad,7,28,35,Holy Warriors take down seven Iraqis with well-planted bombs along a commercial district.
16536,26/11/2011,Pakistan,Rawalpindi,2,0,2,Two sisters have their throats slit by conservative in-laws after failing to conceive.
16537,26/11/2011,India,Kakinara,1,0,1,A 17-year-old Hindu girl is stabbed to death by a Muslim rapist.
16538,26/11/2011,Nigeria,Geidam,4,20,24,"Islamic radicals descend on a small town, burn eight churches and murder four defenders."
16539,27/11/2011,Somalia,Mogadishu,1,5,6,"Religion of Peace proponents blow a hole in a hospital, killing a nurse treating famine victims."
16540,27/11/2011,Nigeria,Borno,2,0,2,Boko Haram Islamists shoot two people to death.
16541,27/11/2011,Yemen,Damaj,30,61,91,"Militant Shiites shell a Sunni town, killing thirty, including several students."
16542,27/11/2011,Pakistan,Karachi,2,0,2,Two Shias are gunned down in separate sectarian attacks.
16543,27/11/2011,Somalia,Afmadow,2,0,2,Two youth are beheaded by al-Shabaab Islamists.
16544,27/11/2011,Pakistan,Numaish Chowrangi,2,8,10,Two people are killed during a sectarian incident between Sunni and Shia.
16545,27/11/2011,Philippines,Zamboanga,3,27,30,"Holy Warriors bomb a hotel packed with wedding guests, killing at least three."
16546,28/11/2011,Iraq,Taji,19,24,43,"Suicide bombers destroy a minibus, along with nineteen passengers."
16547,28/11/2011,Iraq,Kirkuk,1,13,14,One family member is killed when 'insurgents' throw a bomb into a house.
16548,28/11/2011,Iraq,Baghdad,5,6,11,"A Shahid suicide bomber detonates himself outside the parliament building, killing five people."
16549,29/11/2011,Pakistan,Quetta,1,0,1,Wahhabis murder a Shia professor.
16550,29/11/2011,Thailand,Narathiwat,1,0,1,Islamic 'separatists' kill a 49-year-old civilian in a drive-by.
16551,29/11/2011,Pakistan,South Waziristan,2,3,5,Two people are killed by a Taliban bomb while attending a funeral.
16552,29/11/2011,Iraq,Samarra,5,0,5,"Sunni extremists murder five family members of a Shia cleric in their home, including two women."
16553,30/11/2011,Pakistan,Hangu,1,2,3,A member of a peace committee gets a rude awakening from militant car bombers.
16554,30/11/2011,Somalia,Mogadishu,4,12,16,Four Somalis are sent to Allah by a Fedayeen suicide bomber.
16555,30/11/2011,Egypt,Ghorayzat,2,3,5,Two Christian brothers are murdered in cold blood by a Muslim mob rampaging through Christian homes and businesses.
16556,30/11/2011,Turkey,Istanbul,0,2,2,A man fires a shotgun at the guards of a palace complex while shouting 'Allah Akbar'.
16557,30/11/2011,Yemen,Aden,2,0,2,Two guards are shot to death by Islamists.
16558,1/12/2011,Iraq,Khalis,10,25,35,Ten patrons at a vegetable market are ripped apart by a well-placed bomb.
16559,1/12/2011,Iraq,Jil al-Said,8,5,13,"al-Qaeda gunmen pull eight people from their homes, line them up against the wall and shoot them."
16560,1/12/2011,Thailand,Yala,1,1,2,A local soldier is killed by a bomb planted by Islamic 'insurgents'.
16561,2/12/2011,Iraq,Taji,4,7,11,"al-Qaeda bombers take down four Iraqis, including a man and his mother."
16562,2/12/2011,Afghanistan,Logar,1,84,85,A suicide truck bomber kills a carpenter and injures about eighty others.
16563,2/12/2011,Yemen,Ghayl Ba Wazir,2,3,5,"al-Qaeda gunmen spray the inside of a coffee shop with bullets, leaving at least two dead."
16564,2/12/2011,Pakistan,Khyber,5,0,5,Three women and two children are killed in the crossfire between two Islamist groups.
16565,2/12/2011,Pakistan,Landi Kotal,2,2,4,Two peace committee members are murdered by armed radicals.
16566,2/12/2011,Iraq,al-Sharqat,3,2,5,Three civilian defense volunteers are machine-gunned at a checkpoint by al-Qaeda.
16567,3/12/2011,Kazakhstan,Boraldai,2,0,2,Two policemen are shot to death by a group of Muslim radicals.
16568,3/12/2011,Nigeria,Maiduguri,2,3,5,"Boko Haram Islamists fire into a wedding ceremony, killing the groom and a guest."
16569,3/12/2011,Pakistan,Jaffarabad,2,0,2,Two people are shot to death on suspicion of 'illicit relations'.
16570,3/12/2011,Yemen,Zinjibar,5,0,5,Five local soldiers are taken out in a brutal al-Qaeda ambush.
16571,3/12/2011,Iraq,Baghdad,2,0,2,A man and his wife are murdered by Islamist gunmen.
16572,3/12/2011,Iraq,Iskandariya,3,0,3,Three innocent people are killed by an 'insurgent' roadside bomb.
16573,3/12/2011,Iraq,Baaj,3,0,3,Three brothers are shot to death in their home by Sunni militants.
16574,3/12/2011,Iraq,Zakho,0,32,32,Thirty-two people are injured during a rampage by fundamentalists against Christian-owned businesses.
16575,3/12/2011,Pakistan,Karachi,2,0,2,Two men are shot to death by sectarian Jihadis.
16576,4/12/2011,Iraq,Bayaa,1,9,10,Sunni bombers manage to take down a Shia pilgrim on foot.
16577,4/12/2011,Nigeria,Bauchi,6,2,8,A boy is among six people killed by a Boko Haram bombing and shooting attack..
16578,4/12/2011,Bangladesh,Dhaka,0,1,1,A man ties up his wife and then cuts off her fingers for seeking higher education without his approval.
16579,4/12/2011,Thailand,Pattani,1,0,1,Suspected fundamentalists smash in the head of a 24-year-old lesbian and throw her into a garbage dump.
16580,5/12/2011,Syria,Homs,36,0,36,"Sectarian violence between the Farouq Brigade of Islamists and Alawites results in thirty-six people kidnapped, tortured and beheaded."
16581,5/12/2011,Kenya,Nairobi,0,1,1,A 23-year-old Christian is beaten into unconsciousness by seven Muslims for the crime of leaving Islam.
16582,5/12/2011,Pakistan,Jhang,0,8,8,Sunni and Shia clash over religious differences.
16583,5/12/2011,Iraq,Latifiyah,2,3,5,Sunni bombers take down two Shiite pilgrims on foot.
16584,5/12/2011,Afghanistan,Chora,5,6,11,Four children and a woman are dismantled by a Taliban roadside bomb.
16585,5/12/2011,Pakistan,Kohat,2,11,13,"Muslim militants fire a rocket into a market, killing two people."
16586,5/12/2011,Kenya,Dadaab,1,3,4,An al-Shabaab roadside bomb leaves a refugee camp guard dead.
16587,5/12/2011,Nigeria,Maiduguri,2,0,2,Two people praying at a mosque are gunned down by Religion of Peace rivals.
16588,5/12/2011,Somalia,Bosaso,1,0,1,al-Shabaab extremists gun down a rival cleric at a mosque.
16589,5/12/2011,Iraq,Hillah,22,63,85,"Two dozen pilgrims, mostly women and children, are ripped apart by three Sunni car bombs."
16590,5/12/2011,Iraq,Baghdad,8,18,26,A Sunni roadside bomb attack on a Shia procession leaves eight pilgrims dead.
16591,5/12/2011,Iraq,Baghdad,3,20,23,Three Shiite pilgrims are killed by Sunni bombers.
16592,6/12/2011,Iraq,Kirkuk,1,0,1,An oil company employee is blown up by Islamic 'insurgents'.
16593,6/12/2011,Pakistan,Jhang,0,6,6,"After offering prayers, two rival Islamic groups pelt each other with stones."
16594,6/12/2011,Afghanistan,Kabul,80,134,214,"About eighty Shiite pilgrims, including women and children, are torn to shreds outside a shrine by a Sunni wearing an explosives vest packed with ball bearings."
16595,6/12/2011,Iraq,Kirkuk,1,8,9,"Sunnis fire mortars at a Shia mosque, killing one occupant."
16596,6/12/2011,Afghanistan,Mazar-i-Sharif,4,21,25,Four Shiites leaving a mosque are sent straight to Allah by Sunni bicycle bombers.
16597,6/12/2011,India,Pulwama,1,0,1,Islamic militants abduct and murder a civilian.
16598,6/12/2011,Somalia,Mogadishu,4,10,14,A Fedayeen suicide bomber scatters the body parts of at least four victims along a city street.
16599,7/12/2011,Nigeria,Kaduna,10,12,22,Very young children are among the casualties of a Shahid suicide bombing in a commercial district.
16600,7/12/2011,Thailand,Pattani,1,0,1,A Buddhist cop is murdered by a Muslim drive-by.
16601,7/12/2011,Afghanistan,Sangin,19,6,25,"Holy Warriors massacre nineteen bus passengers, including five children, with a landmine."
16602,7/12/2011,Yemen,Dammaj,3,0,3,"Sunni Islamists open fire on a group of Shia, killing three."
16603,7/12/2011,Iraq,Mosul,2,0,2,A professor is among two people shot to death by suspected Islamists.
16604,7/12/2011,Iraq,Fallujah,3,2,5,Three local cops are taken out by Jihadi bombers.
16605,8/12/2011,Pakistan,Khyber,1,0,1,The Abdullah Azam Brigade claim responsibility for the murder of a women's rights advocate.
16606,8/12/2011,Yemen,Dammaj,7,15,22,Seven are killed when Salafists and Shiites lob shells at each other.
16607,9/12/2011,Pakistan,Karachi,1,0,1,A 45-year-old Shia man is gunned down in his own home by Wahhabis.
16608,9/12/2011,Thailand,Yala,1,0,1,Militant Muslims shoot a 28-year-old man to death outside a rubber plantation.
16609,9/12/2011,Afghanistan,Ghazi Abad,6,8,14,"A Shahid suicide bomber detonates inside a mosque, killing six."
16610,9/12/2011,Pakistan,Karachi,3,4,7,A roadside attack by suspected Islamists leaves three security personnel dead.
16611,10/12/2011,Nigeria,Sapele,0,1,1,A bomb is thrown into a mosque to settle a disagreement between members over 'mode of worship'.
16612,10/12/2011,Pakistan,Landikotal,1,0,1,Religious extremists tear down two Sufi shrines and murder an elderly caretaker.
16613,10/12/2011,Nigeria,Jos,1,11,12,"A young fan is killed when Islamic bombers target several Christian areas, including an outdoor viewing of a televised soccer match."
16614,10/12/2011,Pakistan,Karachi,3,0,3,A victim of torture is among three people killed in sectarian violence.
16615,10/12/2011,Pakistan,Sham,1,3,4,Terrorists take down a child and injure three women with a landmine.
16616,10/12/2011,Iraq,Kirkuk,7,4,11,Seven Iraqis are killed in a series of sectarian attacks.
16617,10/12/2011,Yemen,Zinjibar,2,36,38,Two local soldiers are murdered in a violent al-Qaeda assault on a barracks.
16618,10/12/2011,Afghanistan,Kunduz,2,16,18,Islamists attach a bomb to a bicycle that manages to kill two innocents.
16619,10/12/2011,Afghanistan,Khakrez,3,0,3,Sunni bombers murder three civilians riding a taxi.
16620,10/12/2011,Afghanistan,Maiwand,1,0,1,A civilian on a motorcycle is taken out by a Taliban bomb.
16621,10/12/2011,Nigeria,Kukum Gida,1,2,3,"Muslim gunmen ambush Christian villagers in the middle of the night, murdering a 50-year-old woman."
16622,10/12/2011,Pakistan,Karachi,1,7,8,A 45-year-old man is killed when Islamists detonate a bomb at a university.
16623,10/12/2011,Nigeria,Sapele,0,1,1,A disagreement at a mosque leads to a bombing that leaves one badly injured.
16624,11/12/2011,Nigeria,Gombe,1,0,1,Muslim gunmen murder a Christian as he is putting gas in his car.
16625,11/12/2011,Nigeria,Kagoro,1,2,3,Fulani extremists gun down a Christian mother.
16626,11/12/2011,Pakistan,Kharhy Mela,3,0,3,"Three tribal elders are shot to death by Islamic activists, including one in captivity."
16627,11/12/2011,Kenya,Mandera,1,12,13,One person is killed when al-Shabaab bombers target humanitarian workers outside a refugee camp.
16628,11/12/2011,India,Srinagar,1,3,4,Muslim terrorists are responsible for a shooting attack that leaves one dead.
16629,12/12/2011,Pakistan,Dadar,1,0,1,The driver of an oil tanker is pulled out of his truck and shot to death by Taliban militants.
16630,12/12/2011,Pakistan,Karachi,0,53,53,"Fifty-three people, some children as young as 7, are chained and tortured in the basement of a seminary by the staff."
16631,12/12/2011,Pakistan,Quetta,1,0,1,A young Hindu is abducted and murdered in captivity.
16632,12/12/2011,Nigeria,Borno,4,0,4,A woman is among four people machine-gunned by suspected Islamists in a surprise drive-by attack.
16633,12/12/2011,India,Sujna,1,0,1,Mujahideen shoot a police officer to death.
16634,12/12/2011,Indonesia,Jakarta,0,2,2,A man stabs members of a TV crew for supposedly insulting Allah.
16635,12/12/2011,Pakistan,Hangu,4,4,8,"Militant Muslims kill four people in two attacks, which include firing rockets into a commercial district."
16636,12/12/2011,Iraq,Baghdad,2,6,8,Terrorists gun down two people and attempt to blow up six others.
16637,12/12/2011,Afghanistan,Greshk,6,2,8,The Taliban slaughter six women and children with a roadside bomb.
16638,13/12/2011,Pakistan,Satellite Town,1,0,1,"The body of a young Hindu is found, three weeks after his abduction by Muslim militants."
16639,13/12/2011,Nigeria,Maiduguri,4,11,15,A 9-year-old child is among four reported dead from a suicide attack.
16640,13/12/2011,Pakistan,Bara,4,4,8,Two children and a woman are among four civilians killed when Islamic militants shell their home.
16641,13/12/2011,Pakistan,Shalobar,2,7,9,Two women are killed in a Taliban rocket attack on their neighborhood.
16642,13/12/2011,Iraq,Fallujah,3,5,8,Three bus passengers are riddled with bullets by al-Qaeda assassins.
16643,13/12/2011,Iraq,Ishaqi,2,3,5,Muslim bombers take out two Iraqis.
16644,13/12/2011,Iraq,Mosul,2,2,4,A Christian man and his wife are gunned down in their car by Jihad warriors.  Their children survive with injuries.
16645,13/12/2011,Yemen,Zinjibar,3,11,14,al-Qaeda gunmen murder several local troops in a shooting attack.
16646,13/12/2011,Thailand,Pattani,1,0,1,Muslim 'insurgents' gun down a Buddhist mechanic riding a motorcycle.
16647,13/12/2011,Iraq,Baghdad,1,5,6,A Fedayeen suicide bombing leaves one other person dead.
16648,14/12/2011,Pakistan,Bara,2,1,3,Two peace committee members are murdered by Islamic terrorists.
16649,14/12/2011,Afghanistan,Khanishin,3,3,6,Three Afghans lose their lives to a Taliban roadside bomb.
16650,14/12/2011,Iraq,Tal Afar,5,33,38,Jihadis take down five Iraqis with two car bombs - the first of which was intended to attract more victims.
16651,14/12/2011,Pakistan,Landikotal,2,0,2,Two cemetery guards are shot to death by Abdullah Ezaam terrorists.
16652,14/12/2011,Pakistan,Quetta,1,0,1,The son of a cleric is murdered by Religion of Peace rivals.
16653,14/12/2011,Thailand,Narathiwat,1,0,1,A local politician is assassinated by Muslim radicals.
16654,14/12/2011,Dagestan,Caspiisk,1,0,1,Muslim 'separatists' murder a man in his own home.
16655,14/12/2011,Nigeria,Maiduguri,2,3,5,"Boko Haram members fire on a group of people playing cards, killing two."
16656,14/12/2011,Lebanon,Ain al-Helweh,1,0,1,A man is shot to death by Jund al-Sham gunmen.
16657,14/12/2011,Iraq,Mosul,2,0,2,Two more Christians are shot to death.
16658,15/12/2011,Saudi Arabia,Jeddah,0,6,6,At least six Ethiopian Christians are beaten when police storm a prayer meeting.  Twenty-nine women are strip-searched.
16659,15/12/2011,Nigeria,Maiduguri,5,0,5,"Gunmen from an Islamic sect fire on a group of civilians outside a shop, killing two."
16660,15/12/2011,Nigeria,Kano,4,2,6,Four security personnel are killed by a surprise Boko Haram assault on their school.
16661,15/12/2011,Thailand,Yala,2,1,3,"Suspected Islamists riddle a family vehicle with bullets, killing a mother and son."
16662,16/12/2011,Iraq,Mosul,1,0,1,A man is shot to death in his home by Mujahideen.
16663,16/12/2011,Afghanistan,Kabul,1,0,1,A 7-year-old girl dies from splinter injuries from a grenade thrown by Sunni radicals.
16664,16/12/2011,Pakistan,Bara,1,4,5,Terrorists take out a 6-year-old girl in a rocket attack on her home.
16665,16/12/2011,Pakistan,Muslim Dhand,3,0,3,A woman is among three killed when Talibanis mortar a residential neighborhood.
16666,17/12/2011,Pakistan,Loralali,1,0,1,A woman is honor-killed by her two brothers-in-law.
16667,17/12/2011,Iraq,Baghdad,1,0,1,A secular judge is assassinated by suspected religious radicals.
16668,17/12/2011,Iraq,Abu Ghraib,3,2,5,"Jihadis bomb a minibus, killing two passengers."
16669,17/12/2011,Thailand,Yala,1,0,1,Islamic 'separatists' kill a 35-year-old man in a drive-by.
16670,17/12/2011,Afghanistan,Kandahar,1,0,1,A government official is shot to death by Taliban militants while walking home.
16671,17/12/2011,Pakistan,Katasarai,3,0,3,Tehreek-e-Taliban terrorists kill three local soldiers with an IED.
16672,18/12/2011,Pakistan,Muzaffargarh,1,3,4,One person is killed in a fight between two groups of worshippers over control of a mosque.
16673,18/12/2011,Lebanon,Ain al-Helweh,1,3,4,A child is among the casualties of a Jund al-Sham shooting attack.
16674,18/12/2011,Nigeria,Kano,6,10,16,A half-dozen victims result from a terror attack by Islamic fundamentalists.
16675,18/12/2011,Pakistan,Jhang,2,0,2,Two women are murdered by relatives on suspicion of illicit relations.
16676,19/12/2011,Kenya,Dadaab,1,2,3,al-Shabaab bombers take out a guard at a refugee camp.
16677,19/12/2011,Iraq,Balad,1,2,3,"Sunnis bomb a minibus carrying Shia pilgrims, killing at least one."
16678,19/12/2011,Iraq,Mosul,4,4,8,A grocer is among four left dead after separate Mujahideen attacks.
16679,19/12/2011,Iraq,Kokjali,1,1,2,A teenager is murdered by Muslim terrorists while walking home from school.
16680,19/12/2011,Pakistan,Mastung,1,0,1,Wahhabis gun down a Shia civilian waiting for a bus.
16681,19/12/2011,Nigeria,Ungwan Rami,5,6,11,Five Christian villagers are hacked and shot to death by Muslim raiders.  The victims include a mother and her baby.
16682,20/12/2011,Pakistan,Huta,1,0,1,A government official is assassinated by al-Qaeda gunmen.
16683,20/12/2011,Iraq,Fallujah,4,0,4,Four contractors are kidnapped and murdered.
16684,21/12/2011,Afghanistan,Rawza,5,0,5,Five Polish soldiers are killed by Taliban bombers in a roadside attack.
16685,21/12/2011,Thailand,Yala,1,1,2,A villager is shot and killed by Muslim 'insurgents'.
16686,21/12/2011,Pakistan,Karachi,1,7,8,One person is killed during a clash between Sunni and Shia.
16687,21/12/2011,Thailand,Pattani,2,11,13,Two Thais are killed during a wave of Mujahid bombing and shootings.
16688,22/12/2011,Pakistan,Punjab,0,16,16,Two student Islamic groups clash over sectarian differences.
16689,22/12/2011,Pakistan,Hangu,0,4,4,"Terrorists bomb the clinic of a female doctor, injuring four, including a young girl."
16690,22/12/2011,Nigeria,Damaturu,4,0,4,Four Nigerians are taken down by Boko Haram bombers.
16691,22/12/2011,Iraq,Baghdad,72,217,289,Over seventy Iraqis are massacred by 'freedom fighters' in a series of bombings and rocket attacks across the city following the departure of U.S. troops.
16692,22/12/2011,Iraq,Kirkuk,1,0,1,A young man is kidnapped and executed by 'insurgents'.
16693,22/12/2011,Iraq,Baqubah,5,0,5,Five family members are machine-gunned in their home by al-Qaeda gunmen.
16694,22/12/2011,Pakistan,Lahore,0,1,1,A young Christian is stabbed several times after having been falsely accused of insulting Islam.
16695,22/12/2011,Nigeria,Chibok,2,0,2,Islamists invade a family home and murder a father and son simply because they are Christian.
16696,23/12/2011,Pakistan,Shadman,2,2,4,Two employees at a telecom office are gunned down in cold blood by orthodox Muslims because they worked for a Norwegian firm.
16697,23/12/2011,Syria,Damascus,44,166,210,Over forty people are torn to shreds by two Shahid suicide bombers in an upscale district.
16698,23/12/2011,Nigeria,Damaturu,4,0,4,"Boko Haram militants open fire on a group of police, killing four."
16699,23/12/2011,Nigeria,Potiskum,1,7,8,A 10-year-old boy is among the casualties of a shooting attack by Muslim militants.
16700,23/12/2011,Somalia,Mataban,3,0,3,A Religion of Peace 'activist' shoots three aid workers to death.
16701,23/12/2011,Pakistan,Tank,1,17,18,"The Taliban take hostages after a deadly attack on a post, threatening to cut them into pieces."
16702,24/12/2011,Nigeria,Maiduguri,11,0,11,A pastor and his young daughter are incinerated when Islamists fire bomb three churches.
16703,24/12/2011,Afghanistan,Takhta Pul,3,0,3,Three locals are killed by a Taliban bomb.
16704,24/12/2011,Pakistan,Bannu,9,17,26,A Fedayeen suicide car bomber murders nine others.
16705,24/12/2011,Kenya,Wajir,0,6,6,A half-dozen people are injured when fundamentalists throw a grenade into a bar.
16706,24/12/2011,Uganda,Namasuba,0,1,1,"A young pastor, who left Islam after having been born the son of an imam, is blinded by acid in a vicious Christmas Eve attack."
16707,24/12/2011,India,Srinagar,1,0,1,The Islamic Movement of Kashmir assassinate a local official.
16708,24/12/2011,Iraq,Kirkuk,3,1,4,"Two brothers are kidnapped and murdered by 'insurgents', who also kill a school principal."
16709,24/12/2011,Iraq,Mosul,4,3,7,Four Iraqis are shot to death in a series of Mujahideen shootings.
16710,24/12/2011,Pakistan,Urmur,1,3,4,A toy bomb planted by religious extremists leaves a father dead and three children injured.
16711,25/12/2011,Pakistan,Gilgit,1,0,1,A Shiite is gunned down by Sunni rivals.
16712,25/12/2011,Sri Lanka,Sammanthurai,1,0,1,A Muslim father beats his daughter to death for dating a non-Muslim.
16713,25/12/2011,Afghanistan,Talaqan,22,50,72,Two dozen mourners at a funeral are sent to Allah by a Fedayeen suicide bomber.
16714,25/12/2011,Nigeria,Madalla,45,73,118,"Religion of Peace bombers strike a Catholic church during a morning Christmas mass, slaughtering forty-five worshippers."
16715,25/12/2011,Nigeria,Damaturu,3,1,4,"A Shahid suicide bomber detonates near a security compound, killing three people."
16716,25/12/2011,Nigeria,Jos,1,0,1,"Muslim militants fire on a protestant church, killing a guard."
16717,25/12/2011,Pakistan,Loralai,1,0,1,A civilian is kidnapped and executed by Tehreek-e-Taliban.
16718,25/12/2011,Iraq,Mosul,1,0,1,Muslim snipers pick off a Christian just outside his home.
16719,25/12/2011,Iraq,Garma,6,2,8,Six local cops at a checkpoint are machine-gunned at point-blank range by Sunni terrorists.
16720,25/12/2011,Iraq,Dujail,2,20,22,A Fedayeen suicide bomber sends two Iraqis to Allah.
16721,26/12/2011,Iraq,Baghdad,7,37,44,Seven people are blown to bits by a Shahid suicide car bomber.
16722,26/12/2011,Pakistan,Peerabad,1,0,1,A school clerk is murdered by religious fundamentalists.
16723,26/12/2011,Pakistan,Kohat,1,1,2,Two members of a peace committee are fired on by Islamic militants.
16724,26/12/2011,Iraq,Baiji,1,0,1,A man is shot in the head by al-Qaeda.
16725,26/12/2011,Pakistan,Banaras,1,0,1,The caretaker of a seminary is murdered by sectarian gunmen.
16726,27/12/2011,Pakistan,Tank,1,2,3,"Terrorists fire on a local peace committee, killing one member."
16727,27/12/2011,Iraq,Mosul,2,0,2,A man and his father are murdered in their home by 'insurgents'.
16728,27/12/2011,Pakistan,Gulbahar,2,0,2,A prayer leader is among two gunned down by sectarian rivals.
16729,27/12/2011,Iraq,Kirkuk,2,1,3,Mujahideen kill two civilians with a car bomb.
16730,27/12/2011,Pakistan,Peshawar,1,0,1,Islamists gun down a security official as he is leaving a mosque.
16731,27/12/2011,Thailand,Yala,1,1,2,One person is killed when Muslim 'insurgents' bomb a group of teachers and their security.
16732,28/12/2011,Pakistan,Plateau,3,0,3,A baby is among three members of a Christian family shot and hacked to death by machete-wielding Muslims.
16733,28/12/2011,Iraq,Mosul,4,0,4,Four local police officers are killed in and around the city by Muslim terrorists.
16734,28/12/2011,Nigeria,Sapele,0,7,7,Seven children at a religious school are injured when a bomb is thrown to settle a dispute over mosque leadership.
16735,29/12/2011,Egypt,Assiut,0,5,5,At least five people are hurt when a Muslim mob burns Christian homes over a Facebook cartoon.
16736,29/12/2011,Pakistan,Orakzai,1,0,1,Religious radicals murder a tribal elder.
16737,29/12/2011,Afghanistan,Nad Ali,10,1,11,Ten police recruits are torn to shreds by a Taliban bomb.
16738,29/12/2011,Afghanistan,Kapisa,3,0,3,Two French and one local troops are murdered by a terrorist in an Afghan uniform.
16739,29/12/2011,Pakistan,Khairpur,0,10,10,Ten are injured when two religious groups clash over a Quran reading.
16740,30/12/2011,Pakistan,Dara Bazar,2,3,5,"A bomb explodes on the main road leading into a village, leaving two dead."
16741,30/12/2011,Pakistan,Quetta,16,35,51,"A suicide bomber slaughters thirteen innocents, including women and children."
16742,30/12/2011,Nigeria,Maiduguri,4,4,8,At least four people are killed when Islamists set off a bomb outside a rival mosque.
16743,30/12/2011,Pakistan,Salarzai,2,1,3,Two children are burned to a crisp when a militant Muslim detonates an incendiary device in a store.
16744,30/12/2011,Nigeria,Maiduguri,2,1,3,Suspected Boko Haram gun down two civilians at a market.
16745,30/12/2011,Afghanistan,Trinkot,4,1,5,Holy Warriors take out four civilians riding in a car.
16746,30/12/2011,Nigeria,Maiduguri,3,0,3,Boko Haram gunmen invade the home of a rival cleric and murder three of his family members.
16747,30/12/2011,Pakistan,Shakoi,2,4,6,"Talibanis mortar a neighborhood, killing two residents."
16748,30/12/2011,Pakistan,Salarzai,2,3,5,Women are among the casualties when Islamic bombers target a peace committee.
16749,30/12/2011,Yemen,Zinjibar,2,3,5,Two local soldiers are killed by 'Partisans of Sharia' gunmen.
16750,30/12/2011,Thailand,Yala,1,0,1,A 23-year-old man is picked off in front of his home by Muslims on motorcycles.
16751,31/12/2011,Iraq,Diyala,5,0,5,Five Iraqis are murdered in cold blood by al-Qaeda gunmen.
16752,31/12/2011,Pakistan,Karachi,1,1,2,A Shia leader is gunned down by Religion of Peace rivals.
16753,31/12/2011,Pakistan,Khugakhel,2,13,15,Two children bleed to death following a bomb blast outside the home of a tribal elder.
16754,1/1/2012,Kenya,Dadaab,1,0,1,A refugee camp leader is shot to death by al-Qaeda-linked terrorists.
16755,1/1/2012,Pakistan,Bajaur,1,3,4,Islamic bombers take out a 7-year-old boy.
16756,1/1/2012,Kenya,Garissa,5,28,33,"At least five are killed when fundamentalists throw a grenade onto the dance floor of a bar serving alcohol, then shoot those trying to flee."
16757,2/1/2012,Somalia,Cee-Carfiid,1,0,1,A Christian humanitarian worker is beheaded by Religion of Peace activists for leaving Islam.
16758,2/1/2012,Tajikistan,Dushanbe,1,0,1,A Christian dressed as Father Christmas is called an 'infidel' and stabbed to death by Muslim radicals.
16759,3/1/2012,Nigeria,Jigawa,1,1,2,A teenage girl is shot to death by Boko Haram.
16760,3/1/2012,Afghanistan,Kandahar,7,13,20,Seven people are blown to bits by a Fedayeen suicide bomber on a tricycle.
16761,3/1/2012,Afghanistan,Kandahar,5,16,21,Four children are torn to shreds by a Shahid suicide bomber at a crowded bazaar.
16762,3/1/2012,Pakistan,Landi Kotal,3,7,10,Three people are left dead when Abdullah Azzam Brigade bombers target a market.
16763,3/1/2012,Pakistan,Peshawar,2,19,21,A bomb planted on a motorcycle near an internet cafe leaves two dead.
16764,3/1/2012,Thailand,Pattani,2,0,2,Two Buddhists on their way to a party are disassembled by a Muslim bomb.
16765,3/1/2012,Nigeria,Damaturu,2,0,2,Two civilians are murdered by Boko Haram gunmen.
16766,3/1/2012,Nigeria,Maiduguri,1,0,1,Two Islamists shoot a civilian to death.
16767,3/1/2012,Pakistan,Shalkanabad,1,1,2,A married woman is shot to death by her father-in-law on a rumor that she was seen talking to another man.
16768,4/1/2012,Nigeria,Maiduguri,2,1,3,An 80-year-old man and his son are murdered by Religion of Peace devotees.
16769,4/1/2012,Pakistan,Warki,1,0,1,Islamic hardliners behead a former peace committee leader.
16770,4/1/2012,Pakistan,Bara,1,1,2,Lashkar-i-Islam kill a defender in an assault on a village.
16771,4/1/2012,Afghanistan,Helmand,1,0,1,The Taliban machine-gun an official on his way to a mosque.
16772,4/1/2012,Pakistan,Mansehra,1,0,1,A 'disloyal' woman is honor killed by her husband for refusing to divorce.
16773,4/1/2012,Iraq,Baqubah,2,9,11,Two children are dismantled by Mujahid bombers.
16774,4/1/2012,Iraq,Abu Ghraib,2,0,2,A man and his wife are murdered in their own home by al-Qaeda gunmen.
16775,4/1/2012,Yemen,Aden,3,24,27,Islamic fundamentalists storm and then set fire to a hotel selling alcohol.  At least three guests burn to death.
16776,4/1/2012,Pakistan,Bhittaiabad,1,0,1,"A woman is strangled, shot and then burned to death by her brother-in-law on suspicion of immoral behavior."
16777,5/1/2012,Afghanistan,Kandahar,4,1,5,Four U.S. National Guard engineers are killed by the Taliban while trying to clear a road of bombs.
16778,5/1/2012,Iraq,Baghdad,13,32,45,Sunnis plant a bomb on a motorcycle next to a group of Shia day laborers lining up for work.  At least thirteen are killed.
16779,5/1/2012,Iraq,Baghdad,16,36,52,At least sixteen Shiites are sent to Allah by Sunni car bombs planted in their neighborhood.
16780,5/1/2012,Nigeria,Damaturu,2,0,2,Two more civilians are shot dead by members of an Islamic sect.
16781,5/1/2012,Iraq,Karbala,48,80,128,"A Sunni suicide bomber blown himself up next to a crowd of Shiite pilgrims, massacring at least fifty."
16782,5/1/2012,Iraq,Nassiriya,5,20,25,Five Shiite pilgrims are blown to bits by Sunni roadside bombers.
16783,5/1/2012,Pakistan,Thal,16,0,16,Sixteen captured Pakistani troops are brutally tortured and executed by Tehrik-e-Taliban fundamentalists.
16784,5/1/2012,Thailand,Yala,1,0,1,Muslim gunmen murder a villager on his way to work at a plantation.
16785,5/1/2012,Nigeria,Mubi,4,0,4,Four Christians are gunned down by Boko Haram.
16786,5/1/2012,Pakistan,Karachi,1,1,2,Tehreek-e-Taliban shoot a man to death in his own home.
16787,5/1/2012,Nigeria,Gombe,9,10,19,"Muslim gunmen spray a church congregation with machine-gun fire, killing nine, including the pastor's wife and several children."
16788,6/1/2012,Afghanistan,Trinkot,7,4,11,Six children bleed to death following detonation of a Taliban bomb.
16789,6/1/2012,Iraq,Baghdad,2,17,19,Two Shiite pilgrims are disassembled by Sunni bombers.
16790,6/1/2012,Syria,Damascus,26,63,89,Twenty-six civilians are blown apart in a brutal al-Qaeda car bombing in a crowded area near a school.
16791,6/1/2012,Thailand,Pattani,2,1,3,'Insurgents' gun down two men in separate attacks.
16792,6/1/2012,Thailand,Narathiwat,1,1,2,A female teacher is the target of an Islamic drive-by that kills her husband.
16793,6/1/2012,Thailand,Narathiwat,2,3,5,Two police officers are machine-gunned in their sleep by Muslim militants.
16794,6/1/2012,Afghanistan,Mohammad Khel,1,0,1,An 18-year-old boy is captured and executed by the Taliban.
16795,6/1/2012,Nigeria,Mubi,20,15,35,Twenty Christians gathered for a funeral are machine-gunned at close range by Muslims shouting 'Allah Akbar'.
16796,6/1/2012,Nigeria,Adamawa,12,4,16,Islamists chanting 'Allah Akbar' barge into a church and massacre a dozen worshippers.
16797,6/1/2012,Nigeria,Yola,3,0,3,Three people at a beauty salon are gunned down by Boko Haram.
16798,7/1/2012,Iraq,Baghdad,2,8,10,Sunni bombers send two Shiite pilgrims straight to paradise.
16799,7/1/2012,Nigeria,Maiduguri,2,0,2,Two Christian university students are murdered by Religion of Peace gunmen.
16800,7/1/2012,India,Sopore,1,8,9,A civilian is killed during a shooting attack by Islamic terrorists.
16801,7/1/2012,Iraq,Fallujah,2,1,3,Mujahid bombers kill two Iraqi policemen.
16802,8/1/2012,Afghanistan,Zabul,1,0,1,A religious militant in uniform shoots a NATO soldier in the back.
16803,8/1/2012,Thailand,Pattani,1,0,1,Militant Muslim shoot a Buddhist to death in front of his wife.
16804,9/1/2012,Nigeria,Maiduguri,2,0,2,Religion of Peace activists shoot two Christians death in their own homes in separate attacks.
16805,9/1/2012,Pakistan,Dabori,10,0,10,"The bodies of ten local troops, abducted during a Taliban raid, are found brutally beheaded."
16806,9/1/2012,Iraq,Hillah,0,15,15,Fifteen Shia pilgrims are left in agony after Sunni bombers target their procession.
16807,9/1/2012,Nigeria,Biu,1,0,1,'Radical' Muslims murder a police officer right outside a mosque.
16808,9/1/2012,Iraq,Baghdad,2,10,12,Two pilgrims on foot are dismantled by Sunni roadside bombers.
16809,9/1/2012,Iraq,Baghdad,5,32,37,"Sunni bombers detonate a car bomb at a Shiite mosque, killing five."
16810,9/1/2012,Iraq,Baghdad,7,19,26,At least seven people at a market are blown to bits by Jihadi car bombers.
16811,9/1/2012,Pakistan,Karachi,1,0,1,A Shia is gunned down by sectarian rivals.
16812,9/1/2012,Iraq,Baghdad,2,0,2,Terrorists shoot a bank manager and her husband to death in their home.
16813,9/1/2012,Iraq,Owairij,1,9,10,Sunni bombers take down a Shiite pilgrim on foot.
16814,10/1/2012,Afghanistan,Kunar,3,13,16,Three local troops lose their lives to a Taliban rocket attack from across the border.
16815,10/1/2012,Afghanistan,Sharan,7,3,10,Civilians and guards are killed during an assault on a telecommunications building by suicidal Fedayeen..
16816,10/1/2012,Nigeria,Dalman,3,0,3,Three Christians are shot and hacked to death in a sectarian attack at a farming community.
16817,10/1/2012,Iraq,Baghdad,2,0,2,Two people at a market are shot to death by Mujahid gunmen.
16818,10/1/2012,Iraq,Baghdad,5,18,23,"A Shahid suicide bomber detonates in a crowd of Shia pilgrims, killing five."
16819,10/1/2012,Iraq,al-Sharqat,2,0,2,Two agricultural employees are blown to bits by 'insurgents'.
16820,10/1/2012,Iraq,Baghdad,2,0,2,Two more Shia pilgrims on foot are sent to paradise by Sunni bombers.
16821,10/1/2012,Somalia,Mogadishu,2,3,5,Two people are taken out during an al-Shabaab ambush.
16822,10/1/2012,Iraq,Yathrib,3,0,3,Three schoolboys between the ages of 9 and 11 are dismantled by 'insurgents' while walking to school.
16823,10/1/2012,Pakistan,Jamrud,35,78,113,Three dozen people waiting in line at a gas station are torn to pieces by Islamist bombers.
16824,10/1/2012,Nigeria,Potiskum,8,12,20,A 7-year-old boy is among eight innocents slain when Islamic fundamentalists storm a bar.
16825,10/1/2012,Somalia,Kismayu,1,0,1,A man is planted in the ground and stoned to death by al-Shabaab.
16826,10/1/2012,Somalia,Elasha-Biyaha,0,3,3,Several businessmen are abducted and tortured by al-Shabaab for failing to contribute to the Jihad.
16827,11/1/2012,Nigeria,Potiskum,6,0,6,"Six Christians, including a woman and a baby, are machine-gunned by Boko Haram while on a bus at a gas station."
16828,11/1/2012,Thailand,Pattani,1,0,1,Muslim 'separatists' murder a Buddhist as he is walking home.
16829,11/1/2012,Iraq,Qaim,3,0,3,Three local cops are mowed down by al-Qaeda.
16830,11/1/2012,Yemen,Aden,1,5,6,"al-Qaeda militants fire on a minibus, killing at least one passenger."
16831,11/1/2012,Kenya,Wajir,7,3,10,"Muhammad loyalists pour bombs and bullets into a refugee camp, killing at least seven, including a teacher."
16832,11/1/2012,Dagestan,Komsomolskoye,1,8,9,A Muslim bomb leaves one Russian dead and eight injured.
16833,12/1/2012,Afghanistan,Panjwai,3,13,16,"A Fedayeen suicide car bomber detonates amid a group of cars, killing a man and two children, ages 4 and 16."
16834,12/1/2012,Pakistan,Sarband,3,11,14,"Islamic militants attack a police checkpoint, killing three defenders."
16835,12/1/2012,Yemen,Mustaba,20,0,20,Twenty people are reported killed in a clash between Sunnis and Shia.
16836,12/1/2012,Pakistan,Merikhel,5,1,6,Four children and a woman are killed when suspected terrorists shell their house.
16837,12/1/2012,Iraq,al-Kefil,1,16,17,A Shiite pilgrim is sent straight to Allah by Sunni bombers.
16838,13/1/2012,Pal. Auth.,Gaza,0,1,1,A human rights activists survives a brutal stabbing by suspected Islamists.
16839,13/1/2012,Pal. Auth.,Gaza,0,30,30,"About thirty Shiites are brutally beaten by Hamas thugs, who break into their worship."
16840,13/1/2012,Somalia,Dusamareb,2,0,2,Islamic hardliners use an RPG to bring down the head of a food distribution charity.
16841,13/1/2012,Nigeria,Gombe,2,2,4,"A beer garden is targeted by Boko Haram gunmen, who kill two locals."
16842,13/1/2012,Iraq,Baghdad,1,10,11,"Sunnis detonate a car bomb near a bus stop full of Shia pilgrims, killing at least one."
16843,13/1/2012,Pakistan,Karachi,1,1,2,Sunni gunmen assassinate a Shia.
16844,14/1/2012,Yemen,Radda,2,0,2,"al-Qaeda militants storm a town, killing at least two residents caught by surprise."
16845,14/1/2012,Iraq,Basra,53,137,190,"A Holy Warrior detonates himself in a crowd of Shia pilgrims, massacring over fifty."
16846,14/1/2012,Pakistan,Nishatabad,2,0,2,A man kills his niece with an axe along with the young man whom she was suspected of having sex.
16847,14/1/2012,Afghanistan,Latak,2,0,2,Suspected Taliban take down two local cops with a bomb.
16848,14/1/2012,Pakistan,Dera Ismail Khan,6,8,14,Fedayeen suicide bombers kill four civilians and two police officers.
16849,14/1/2012,Nigeria,Yola,2,1,3,Fundamentalists shoot two bar patrons to death.
16850,15/1/2012,USA,"Houston, TX",1,0,1,A 30-year-old Christian convert is shot to death by a devout Muslim.
16851,15/1/2012,Sudan,Rabak,0,2,2,"Islamic militia force their way into a church and kidnap two priests, who are then 'mistreated' in captivity."
16852,15/1/2012,Yemen,Zinjibar,2,0,2,Two local soldiers are abducted and executed by Islamic hardliners.
16853,15/1/2012,Pakistan,Khanpur,21,30,51,"Sunnis set off a bomb next to a crowd of Shia pilgrims on foot, dismantling about twenty, including fourteen from the same family."
16854,15/1/2012,Iraq,Ramadi,7,18,25,Six guards and a civilian are killed when Fedayeen stage a suicide assault on a police building.
16855,15/1/2012,Syria,Damascus,3,0,3,Three Christians are killed in targeted attacks - two while waiting in line at a bakery.
16856,15/1/2012,Nigeria,Damaturu,2,0,2,Two people are gunned down by Religion of Peace radicals.
16857,16/1/2012,Nigeria,Damaturu,3,0,3,Advocates of Sharia law murder three foreigners.
16858,16/1/2012,Nigeria,Maiduguri,2,0,2,Two people are murdered in their homes by Boko Haram gunmen.
16859,16/1/2012,Iraq,Hillah,3,15,18,A car bomb targeting Shabak minorities in their homes kills three.
16860,16/1/2012,Iraq,Mosul,8,4,12,"Sunnis set off a car bomb outside a housing complex for displaced Shias, killing at least eight."
16861,16/1/2012,Pakistan,Bara Maidan,1,0,1,A 27-year-old police recruit is shot to death by sectarian Jihadis.
16862,17/1/2012,Nigeria,Mubi,1,0,1,A man is murdered and dumped by Boko Haram.
16863,17/1/2012,Nigeria,Maiduguri,6,1,7,Four civilians are among six killed when radical Islamists open fire on a local police checkpoint.
16864,17/1/2012,Pakistan,Shabqadar,1,0,1,A journalist loses his life to a targeted Taliban assassination.
16865,17/1/2012,Afghanistan,Kandahar,1,0,1,The Taliban enter a mosque and assassinate an adversary.
16866,17/1/2012,Iraq,Rutba,5,0,5,"Jihadis throw hand grenades at sleeping police officers, killing five."
16867,17/1/2012,Thailand,Pattani,2,0,2,A 14-year-old Buddhist boy and his father are shot in the head and chest by Muslim 'insurgents'.
16868,17/1/2012,Afghanistan,Nangahar,1,2,3,A Shahid suicide bomber takes out a guard at a government facility.
16869,17/1/2012,Sudan,Khartoum,0,1,1,A church evangelist is arrested and brutally beaten by police.
16870,17/1/2012,Nigeria,Maiduguri,1,0,1,An accountant is gunned down after standing up to Boko Haram.
16871,18/1/2012,Nigeria,Maiduguri,2,0,2,A hospital worker is among two people shot to death by radical Islamics.
16872,18/1/2012,Indonesia,Pulau Punjung,0,1,1,An atheist is beaten by a mob after writing 'God doesn't exist' on Facebook.
16873,18/1/2012,Iraq,Latifiyah,4,1,5,"al-Qaeda militants open fire on a family sleeping in their home, killing four members."
16874,18/1/2012,Afghanistan,Kajaki,12,20,32,A dozen innocents are torn to pieces by a Fedayeen suicide bomber.
16875,18/1/2012,Afghanistan,Nad Ali,4,0,4,Four Afghans are dismantled by a Taliban roadside bomb.
16876,19/1/2012,Afghanistan,Kandahar,7,8,15,Two children are among seven civilians blown to bits by a suicide bomber.
16877,19/1/2012,Thailand,Pattani,1,0,1,A 39-year-old Buddhist is gunned down by militant Muslims.
16878,19/1/2012,Somalia,Mogadishu,6,0,6,Four refugees and a local aid worker are among six Somalis taken out by a Shahid suicide bomber.
16879,19/1/2012,Egypt,Kebly-Rahmaniya,0,2,2,"A man and boy suffer gunshot injuries when a mob rampages through a Christian town, shouting 'Allah Akbar' and burning homes."
16880,20/1/2012,Iran,Sistan,1,0,1,An Iranian cleric who advocated peace is murdered by alleged Wahhabis.
16881,20/1/2012,Somalia,Mogadishu,4,0,4,"Islamists attack a vehicle carrying officials and journalists with an RPG, killing three."
16882,20/1/2012,Nigeria,Kano,1,0,1,Religion of Peace hardliners murder a 31-year-old reporter.
16883,20/1/2012,Yemen,Aden,3,0,3,al-Qaeda militants roll up on a checkpoint and shoot three local soldiers to death.
16884,20/1/2012,Afghanistan,Kandahar,4,16,20,A Fedayeen in an Afghan uniform murders four French soldiers.
16885,20/1/2012,Nigeria,Kano,3,6,9,Islamists shoot dead an Indian engineer and two Nepalese riding in a car.
16886,20/1/2012,Nigeria,Kano,256,200,456,Over two-hundred and fifty people eventually die from a series of coordinated bombing and shooting attacks by Boko Haram militants screaming 'Allah Akbar.
16887,20/1/2012,Pakistan,Bakhshi Pul,1,0,1,Islamic militants shoot a tribal elder to death.
16888,20/1/2012,Iraq,Mosul,2,0,2,'Insurgents' murder two Iraqis in separate attacks.
16889,20/1/2012,Iraq,Hawija,2,5,7,Mujahideen bombers disassemble two patrons at a market.
16890,21/1/2012,Pakistan,Rohilanwali,1,0,1,A woman is chopped up with an axe by her brother for allegedly having 'loose morals'.
16891,21/1/2012,Pakistan,Bahawalnagar,2,0,2,A man and his wife are 'honor killed' by her family for marrying by choice.
16892,21/1/2012,Yemen,Rada,3,3,6,Three residents are left dead following an al-Qaeda rocket and machine-gun attack on the home of a local healer.
16893,21/1/2012,Thailand,Pattani,1,0,1,A widow is shot in the head by Islamic 'insurgents' while visiting her husband's grave.
16894,21/1/2012,Iraq,Fallujah,4,0,4,Four Iraqis are machine-gunned at point-blank range by 'insurgents'.
16895,22/1/2012,Iraq,al-Asoud,3,3,6,"'Insurgents' attack a police checkpoint, killing three."
16896,22/1/2012,Nigeria,Tafawa Balewa,9,12,21,"Militant Muslims hurl grenades into Christian homes, killing some as they slept and then shooting others as they tried to escape."
16897,22/1/2012,Afghanistan,Ela-Sai,1,9,10,"Radicals toss a grenade into the street, killing a civilian."
16898,22/1/2012,Nigeria,Bauchi,10,0,10,Eight civilians are among ten people machine-gunned by Islamists at a checkpoint.
16899,22/1/2012,Thailand,Yala,2,0,2,Two Thais die in a shooting attack by Islamic terrorists.
16900,22/1/2012,Thailand,Yala,1,0,1,A 21-year-old man is shot three times in the chest by Muslim activists.
16901,22/1/2012,Nigeria,Maiduguri,1,0,1,Boko Haram shoot a court registrar to death in his home.
16902,23/1/2012,Syria,Homs,2,0,2,An elderly Alawite man and wife are kidnapped and murdered by Sunnis.
16903,23/1/2012,Yemen,Dhamar,1,0,1,A Yemeni security officer is murdered by al-Qaeda.
16904,23/1/2012,Turkey,Istanbul,0,1,1,A Christian laborer is severely tortured with scalding water on orders of his Muslim employer.
16905,23/1/2012,Iraq,al-Rashad,1,3,4,Suspected al-Qaeda assassinate a Sunni rival.
16906,23/1/2012,Pakistan,Khyber Pakhtunkhwa,3,4,7,Islamic militants kill two civilians and a police officer.
16907,24/1/2012,Iraq,Ramadi,2,3,5,Terrorists set off a bomb that leaves two people dead.
16908,24/1/2012,Iraq,Mosul,2,1,3,"Suspected Sunni fundamentalists behead a policeman and fire into a barber shop, killing a customer."
16909,24/1/2012,Iraq,Shirqat,1,2,3,Roadside bombers take out a civilian
16910,24/1/2012,India,Shubdani Newa,1,0,1,A 47-year-old man is killed by suspected Lashkar-i-Toiba.
16911,24/1/2012,Pakistan,Landi Kotal,1,2,3,One person is killed when Islamic militants blow up a school.
16912,24/1/2012,Iraq,Baghdad,8,24,32,"Muslim bombers target a group of day laborers in line for jobs, taking apart at least eight."
16913,24/1/2012,Iraq,Baghdad,2,26,28,Two Iraqis bleed to death after terrorists detonate a bomb in a commercial district.
16914,24/1/2012,Iraq,Baghdad,3,25,28,Two car bombs targeting Shias leaves three dead.
16915,24/1/2012,Yemen,Dhu Holais,46,20,66,Forty-six people are reported dead in armed attacks between Sunni and Shia.
16916,24/1/2012,Norway,Haugesund,0,2,2,Two ex-Muslim converts to Christianity are stabbed by three attackers shouting 'kuffar' (unbeliever).
16917,24/1/2012,Nigeria,Kano,1,1,2,A woman is killed when Islamic militants surround and open fire on a police station.
16918,24/1/2012,Somalia,Mogadishu,0,10,10,A child is among ten injured when hardliners throw a grenade into a rival mosque.
16919,24/1/2012,Somalia,Beledweyne,33,72,105,al-Shabaab claims credit for killing thirty-three Ethiopians in a massive suicide truck bombing outside a military base.
16920,24/1/2012,Thailand,Narathiwat,1,0,1,Islamic 'separatists' murder a 57-year-old man.
16921,24/1/2012,Pakistan,Kurram Agency,6,4,10,Six local troops are killed during a Taliban assault.
16922,25/1/2012,Pakistan,Karachi,3,1,4,"Sunni radicals shoot three Shiites to death, including a father and son."
16923,25/1/2012,Iraq,Salahuddin,1,0,1,A religious leader is gunned down by rivals.
16924,25/1/2012,Afghanistan,Kapisa,2,7,9,A woman and her 3-year-old child are taken out by a Taliban rocket.
16925,25/1/2012,Yemen,Hajja,13,0,13,Thirteen are reported dead in an attack by Sunnis on Shiites.
16926,26/1/2012,Iraq,Hit,1,0,1,A mosque preacher is blown up by sectarian bombers.
16927,26/1/2012,Iraq,Mosul,2,0,2,An imam and his brother are gunned down by sectarian rivals.
16928,26/1/2012,Egypt,Bahgourah,2,0,2,A Christian father and son are machine-gunned by Muslims after refusing to pay money.
16929,26/1/2012,Yemen,Kataf,9,0,9,Nine are killed during a second attack in as many days by Sunni hardliners on Shiites.
16930,26/1/2012,Afghanistan,Lashkar Gah,4,31,35,A child is among four civilians disassembled by a Shahid suicide bomb attack on an aid convoy.
16931,26/1/2012,Iraq,Musayyeb,10,0,10,Two women and six children under the age of ten are among ten killed when terrorists bomb two houses in the middle of the night.
16932,26/1/2012,Iraq,Garma,1,0,1,al-Qaeda gunmen assassinate a rival Sunni.
16933,26/1/2012,Iraq,Baghdad,3,17,20,Mujahideen bombers kill at least three Iraqis with two blasts at a coffee shop.
16934,26/1/2012,Iraq,Kirkuk,3,6,9,Terrorists kill two people with a bomb planted on a motorcycle.
16935,26/1/2012,Russia,Kabardino-Balkaria,1,0,1,Islamists cut the throat of a Russian playing volleyball at a grammar school.
16936,27/1/2012,Nigeria,Mandawari,2,0,2,Gunmen shouting 'Allah Akbar' machine-gun two police officers.
16937,27/1/2012,Somalia,Masagway,3,0,3,Three boys are beheaded by Islamists.
16938,27/1/2012,Iraq,Baghdad,33,71,104,Three dozen innocents are torn to shreds when a suicide car bomber plows into a Shiite funeral procession.
16939,27/1/2012,Iraq,Ghazaliya,1,6,7,Bombers take down a soccer player and injure six companions.
16940,27/1/2012,Iraq,Sinjar,2,0,2,Terrorists shoot a man and his wife to death.
16941,27/1/2012,Yemen,Hadrawamout,1,0,1,Islamic militants ambush and murder a police officer.
16942,28/1/2012,Dagestan,Kumturkalinsky,1,0,1,A police officer is assassinated outside his home by religious extremists.
16943,28/1/2012,Iraq,Garma,2,0,2,al-Qaeda murder a woman and her daughter in their home.
16944,28/1/2012,Nigeria,Kaduna,1,0,1,A cop is murdered by Boko Haram while on his way home
16945,28/1/2012,Thailand,Narathiwat,1,0,1,Islamic 'insurgents' pump a 45-year-old man with automatic weapons fire.
16946,28/1/2012,Pakistan,Gulberg,1,0,1,A 59-year-old Shiite doctor is shot to death in a targeted sectarian attack.
16947,28/1/2012,Pakistan,Dera Ismail Khan,1,0,1,A policeman loses his life to an Islamic militant attack.
16948,29/1/2012,Nigeria,Kano,2,0,2,At least two civilians are left dead following a Boko Haram bombing attack.
16949,29/1/2012,Pakistan,Karachi,2,0,2,Two Sunni activists are gunned down by sectarian Jihadis.
16950,29/1/2012,Iraq,Baghdad,1,9,10,A civilian is killed by a bomb blast in a Shia neighborhood.
16951,30/1/2012,Iraq,Baqubah,3,3,6,An al-Qaeda bomb leaves three Iraqis dead.
16952,30/1/2012,Nigeria,Potiskum,1,0,1,A guard at a church is picked off by Islamist snipers.
16953,30/1/2012,Yemen,Aden,0,8,8,Children are among the casualties when al-Qaeda sets off a bomb at a refugee camp school.
16954,30/1/2012,Pakistan,Peshawar,4,7,11,A Fedayeen suicide bomber takes out four people at a housing construction site.
16955,30/1/2012,Pakistan,Karachi,1,0,1,A Shia is murdered by Sunni extremists.
16956,30/1/2012,Iraq,Mosul,2,0,2,'Insurgents' shoot a father and son to death.
16957,31/1/2012,Nigeria,Borno,5,1,6,Civilians are among the casualties during a shooting rampage by Islamic militants.
16958,31/1/2012,Somalia,Galkayo,2,4,6,Two people are sent to Allah by a Shahid suicide bomber.
16959,31/1/2012,Iraq,Diyala,3,4,7,Terrorists kill three Iraqis in separate attacks.
16960,31/1/2012,Pakistan,Jogi,8,15,23,A Taliban attack on a check post leaves eight security officials dead.
16961,1/2/2012,Nigeria,Kawar Maila,7,0,7,Seven men are pulled out of their homes and butchered in the middle of the night by Religion of Peace activists.
16962,1/2/2012,Pakistan,Shahbazkhel,4,1,5,Taliban gunmen murder four policemen.
16963,1/2/2012,Thailand,Pattani,1,2,3,A security man is murdered in a Muslim drive-by.
16964,2/2/2012,Pakistan,Landi Kotal,1,0,1,A 70-year-old man is decapitated by the Taliban for crimes against Islam.
16965,2/2/2012,Pakistan,Rajanpur,2,0,2,A woman and her neighbor are murdered by her stepson on suspicion of sexual activity.
16966,2/2/2012,Nigeria,Kabar Maila,6,0,6,Radical Islamists disassemble a half-dozen people with a series of bombs.
16967,3/2/2012,Somalia,Garissa,3,1,4,al-Shabaab fundamentalists shoot three civilians to death as they are drinking tea.
16968,3/2/2012,Nigeria,Ajaokuta,4,0,4,A brutal assault by Boko Haram on a bank leaves four dead.
16969,3/2/2012,Thailand,Narathiwat,1,0,1,Terrorists gun down a 36-year-old civilian.
16970,3/2/2012,Thailand,Pattani,1,1,2,Muslim 'insurgents' shoot a mother to death and gravely injure her 8-year-old son.
16971,3/2/2012,Pakistan,Kurram,7,3,10,Seven local security personnel are killed in a Taliban ambush.
16972,3/2/2012,Pakistan,Basti Damraywala,3,0,3,A woman and her two daughters are shot to death by her sons for having 'loose morals'.
16973,3/2/2012,Pakistan,Bazaar Zakhakhel,1,2,3,"Lashkar-e-Islam militants bomb a family home, killing a boy and injuring two others."
16974,3/2/2012,Pakistan,Umerkot,0,2,2,Two Hindus are injured when Muslims open fire on their temple.
16975,3/2/2012,Pakistan,Peshawar,4,3,7,Jihadi car bombers take down four people outside a house.
16976,4/2/2012,Somalia,Luuq,14,30,44,At least fourteen people are killed during an attack by al-Shabaab Islamists.
16977,4/2/2012,Thailand,Pattani,1,0,1,A man sitting in his pickup truck is murdered by Islamic gunmen.
16978,5/2/2012,Iraq,Baghdad,1,0,1,Terrorists assassinate a government official.
16979,5/2/2012,Pakistan,Shahedano Dhand,1,12,13,One person is exterminated during a Tehreek-i-Taliban attack.
16980,5/2/2012,Nigeria,Damboa,2,0,2,Fundamentalists gun down two people at a gathering for mourning another of their victims.
16981,5/2/2012,Thailand,Yala,2,0,2,Two guards are cut down when Muslim terrorists fire on a group of Buddhist monks.
16982,5/2/2012,Afghanistan,Kandahar,9,19,28,"Shahid suicide car bombers detonate next to a market, killing nine."
16983,5/2/2012,Pakistan,Kalar Abadi,0,7,7,Seven are injured when gunmen fire into a rival religious procession.
16984,5/2/2012,Nigeria,Damaturu,1,0,1,Boko Haram murder a man sitting outside his home.
16985,6/2/2012,Iraq,Geyara,5,0,5,Five youth are murdered by Shiite death squads for appearing punk or gay.
16986,6/2/2012,Thailand,Narathiwat,1,0,1,A villager is ambushed and killed by Islamic insurgents.
16987,6/2/2012,Pakistan,Mansehra,1,14,15,A prayer leader is among those charged after rival religious groups shoot and throw stones at each other.
16988,6/2/2012,Afghanistan,Dehrawod,1,3,4,A young girl bleeds to death following the detonation of a shrapnel bomb by Sunni hardliners.
16989,6/2/2012,Nigeria,Ummarari,2,0,2,Gunmen enter an apartment building and shoot two residents to death while shouting 'Allah akbar.'
16990,6/2/2012,Yemen,Kashar,55,40,95,"Armed Shiites attack Sunnis, sparking a 2-day sectarian clash that leaves fifty-five dead."
16991,7/2/2012,Thailand,Narathiwat,1,1,2,Violent Islamic separatists gun down a Buddhist man and his wife.
16992,7/2/2012,Thailand,Narathiwat,1,0,1,Muslim militants shoot a man to death at a tea shop.
16993,7/2/2012,Yemen,Mastaba,30,24,54,At least thirty people are killed when Shia and Sunni fundamentalists begin shooting at each other.
16994,7/2/2012,Pakistan,Abadpur,1,0,1,A young woman is murdered by her conservative father for marrying by choice.
16995,8/2/2012,Pakistan,Mohalla Naseerabad,3,0,3,"A man kills his two sisters and another person for refusing his order to ""mend their ways."""
16996,8/2/2012,Pakistan,Alenger,2,0,2,Mujahideen murder two security officials with a landmine.
16997,8/2/2012,Somalia,Mogadishu,15,24,39,Fifteen people at a hotel cafe are torn to shreds by a Fedayeen suicide bomber.
16998,9/2/2012,Syria,Qusayr,1,0,1,Sunni rebels pull a Christian family man out of his car and execute him in cold blood.
16999,9/2/2012,Thailand,Yala,1,13,14,A retired teacher bleeds to death following a bombing by Muslim militants.
17000,9/2/2012,India,Hawoora,1,0,1,Muslim militants assassinate a local official.
17001,9/2/2012,Nigeria,Kano,1,0,1,Boko Haram cadres murder a critic outside a mosque.
17002,9/2/2012,Yemen,Lahj,1,0,1,A security official is murdered by al-Qaeda gunmen.
17003,10/2/2012,Nigeria,Potiskum,1,0,1,A cleric is assassinated by Religion of Peace rivals.
17004,10/2/2012,Syria,Allepo,28,235,263,Children are among the casualties of twin suicide blasts outside of two government buildings.
17005,10/2/2012,Nigeria,Maiduguri,2,0,2,At least two people are killed by a Boko Haram bomb.
17006,11/2/2012,Afghanistan,Khogyani,2,6,8,An 8-year-old girl is among two killed when Muslim gunmen spray the inside of a house.
17007,11/2/2012,Yemen,al-Bayda,1,0,1,al-Qaeda gunmen shoot an intelligence officer to death.
17008,11/2/2012,Iraq,Fallujah,6,0,6,A two-year-old is among six Iraqis murdered by suspected al-Qaeda bombers.
17009,11/2/2012,Iraq,Baghdad,1,0,1,'Insurgents' assassinate a government official in his car.
17010,11/2/2012,Pakistan,Khwezai,1,0,1,Tehreek-e-Taliban murder an abductee.
17011,11/2/2012,Philippines,Basilan,0,1,1,Abu Sayyaf gunmen fire on a group of road construction workers.
17012,11/2/2012,Afghanistan,Uruzgan,5,1,6,Sunni hardliners send five local cops to Allah with a roadside bomb.
17013,11/2/2012,Nigeria,Potiskum,2,0,2,Two Christian brothers are murdered in cold blood by Islamists in white robes.
17014,12/2/2012,Yemen,Abyan,1,0,1,A man is crucified by Ansar al-Sharia.
17015,12/2/2012,Yemen,Jaar,3,0,3,Three civilians are beheaded by Ansar al-Sharia.
17016,12/2/2012,Yemen,Hajjah,30,12,42,Thirty people are killed when Shiites attack Sunnis.
17017,13/2/2012,Nigeria,Maiduguri,3,0,3,Three civilians are beheaded by Boko Haram Salafists..
17018,13/2/2012,Pakistan,Haripur,1,0,1,Wahhabi gunmen murder a Shiite activist.
17019,13/2/2012,Iraq,Fallujah,3,0,3,Three Iraqis are gunned down in cold blood by Muslim assassins.
17020,13/2/2012,Iraq,Mosul,1,1,2,'Insurgents' kill a woman and injure her child.
17021,13/2/2012,Russia,Pyatigorsk,1,0,1,A cleric is taken apart by a Religion of Peace car bombing.
17022,13/2/2012,Russia,Dagestan,3,6,9,Three police officers are gunned down by Islamic 'separatists'.
17023,13/2/2012,India,New Delhi,0,4,4,A woman is among four injured when terrorists detonate a bomb outside the Israeli embassy.
17024,14/2/2012,Iraq,Mosul,2,12,14,An al-Qaeda bomb blast ends the lives of two Iraqis.
17025,14/2/2012,Iraq,Mashtal,1,6,7,A roadside attack leaves one civilian dead.
17026,14/2/2012,Thailand,Bangkok,0,4,4,A woman is among the casualties of a grenade attack by an Iranian.
17027,14/2/2012,Nigeria,Kaduna,1,2,3,A policeman is killed trying to defuse a Boko Haram bomb outside a mosque.
17028,14/2/2012,Pakistan,Karachi,2,0,2,Two Sunnis are gunned down in a suspected sectarian drive-by.
17029,14/2/2012,Thailand,Narathiwat,1,0,1,A 48-year-old man is slain by Muslim 'separatists' while sitting in his pickup truck.
17030,15/2/2012,Nigeria,Suleija,1,0,1,A policeman is murdered by Boko Haram.
17031,15/2/2012,Iraq,Jurf al-Sakhar,3,1,4,A 1-year-old baby is among three shot dead when Islamic terrorists storm a policeman's home.
17032,15/2/2012,Iraq,al-Bubali Island,1,2,3,One family member is killed during an 'insurgent' home invasion.
17033,15/2/2012,Iraq,Ramadi,1,3,4,"Islamic militants set off a bomb outside a home, killing one resident."
17034,15/2/2012,Saudi Arabia,Dammam,1,3,4,"Sunni police open fire on a Shia religious festival, exterminating a participant."
17035,15/2/2012,Pal. Auth.,Bait Oula,1,0,1,A 16-year-old girl is strangled in her sleep by her mother over a (false) rumor of sexual impropriety (occurred weeks earlier).
17036,15/2/2012,Yemen,al-Baydah,5,0,5,"Ansar al-Sharia gunmen open fire on a car at point blank range and send all five occupants to Allah, including a teen boy."
17037,15/2/2012,Pakistan,Jamrud,1,5,6,"Terrorists set off a bomb at a market, killing at least one patron."
17038,15/2/2012,Nigeria,Koton-Karifi,1,0,1,A warden is killed when Boko Haram militants storm a jail.
17039,16/2/2012,Nigeria,Minna,2,1,3,Islamists stage a bloody assault on a police station that leaves two officers dead.
17040,16/2/2012,Pakistan,Upper Dir,3,9,12,"A suicide bomber detonates at a market, leaving three other persons dead."
17041,16/2/2012,Yemen,Hizam,3,0,3,"Three members of a family, including a child, are disassembled when al-Qaeda militants fire a rocket into their home."
17042,16/2/2012,Yemen,Hizam,11,0,11,Eleven tribesmen are blown to bits by an al-Qaeda rocket attack on their convoy.
17043,16/2/2012,Iraq,Baqubah,1,0,1,Muslim bombers take out the owner of a mobile phone store.
17044,16/2/2012,Pakistan,Peshawar,0,5,5,A Fedayeen detonates himself along a city street.
17045,16/2/2012,Dagestan,Gurbuki,13,17,30,Islamic militias kill thirteen police officers.
17046,17/2/2012,Lebanon,Tripoli,1,0,1,A 17-year-old girl is killed by a stray bullet when rival Muslim groups clash following urging by their clerics.
17047,17/2/2012,Pakistan,Parachinar,43,41,84,A Sunni suicide bomber takes out over three dozen Shia outside their own mosque following prayers.
17048,17/2/2012,Nigeria,Konduga,1,0,1,A cleric is shot to death by Religion of Peace rivals in front of his family at his house.
17049,17/2/2012,Nigeria,Geidam,1,0,1,Boko Haram gunmen 'execute' a local official in front of his home.
17050,17/2/2012,Iraq,Baghdad,2,0,2,Drive-by terrorists take out two Iraqis.
17051,17/2/2012,Pakistan,Tirah,3,0,3,Three local security personnel are killed by Mujahideen bombers.
17052,17/2/2012,Pakistan,Karachi,2,0,2,Two religious activists are gunned down by sectarian Jihadis.
17053,17/2/2012,Saudi Arabia,Mount Arafat,0,12,12,A dozen people are injured when religious groups fight each other at a Muslim holy site.
17054,17/2/2012,Kenya,Fafi,1,1,2,A police officer is gunned down by al-Shabaab Islamists.
17055,18/2/2012,Kenya,Nairobi,30,0,30,At least thirty Kenyan civilians are murdered by al-Shabaab Islamists in various attacks.
17056,18/2/2012,Mali,Hombori,1,0,1,A 77-year-old man is kidnapped and murdered by suspected al-Qaeda.
17057,19/2/2012,Israel,Jerusalem,0,1,1,One person is injured when Muslims hurl rocks at Christian tourists from their mosque on the Temple Mount.
17058,19/2/2012,Afghanistan,Washir,4,0,4,Four civilians are beheaded by Sunni fundamentalists.
17059,19/2/2012,Algeria,Bordj Menail,4,10,14,Islamic bombers take out four bus passengers.
17060,19/2/2012,Pakistan,Landikotal,9,5,14,Nine people are left dead following a Lashkar-e-Islam bomb blast.
17061,19/2/2012,Iraq,Baghdad,19,28,47,Twenty young Iraqi police recruits are sent to Allah by Shahid suicide bombers.
17062,19/2/2012,Iraq,Baqubah,4,0,4,al-Qaeda gunmen murder three women and one man inside their home.
17063,19/2/2012,Nigeria,Sulieja,0,5,5,Sharia advocates set off a car bomb next to a church.
17064,19/2/2012,Philippines,Kidapawan,3,4,7,Three civilian bystanders are killed during an attack by Moro Islamists on a jail.
17065,20/2/2012,Afghanistan,Kandahar,1,4,5,A Fedayeen suicide bomber takes out one other person.
17066,20/2/2012,Yemen,Zinjibar,2,0,2,al-Qaeda gunmen take out two local cops.
17067,20/2/2012,Nigeria,Maiduguri,30,3,33,Women and children are among the dead when caliphate advocates storm a market and shoot traders and patrons alike.
17068,20/2/2012,Afghanistan,Robat,2,2,4,Terrorists in uniform open fire on foreigners at a meeting to discuss opening a school and health center.
17069,20/2/2012,Thailand,Pattani,1,0,1,A villager is gunned down in a Religion of Peace drive by.
17070,21/2/2012,Thailand,Narathiwat,1,0,1,A peaceful Muslim is stabbed to death for declining to join the Jihad.
17071,21/2/2012,Nigeria,Damaturu,3,0,3,Boko Haram is thought responsible for an attack that leaves three innocents dead.
17072,22/2/2012,Pakistan,Faisalabad,0,2,2,A Muslim mob attacks a church and shoots one Christian while pushing another off the roof.
17073,22/2/2012,Afghanistan,Urgun,1,0,1,A local journalist is lured to a meeting by the Taliban and then beheaded.
17074,22/2/2012,Pakistan,Akkakhel,3,0,3,Three civilians are killed in separate terror attacks.
17075,22/2/2012,Pakistan,Sipah,3,0,3,Lashkar-e-Islam militants kill three people with a landmine.
17076,22/2/2012,Nigeria,Maiduguri,1,0,1,Islamists slit the throat of a pastor's 75-year-old mother and leave a note in Arabic for her son.
17077,23/2/2012,Philippines,Lapuyan,6,9,15,"Young children are among the casualties when Muslim militants strafe a house with gunfire, killing six."
17078,23/2/2012,Iraq,Baghdad,20,198,218,Authorities report dozens of additional casualties from a wave of al-Qaeda bombings and shootings against Iraqi Shiites.
17079,23/2/2012,Iraq,Baghdad,6,0,6,Six policemen are machine-gunned at a checkpoint by Islamic 'insurgents.'
17080,23/2/2012,Iraq,Musayyib,3,75,78,Children are heavily represented among the casualties of an al-Qaeda car bombing near an elementary school.
17081,23/2/2012,Iraq,Sulaiman Beg,2,1,3,Two local cops are gunned down by terrorists.
17082,23/2/2012,Iraq,Mandali,2,1,3,Two children are taken out by an al-Qaeda bomb at a soccer field.
17083,23/2/2012,Iraq,Diyala,11,16,27,A series of suicide attacks and shootings leave at least eleven dead.
17084,23/2/2012,Iraq,Baiji,3,5,8,Sunni militants place a bomb near a court that leaves three dead.
17085,23/2/2012,Iraq,Balad,7,33,40,An al-Qaeda car bomb leaves seven dead and thirty-three more in agony.
17086,23/2/2012,Iraq,Karrada,10,27,37,Body parts are strewn across roads as terrorists kill at least ten people with a bomb in a residential Shiite neighborhood.
17087,23/2/2012,Iraq,Kadhimiya,6,18,24,Six patrons are taken apart by an al-Qaeda car bomb at a restaurant.
17088,23/2/2012,Nigeria,Kano,4,0,4,"Islamists fire at a passing police patrol, killing two officers."
17089,23/2/2012,Nigeria,Niger State,2,0,2,Two cops are gunned down by Boko Haram.
17090,23/2/2012,Afghanistan,Kabul,2,4,6,Two American troops are killed 'in revenge' over reports of an accidental Quran burning at another base.
17091,23/2/2012,Pakistan,Kohat,15,35,50,"A Religion of Peace car bomb rips through a bus station, leaving at least a dozen dead."
17092,23/2/2012,Pakistan,Enjani Kali,2,3,5,"Taliban militants hit three houses with rockets, killing two residents."
17093,23/2/2012,Iraq,Balad Ruz,3,7,10,Three family members are disassembled by an 'insurgent' bomb attack on their home.
17094,23/2/2012,Iraq,Jalawla,3,21,24,"Sunni bombers attack Kurds, taking down two women and one man."
17095,23/2/2012,Iraq,Kirkuk,7,24,31,"Jihad car bombers take out seven Iraqis in two attacks -one in a residential neighborhood, the other at a bank."
17096,24/2/2012,Pakistan,Peshawar,4,6,10,Fedayeen suicide bombers take out four people at a police station.
17097,24/2/2012,Nigeria,Kano,5,0,5,"Boko Haram radicals spray the inside of a mosque with bullets, killing a rival and four others."
17098,24/2/2012,Afghanistan,Laghman,0,20,20,Twenty people are injured when a mob hurls stones in protest of an alleged Quran desecration.
17099,24/2/2012,Pakistan,Bara,3,3,6,"Taliban militants open up on a car at point-blank range, killing three occupants."
17100,25/2/2012,Sudan,Umsirdipa,5,0,5,Five members of a Christian family are killed in a targeted attack by the Islamic republic.
17101,25/2/2012,Yemen,Sana'a,26,10,36,al-Qaeda kills nearly thirty Yemenis with a suicide blast by a Saudi bomber.
17102,25/2/2012,Nigeria,Gombe,12,5,17,Ten civilians are among twelve found dead after Islamists attack a police station with petrol bombs.
17103,25/2/2012,Afghanistan,Kabul,2,0,2,Two American staffers are shot to death by fundamentalists 'in revenge' for an accidental Quran burning.
17104,25/2/2012,Afghanistan,Muqur,6,16,22,Six Afghan sappers are killed by a Taliban bomb.
17105,26/2/2012,Egypt,Cairo,2,0,2,"Two young women, suspected of having relations by choice, are murdered by their families in separate honor attacks."
17106,26/2/2012,Pakistan,Tank,1,2,3,The Taliban shoot a drummer to death in this home.
17107,26/2/2012,Iraq,Buhriz,2,4,6,A Mujahideen bombing at a market leaves two civilians dead.
17108,26/2/2012,Pakistan,Hussainabad,1,0,1,A Shiite bakery worker is the victim of a targeted sectarian killing.
17109,26/2/2012,Pakistan,South Waziristan,2,1,3,Suspected Lashkar-e-Islam bombers kill two local cops.
17110,26/2/2012,Afghanistan,Kunduz,1,6,7,"A Muslim, angered over an inadvertent Quran burning, throws a grenade at a group of Americans, killing one."
17111,26/2/2012,Nigeria,Jos,4,38,42,"A suicide bomber detonates during a church service, killing four worshippers including a woman and a father and 18-month-old child."
17112,26/2/2012,Pakistan,Akakhel,4,3,7,"Three girls, ages 2 to 10, and a woman are blown apart by a mortar round fired into their home by suspected Islamic militants."
17113,26/2/2012,Pakistan,Kot Meerath,0,1,1,A Christian woman is brutally tortured and paraded for harboring alleged 'anti-Islam' views.
17114,27/2/2012,Dagestan,Karabudakhkent,5,0,5,Islamic extremists execute five hunters.
17115,27/2/2012,Nigeria,Kagoro,2,0,2,Islamists chant religious slogans as they butcher two people.
17116,27/2/2012,Nigeria,Bundumi Rimi,4,4,8,Four villagers are murdered and mutilated by Islamic fundamentalists.
17117,27/2/2012,Somalia,Mogadishu,3,7,10,Mujahid bombers take out three people at a soccer match.
17118,27/2/2012,Pakistan,Nowshera,5,26,31,Terrorists dismantle five people at a political rally.
17119,27/2/2012,Afghanistan,Jalalabad,9,10,19,A Shahid suicide bomber murders nine people at an airport.
17120,27/2/2012,Nigeria,Adamawa,3,1,4,Radical Muslims shoot three police officers to death at a checkpoint.
17121,27/2/2012,Nigeria,Bauchi,3,0,3,"Islamists firebomb a police station, killing three occupants."
17122,27/2/2012,Nigeria,Maiduguri,1,0,1,A local official is assassinated by Boko Haram gunmen.
17123,28/2/2012,Iraq,Baghdad,4,0,4,Sectarian Jihadis shoot four young family members to death.
17124,28/2/2012,Iraq,Falluja,1,1,2,al-Qaeda gunmen murder an Iraqi.
17125,28/2/2012,Pakistan,Kohistan,18,0,18,Jundallah fundamentalists pull eighteen Shiite civilians off a bus and execute them in cold blood.
17126,28/2/2012,Nigeria,Adamawa,1,0,1,Boko Haram radicals gun down a cop.
17127,28/2/2012,China,Kashgar,10,5,15,A second assault by knife-wielding Muslim terrorists in a shopping district leaves at least ten more innocents dead.
17128,28/2/2012,Kenya,Mandera,1,8,9,An unarmed police man is killed by al-Shabaab assassins at a market.
17129,28/2/2012,Pakistan,Peshawar,2,0,2,Two foreign civilians are gunned down at a market by Taliban militants in a targeted killing.
17130,28/2/2012,China,Yecheng,3,0,3,Three ethnic Chinese are hacked to pieces by a Muslim mob.
17131,29/2/2012,Nigeria,Maiduguri,4,1,5,Witnesses report seeing four dead following a Boko Haram bombing attack on a market.
17132,29/2/2012,Pakistan,Karachi,1,2,3,A 22-year-old Shiite is gunned down by Wahhabis.
17133,29/2/2012,Pakistan,Bara,3,5,8,Two women and a child are disassembled by a Taliban roadside blast.
17134,29/2/2012,Iraq,Baghdad,3,9,12,"Jihadis set off a car bomb next to a shopping area, taking out three Iraqis."
17135,29/2/2012,Bangladesh,Madarganj,0,3,3,"Three missionaries are injured when a mob, stirred up by an Islamic seminary, throw stones at them."
17136,29/2/2012,Pakistan,Hyderabad,1,1,2,An 80-year-old member of the Ahmadi minority is murdered over his religious beliefs.
17137,29/2/2012,Somalia,Mogadishu,1,0,1,A journalist trying to open a radio station shut down by Islamists is murdered outside his home.
17138,29/2/2012,Afghanistan,Lashkargah,0,7,7,Children are among the casualties of a Shahid suicide bombing.
17139,1/3/2012,Iraq,Sulaymaniyah,1,0,1,A Christian schoolteacher is gunned down by a Muslim student over 'religious differences'.
17140,1/3/2012,Afghanistan,Kandahar,2,0,2,Two American soldiers are shot in the back in retaliation for an unintentional Quran burning the week before by others.
17141,1/3/2012,Pakistan,Bara,10,3,13,Ten local soldiers are killed when Lashkar-e-Islam militants attack a base.
17142,2/3/2012,Thailand,Pattani,2,0,2,A husband and wife are shot to death in their home by Muslim 'insurgents'.
17143,2/3/2012,Thailand,Pattani,1,1,2,Islamic militants kill a local soldier with a roadside bomb.
17144,2/3/2012,Nigeria,Kano,1,0,1,Boko Haram shoot a man at close quarters as he is walking home from work.
17145,2/3/2012,Pakistan,Peshawar,1,0,1,A 38-year-old intelligence officer is assassinated by the Taliban.
17146,2/3/2012,Pakistan,Tirah Bazaar,25,18,43,Two dozen people are blown to bits by a Fedayeen suicide bomber outside a mosque.
17147,3/3/2012,Philippines,Jolo,2,13,15,"Abu Sayyaf militants detonate a bomb in front of a grocery store, killing two civilians."
17148,3/3/2012,Pakistan,Peshawar,2,2,4,A 5-year-old girl is among two innocents slain by a Shahid suicide bomber.
17149,3/3/2012,Yemen,al-Bayda,2,5,7,Two local security men are killed in separate al-Qaeda suicide blasts.
17150,3/3/2012,Afghanistan,Nangarhar,4,0,4,Islamic hardliners shred four family members with a roadside bomb.
17151,3/3/2012,Syria,Dara,3,20,23,Three civilians are taken out when a Holy Warrior blows himself up at a traffic circle.
17152,3/3/2012,Algeria,Tamanrasset,0,23,23,A Fedayeen suicide bomber detonates outside a government building.
17153,4/3/2012,Egypt,Abu Al-Reesh,0,2,2,Two nuns are injured when a Muslim mob of 1500 lays siege to a Catholic school on rumors of a church building.
17154,4/3/2012,Pakistan,Larkana,2,0,2,An 18-year-old girl and her boy friend are killed by her brother on suspicion of sex.
17155,4/3/2012,Nigeria,Benue,21,13,34,Women and children comprise the bulk of twenty-one members of a Christian farming community slaughtered by Fulani 'mercenaries'  wielding machetes and burning homes.
17156,4/3/2012,Nigeria,Maiduguri,2,0,2,Islamists shoot a middle-aged woman and her 10-year-old daughter to death in their home.
17157,4/3/2012,Nigeria,Gamborou,2,0,2,A tailor and trader are executed in cold blood by Boko Haram gunmen.
17158,4/3/2012,Yemen,Hadramout,1,0,1,A local cop is assassinated in an al-Qaeda drive-by.
17159,4/3/2012,Syria,Aleppo,1,4,5,A child dies from injuries suffered from a bombing blamed on Sunni militants.
17160,4/3/2012,Dagestan,Khasavyurt,3,0,3,Three guards are machine-gunned outside a polling station by Islamic extremists.
17161,4/3/2012,Yemen,Zinjibar,15,12,27,A al-Qaeda suicide bomber sends fifteen other souls to Allah.
17162,4/3/2012,Pakistan,Dera Ismail Khan,0,5,5,A suicide bomber on foot racks up five casualties.
17163,4/3/2012,Yemen,Zinjibar,185,91,276,A surprise attack by al-Qaeda on a local security base leaves nearly two-hundred occupants dead and mutilated
17164,5/3/2012,Thailand,Narathiwat,1,7,8,"Muslim terrorists detonate a bomb at a market, killing a 37-year-old boat driver."
17165,5/3/2012,Nigeria,Kano,2,2,4,Boko Haram assassins take down two guards at a residence.
17166,5/3/2012,Afghanistan,Jalalabad,1,12,13,A Shahid suicide bomber manages to kill one other person.
17167,5/3/2012,Afghanistan,Parwan,2,4,6,Two children bleed to death following a suicide attack that is 'in revenge' for a Quran burning.
17168,5/3/2012,Yemen,Bayda,1,2,3,An al-Qaeda attack leaves one local soldier dead.
17169,5/3/2012,Pakistan,Akkakhel,1,0,1,Hardliners behead a local tribesman.
17170,5/3/2012,Iraq,Mosul,3,2,5,"Terrorists fire rockets into a market, killing three civilians."
17171,5/3/2012,Somalia,Mogadishu,2,0,2,Suspected al-Shabaab murder two surrendered terrorists.
17172,5/3/2012,Iraq,Haditha,27,3,30,Twenty-seven Iraqi police are massacred by Religion of Peace advocates in a series of attacks.
17173,6/3/2012,Iraq,Baghdad,56,0,56,"A Shiite militia executes at least fifty-six suspected homosexuals over a 30 day period, some by stoning."
17174,6/3/2012,Afghanistan,Uruzgan,9,0,9,Nine local police officers are murdered in their beds by Taliban gunmen.
17175,6/3/2012,Nigeria,Potiskum,1,0,1,A customs officer is shot to death in his own home by Muslim terrorists.
17176,6/3/2012,Thailand,Yala,1,1,2,One member of a security team for teachers dies from a shrapnel injury to the head from a Muslim 'insurgent' bomb.
17177,6/3/2012,Dagestan,Karabudakhkent,5,2,7,Five traffic cops are blown to bits by a female suicide bomber.
17178,6/3/2012,Bangladesh,Dhaka,1,0,1,A Saudi envoy is murdered by suspected Shiite radicals.
17179,7/3/2012,Nigeria,Bilala,4,0,4,A 5-year-old boy is among four killed when Boko Haram devotees blow up two churches and a police station.
17180,7/3/2012,Iraq,Baghdad,4,14,18,Mujahid bombers take out four Iraqis.
17181,7/3/2012,Iraq,Tal Afar,14,23,37,Fourteen people near a restaurant are obliterated in a double bomb attack by Holy Warriors.
17182,7/3/2012,Afghanistan,Spin Boldak,4,10,14,A woman and two children are among four civilians ripped apart by a suicide bomber on a motorcycle.
17183,7/3/2012,Yemen,Shabwa,1,4,5,al-Qaeda militants shoot a local patrolman to death.
17184,7/3/2012,Pakistan,Bara,1,0,1,A student is beheaded by Islamic radicals.
17185,7/3/2012,Pakistan,Peshawar,4,0,4,A girl and a woman are among four family members slain in an honor killing.
17186,7/3/2012,Pakistan,Karachi,1,0,1,An Ahmadi is gunned down in a targeted attack at a market.
17187,7/3/2012,Thailand,Narathiwat,4,1,5,"Islamic militants detonate a bomb under a passing vehicle, killing four occupants."
17188,7/3/2012,Pakistan,Peshawar,1,3,4,A Taliban bomb planted in a sewer takes out a 9-year-old child.
17189,7/3/2012,Pakistan,Kohat,0,4,4,Four schoolchildren receive splinter injuries from a grenade thrown by Muslim extremists.
17190,7/3/2012,Yemen,Amran,7,0,7,Seven people are ambushed and killed by Shiite militants.
17191,7/3/2012,Iraq,Baghdad,2,0,2,Two young women are murdered on suspicion of being lesbians.
17192,8/3/2012,Nigeria,Ashaka,7,3,10,Civilians are among seven dead when Boko Haram cadres attack two banks and a police station.
17193,8/3/2012,Pakistan,Mohllah Dak-Khana,2,0,2,Two grown women are strangled by their brother for disobedience on orders of a jirga.
17194,8/3/2012,Nigeria,Sokoto,2,0,2,Fundamentalists murder two European engineers in captivity.
17195,8/3/2012,Nigeria,Kadarko,9,50,59,Fulani raiders sweep into a market and hack at least nine people to death.
17196,9/3/2012,India,Nutangram,0,1,1,A young Muslim woman barely survives a severe beating by her parents and a group of Islamic extremists over her interest in Jesus.
17197,9/3/2012,Pakistan,Feroz Khail,1,0,1,A Fedayeen takes out a peace committee member.
17198,9/3/2012,Pakistan,Khar Qamar,7,0,7,Tehreek-e-Taliban militants ambush a local security patrol and kill seven.
17199,9/3/2012,Thailand,Yala,2,12,14,"Muslim 'rebels' kidnap two local soldiers from their post, tie them up and then execute them."
17200,9/3/2012,Nigeria,Gombe,1,0,1,A tribal leader is assassinated by Religion of Peace radicals outside a mosque.
17201,9/3/2012,Nigeria,Mashimary,1,0,1,A religious teacher is shot to death by Religion of Peace rivals.
17202,9/3/2012,Nigeria,Maiduguri,1,0,1,One person is killed when Boko Haram set fire to a government building.
17203,9/3/2012,Afghanistan,Lalpur,2,0,2,Two police officers are murdered by Taliban terrorists.
17204,10/3/2012,Pakistan,Khadim Solangi Goth,1,0,1,A father hacks his 24-year-old daughter up with an axe on suspicion of a sexual affair.
17205,10/3/2012,Kenya,Nairobi,6,40,46,"al-Shabaab Islamists throw three grenades into a bus station, killing six people."
17206,10/3/2012,Somalia,Yurkud,6,0,6,At least six Ethiopians are shot to death during an al-Shabaab ambush.
17207,10/3/2012,Pakistan,Bara,4,15,19,Four children bleed to death following a militant rocket attack on a residential compound.
17208,10/3/2012,Thailand,Pattani,1,0,1,A local politician is machine-gunned by Islamic 'insurgents'.
17209,10/3/2012,Thailand,Narathiwat,1,0,1,Muslim terrorists take down a vendor with two shotgun blasts to the torso.
17210,11/3/2012,France,Toulouse,1,0,1,An off-duty paratrooper is shot in the head at close range by a Muslim terrorist.
17211,11/3/2012,Nigeria,Chugwi,3,3,6,Three Christians are shot dead by Muslim gunmen in a targeted attack.
17212,11/3/2012,Iraq,Tarmiyah,5,0,5,Two girls and two women are among five family members brutally shot to death in their own home.
17213,11/3/2012,Nigeria,Jos,11,22,33,"A suicide bomber detonates at a Catholic church during mass, killing at least eleven worshippers."
17214,11/3/2012,Iraq,Baqubah,2,1,3,A Mujahideen bomb in front of a cafe leaves two civilians dead.
17215,11/3/2012,Pakistan,Badabher,17,40,57,"A Shahid suicide bomber detonates at a funeral, sending seventeen mourners to Allah."
17216,11/3/2012,Nigeria,Bama,2,0,2,Two people are shot to death by a radical Muslim sect.
17217,11/3/2012,Pakistan,Alamgudar,1,0,1,Sunni hardliners behead a captive.
17218,11/3/2012,Pakistan,Ghalanai,5,7,12,A Taliban landmine leaves five local security personnel dead.
17219,11/3/2012,Pakistan,Tappai,2,0,2,Two family members are killed when Muslim terrorists bomb a house.
17220,12/3/2012,Syria,Deraa,1,25,26,A girl is killed by a car bomb planted by a suspected Sunni terror group.
17221,12/3/2012,Nigeria,Bum,2,3,5,Fulani raiders slaughter two Christian villagers.
17222,12/3/2012,Nigeria,Maiduguri,2,0,2,"Islamists set fire to a house, burning a man and his pregnant wife alive."
17223,12/3/2012,Pakistan,Kurram,2,17,19,Islamic militants kill two bus riders with a well-placed bomb.
17224,12/3/2012,Iraq,Baghdad,9,14,23,'Insurgents' shoot and blast nine Iraqis to death.
17225,12/3/2012,Afghanistan,Panjwai,1,2,3,One person is killed when Talibanis fire rockets at a mosque.
17226,12/3/2012,Belgium,Anderlecht,1,1,2,"A Sunni firebombs a Shiite mosque, killing the imam."
17227,13/3/2012,Iraq,Mosul,4,3,7,'Insurgents' wipe out four Iraqis with a roadside bomb.
17228,13/3/2012,Iraq,Mosul,2,0,2,A professor and his sister are brutally shot to death by Muslim militants.
17229,13/3/2012,Iraq,Kirkuk,1,2,3,A school teacher is dismembered by a targeted bomb attack.
17230,13/3/2012,Nigeria,Mubi,5,3,8,Three civilians are among five people taken out by Boko Haram gunmen.
17231,13/3/2012,Nigeria,Kano,2,0,2,"Islamic militants ambush a police patrol, killing two members."
17232,13/3/2012,Yemen,al-Bayda,4,4,8,A Shahid suicide bomber takes out four local soldiers at a checkpoint.
17233,14/3/2012,Afghanistan,Helmand,8,0,8,Three members of a family are among eight minibus riders obliterated by a Sunni bomb.
17234,14/3/2012,Afghanistan,Kandahar,1,2,3,A Taliban motorcycle bomb leaves one person dead.
17235,14/3/2012,Somalia,Mogadishu,4,10,14,An al-Shabaab suicide bomber sends four others to Allah.
17236,14/3/2012,Pakistan,Mamond Tehsil,6,3,9,Tehreek-e-Taliban bombers murder six locals at their village.
17237,14/3/2012,Pakistan,Mattani,1,5,6,Sunni hardliners take out a young girl with a rocket.
17238,15/3/2012,France,Montauban,2,1,3,Two soldiers are shot to death in an al-Qaeda drive-by attack.
17239,15/3/2012,Pakistan,Peshawar,1,5,6,A Fedayeen suicide bomber kills one other person.
17240,15/3/2012,Thailand,Pattani,1,1,2,A civilian dies after being hit with shrapnel in the head and face from a motorcycle bomb.
17241,15/3/2012,Indonesia,Semarang,0,3,3,A 'training' bomb made at an Islamic boarding school injures three workers.
17242,15/3/2012,Afghanistan,Uruzgan,13,2,15,The lives of nine children and four women are snuffed out by a Taliban roadside bomb.
17243,15/3/2012,Nigeria,Nayi,10,4,14,A pastor is among ten people hacked and shot to death when armed Muslims raid Christian homes around a church.
17244,16/3/2012,Pakistan,Parchar Khel,0,16,16,Sixteen Shiites are casualties of a targeted bombing of their bus.
17245,16/3/2012,Pakistan,Karachi,1,1,2,A Shia father and son are gunned down in a targeted attack.
17246,16/3/2012,Pakistan,Sheikhabad,1,0,1,A peace committee member is abducted and murdered by hardliners.
17247,17/3/2012,Syria,Damascus,27,140,167,A series of vicious suicide car bomb blasts leave nearly thirty people dead and over a hundred more in agony.
17248,17/3/2012,Pakistan,Tunsa Sharif,1,1,2,A Shiite is shot and another injured in a sectarian attack.
17249,17/3/2012,Thailand,Pattani,1,4,5,Muslim bombers take out a high school girl riding on her motorbike.
17250,17/3/2012,Pakistan,Islamabad,1,0,1,A scholar of a religious sect is strangled to death by suspected mainstream rivals.
17251,17/3/2012,Pakistan,Mundi Kas,3,2,5,Three women are torn apart by roadside bombers.
17252,17/3/2012,Thailand,Yala,1,0,1,A rubber tapper is ambushed and murdered by Muslim gunmen.
17253,18/3/2012,Nigeria,Palang,2,3,5,Fulani terrorists murder two local cops.
17254,18/3/2012,Syria,Allepo,2,30,32,A woman is among two killed when Al-Nusra Front terrorists detonate a car bomb.
17255,18/3/2012,Iraq,Tikrit,3,2,5,Sunni terrorists kill three Iraqis with a bomb.
17256,18/3/2012,Nigeria,Suleja,0,5,5,A church is firebombed during a service.
17257,18/3/2012,Thailand,Pattani,1,1,2,A grocery shop owner dies of bullet injuries from a Muslim 'insurgent' drive-by on his shop.
17258,18/3/2012,Yemen,Taiz,1,0,1,al-Qaeda gunmen murder an American teacher accused of being a 'Christian proselytizer'.
17259,19/3/2012,Pakistan,Hangu,1,0,1,A Shiite is the victim of a targeted sectarian killing.
17260,19/3/2012,Pakistan,Tirah Valley,5,0,5,Laskar-e-Islam terrorists take out five rivals with a remote-controlled bomb.
17261,19/3/2012,Pakistan,Ahsanpur,1,0,1,A 19-year-old woman is shot to death by her family on suspicion of a sexual affair.
17262,19/3/2012,Somalia,Mogadishu,6,7,13,A one-year-old baby is among a family of six refugees obliterated by an al-Shabaab mortar.
17263,19/3/2012,France,Toulouse,4,0,4,Three children under the age of seven are chased and shot in the head at a Jewish school along with their father.
17264,19/3/2012,Thailand,Pattani,1,0,1,Muslim 'insurgents' shoot a 43-year-old man to death.
17265,19/3/2012,Yemen,Dalea,3,2,5,An al-Qaeda gunmen creeps into a local army barracks and murders three soldiers in their sleep.
17266,20/3/2012,Iraq,Jludiat,2,4,6,Jihadis take out two farmers with an IED.
17267,20/3/2012,Nigeria,Kano,2,0,2,Fundamentalists shoot two persons to death as they are playing cards.
17268,20/3/2012,Iraq,Baghdad,2,5,7,Religion of Peace bombers kill two people with a blast at an Orthodox church.
17269,20/3/2012,Nigeria,Maiduguri,2,0,2,Two civilians are gunned down in cold blood by Boko Haram.
17270,20/3/2012,Iraq,Baghdad,3,0,3,Suspected al-Qaeda storm a church and kill three guards.
17271,20/3/2012,Iraq,Karbala,13,50,63,Sunni bombers send thirteen Shia pilgrims straight to Allah.
17272,20/3/2012,Iraq,Kirkuk,13,59,72,Holy Warriors blow thirteen Iraqis to bits with shrapnel bombs.
17273,20/3/2012,Iraq,Baghdad,5,28,33,A Shahid suicide bomber murders five civilians
17274,20/3/2012,Iraq,Hilla,2,30,32,"Mujahideen detonate a bomb outside a cafe, incinerating two patrons."
17275,20/3/2012,Iraq,Ramadi,6,2,8,A double car bombing tears six Iraqis to shreds.
17276,20/3/2012,Iraq,Mahmudiya,3,12,15,A car bomb leaves three passersby dead.
17277,20/3/2012,Iraq,Ba'aj,3,8,11,Three Iraqis are killed in targeted bombings.
17278,20/3/2012,Iraq,Fallujah,2,0,2,A pregnant woman and her 6-year-old child are dismantled by a Jihad bomb attack on their home.
17279,20/3/2012,Pakistan,Peshawar,2,4,6,A bomb planted in a rickshaw leaves two dead.
17280,21/3/2012,Thailand,Burangae,1,3,4,A man at a tea shop is among the casualties of a Muslim bombing along a nearby railway.
17281,21/3/2012,Pakistan,Zakhakhel,3,0,3,Tauheed-e-Islam members kidnap and execute three men for allegedly working with a rival group.
17282,21/3/2012,Yemen,Mukalla,1,0,1,al-Qaeda militants kidnap and then cut the throat of a local intelligence officer.
17283,21/3/2012,Afghanistan,Muqur,3,15,18,A Taliban rocket fired into a bazaar shreds three civilians.
17284,21/3/2012,Iraq,Zafaraniyah,4,0,4,Sunnis slit the throats of a Shiite mother and her three children in their home.
17285,21/3/2012,Pakistan,Tank,1,0,1,A female Red Cross worker is killed by suspected militants during an attempted abduction.
17286,21/3/2012,Iraq,Nineveh,5,7,12,"Islamic terrorists kill five Iraqis in a series of attacks, including two roadside vendors."
17287,22/3/2012,Iraq,Mosul,1,0,1,A Christian is kidnapped and murdered.
17288,22/3/2012,Iraq,Baghdad,4,0,4,A bomb planted by Islamic terrorists takes the lives of four Iraqis.
17289,22/3/2012,India,Bijbehara,2,23,25,Jihadi car bombers take down two members of a road construction crew.
17290,23/3/2012,Pal. Auth.,Gaza,1,0,1,A 22-year-old woman with a baby is murdered by her brother at a hospital in a case of 'honor killing'.
17291,23/3/2012,Nigeria,Maiduguri,2,0,2,A cleric and a shoe cobbler are killed in separate Boko Haram shootings.
17292,23/3/2012,Pakistan,Wana,2,3,5,A 10-year-old boy and his father are blown to bits by Sunni bombers.
17293,23/3/2012,Dagestan,Buinaksk,2,0,2,A cleric and his bodyguard are blown up in their mosque after criticizing Islamic terrorists.
17294,23/3/2012,Pakistan,Kolay,13,7,20,A Taliban suicide bomber takes out a dozen rivals at a mosque.
17295,23/3/2012,Pakistan,Orakzai,3,5,8,Islamic militants machine-gun three security personnel at a checkpoint.
17296,24/3/2012,Yemen,Huta,1,2,3,al-Qaeda gunmen pick off a local soldier.
17297,24/3/2012,Afghanistan,Trinkot,4,0,4,Sunni hardliners tear four Afghans to shreds with a roadside bomb.
17298,24/3/2012,Pakistan,Pango Mor,2,0,2,A woman is shot to death by her brother for leaving her husband.  Her mother is killed when she tries to intervene.
17299,24/3/2012,Afghanistan,Kandahar,9,1,10,Taliban bombers send nine souls to Allah.
17300,24/3/2012,Pakistan,Karachi,2,0,2,A man and his son are sprayed with bullets in a targeted sectarian attack.
17301,24/3/2012,Pakistan,Quetta,1,0,1,A Sunni religious scholar is shot to death by sectarian activists.
17302,24/3/2012,Pakistan,Shero Jhangi,4,2,6,Four people are killed by suspected Islamist snipers.
17303,24/3/2012,Pakistan,Shirani,4,4,8,The Taliban abduct and murder four local soldiers.
17304,25/3/2012,Algeria,Algiers,1,0,1,A 16-year-old girl is butchered with a knife by her father over pictures on her cell phone.
17305,25/3/2012,Nigeria,Maiduguri,3,0,3,Boko Haram gunmen pick off three men standing in front of their house.
17306,25/3/2012,Pakistan,Faisalabad,1,0,1,A young woman is honor killed by her father.
17307,25/3/2012,Pakistan,Rajanpur,2,0,2,Two young lovers are gunned down by their family over a suspected sexual relationship.
17308,25/3/2012,Thailand,Narathiwat,1,0,1,Muslim terrorists shoot a 53-year-old man four times as he is riding his motorcycle.
17309,25/3/2012,Thailand,Pattani,1,0,1,A cop is gunned down outside his home by eight Muslim 'insurgents'.
17310,25/3/2012,Thailand,Pattani,1,0,1,Muslim terrorists shoot a 49-year-old to death in his pickup truck.
17311,26/3/2012,Somalia,Mogadishu,2,7,9,A father and son are dismantled by an al-Shabaab rocket attack on a refugee camp.
17312,26/3/2012,Afghanistan,Lashkar Gar,2,0,2,Two British soldiers are shot in the back at their base by a terrorist wearing an Afghan uniform.
17313,26/3/2012,Pakistan,Badan Kot,1,0,1,A preacher is gunned down by Religion of Peace rivals in a mosque.
17314,26/3/2012,Morocco,Fez,1,0,1,A 74-year-old man is beaten to death with a hammer by an attacker shouting praises to Allah.
17315,26/3/2012,Nigeria,Takum,2,2,4,Muslim 'mercenaries' attack two Christian villages and shoot a 22-year-old and an elderly man to death.
17316,26/3/2012,Afghanistan,Paktika,1,0,1,A US soldier is shot in the face by a Muslim terrorist in police uniform.
17317,26/3/2012,Afghanistan,Mirwais,0,4,4,"The Taliban send a child suicide bomber into a group of foreign humanitarian workers, injuring four."
17318,27/3/2012,Somalia,Mogadishu,2,0,2,Two men are gunned down in cold blood by al-Shabaab Islamists.
17319,27/3/2012,Iraq,Jahoni,4,0,4,Four men caught drinking are machine-gunned by fundamentalists.
17320,27/3/2012,Iraq,Hamam Alil,2,2,4,A woman is among two people who bleed to death following a terrorist bombing.
17321,27/3/2012,Iraq,Ghazaliya,1,2,3,A Fedayeen suicide bomber kills an Iraqi.
17322,28/3/2012,Pakistan,Nazimabad,1,0,1,Wahhabi gunmen pick off a Shiite tailor outside his shop.
17323,28/3/2012,Nigeria,Maiduguri,1,0,1,A man is shot to death by Boko Haram while shopping at a market.
17324,28/3/2012,Nigeria,Damagun,1,2,3,Radicals shouting 'Allah Akbar' break into a police station and kill a cop.
17325,29/3/2012,Thailand,Pattani,1,0,1,A 59-year-old man takes two Religion of Peace bullets to the head and torso.
17326,29/3/2012,Pakistan,Mastung,2,0,2,Islamists are suspected in the shooting attack on a UN food vehicle that leaves two aid workers dead.
17327,29/3/2012,Pakistan,Quetta,5,6,11,"Sunni militants open up on a group of Shiites with automatic weapons, taking down at least five, including a woman."
17328,30/3/2012,India,Nutangram,0,1,1,A 65-year-old widow is badly beaten in her own church by Islamic extremists.
17329,30/3/2012,Nigeria,Askira Uba,2,0,2,Radical Islamists shoot two people to death at a bank.
17330,30/3/2012,Afghanistan,Yayakhil,9,0,9,Nine Afghan police are shot to death in their sleep by a Taliban wearing a uniform.
17331,30/3/2012,Pakistan,Rabwah,1,0,1,An Ahmadi schoolteacher is tortured to death by Sunni police in what is felt to be a sectarian incident.
17332,31/3/2012,Thailand,Yala,5,350,355,A Religion of Peace bombing at a hotel ignites a fire that kills five and injures over three-hundred.
17333,31/3/2012,Kenya,Mombasa,1,12,13,A woman is killed when suspected al-Shabaab radicals throw grenades into a bar.
17334,31/3/2012,Dagestan,Khasavyurt,2,0,2,Two police officers are gunned down by suspected Mujahideen.
17335,31/3/2012,Kenya,Mtwapa,2,30,32,Two Christians are blown apart when Mujahideen toss a grenade into an outdoor worship service.
17336,31/3/2012,Yemen,Mallah,17,11,28,A surprise attack by al-Qaeda leaves seventeen local soldiers dead.
17337,31/3/2012,Thailand,Yala,9,105,114,A brutal double-bombing in a commercial hub leaves at least nine shoppers dead and over one-hundred injured.
17338,31/3/2012,Afghanistan,Gizab,3,2,5,Three Afghans are torn to shreds by a Taliban bomb.
17339,1/4/2012,Nigeria,Maiduguri,1,0,1,A Christian is shot to death by Islamists on his way home from church.
17340,1/4/2012,Afghanistan,Tarin Kot,2,0,2,Religious radicals murder two local cops.
17341,1/4/2012,Yemen,Hadramout,7,0,7,Seven local troops are slaughtered by al-Qaeda.
17342,2/4/2012,Israel,Jerusalem,0,1,1,An elderly Jewish man in ultra-orthodox dress is assaulted by an axe-wielding Arab.
17343,2/4/2012,Nigeria,Maiduguri,1,0,1,Boko Haram radicals murder a cop.
17344,2/4/2012,Pakistan,Mohmand,4,7,11,"Islamic militants assault a Pakistani checkpoint, killing three soldiers."
17345,2/4/2012,Afghanistan,Kandahar,2,23,25,Taliban marketplace bombers kill two and wound two dozen others.
17346,2/4/2012,Pakistan,Sadda Bazaar,1,13,14,"A Tehreek-e-Taliban bomb explodes at a taxi stand, killing a bystander."
17347,2/4/2012,Iraq,Dujail,4,0,4,"Four truck drivers are kidnapped, strangled and burned by Muslim terrorists."
17348,2/4/2012,Pakistan,Shah Wali,1,0,1,A woman is hacked alive by her brother-in-law for having 'loose morals'.
17349,2/4/2012,Pakistan,Quetta,2,0,2,Sunnis barge into a shoe store and gun down two Shia.
17350,2/4/2012,Thailand,Pattani,2,0,2,Two Buddhists are shot to death sitting in their pickup truck by Mujahideen.
17351,3/4/2012,Afghanistan,Wardoj,3,11,14,Religion of Peace militants storm a checkpoint and kill three police officers.
17352,3/4/2012,Pakistan,Miranshah,1,2,3,Islamic militants murder a security guard with a bomb.
17353,3/4/2012,Afghanistan,Nahri Sarraj,6,3,9,Two civilians and four police are poisoned and shot by the Taliban.
17354,3/4/2012,Pakistan,Gari Bagh,6,50,56,At least six people die from shrapnel injuries after a sectarian grenade attack on a Sunni rally.
17355,3/4/2012,Iraq,Diwaniya,1,0,1,A Shiite cleric is assassinated by sectarian rivals outside his home.
17356,3/4/2012,Pakistan,Gilgit,10,0,10,Ten more people are killed in a sectarian clash between Sunni and Shia.
17357,3/4/2012,Iraq,Tikrit,1,0,1,A father of two is killed by bombers because he worked for an American-supported TV station.
17358,4/4/2012,Iraq,Kirkuk,1,0,1,A 16-year-old boy is beaten and strangled on suspicion of being homosexual.
17359,4/4/2012,Iraq,Hamdaniya,4,3,7,Terrorists take out four civilians with a car bomb.
17360,4/4/2012,Pakistan,Sheikhupura,2,0,2,Two women are honor killed by their brother-in-law for 'having suspicious characters.
17361,4/4/2012,Nigeria,Maiduguri,9,0,9,"Islamic radicals fire on Christian traders at a market, killing nine."
17362,4/4/2012,Iraq,Dhuluiyah,6,10,16,Five civilians are cut down by a Mujahid bombing along a city street.
17363,4/4/2012,Afghanistan,Maimanah,12,26,38,At least twelve people at a park are dismantled by a Fedayeen suicide bomber.
17364,4/4/2012,Somalia,Mogadishu,10,24,34,"A Shahid suicide bomber detonates in a theater, killing at least ten innocents."
17365,4/4/2012,Pakistan,Jamrud,6,7,13,A half-dozen bus passengers are sent to Allah by Muslim bombers.
17366,4/4/2012,Afghanistan,Khak Safid,10,0,10,Ten Afghan cops are murdered by Sunni fundamentalists.
17367,5/4/2012,Pakistan,Karachi,1,0,1,A 22-year-old Shiite is shot to death by suspected Sunnis.
17368,5/4/2012,Philippines,Sumisip,4,7,11,Four people at an agriculture co-op lose their lives to an Abu Sayyaf attack.
17369,5/4/2012,Pakistan,Karachi,4,14,18,A Tehrik-e-Taliban suicide car bomber takes out four Pakistanis.
17370,5/4/2012,Algeria,Tizi-Ouzou,1,2,3,Fundamentalists attack a police vehicle and kill an officer.
17371,5/4/2012,Thailand,Pattani,1,1,2,"Muslim 'insurgents' fire into a car care shop, killing the owner and seriously injuring his son."
17372,5/4/2012,Afghanistan,Badakhshan,2,16,18,"A Fedayeen suicide bomber detonates at a bazaar, killing two innocents."
17373,5/4/2012,Somalia,Mogadishu,1,0,1,A journalist is gunned down by suspected al-Shabaab militants.
17374,6/4/2012,Dagestan,Khasavyurtovsky,1,0,1,Suspected Islamists gun down a local cop.
17375,6/4/2012,Pakistan,Karachi,1,0,1,A 55-year-old seminary teacher is shot five times by sectarian rivals.
17376,6/4/2012,Azerbaijan,Ganja,1,0,1,A police officer is killed when an Islamic militant blows himself up.
17377,6/4/2012,Afghanistan,Kunar,2,1,3,A peace envoy and his son are blown to bits by a Shahid suicide bomber.
17378,6/4/2012,Yemen,Mansoura,1,0,1,A civilian is killed instantly by an al-Qaeda suicide bomber.
17379,7/4/2012,Mali,Timbuktu,1,0,1,A Christian leader is beheaded by Religion of Peace activists.
17380,7/4/2012,Pakistan,Karachi,1,0,1,A prayer leader is murdered by sectarian rivals in a drive-by shooting.
17381,7/4/2012,Iraq,Khan Bani Saad,3,0,3,'Insurgents' kill three Iraqis with a roadside bomb.
17382,7/4/2012,Lebanon,Jusiyeh,7,21,28,Seven Shiite pilgrims are killed by a mortar attack on their bus.
17383,7/4/2012,Iraq,Karrada,2,9,11,Two passengers on a minibus bleed to death following a Mujahideen bomb blast.
17384,7/4/2012,Turkey,Bahcelievler,0,1,1,Radicals rush into a church and assault a pastor when he refuses to embrace Islam.
17385,8/4/2012,Nigeria,Kaduna,41,33,74,A suicide car bomber detonates outside a church celebrating Easter.  Nearly forty people lose their lives in the carnage.
17386,8/4/2012,Pakistan,Khapiyanga,2,0,2,Islamic militants kill two people at a check post.
17387,9/4/2012,Yemen,Loder,20,3,23,An Ansar al-Sharia assault leaves twenty local soldiers and tribesmen dead.
17388,9/4/2012,Nigeria,Potiskum,1,2,3,A 6-year-old girl is murdered by Islamic terrorists.
17389,9/4/2012,Nigeria,Dikwa,3,0,3,A civilian and guard at a church are among three people shot to death by Boko Haram.
17390,9/4/2012,Pakistan,Quetta,6,2,8,Six minority Shiites are machine-gunned by Lashkar-i-Jhangvi at close range as they are sitting outside a shop.
17391,9/4/2012,Somalia,Baidoa,12,30,42,A dozen women and children are sent to Allah by al-Shabaab bombers at a marketplace.
17392,10/4/2012,Algeria,Kabylie,1,2,3,A fundamentalist roadside blast leaves a local soldier dead.
17393,10/4/2012,Philippines,Sumisip,1,26,27,One person is killed by an Abu Sayyaf landmine.
17394,10/4/2012,Nigeria,Banki,5,5,10,A Boko Haram assault on a village leaves five dead.
17395,10/4/2012,Yemen,Abar,8,4,12,al-Qaeda militants machine-gun eight local soldiers at point-blank range.
17396,10/4/2012,Afghanistan,Guzara,14,23,37,A 4-year-old girl is among fourteen innocents blown up by a Fedayeen suicide bomber wearing a burqa.
17397,10/4/2012,Afghanistan,Musa Qala,8,5,13,A Shahid suicide bomber takes out eight Afghans.
17398,10/4/2012,Pakistan,Speen Qabar,7,0,7,Lashkar-e-Islam tortures and kills seven former member for leaving the group.
17399,11/4/2012,Afghanistan,Dawlat Shahi,1,1,2,A schoolteacher is among two casualties of a Taliban roadside bomb.
17400,11/4/2012,Philippines,Carmen,3,16,19,"A bus bomb, linked to Muslim 'rebels', leaves three people dead and injures many children."
17401,11/4/2012,Iraq,Mosul,2,0,2,Muslim militants murder two workers at a construction site.
17402,11/4/2012,Mali,Timbuktu,1,0,1,A Christian leader is beheaded shortly after Islamic forces take control of the city.
17403,11/4/2012,Iraq,Baqubah,5,6,11,Five members of a Shiite family are demolished along with their own home by Sunni bombers.
17404,12/4/2012,Macedonia,Smilkovsko,5,0,5,Five young Christian fishermen between the ages of 18 and 22 are brutally slaughtered by a group of radical Muslims at a lake.
17405,12/4/2012,Yemen,Moudia,3,0,3,Three tribesmen lose their live to an al-Qaeda ambush.
17406,12/4/2012,Nigeria,Maiduguri,5,3,8,Boko Haram radicals shoot five traders to death at a market.
17407,12/4/2012,Afghanistan,Garmser,2,6,8,A Taliban bomber takes out two teenagers and injures three other children.
17408,12/4/2012,Thailand,Pattani,3,0,3,"Three villagers, including a woman, are gunned down in cold blood by Muslim 'separatists'."
17409,12/4/2012,Iraq,Kirkuk,5,5,10,'Insurgents' murder three civilians and two cops in a drive-by.
17410,12/4/2012,Pakistan,Quetta,2,0,2,Two more Shiites are shot to death by Sunnis in a second attack on the same day.
17411,12/4/2012,Pakistan,Quetta,1,1,2,A Shiite minority is assassinated in a Sunni drive-by outside a tea shop.
17412,13/4/2012,Pakistan,Bajri,1,0,1,A man is beheaded by Religion of Peace rivals.
17413,13/4/2012,Iraq,Samarra,5,6,11,"Sunni gunmen block buses carrying Shia pilgrims and open up at point-blank range, killing five."
17414,13/4/2012,Iraq,Baghdad,2,6,8,Two Shiite pilgrims are shot to death by Sunni militants.
17415,13/4/2012,Pakistan,Quetta,1,0,1,Sunni militants shoot a Shiite to death outside a shop.
17416,13/4/2012,Afghanistan,Khanabad,5,5,10,Women and children are among five victims of a Fedayeen suicide bomber.
17417,14/4/2012,Iraq,Baiji,1,14,15,One person is killed by a sticky bomb attached to a vegetable cart.
17418,14/4/2012,Pakistan,Ghaniur Rehman,1,0,1,An excise inspector is killed by a remote-controlled bomb.
17419,14/4/2012,Pakistan,Quetta,8,0,8,Eight members of a Shia minority community are shot to death by Sunni radicals in two attacks.
17420,14/4/2012,Yemen,al-Jawalah,5,0,5,A sudden al-Qaeda attack on a checkpoint leaves five local soldiers dead.
17421,14/4/2012,Pakistan,Shal Kot,1,0,1,A man loses his life to sectarian Jihadis.
17422,15/4/2012,Yemen,Hadramawt,3,0,3,"Three young children, all siblings, are disassembled by al-Qaeda explosives while on their way to school."
17423,15/4/2012,Yemen,Lawder,3,0,3,A Shahid suicide bomber takes out three civilians at a checkpoint.
17424,15/4/2012,Egypt,el-Arish,2,1,3,Islamists machine-gun two policemen to death at an airport.
17425,15/4/2012,Afghanistan,Mahmud-i-Raqi,4,0,4,All four people riding in a police vehicle are torn apart by a Taliban bomb.
17426,15/4/2012,Iraq,Taji,3,2,5,"A Shiite family home is blown up by Sunni radicals, leaving three members dead."
17427,15/4/2012,Iraq,Hawija,1,0,1,A boy riding in a car is murdered by suspected al-Qaeda bombers.
17428,15/4/2012,Iraq,Kirkuk,1,15,16,A bomb near a university kills one.
17429,15/4/2012,Pakistan,Mohmand,2,0,2,Tehreek-e-Taliban militants attack and kill two local cops.
17430,15/4/2012,Afghanistan,Kabul,12,65,77,At least a dozen civilians and police are killed during a wave of Fedayeen suicide assaults by the Taliban.
17431,15/4/2012,Pakistan,Sheikhupura,1,0,1,An 80-year-old man is assassinated after being acquitted for blasphemy.
17432,15/4/2012,Iraq,Baqubah,4,0,4,"A woman and four children, ages 5 to 15, are sent to Allah by an al-Qaeda bomber."
17433,15/4/2012,South Sudan,Mayom,7,14,21,Seven civilians are killed as a result of a Sudanese bombing.
17434,15/4/2012,South Sudan,Bentiu,2,8,10,A pregnant woman is among two people killed during a bombing by the Islamic Republic of Sudan.
17435,16/4/2012,Pakistan,Quetta,1,0,1,Sunni gunmen murder a Shia civilian.
17436,16/4/2012,Dagestan,Makhachkala,1,1,2,Muslim car bombers take out a woman and injure her husband.
17437,16/4/2012,Pakistan,Khazana,1,2,3,A 6-year-old child is killed by a grenade thrown into a school by religious hardliners opposed to mixed education.
17438,16/4/2012,Nigeria,Maiduguri,2,0,2,Two people are shot to death by Boko Haram extremists.
17439,16/4/2012,Iraq,Rashidiya,4,3,7,Four Shiite farmers are picked off by Sunni snipers.
17440,16/4/2012,Pakistan,Korangi,2,0,2,Two cousins are shot to death in a targeted sectarian attack by Religion of Peace rivals.
17441,17/4/2012,Somalia,Baidoa,1,0,1,A security guard is murdered by a Fedayeen suicide bomber.
17442,17/4/2012,Yemen,al-Bayda,6,4,10,An al-Qaeda suicide bomber takes out five local soldiers and a civilian.
17443,17/4/2012,Afghanistan,Takhar,0,150,150,One-hundred and fifty schoolgirls are poisoned by religious hardliners for seeking an education.
17444,17/4/2012,Afghanistan,Dilaram,2,4,6,Taliban fundamentalists kill two Afghans with a roadside bomb.
17445,17/4/2012,Pakistan,Karachi,1,0,1,A Shia school principal is assassinated by Wahhabi gunmen.
17446,17/4/2012,Iraq,Bagdhad,4,6,10,Four civilians are disassembled by a well-placed Mujahideen bomb.
17447,17/4/2012,Pakistan,Asharey,1,0,1,A woman is strangled by her relatives on suspicion of a sexual affair.
17448,18/4/2012,Nigeria,Maiduguri,2,0,2,A water vendor is among two men shot to death by Islamic radicals.
17449,19/4/2012,Iran,Marwdasht,1,0,1,A young man is hanged for allegedly engaging in gay sex.
17450,19/4/2012,Nigeria,Kano,2,0,2,Boko Haram is suspected in the murder of two civilians.
17451,19/4/2012,Iraq,Baghdad,11,49,60,Terrorists murder at least eleven Iraqis in five separate bombings.
17452,19/4/2012,Pakistan,Shawa,5,24,29,A woman is among five villagers killed during a massive Taliban assault.
17453,19/4/2012,Iraq,al-Malhaa,9,24,33,A series of vicious Mujahideen bombings leave at least nine dead.
17454,19/4/2012,Iraq,Samarrah,10,9,19,Ten Iraqis are blown to bits by three Sunni car bombs.
17455,19/4/2012,Iraq,Ramadi,8,10,18,Eight Shiites are exterminated by a pair of al-Qaeda car bombers.
17456,19/4/2012,Iraq,Kirkuk,4,19,23,Four people die of shrapnel injuries from a Mujahid explosive.
17457,19/4/2012,Iraq,Taji,5,9,14,A Shahid suicide bomber sends five souls to Allah.
17458,19/4/2012,Iraq,Mosul,5,5,10,"Two bombs, one near a restaurant, leave five people dead."
17459,19/4/2012,Iraq,Fallujah,7,7,14,Seven Iraqis are taken down by three roadside bombs planted by the 'Islamic State of Iraq'.
17460,19/4/2012,Afghanistan,Lagrai,4,7,11,A Fedayeen suicide bomber sends four Afghan souls to Allah.
17461,19/4/2012,Nigeria,Maiduguri,5,0,5,Five day laborers at a bakery are brutally shot to death by Boko Haram.
17462,19/4/2012,Nigeria,Damaturu,1,0,1,A cop is gunned down outside his home by Boko Haram.
17463,19/4/2012,Israel,Jerusalem,0,1,1,An orthodox Jewish pilgrim is stabbed outside a tomb by two Arabs.
17464,20/4/2012,Iraq,al-Amiriyah,2,4,6,Mujahideen invade a home and shoot two residents to death.
17465,20/4/2012,Iraq,Baghdad,1,0,1,A mosque imam is assassinated by sectarian rivals.
17466,20/4/2012,India,Srinagar,1,0,1,The 'Islamic Front' assassinate a cop in broad daylight.
17467,21/4/2012,Pakistan,Quetta,2,0,2,Two religious minorities are killed for their faith by Wahhabi gunmen.
17468,21/4/2012,Iraq,Baghdad,3,12,15,Sunni bombers take out three people near a Shiite place of worship with bombs planted on a minibus.
17469,21/4/2012,Pakistan,North Waziristan,2,0,2,Two grandchildren of a tribal elder are kidnapped and brutally executed by Sunni hardliners.
17470,22/4/2012,Uganda,Kampala,1,0,1,A top cleric is the victim of an apparent sectarian attack.
17471,22/4/2012,Pakistan,Karachi,1,0,1,A Sunni is gunned down by suspected Shia.
17472,22/4/2012,Pakistan,Adezai,4,0,4,Four cousins are ambushed and murdered by machine-gun wielding Islamists.
17473,23/4/2012,Sweden,Landskrona,1,0,1,A 19-year-old woman is stabbed to death by her younger brother for having boyfriends and wanting to live independently.
17474,23/4/2012,Sudan,Bentiu,1,2,3,A boy is killed in an air strike on a market by the Islamic Republic of Sudan.
17475,23/4/2012,Lebanon,Tyre,0,5,5,Fundamentalists bomb a restaurant serving alcohol.
17476,23/4/2012,Iraq,Tikrit,2,1,3,Two children are machine-gunned to death in their school by Jihadis.
17477,23/4/2012,Iraq,Baghdad,2,0,2,A young girl is among two Iraqis killed by terrorists with silencers.
17478,23/4/2012,Thailand,Pattani,1,0,1,A security volunteer is slain by Muslim 'insurgents'.
17479,24/4/2012,Pakistan,Bara Qadeem,1,3,4,A child dies from splinter injuries suffered from a Mujahideen grenade attack.
17480,24/4/2012,Iraq,Mosul,2,0,2,A man and woman are shot to death by 'insurgents'.
17481,24/4/2012,Iraq,Mosul,2,2,4,Jihadi car bombers take out two Iraqis.
17482,24/4/2012,Nigeria,Gwa-Rim,5,0,5,Suspected Boko Haram attack a village and massacre five residents.
17483,24/4/2012,Nigeria,Jos,1,9,10,Fundamentalists bomb a bar where locals gather to watch a soccer match.  One person is killed.
17484,24/4/2012,Pakistan,Lahore,4,27,31,"Islamic militants bomb a train station, killing three bystanders, including a 9-year-old child and a 3-year-old toddler."
17485,24/4/2012,Nigeria,Damaturu,5,6,11,"Islamic fundamentalists fire into a bar serving alcohol, killing five patrons."
17486,24/4/2012,India,Nadia,1,0,1,The caretaker of a Hindu temple is ambushed and has his throat cut by Muslim criminals.
17487,24/4/2012,Thailand,Narathiwat,1,0,1,A 50-year-old man is shot in the head by Islamic militants.
17488,25/4/2012,Nigeria,Abuja,2,2,4,"Muslims shoot a Christian father and teenage son to death for 'not serving Allah' and also kidnap the family's two young daughters, ages 7 and 9."
17489,25/4/2012,Thailand,Pattani,2,0,2,Two middle-aged men are machine-gunned in their pickup truck by Religion of Peace militants
17490,25/4/2012,Thailand,Narathiwat,0,8,8,A 3-year-old boy is among the casualties of a Muslim bombing.
17491,25/4/2012,Afghanistan,Kandahar,2,3,5,A terrorist in uniform shoots an American and an interpreter in the back.
17492,25/4/2012,Afghanistan,Badakhshan,3,11,14,Religious radicals murder three local cops at a checkpoint.
17493,25/4/2012,Nigeria,Riyom,5,5,10,Four women and a 4-year-old child are among members of a Christian village hacked to death by Fulani raiders.
17494,26/4/2012,Iraq,Hurriyah,4,25,29,Car bombers take down four Iraqis.
17495,26/4/2012,Israel,Jerusalem,0,3,3,A family is attacked by Arabs yelling anti-Jewish slogans.
17496,26/4/2012,Iraq,Garma,10,18,28,A Shahid suicide bomber murders ten Iraqis at a coffee shop.
17497,26/4/2012,Afghanistan,Maidan Wardak,3,3,6,Three women are crushed to death in their home from a mortar round fired during a Taliban ambush.
17498,26/4/2012,Nigeria,Abuja,4,8,12,A Fedayeen suicide bomber takes out four innocents at a second newspaper office.
17499,26/4/2012,Nigeria,Kaduna,4,19,23,A Boko Haram car bombing at a newspaper office leaves four people dead.
17500,26/4/2012,Syria,Erbin,4,0,4,Sunni terrorists reportedly shoot four members of an Alawite family to death.
17501,26/4/2012,Iraq,Baghdad,9,14,23,"Muslim terrorists attack a gold market with grenades and guns, killing at least nine."
17502,27/4/2012,Syria,Damascus,10,28,38,"A suicide bomber detonates across the street from a mosque, leaving a grisly scene and about ten bodies."
17503,27/4/2012,Pakistan,Khairpur,0,10,10,At least ten people are injured when Sunni and Shia begin firing at each other.
17504,27/4/2012,Somalia,Hodan,3,10,13,At least three die from splinter injuries when fundamentalists throw grenades into a cinema where youth are enjoying a movie.
17505,27/4/2012,Somalia,Mogadishu,4,2,6,A child is among four civilians cut down by an al-Shabaab ambush.
17506,27/4/2012,Iraq,Abu Garma,4,0,4,A Sunni mother and her four children are brutally shot to death in their own home by Shia gunmen.
17507,27/4/2012,Afghanistan,Wardak,10,0,10,Ten Afghans are disassembled by Taliban bombers.
17508,27/4/2012,Ethiopia,Asasa,5,10,15,Angry Muslims attack a police station and murder five cops over the arrest of an imam trying to incite religious violence.
17509,28/4/2012,Ingushetia,Sagopshi,2,1,3,Two policemen are destroyed by a roadside bomb.
17510,28/4/2012,Afghanistan,Kandahar,2,1,3,Two security guards are murdered in cold blood by Taliban assassins.
17511,28/4/2012,Yemen,Lahj,1,0,1,A man walking near a hospital is taken down in an al-Qaeda drive-by.
17512,29/4/2012,Nigeria,Kano,16,22,38,"Sixteen Christians, including professors and doctors, are massacred by Islamists, who bomb their church service and then shoot them in the back as they try to flee."
17513,29/4/2012,Nigeria,Maiduguri,5,6,11,The pastor is among five Christians shot to death by Boko Haram Islamists inside their church.
17514,29/4/2012,Kenya,Nairobi,1,16,17,"A suspected al-Shabaab member throws a grenade into a church during Sunday service, killing a worshipper."
17515,29/4/2012,Pakistan,Bara,5,14,19,A woman and child are among five innocents killed in the fighting that follows a Lashkar-e-Islam attack on a peace committee.
17516,29/4/2012,Pakistan,Jamrud,2,14,16,Lashkar-e-Islam bombers take down two bystanders at a bus stop.
17517,29/4/2012,Pakistan,Quetta,1,0,1,A 60-year-old British humanitarian worker is beheaded by Islamic radicals four months after his abduction.
17518,29/4/2012,Iraq,Abu Ghraib,1,6,7,A Sunni bomb leaves one Iraqi dead.
17519,30/4/2012,Afghanistan,Shahjoy,4,3,7,"Two Muslim radicals fire on a group of children, killing at least four."
17520,30/4/2012,Afghanistan,Paktika,2,2,4,Two 12-year-old children are sent to Allah by Religion of Peace bombers.
17521,30/4/2012,Nigeria,Jalingo,11,26,37,"A Fedayeen suicide bomber detonates along a city street, killing at least eleven others."
17522,30/4/2012,Syria,Idlib,8,24,32,At least eight people are blown to bits by an al-Nusra suicide bomber.
17523,30/4/2012,Algeria,Mekla,4,2,6,Fundamentalists machine-gun four local cops.
17524,30/4/2012,Pakistan,Karimabad,2,0,2,Two Shiites riding a motorcycle are shot to death by Sunni terrorists.
17525,30/4/2012,Pakistan,Karachi,1,0,1,Sunnis gun down a Shia civilian.
17526,30/4/2012,Pakistan,Ghari Suhbat Khan,1,1,2,A bomb blast at a girls' school leaves one dead.
17527,1/5/2012,Yemen,Sayoun,2,1,3,At least two victims die during an al-Qaeda ambush.
17528,1/5/2012,Somalia,Dusamareb,4,6,10,"Civilians at a cafe are among the casualties of a Shahid suicide bomber, who praised Allah as he detonated."
17529,1/5/2012,Somalia,Mogadishu,1,0,1,A man is killed by an al-Shabaab car bomb.
17530,1/5/2012,Nigeria,Riyom,6,6,12,"Muslims raid a Christian village, setting fire to homes and shooting those who fled."
17531,1/5/2012,Thailand,Pattani,2,6,8,A Muslim bomb planted on a motorcycle kills two local soldiers.
17532,1/5/2012,Pakistan,Quetta,2,16,18,A 14-year-old student is among two civilians killed by a powerful Tehreek-e-Taliban bomb.
17533,1/5/2012,Pakistan,Karachi,1,0,1,A Shiite is assassinated by Sunni gunmen.
17534,2/5/2012,Thailand,Narathiwat,2,0,2,Two Buddhists are gunned down at a checkpoint by Muslim 'insurgents'.
17535,2/5/2012,Afghanistan,Kabul,7,17,24,Four children on their way to school are among seven innocents torn to shreds by Fedayeen suicide bombers disguised in burqas.
17536,2/5/2012,Egypt,Rafah,1,2,3,Palestinian-based terrorists take out an Egyptian policeman with a rocket.
17537,2/5/2012,India,Terana,1,0,1,An Indian soldier is shot to death by Islamic militants.
17538,3/5/2012,Dagestan,Makhatchkala,12,110,122,Rescue workers and civilians are among those bleeding to death in the aftermath of a vicious suicide blast and follow-up bombing.
17539,3/5/2012,Pakistan,Chamarkand,5,2,7,Tribal elders are among those taken apart by a Taliban double-bomb attack.
17540,3/5/2012,Thailand,Narathiwat,1,0,1,The life of a 21-year-old is snuffed out by suspected terrorists.
17541,3/5/2012,Thailand,Pattani,4,0,4,Four Buddhists are hunted down and assassinated by Muslim gunmen.
17542,3/5/2012,Nigeria,Potiskum,56,29,85,"Islamists toss bombs and fire into a cattle market, massacring about sixty innocents."
17543,4/5/2012,Egypt,Cairo,3,300,303,Three people are killed when Jihadists storm a government building.
17544,4/5/2012,Pakistan,Khar,29,72,101,Tehrik-e-Taliban suicide bombers at a bazaar send two dozen innocents to Allah.
17545,4/5/2012,Nigeria,Taraba,5,0,5,Muslim extremists gun down five villagers.
17546,4/5/2012,Nigeria,Kumshe,2,0,2,Two guards at a jail are shot to death by Boko Haram radicals.
17547,4/5/2012,Afghanistan,Nangarhar,5,0,5,Five Afghan cops are brutally murdered by Taliban bombers.
17548,4/5/2012,Algeria,Boumerdes,2,1,3,Two Algerians are dismantled by a mortar round fired by Islamic fundamentalists.
17549,4/5/2012,Thailand,Yala,1,1,2,Islamic snipers pick off a father in his pickup truck and seriously injure his 7-year-old son.
17550,5/5/2012,Nigeria,Hotoro,2,0,2,Islamic snipers assassinate two security personnel.
17551,5/5/2012,Germany,Bonn,0,29,29,Twenty-nine police are injured when 'strict Muslims' attack with bottles and sticks over cartoons of Muhammad.
17552,5/5/2012,Thailand,Yala,1,0,1,Muslim 'separatists' shoot a rival mosque official to death.
17553,5/5/2012,Nigeria,Maiduguri,3,4,7,Three civilians are brought down when Boko Haram radicals open fire during a wedding.
17554,5/5/2012,Philippines,Iligan,2,19,21,Two cousins are killed when suspected Muslims activists toss a grenade into a restaurant.
17555,6/5/2012,Afghanistan,Kandahar,1,0,1,A NATO soldier is shot in the back by a Mujahideen wearing a local uniform.
17556,6/5/2012,Pakistan,Turbat,2,1,3,Two people are killed in their own home by Mujahideen.
17557,6/5/2012,Pakistan,Miranshah,9,12,21,Tehreek-e-Taliban militants kill nine local soldiers in a coordinated ambush.
17558,6/5/2012,Pakistan,Dasht,1,11,12,"A Shiite is gunned down in a targeted attack, while injuries are suffered during a separate attack on a bus carrying pilgrims."
17559,6/5/2012,Pakistan,Miranshah,3,15,18,Three civilians are killed when a shell hits a mosque during a sustained attack by Islamic militants on security forces.
17560,6/5/2012,Pakistan,Miranshah,14,0,14,Religious extremists kidnap and behead fourteen local soldiers.
17561,7/5/2012,Iraq,Baqubah,2,4,6,A Shia man and his son are blown to bits in their own home by Sunni extremists.
17562,7/5/2012,Iraq,Baghdad,1,4,5,A civilian is killed when terrorists blow up a minibus.
17563,7/5/2012,Yemen,Zinjibar,32,40,72,Thirty-two soldiers are killed during a sustained attack by al-Qaeda militants.
17564,7/5/2012,India,Kishtwar,1,3,4,A 12-year-old dies from splinter injuries when Muslim terrorists toss a grenade into his family's home.
17565,8/5/2012,Pakistan,Dhamala,0,3,3,Three Christian women are 'beaten mercilessly' in their own home by a Muslim gang.
17566,8/5/2012,Pakistan,Orangi,1,0,1,A 35-year-old Shiite man is murdered down by Sunni gunmen.
17567,8/5/2012,Afghanistan,Urgun,5,0,5,Education ministry officials are cut down in a brutal ambush by Sunni hardliners.
17568,8/5/2012,Afghanistan,Pul-e-Alam,2,0,2,Taliban gunmen assassinate two locals at a bazaar.
17569,8/5/2012,Afghanistan,Pusht Rod,5,0,5,Five local policemen bleed out following a Religion of Peace roadside bombing.
17570,8/5/2012,Somalia,Mogadishu,7,4,11,Four children are among seven civilians crushed to death by an al-Shabaab mortar attack on their neighborhood.
17571,9/5/2012,Nigeria,Rim,1,2,3,A Christian villager is killed by Muslim attackers.
17572,9/5/2012,Nigeria,Tahoss,7,1,8,"Muslim activists set fire to Christian homes and then shoot those trying to flee, killing at least seven, including two children."
17573,9/5/2012,Pakistan,Nowshera,0,12,12,A dozen people are injured when Taliban militants blow up the tomb of a poet who promoted peace.
17574,9/5/2012,Pakistan,Karachi,1,0,1,A 60-year-old man is murdered by Sunnis for being a Shiite.
17575,9/5/2012,Nigeria,Maiduguri,2,0,2,Muslim radicals shoot two cattle traders to death at a market.
17576,9/5/2012,Iraq,Salah al-Din,2,0,2,Two electrical workers are killed by a bomb planted near a pylon.
17577,9/5/2012,Somalia,Baidoa,1,0,1,An aid worker is gunned down by suspected Islamists.
17578,9/5/2012,Yemen,Lawder,3,5,8,Ansar al-Sharia militants murder three local soldiers.
17579,10/5/2012,Dagestan,Kizlyarsky,2,4,6,Islamic 'rebels' murder two local cops.
17580,10/5/2012,Iraq,Saddamiyat,7,0,7,"Seven suspected al-Qaeda victims are found bound, blindfolded and shot."
17581,10/5/2012,Syria,Damascus,55,372,427,"Two Religion of Peace suicide bombers detonate during the morning rush hour, sending at least fifty-five people to Allah."
17582,10/5/2012,Afghanistan,Paktika,4,5,9,Four others are left dead when six Shahid suicide bombers attack a government building.
17583,10/5/2012,Pakistan,Tank,1,5,6,The Taliban gun down a member of a peace committee.
17584,10/5/2012,Pakistan,Karachi,1,0,1,A young Shiite is shot through the head and neck by Sunni militants.
17585,10/5/2012,Somalia,Mogadishu,3,5,8,"Islamists throw grenades into the street, killing three civilians."
17586,11/5/2012,Afghanistan,Kunar,1,0,1,A Taliban wearing an army uniform shoots and American in the back.
17587,11/5/2012,Iraq,Baqubah,5,5,10,"Terrorists kill five people in their own home, including a teenager."
17588,11/5/2012,Pakistan,Hayatabad,1,4,5,A taxi driver is killed in his cab during a Taliban mortar attack.
17589,11/5/2012,Pakistan,Peeral Rind,2,0,2,An 18-year-old girl and her boyfriend are 'honor' killed by her father.
17590,11/5/2012,Nigeria,Kano,1,0,1,A Shiite cleric is murdered in his home by more radical rivals.
17591,12/5/2012,Afghanistan,Helmand,2,0,2,Two British troops are shot in the back by Mujahideen in police uniforms.
17592,12/5/2012,Pakistan,Bahawalnagar,3,0,3,A woman is among three people taken down by sectarian Jihadis.
17593,12/5/2012,Pakistan,Peshawar,2,17,19,Muslim bombers take down two innocents.
17594,12/5/2012,Afghanistan,Qaraghul,4,0,4,Sunni hardliners take out four local police with a roadside bomb.
17595,12/5/2012,Germany,Bonn,0,2,2,Two police officers are stabbed by an Islamist.
17596,12/5/2012,Nigeria,Bauchi,2,0,2,"Suspected Islamists bomb a police station, killing two occupants."
17597,12/5/2012,Somalia,Mogadishu,3,0,3,Three civilians bleed to death following an al-Shabaab grenade attack.
17598,13/5/2012,Syria,Damascus,1,0,1,A Shiite cleric is assassinated by Sunni gunmen as he stepped out of his mosque.
17599,13/5/2012,Pakistan,Khawaizai,1,10,11,Muslim militants kill a civilian volunteer outside a bazaar checkpoint.
17600,13/5/2012,Lebanon,Tripoli,2,0,2,Two people are killed during a sectarian clash between Shia and Sunni.
17601,13/5/2012,Pakistan,Mardan,1,20,21,A powerful Tehreek-e-Taliban bomb leaves at least one person dead.
17602,13/5/2012,Iraq,Baghdad,3,9,12,A Shahid suicide bomber kills three Iraqis.
17603,13/5/2012,Afghanistan,Kabul,1,0,1,A peace negotiator is assassinated by Islamic extremists.
17604,13/5/2012,Thailand,Pattani,0,24,24,"Muslim terrorists throw grenades into a Red Cross fair, injuring two dozen."
17605,13/5/2012,Pakistan,Tirah,4,3,7,Four people are killed when Lashkar e-Islam and Ansar al-Islam shoot at each other.
17606,13/5/2012,Iraq,Saadyiah,1,2,3,"'Insurgents' blow up a home with a family inside, killing the mother and injuring a child."
17607,13/5/2012,Iraq,Fallujah,2,6,8,A Fedayeen suicide bomber takes out two Iraqis.
17608,13/5/2012,Pakistan,Dhoraji,3,1,4,A religious scholar and two others are murdered by sectarian rivals.
17609,13/5/2012,Pakistan,Bhutto Nagar,2,0,2,"Two Shiites are abducted, tortured and then shot to death by Sunni radicals."
17610,13/5/2012,Nigeria,Kano,3,4,7,"Fundamentalists open fire on a group of card players, killing three."
17611,13/5/2012,Nigeria,Mafa,3,0,3,A civilian is among three people burned to death when Boko Haram cadres torch a police station.
17612,14/5/2012,Afghanistan,Ghormach,9,8,17,Religion of Peace bombers take down nine civilians at a market.
17613,14/5/2012,Iraq,Fallujah,5,18,23,A suicide car bombing is among three blasts that leave five people dead.
17614,14/5/2012,Nigeria,Adamawa,15,48,63,Fifteen Christian villagers are massacred by twenty Fulani raiders.
17615,14/5/2012,Thailand,Pattani,1,0,1,An elderly Buddhist man is shot several times in the torso by Muslim 'rebels'.
17616,14/5/2012,Pakistan,Sherakot,2,4,6,Two local cops are gunned down by terrorists.
17617,14/5/2012,Lebanon,Jabal Mohsen,5,70,75,Five people die when supporters of a Sunni terrorist attack a Shiite village.
17618,14/5/2012,Pakistan,Khara Shah,1,9,10,A civilian is left dead following a Lashkar-e-Islam ambush.
17619,14/5/2012,Iraq,Baghdad,1,30,31,At least one person is killed when Muslim terrorists bomb a cafe
17620,14/5/2012,Iraq,Himreen,2,0,2,A man and his son are pulled out of their home and executed by Mujahideen.
17621,15/5/2012,Iraq,Mosul,2,0,2,'Insurgents' assassinate a judge and his driver.
17622,15/5/2012,Kenya,Dadaab,1,3,4,An al-Shabaab bombing at a refugee camp leaves one person dead.
17623,15/5/2012,Kenya,Mombasa,1,2,3,A woman dies from a gunshot wound to the chest as Islamists assault a nightclub.
17624,15/5/2012,Pakistan,Karachi,1,0,1,A Shia man bleeds to death from attack by Sunni gunmen.
17625,15/5/2012,Pakistan,Quetta,2,1,3,Two Shiite brothers are murdered by Lashkar-e-Jhangvi gunmen.
17626,15/5/2012,Egypt,Cairo,1,0,1,A 20-year-old woman is 'honor poisoned' by her family for falling in love with the wrong man.
17627,15/5/2012,Pakistan,Quetta,1,0,1,A Christian man is shot to death while walking home.
17628,15/5/2012,Pakistan,Panian,1,0,1,A woman is murdered by her family for having an illicit sexual relationship.
17629,15/5/2012,Iraq,Mosul,7,20,27,Seven Iraqis are taken out by a Shahid suicide bomber.
17630,16/5/2012,Afghanistan,Badghis,1,5,6,A local cop is disassembled by a Taliban bomb.
17631,17/5/2012,Lebanon,Tripoli,1,0,1,A teenager is killed during a sectarian clash between Sunni and Alawite.
17632,17/5/2012,Pakistan,Quetta,2,2,4,Two Shia police officers are murdered in a targeted attack by Sunnis.
17633,17/5/2012,Afghanistan,Farah,7,13,20,Seven people are shot or blasted to death during a sustained Fedayeen assault on a house.
17634,17/5/2012,Pakistan,Peshawar,1,1,2,"Muslim militants bomb a commercial district, killing a shop owner."
17635,18/5/2012,Iraq,Baghdad,5,34,39,"Holy Warriors bomb a bird market packed with shoppers, leaving at least five dead."
17636,18/5/2012,Algeria,Azzeffoun,2,2,4,"Fundamentalists bomb a Coast Guard barracks, killing two sleeping members."
17637,18/5/2012,Pakistan,Mamond,1,2,3,A member of a peace committee is ambushed and killed by Mujahideen.
17638,18/5/2012,Iraq,Baghdad,5,24,29,"Terrorists detonate a bomb at a restaurant, killing five innocents."
17639,18/5/2012,Afghanistan,Kunar,3,0,3,Two women and a child are crushed in their own home by a Sunni mortar round.
17640,18/5/2012,Iraq,Baghdad,5,0,5,"A family of five, including three young children, are murdered in their own home by Muslim 'insurgents'."
17641,19/5/2012,Somalia,Mogadishu,2,0,2,Two people are killed when al-Shabaab militants toss hand grenades into a market.
17642,19/5/2012,Somalia,Mogadishu,5,0,5,At least five Somalis are exterminated by an Islamic roadside bomb.
17643,19/5/2012,Afghanistan,Khost,13,9,22,Two children are among at least ten civilians wiped out by a Taliban suicide attack on a meeting between police and locals.
17644,19/5/2012,Syria,Deir Ezzor,9,100,109,A least nine people are sent to Allah by a Shahid suicide bomber.
17645,19/5/2012,Nigeria,On-Mbaagbu,12,5,17,"Muslim 'mercenaries' storm two Christian villages and slaughter seven people, including a 2-year-old boy butchered with a knife."
17646,19/5/2012,Pakistan,Lahore,1,0,1,A Shiite poet is gunned down by a Sunni terrorist.
17647,19/5/2012,Iraq,Mosul,3,2,5,Three local policemen are blasted to bits by Sunni roadside bombers.
17648,19/5/2012,Thailand,Narathiwat,1,0,1,Islamic 'separatists' murder an owner in front of his shop.
17649,20/5/2012,Pakistan,Karachi,1,0,1,A 70-year-old Shiite man is taken out in a targeted attack by Sunni gunmen.
17650,20/5/2012,Nigeria,Maiduguri,7,0,7,Seven people are shot to death by Religion of Peace activists near a mosque.
17651,20/5/2012,Afghanistan,Tirin Kot,4,3,7,Two children are among four people torn to shreds by a Religion of Peace suicide bomber.
17652,20/5/2012,Egypt,al-Arish,1,0,1,A tribal sheikh is assassinated by suspected Islamists.
17653,21/5/2012,Yemen,Sanaa,112,311,423,"An al-Qaeda suicide bomber detonates amid a crowd of Yemeni soldiers, massacring about one-hundred."
17654,21/5/2012,Nigeria,Benue,5,3,8,Five people in a Christian village are murdered by Muslim raiders.
17655,21/5/2012,Iraq,Mosul,4,0,4,Four Iraqis are gunned down by Sunni 'insurgents'.
17656,21/5/2012,Iraq,Houd,2,1,3,Two Iraqis are sent to Allah by Jihadi car bombers.
17657,21/5/2012,Lebanon,Beirut,2,18,20,Two people are killed when rival Muslim groups shoot at each other.
17658,21/5/2012,Iraq,Taji,3,2,5,Terrorists machine-gun three Iraqi police officers at a checkpoint.
17659,22/5/2012,Yemen,Sanaa,1,0,1,A Jewish man is stabbed to death by a Muslim at a market.
17660,22/5/2012,Nigeria,Borno,1,0,1,Members of an Islamic sect enter a security officer's home and shoot him to death.
17661,22/5/2012,Nigeria,Maiduguri,4,6,10,Boko Haram bombers claim the lives of four innocents.
17662,22/5/2012,Yemen,Sanaa,1,0,1,A Spanish embassy guard is kidnapped and murdered by suspected terrorists.
17663,22/5/2012,Iraq,Baqubah,6,6,12,Two mothers and four children are killed when two family homes are bombed by Sunni terrorists.
17664,22/5/2012,Pakistan,Sanda Pal,5,5,10,Five people are killed when religious extremists work out their differences.
17665,22/5/2012,Somalia,Baidoa,1,0,1,Suspected al-Shabaab gunmen assassinate a local official.
17666,22/5/2012,Pakistan,Quetta,1,0,1,Lashkar-e-Jhangvi is suspected in the murder of a warden.
17667,23/5/2012,Somalia,Mogadishu,1,0,1,Islamic militants shoot a businessman to death on the street.
17668,23/5/2012,Iraq,Ramadi,3,10,13,Sunnis manage to take down three Shia pilgrims riding on a bus.
17669,23/5/2012,Iraq,Baqubah,3,14,17,A series of Jihad attacks leave three Iraqis dead.
17670,23/5/2012,Pakistan,Khawezai,2,0,2,A woman and her young son bleed to death following a Religion of Peace mortar attack on their residence.
17671,23/5/2012,Pakistan,Qambarkhel,1,0,1,Islamic militants gun down an opponent outside a mosque.
17672,23/5/2012,Pakistan,Tirah,1,1,2,A peace volunteer is ambushed and killed by Tehreek-e-Taliban hardliners.
17673,23/5/2012,Iraq,Mosul,3,2,5,"Extremists enter the home of a Catholic priest, murder his father and two brothers, and rape his mother and sister."
17674,23/5/2012,Pakistan,Ahmedi Shama,0,4,4,Women and children are among the victims of a brutal attack on Shiite pilgrims.
17675,24/5/2012,Tunisia,Tunis,0,1,1,Salafis nearly beat an actor to death for 'being an unbeliever'.
17676,24/5/2012,Somalia,Galkayo,2,8,10,"Radicals throw a grenade into a rival mosque, killing at least two."
17677,24/5/2012,Pakistan,Killi Chakar,1,0,1,Militant Sunnis take down a Shiite in a targeted attack.
17678,24/5/2012,Pakistan,Kohat,1,4,5,Terrorists kill a bystander with a bomb placed near a bus stop.
17679,24/5/2012,Pakistan,Lahore,1,0,1,A Shiite is shot to death by Sunnis.
17680,25/5/2012,Afghanistan,Helmand,3,9,12,Sunni radicals kill three Afghans with two bombs.
17681,25/5/2012,Thailand,Narathiwat,1,0,1,Four Islamic militants ambush and murder a local cop.
17682,25/5/2012,Yemen,Hazm,18,5,23,A woman and her three children are among eighteen killed when an al-Qaeda suicide bomber plows into a crowd of Shiites.
17683,25/5/2012,Pakistan,Kazi Ahmed,7,3,10,Islamic 'separatists' murder seven passengers on a civilian bus.
17684,25/5/2012,Pakistan,Sukkur,2,0,2,Two women are murdered by family members over sex.
17685,25/5/2012,Syria,Houla,108,0,108,"Shia militia stage a sectarian attack on eight Sunni houses, slaughtering over one-hundred people, including forty-nine children."
17686,26/5/2012,Kenya,Dadaab,0,8,8,Eight people suffer shrapnel injuries when al-Shabaab militants toss grenades into a refugee camp.
17687,26/5/2012,Nigeria,Maiduguri,1,0,1,A local politician is assassinated by Boko Haram.
17688,26/5/2012,Iraq,Badush,3,0,3,Three Iraqis are blown to bits by Jihadi bombers.
17689,26/5/2012,Nigeria,Yobe,2,0,2,Two men are gunned down in their own homes by Islamic extremists.
17690,26/5/2012,Pakistan,Kharan,2,3,5,A 12-year-old boy and his uncle are brutally shot to death by suspected Muslim radicals.
17691,27/5/2012,Nigeria,Kano,4,0,4,Four men playing cards under a tree are suddenly machine-gunned in a Boko Haram drive-by.
17692,27/5/2012,Afghanistan,Marjah,2,1,3,Mujahideen take out two civilians with a roadside bomb.
17693,27/5/2012,Pakistan,Nowshera,1,4,5,"Militants detonate a bomb outside a store, killing a guard."
17694,27/5/2012,Nigeria,Potiskum,2,5,7,"Religious extremists attack the home of a rival cleric, shooting two people to death."
17695,27/5/2012,Iraq,Baghdad,0,24,24,"A bus carrying Shiite pilgrims is upended by a Sunni roadside bomb, injuring at least two dozen."
17696,28/5/2012,Myanmar,Kyaukpyu,1,0,1,A Buddhist girl is raped and murdered by three Muslims.
17697,28/5/2012,Kenya,Nairobi,0,33,33,Islamists bomb a shopping complex.
17698,28/5/2012,Syria,Maliha,4,3,7,A suicide bomber takes down four local soldiers.
17699,28/5/2012,Thailand,Pattani,3,4,7,At least three people are killed when Muslim terrorists detonate a bomb under a pick-up truck
17700,28/5/2012,Pakistan,Chrakhel,3,6,9,Sunni gunmen ambush and machine-gun a vehicle carrying Shia civilians.
17701,28/5/2012,Pakistan,Quetta,1,0,1,A Shia civilian is murdered by Wahhabi gunmen.
17702,28/5/2012,Pakistan,Sharbat Khan,2,1,3,Two women are killed in separate attacks by their own brothers over premarital sex.
17703,28/5/2012,Pakistan,Kot Langarkhel,2,3,5,Two local soldiers are ambushed and killed by the Taliban while fetching water.
17704,28/5/2012,Russia,Moscow,0,1,1,A journalist is slashed fifteen times with a knife outside his apartment for criticizing Islam's prophet on a radio show.
17705,28/5/2012,England,Luton,0,1,1,A 19-year-old Sikh is raped in a targeted attack by an Islamic radical.
17706,29/5/2012,Dagestan,Makhachkala,1,0,1,A sports official is machine-gunned by Islamic extremists.
17707,29/5/2012,Thailand,Pattani,3,4,7,"Muslim 'rebels' detonate a bomb under a pick-up truck, killing three people and leaving another four in agony."
17708,29/5/2012,Afghanistan,Wardaj,8,2,10,Eight Afghan police are murdered in an ambush by militant Sunnis.
17709,29/5/2012,Yemen,Aden,4,0,4,Four local soldiers are dismantled by an al-Qaeda bomb.
17710,30/5/2012,Afghanistan,Chora Valley,1,0,1,An anti-landmine worker is shot in the back by a Mujahid in police uniform.
17711,30/5/2012,Somalia,Galkayo,6,3,9,Six Somalis are sent to Allah by suspected al-Shabaab bombers.
17712,30/5/2012,Pakistan,Karachi,2,2,4,Two Shiites are murdered by Sunni gunmen as they step off a bus.
17713,30/5/2012,Afghanistan,Ghazni,1,0,1,A cleric is gunned down by Sunni rivals in his own mosque.
17714,30/5/2012,Kenya,Wajir,1,4,5,"al-Shabaab radicals toss a hand grenade into a shop, killing a patron."
17715,30/5/2012,Yemen,Radda,3,3,6,"Ansar-al-Sharia members attack a local security patrol, killing three members."
17716,30/5/2012,Pakistan,Quetta,1,0,1,A member of the minority Shia community is shot to death by Sunnis on a passing motorcycle.
17717,30/5/2012,Pakistan,Mansehra,3,0,3,Three brothers are shot in their sleep by the Taliban.
17718,31/5/2012,Iraq,Baghdad,1,4,5,'Insurgents' kill a civilian with a car bomb.
17719,31/5/2012,Iraq,Amariyah,2,9,11,Children are among the casualties when sectarian Jihadis bomb two Sunni homes.
17720,31/5/2012,Iraq,Baghdad,13,37,50,"A Holy Warrior detonates a delivery truck packed with explosives near a restaurant, slaughtering at least nine."
17721,31/5/2012,Afghanistan,Kandahar,5,6,11,At least five local cops are blown to bits by a Shahid suicide bomber.
17722,31/5/2012,Nigeria,Kano,1,0,1,"A German engineer, kidnapped by al-Qaeda, is executed in handcuffs during a rescue attempt."
17723,31/5/2012,Dagestan,Tsuntinsk,1,0,1,"Muslim militants gun down a teacher on his way home, then set fire to his school."
17724,31/5/2012,Pakistan,Quetta,1,0,1,A Shiite is shot to death by Wahhabi gunmen.
17725,31/5/2012,Pakistan,Kohistan,7,0,7,Four women and three men are executed on orders of a jirga for singing and dancing together at a wedding.
17726,1/6/2012,Syria,al-Nairab,130,0,130,A suicide bomber from Spain massacres over one-hundred and thirty people.
17727,1/6/2012,Afghanistan,Khost,7,13,20,Seven Afghans are sent to Allah by a Taliban suicide bomber.
17728,1/6/2012,Iraq,Baghdad,1,2,3,Terrorist take down a civilian with a roadside bomb.
17729,1/6/2012,Israel,Gaza Border,1,0,1,"Infiltrating terrorists open fire on a group of Israeli soldiers, killing one."
17730,1/6/2012,Nigeria,Maiduguri,3,0,3,A teacher inside a house is among three people shot dead by Islamic radicals.
17731,1/6/2012,Nigeria,Maiduguri,2,0,2,Two civilians are gunned down by fundamentalists in a hotel that served alcohol.
17732,2/6/2012,Dagestan,Makhachkala,1,0,1,A traffic cop is assassinated by a suspected Islamist sniper.
17733,2/6/2012,Pakistan,Quetta,1,0,1,Sunni snipers pick off a Shia civilian near a bus stop.
17734,2/6/2012,Afghanistan,Kabul,5,4,9,A series of Mujahideen attacks leave five Afghans dead.
17735,2/6/2012,Lebanon,Tripoli,10,35,45,Ten people are killed in a clash between Sunni and Alawite.
17736,2/6/2012,France,Villeurbanne,0,3,3,Three young Jewish men with skullcaps are severely beaten with hammers and iron bars by ten Muslims.
17737,3/6/2012,Nigeria,Bauchi,21,45,66,"A Holy Warrior runs his car into a church service and detonates, taking out over twenty praying Christians.  The responsible group later thanks Allah for the victory."
17738,3/6/2012,Pakistan,Quetta,6,1,7,Six innocents are killed during a Sunni shooting rampage at a Shia shop.
17739,3/6/2012,Yemen,Sa’ada,66,50,116,A sectarian clash between Sunni and Shia leaves nearly seventy dead.
17740,3/6/2012,Pakistan,Doaba,1,2,3,Islamic militants shoot a man to death inside his home and abduct his grandchildren.
17741,3/6/2012,Pakistan,Qambar Khel,3,0,3,A woman is among three people executed by Lashkar-e-Islam after being accused of immoral activity.
17742,3/6/2012,Yemen,Zinjibar,1,0,1,A security guard is taken out by an al-Qaeda sniper.
17743,4/6/2012,Maldives,Male,0,1,1,A blogger survives being stabbed in the throat by religious extremists.
17744,4/6/2012,Yemen,Shaqra,4,0,4,Four locals are killed by a Fedayeen suicide bomber.
17745,4/6/2012,Iraq,Baghdad,26,190,216,A Sunni suicide bomber plows an explosives-laden car into a Shiite religious center.  Over two dozen innocents are slain.
17746,4/6/2012,Iraq,Dijail,3,3,6,Three Iraqis are sent to Allah by Mujahideen bombers.
17747,4/6/2012,Iraq,Fallujah,3,4,7,Three occupants are killed when 'insurgents' blow up a house.
17748,4/6/2012,Pakistan,Gilgit,1,2,3,A Shia civilian is picked off by Wahhabi snipers.
17749,4/6/2012,Tunisia,Tunis,1,0,1,Video surfaces of an execution earlier in the year in which a man's throat is cut for embracing Christianity by Muslims who offer prayers as they slice.
17750,4/6/2012,Pakistan,Matani,1,0,1,A peace volunteer is abducted and slaughtered by Muslim fundamentalists.
17751,5/6/2012,Yemen,al-Qobaaf,16,6,22,At least sixteen are left dead following a clash between Sunni and Shiite.
17752,5/6/2012,Afghanistan,Ghazni,1,2,3,A civilian is sent to Allah by Sunni bombers.
17753,5/6/2012,Afghanistan,Wardak,4,1,5,Four Afghans are taken apart by a Taliban roadside bomb.
17754,5/6/2012,Iraq,Baghdad,9,37,46,"Nine people are killed in a series of Mujahideen shootings and bombings, one of which targeted a Shiite mosque."
17755,5/6/2012,Pakistan,Mand,2,0,2,Two Shiite pilgrims are murdered by Sunni gunmen.
17756,5/6/2012,Thailand,Pattani,1,0,1,Muslim extremists shoot a 58-year-old man to death in his pick-up truck.
17757,5/6/2012,Pakistan,Salala,4,4,8,At least four local soldiers are killed during an Islamist assault on their check post.
17758,5/6/2012,Nigeria,Kano,3,0,3,At least three police officers are gunned down in a Boko Haram drive-by.
17759,6/6/2012,Dagestan,Kizilyurt,1,1,2,Suspected Islamic snipers take down another cop.
17760,6/6/2012,Syria,Qubair,78,0,78,"Shiite militia massacre seventy-eight Sunni men, women and children in their village."
17761,6/6/2012,Thailand,Narathiwat,2,5,7,"A woman is among two villagers shot to death by Muslim 'insurgents', who also burn down a school."
17762,6/6/2012,Afghanistan,Kandahar,22,50,72,A pair of Shahid suicide bombers take out nearly two dozen people at a bazaar.
17763,6/6/2012,Pakistan,Bara,2,0,2,Two members of a peace committee are shot to death by Lashkar-e-Islam.
17764,7/6/2012,Pakistan,Quetta,15,48,63,Five children are among fifteen people blown up by sectarian Jihadis outside a Sunni seminary.
17765,7/6/2012,Iraq,Tarmiyah,2,0,2,Two Iraqis are machine-gunned at point-blank range by al-Qaeda.
17766,7/6/2012,Iraq,Baghdad,2,1,3,An al-Qaeda militant murders two prison guards.
17767,7/6/2012,Egypt,Assuit,3,0,3,Three female family members are carved up and beheaded by two brothers concerned about immoral activities.
17768,8/6/2012,Yemen,Jaar,2,4,6,al-Qaeda militants roll up on a checkpoint and machine-gun two local soldiers.
17769,8/6/2012,Nigeria,Maiduguri,8,19,27,A Religion of Peace suicide bomber sends eight Nigerians to Allah.
17770,8/6/2012,Iraq,Baghdad,2,3,5,A brutal ambush of a family vehicle by Mujahideen leaves a married couple dead and their three children injured.
17771,8/6/2012,Pakistan,Peshawar,19,35,54,Seven women and a child are among nineteen innocents on a bus torn to shreds by a Sunni bomb.
17772,8/6/2012,Iraq,Garma,3,3,6,Three Iraqis are taken down by terrorist roadside bombers.
17773,8/6/2012,Myanmar,Muangdaw,4,12,16,"Four Buddhists, including a doctor and an elderly man, are stabbed to death by Muslim rioters following Friday prayers."
17774,9/6/2012,Belgium,Brussels,0,2,2,Two police officers are stabbed with a knife at a train station by an Islamist.
17775,9/6/2012,Afghanistan,Kapisa,4,5,9,A Fedayeen suicide bomber in a burqa kills four French soldiers.
17776,9/6/2012,Myanmar,Muangdaw,16,0,16,Another sixteen Buddhists are reported dead following a rampage by Muslim migrants.
17777,9/6/2012,Thailand,Pattani,1,0,1,Muslim gunmen blow away a man sitting in a tea shop.
17778,10/6/2012,Kuwait,Manama,1,0,1,A 19-year-old woman is beaten and strangled by her brothers on orders from their father over a suspected moral issue.
17779,10/6/2012,Nigeria,Biu,2,12,14,A woman and an usher are among two Christians machine-gunned by Islamists during a church service.
17780,10/6/2012,Nigeria,Jos,4,40,44,"A Shahid suicide bomber detonates inside a church during Sunday morning service, killing at least four."
17781,10/6/2012,Pakistan,Kari Kot Chowk,3,3,6,Two women are among three killed in a rocket attack by Islamic militants.
17782,10/6/2012,Iraq,Baghdad,7,38,45,"Sunnis successfully hit a square packed with Shiite pilgrims with mortar bombs, killing at least seven."
17783,10/6/2012,Pakistan,Ibrahimzai,2,0,2,Two Shiites are brutally tortured to death by Wahhabi terrorists.
17784,10/6/2012,Thailand,Pattani,0,6,6,Three children are among six casualties of a Muslim grenade attack.
17785,11/6/2012,Pakistan,Mastung,6,50,56,"Sunnis bomb a passenger bus carrying Shiites, killing six civilians and injuring fifty more."
17786,11/6/2012,Pakistan,Chowk Korona,2,0,2,A boy and girl are 'honor killed' by the girl's brothers after they are discovered together.
17787,11/6/2012,Afghanistan,Sari Pul,4,0,4,"Taliban bombers take out an ambulance carrying a pregnant woman to the hospital, killing three of her relatives as well."
17788,11/6/2012,Iraq,Falujah,2,4,6,"'Insurgents' blow up a family home, killing two members."
17789,11/6/2012,Iraq,Mosul,1,1,2,Terrorists storm a home and shoot a 20-year-old woman to death.
17790,11/6/2012,Egypt,Cairo,1,0,1,A young girl is beaten by her brothers and thrown off a building for the crime of being in a 'relationship'.
17791,11/6/2012,Pakistan,Nasir Bagh,1,3,4,Three young children and their mother are victimized by a bomb hidden in a toy.
17792,11/6/2012,Egypt,Cairo,0,12,12,Several Christian students are injured by Muslims angered over their evangelism.
17793,11/6/2012,Pakistan,Helmand,3,12,15,Three local soldiers are exterminated by a Taliban rocket attack.
17794,11/6/2012,Somalia,El Bur,2,0,2,Two young men are kidnapped and beheaded by Islamic fundamentalists.
17795,12/6/2012,Nigeria,Dalori,2,3,5,Boko Haram gunmen ambush a Volkswagen and shoot two occupants to death.
17796,12/6/2012,Iraq,Baghdad,2,0,2,A targeted bombing attack on a procession of Shiite pilgrims leaves at least two dead.
17797,12/6/2012,Pakistan,Nankana Sahib,2,0,2,A family member slays a 16-year-old girl and her boyfriend on suspicion of sex.
17798,12/6/2012,Afghanistan,Chahar Bolak,3,5,8,"A Fedayeen bicycle bomber pedals his way to paradise, taking three innocents with him."
17799,12/6/2012,Afghanistan,Wardak,5,2,7,Women and children are among five dead when Sunni fundamentalists set off a bomb under a minibus.
17800,12/6/2012,Pakistan,Bazidkhel,2,2,4,Two security guards are sent to Allah by a Shahid suicide bomber.
17801,13/6/2012,Iraq,Basra,10,11,21,At least ten civilians are sent to Allah by Mujahideen car bombers.
17802,13/6/2012,Iraq,Hillah,22,38,60,Twenty-two people at a restaurant are massacred in mid-bite by two Sunni car bombs.
17803,13/6/2012,Iraq,al-Madain,5,18,23,Terrorists affiliated with the Islamic State of Iraq kill at least five Iraqis with two car bombs.
17804,13/6/2012,Iraq,Baghdad,16,32,48,Sixteen people at a dining hall are liquidated by Religion of Peace blast.
17805,13/6/2012,Iraq,Baghdad,9,21,30,An Islamic State of Iraq bomb at a commercial compound rips nine people to shreds.
17806,13/6/2012,Iraq,Baghdad,7,20,27,"Sunnis set off a car bomb in a Shiite neighborhood, killing at least seven."
17807,13/6/2012,Iraq,Juba,2,7,9,A Fedayeen suicide bomber sends two souls to Allah.
17808,13/6/2012,Iraq,Baqubah,2,44,46,Jihadi bombers take out two Iraqis and leave another forty-four in agony.
17809,13/6/2012,Iraq,Balad,5,30,35,Sunni car bombings leave five Shiites dead.
17810,13/6/2012,Iraq,Mosul,2,5,7,A child is one of two people killed by 'insurgent' bombers.'
17811,13/6/2012,Iraq,Fallujah,3,12,15,Women and children are among the casualties when Jihadis blow up a house.
17812,14/6/2012,Philippines,Parang,4,2,6,A 90-year-old woman is among four people strafed with machine-gun fire by Abu Sayyaf.
17813,14/6/2012,Syria,Damascus,0,14,14,Fourteen people are injured when a suicide bomber detonates at a Shia shrine.
17814,14/6/2012,Pakistan,Idalakudi,1,0,1,A 24-year-old non-Muslim is beaten to death with iron bars for marrying a Muslim girl.
17815,15/6/2012,USA,"Mission, TX",0,3,3,"A man shoots his daughter, her boyfriend and her mother for letting the girl date a non-Muslim."
17816,15/6/2012,Algeria,Ouacifs,2,5,7,A young girl is among the casualties when Islamic terrorists attack a police barracks.
17817,15/6/2012,Afghanistan,Chinarto,3,1,4,Religious extremists detonate a bomb that leaves three people dead.
17818,15/6/2012,Afghanistan,Maroof,1,10,11,"Terrorists detonate a bomb at a marketplace, killing a patron."
17819,15/6/2012,India,Srinagar,1,0,1,Suspected Lashker-e-Toiba militants assassinate a local politician.
17820,15/6/2012,Iraq,Mahmudiyah,6,0,6,Children and their parents are exterminated in their own home by 'insurgent' gunmen.
17821,15/6/2012,Iraq,Saadiyah,2,0,2,A husband and wife are murdered in their bedroom by Mujahideen.
17822,15/6/2012,Pakistan,Bara,2,0,2,Two children lose their lives to a landmine left by Islamic militants.
17823,15/6/2012,Pakistan,Karachi,1,0,1,A Shiite dies in the hospital after being shot by Sunni terrorists.
17824,16/6/2012,Thailand,Yala,3,6,9,Muslim terrorists ambush and kill three local soldiers.
17825,16/6/2012,Pakistan,Landi Kotal,26,65,91,"Sharia advocates detonate a truck bomb amid a crowd at a market, sending over twenty-six souls to Allah."
17826,16/6/2012,Iraq,Baghdad,18,36,54,A Mujahideen bomb targeting rescue personnel assisting survivors of an earlier blast ends the lives of at least eighteen more innocents.
17827,16/6/2012,Iraq,Baghdad,14,32,46,A bomb targeting Shiite pilgrims leaves fourteen dead.
17828,16/6/2012,Pakistan,Kohat,6,5,11,Sunni bombers send six souls to Allah.
17829,16/6/2012,Pakistan,Quetta,2,19,21,Two children are killed during a rampage by a mob angered over an alleged Quran desecration by a mentally ill man.
17830,16/6/2012,Somalia,Afgoye,2,3,5,A Shahid suicide bomber takes out two Somalis.
17831,17/6/2012,Iraq,al-Sharqat,2,26,28,"Terrorists set off a car bomb amid a line of cars waiting for fuel, killing two Iraqis."
17832,17/6/2012,Iraq,Fallujah,6,12,18,Two children are among six slain by Jihadi bombers.
17833,17/6/2012,Nigeria,Zaria,34,125,159,"Holy Warriors walk into two church services and detonate, leaving over thirty worshipers dead in the carnage, including at least ten children."
17834,17/6/2012,Iraq,Mosul,4,2,6,Four local police are torn to shreds by Mujahid bombers.
17835,17/6/2012,Nigeria,Trikania,5,40,45,A Shahid suicide car bomber crashes through a church gate and blows up at least five Christians.
17836,17/6/2012,Afghanistan,Kandahar,1,0,1,A NATO soldier is shot in the back by three Taliban in police uniform.
17837,18/6/2012,Iraq,Baqubah,22,50,72,"A Sunni detonates himself inside a tent packed with Shia funeral mourners, killing at least twenty-two."
17838,18/6/2012,Yemen,Aden,3,0,3,Three die from injuries after an al-Qaeda suicide bomber throws himself into a car.
17839,18/6/2012,Afghanistan,Tagab,6,13,19,At least six locals are exterminated when religious extremists detonate a bomb at a bazaar.
17840,18/6/2012,Israel,Sinai Border,1,3,4,An Israeli construction worker is shot to death by infiltrating terrorists.
17841,18/6/2012,Pakistan,Quetta,6,69,75,Six Shiite students are blown to bits by Taliban bombers.
17842,18/6/2012,Iraq,Ramadi,4,6,10,The lives of four civilians at a coffee shop are snuffed out by Jihadi bombers.
17843,18/6/2012,Afghanistan,Musa Qala,8,5,13,Women and children are torn to shreds by a roadside bomb planted by Islamic hardliners.
17844,18/6/2012,Somalia,Mogadishu,1,3,4,Children are egregiously injured by a bomb planted by suspected al-Shabaab.
17845,18/6/2012,Saudi Arabia,Najran,1,0,1,A man is beheaded on charges of sorcery.
17846,19/6/2012,Thailand,Narathiwat,1,2,3,A Muslim 'insurgent' bomb leaves a local cop dead.
17847,19/6/2012,Myanmar,Yathedaung,3,0,3,Muslims attack and kill three Buddhist villagers.
17848,19/6/2012,Iraq,Mosul,4,0,4,Four policemen guarding a school are executed in cold blood by 'insurgents'.
17849,19/6/2012,Afghanistan,Kandahar,3,7,10,Three local police are gunned down by Taliban fundamentalists.
17850,19/6/2012,India,Handwara,1,0,1,Islamic terrorists shoot a local soldier to death.
17851,19/6/2012,Iraq,Ayadiya,5,3,8,A woman is among five Iraqis exterminated by Mujahideen bombers.
17852,19/6/2012,Pakistan,Sargodha,3,0,3,Three women are murdered by family members in the name of 'honor'.
17853,19/6/2012,Nigeria,Damaturu,40,9,49,At least forty people lose their lives to coordinated attacks by Boko Haram Islamists.
17854,20/6/2012,Pakistan,Karachi,1,0,1,A Shiite prayer leader is shot to death by Sunni rivals.
17855,20/6/2012,Afghanistan,Logar,8,4,12,Four children and two women are among eight innocents torn apart by a Religion of Peace bomb.
17856,20/6/2012,Afghanistan,Khost,21,32,53,Mostly civilians are victimized by a Fedayeen suicide blast that leaves at least twenty-one dead.
17857,20/6/2012,Iraq,Kirkuk,3,9,12,A powerful 'insurgent' bomb leaves at least three Iraqis dead.
17858,21/6/2012,Syria,Damascus,1,1,2,A Shiite cleric is gunned down by sectarian rivals.
17859,21/6/2012,Pakistan,Pakhtunkhwa,3,21,24,Two very young children are among the dead when Islamists bomb a Sufi shrine.
17860,21/6/2012,Afghanistan,Qargha Lake,20,50,70,At least twenty people are massacred by fundamentalists at a hotel serving alcohol.
17861,21/6/2012,Pakistan,Karachi,1,0,1,A spiritualist is shot to death in a suspected targeted attack over his faith.
17862,21/6/2012,Pakistan,Quetta,2,17,19,"Religion of Peace rivals bomb a mosque, killing two worshippers."
17863,22/6/2012,France,Rennes,1,0,1,A 16-year-old is violently killed by a Muslim classmate in what is regarded as a 'racist' attack.  Other Muslims have shown solidarity with the killer.
17864,22/6/2012,Pakistan,Khra Shah,2,2,4,Terrorists kill two people with a landmine
17865,22/6/2012,Pakistan,Laddah,7,0,7,Fundamentalists capture and behead seven local soldiers.
17866,22/6/2012,Iraq,Samarrah,1,10,11,A Sunni suicide bomber takes out a Shiite pilgrim.
17867,22/6/2012,Iraq,Baghdad,14,106,120,"'Insurgents' set off a nail bomb at a crowded market, killing at least a dozen innocents and leaving over a hundred more injured."
17868,22/6/2012,Pakistan,Karachi,2,0,2,Two seminary teachers are assassinated by Religion of Peace rivals.
17869,22/6/2012,Pakistan,Liaqatabad,1,0,1,A Shiite walking near a market is exterminated by Sunni gunmen.
17870,22/6/2012,Iraq,Baghdad,3,0,3,Three young police officers are machine-gunned at point-blank range by Islamic terrorists.
17871,22/6/2012,Afghanistan,Noghi,2,0,2,A father and son are kidnapped by Taliban in uniforms and executed in captivity.
17872,23/6/2012,Pakistan,Quetta,8,1,9,Islamic militants are suspected in the target killing of eight men at a laundry mat.
17873,23/6/2012,Thailand,Yala,1,0,1,A 42-year-old is shot off of his motorcycle by Jihadi gunmen.
17874,23/6/2012,Yemen,Zinjibar,35,12,47,Thirty-five people are killed in a series of al-Qaeda landmine blasts.
17875,24/6/2012,Pakistan,Karachi,2,0,2,Two sisters are poisoned by their brothers on suspicion of sexual activity.
17876,24/6/2012,Nigeria,Bauchi,0,9,9,A 3-month-old baby is among the casualties of a Boko Haram blast at a beer garden.
17877,24/6/2012,Pakistan,Quetta,4,0,4,Islamists are suspected of shooting four local police officers in a drive-by attack.
17878,24/6/2012,Kenya,Mombasa,3,3,6,At least one person is killed when religious extremists throw a hand-grenade into a bar showing a soccer game.
17879,24/6/2012,Pakistan,Upper Dir,13,5,18,Muslim hardliners murder six border guards.  Seven others are captured and beheaded.
17880,24/6/2012,Afghanistan,Jalalabad,2,2,4,"Fundamentalists bomb a market selling music, killing two participants."
17881,24/6/2012,Pakistan,Shareefabad,1,0,1,Sipah-e-Sahab cadres shoot a 46-year-old Shiite to death.
17882,24/6/2012,Pakistan,Lahore,1,0,1,A 40-year-old Shiite is murdered by members of Lashkar-e-Jhangvi.
17883,24/6/2012,Egypt,Alexandria,1,0,1,A pregnant woman is beaten to death by her husband for not voting Muslim Brotherhood.
17884,25/6/2012,Somalia,Mogadishu,0,3,3,Three Christian converts are shot inside their home by Islamic fundamentalists.
17885,25/6/2012,Pakistan,Karachi,1,0,1,Sipah-Sahaba snipers pick off a Shiite with a shot to the head.
17886,25/6/2012,Dagestan,Shauri,1,0,1,A local cop is shot in the head by Muslim 'separatists'.
17887,25/6/2012,Thailand,Pattani,3,0,3,A 17-year-old is among three innocent victims pulled out of a car and machine-gunned in cold blood by Islamic 'separatists'.
17888,25/6/2012,Iraq,Hillah,9,32,41,"'Insurgents' set off a bomb near a soccer field, killing nine young Shiites.."
17889,25/6/2012,Iraq,Baqubah,2,3,5,Two people lose their lives to a terrorist bomb.
17890,26/6/2012,Iraq,Ramadi,1,1,2,Terrorists kill a doctor and seriously injure his daughter.
17891,26/6/2012,Thailand,Yala,1,14,15,A separate shooting and bombing by militant Muslims leaves one dead and fourteen injured.
17892,26/6/2012,Dagestan,Makhachkala,1,0,1,A Islamist drive-by leaves one cop dead.
17893,26/6/2012,Nigeria,Kano,1,0,1,Islamic extremists shoot a prison guard to death.
17894,27/6/2012,Afghanistan,Ghoryan,6,2,8,Six Afghan police are killed in an ambush and roadside bombing.
17895,27/6/2012,Afghanistan,Musa Qala,4,0,4,Four policemen investigating an earlier bombing are sent to Allah by Taliban bombers.
17896,27/6/2012,Yemen,Jaar,39,24,63,An additional thirty-nine people are reported dead from al-Qaeda landmines.
17897,27/6/2012,Iraq,Baghdad,3,2,5,"'Insurgents' blow up a family home, killing three women."
17898,27/6/2012,Iraq,Madain,8,10,18,A vicious double bomb attack kills eight Iraqis.
17899,27/6/2012,Syria,Damascus,7,11,18,Seven employees at a television station are butchered by Sunni terrorists.
17900,27/6/2012,Pakistan,Bazidkhel,4,0,4,Four people are kidnapped and brutally executed by Islamic militants.
17901,27/6/2012,Iraq,al-Wahda,3,0,3,Two children are among three people slain when terrorists bomb a house through the air conditioning system.
17902,27/6/2012,Pakistan,Dera Ismail Khan,1,0,1,A woman is murdered by her family for marrying by choice.
17903,28/6/2012,Somalia,Baidoa,3,3,6,At least three people are killed during an al-Shabaab ambush.
17904,28/6/2012,Pakistan,Ziauddin,2,0,2,Islamists dismember two guards and blow up a primary school.
17905,28/6/2012,Nigeria,Gulak,5,3,8,Five policemen are ambushed and killed by Boko Haram.
17906,28/6/2012,Dagestan,Karamakhi,2,0,2,Islamists shoot an anti-extremist imam and one other to death in his mosque.
17907,28/6/2012,Pakistan,Bara,8,3,11,Taliban militants murder eight local soldiers with a remote-controlled bomb.
17908,28/6/2012,Pakistan,Quetta,18,30,48,A Fedayeen attack on a bus carrying Shia pilgrims leaves at least eighteen dead.
17909,28/6/2012,Iraq,Fallujah,2,4,6,A Holy Warrior sends to security guards to Allah.
17910,28/6/2012,Mali,Gao,17,41,58,"The Movement for Oneness and Jihad assaults a small town, killing at least seventeen defenders."
17911,28/6/2012,Iraq,Baghdad,8,30,38,Islamic bombers successfully kill eight patrons at a marketplace.
17912,28/6/2012,Iraq,Taji,4,20,24,Twin sectarian car-bombings leave four Iraqis dead.
17913,28/6/2012,Iraq,Samarrah,2,0,2,Two Iraqis are gunned down at close range by al-Qaeda.
17914,28/6/2012,Iraq,Baqubah,6,51,57,Sectarian Jihadis set off a bomb near shops and cafes frequented by Shiites.  At least six are killed.
17915,28/6/2012,Syria,Homs,6,0,6,"A university professor is shot to death in her home along with five family members, including three children."
17916,29/6/2012,Iraq,Balad,7,50,57,Jihadis take down seven patrons with two market bombs.
17917,29/6/2012,Iraq,Baqubah,4,4,8,Four Iraqis are shot to death at a checkpoint by al-Qaeda.
17918,29/6/2012,Kenya,Dabaab,1,4,5,Islamists shoot a driver and kidnap four humanitarian workers.
17919,29/6/2012,Thailand,Pattani,2,0,2,Two village guards are machine-gunned by Muslim terrorists.
17920,29/6/2012,Algeria,Ouargla,1,3,4,A suicide car bomber manages to take out one other person.
17921,29/6/2012,Afghanistan,Kamdesh,10,16,26,Four women are among ten innocents slain by a Shahid suicide attack.
17922,29/6/2012,Pakistan,Karachi,1,0,1,Sipah-e-Sahaba shoot a young Shia man to death at a bus stop.
17923,29/6/2012,Egypt,El Sharqiya,2,0,2,Two Christians are reported murdered by Muslim Brotherhood activists.
17924,30/6/2012,Syria,Zamalka,85,0,85,"Shia militia are strongly suspected of bombing a funeral in a Sunni town, killing eighty-five."
17925,30/6/2012,Afghanistan,Qimchok,1,0,1,Fundamentalists pump five rounds into an accused adulteress's chest before a crowd cheering 'long live Islam.'
17926,30/6/2012,Thailand,Yala,1,0,1,A 60-year-old man is murdered in front of his home by suspected Muslim 'separatists'.
17927,30/6/2012,Iraq,Abu Ghraib,1,2,3,A woman and child are among the casualties of a terrorist bomb attack on their home.
17928,30/6/2012,Iraq,Mosul,4,5,9,Four Iraqis are sent to Allah by Mujahideen bombers.
17929,30/6/2012,Yemen,Zinjibar,8,0,8,al-Qaeda landmines take down eight more civilians.
17930,30/6/2012,Iraq,Baaj,2,0,2,Terrorists gun down two civilians.
17931,30/6/2012,Iraq,Samarra,7,3,10,A Shahid suicide bomber take down seven Iraqis.
17932,30/6/2012,Afghanistan,Paktia,2,0,2,A Taliban bomb kills two people outside a bank.
17933,1/7/2012,Afghanistan,Helmand,3,0,3,A Taliban disguised in police uniform murders three British soldiers.
17934,1/7/2012,Iraq,Baghdad,3,4,7,Terrorists kill three people including a judge.
17935,1/7/2012,Pakistan,Faisalabad,0,1,1,A man is beaten and 'severely tortured' by a mob for 'defaming' prophet Muhammad with remarks.
17936,1/7/2012,Kenya,Garissa,18,66,84,"Muslims throw grenades into two churches and then shoot fleeing Christians.  Some eighteen die in the massacre, including three children.."
17937,1/7/2012,Afghanistan,Ghazni,5,11,16,Five women and children are ripped apart when the Taliban bomb their bus.
17938,1/7/2012,Dagestan,Khasavyurt,1,0,1,An off-duty cop is gunned down in a Muslim drive-by.
17939,1/7/2012,Nigeria,Maiduguri,9,0,9,Nine Christian construction workers have their throats cut by Islamists in a 'gruesome' killing.
17940,2/7/2012,Pakistan,Lalu Ali,2,0,2,Sipah-e-Sahaba cadres capture and behead two brothers for being Shia.
17941,2/7/2012,Yemen,Sanaa,1,0,1,A Yemeni is killed by a suspected al-Qaeda car bomb.
17942,2/7/2012,Iraq,Baghdad,1,8,9,Jihadi bombers take out a traffic cop.
17943,2/7/2012,Afghanistan,Kandahar,7,23,30,"A Shahid suicide bomber detonates near the entrance of a university, killing seven students and staff."
17944,2/7/2012,Egypt,Suez,1,0,1,A 20-year-old engineering student is stabbed to death by religious police for walking with his girlfriend.
17945,3/7/2012,Thailand,Yala,1,0,1,A 49-year-old Buddhist is dismantled by Muslim bombers while on his way home.
17946,3/7/2012,Pakistan,Bara Kamangra,1,4,5,Islamic militants kill one person with a remote-controlled bomb.
17947,3/7/2012,Iraq,Taji,3,15,18,Muslim bombers kill three Iraqis.
17948,3/7/2012,India,Pulwama,2,0,2,Muslim terrorists shoot an off-duty policeman and a traffic cop to death at close range.
17949,3/7/2012,Iraq,Diwaniya,40,75,115,"Sunnis set off a powerful bomb near a Shiite mosque, taking down at least forty Religion of Peace rivals."
17950,3/7/2012,Iraq,Karbalah,8,54,62,Eight Shiite worshippers are sent straight to Allah by Sunni bombers at a vegetable market.
17951,4/7/2012,Nigeria,Borno,2,0,2,Two employees at a housing complex are chased down and murdered by Boko Haram radicals.
17952,4/7/2012,Iraq,Mosul,3,1,4,A woman is among three Iraqis taken down by Mujahideen bombers.
17953,4/7/2012,Pakistan,Jamrud,1,0,1,A young women's rights activist is gunned down in a targeted attack.
17954,4/7/2012,Afghanistan,Ghazni,3,0,3,An honor killer beheads his ex-wife and two children.
17955,4/7/2012,Pakistan,Kuchlak,3,0,3,Lashkar-e-Jhangvi gunmen murder three Religion of Peace rivals.
17956,4/7/2012,Kenya,Mandera,1,0,1,Somali militants shoot a 16-year-old girl several times in the chest.
17957,4/7/2012,Iraq,Baghdad,3,0,3,Terrorists assassinate three people in separate attacks.
17958,4/7/2012,Iraq,Zubaidiyah,8,37,45,One child and two women are among eight dead when Sunnis detonate a bomb at a Shiite market.
17959,4/7/2012,Pakistan,Pasrur,2,3,5,A pregnant woman and her baby are shot to death by Wahhabis because they were Shia.
17960,4/7/2012,Pakistan,Bahawalpur,1,0,1,"A mentally-ill man is tortured, doused with petrol and burned alive by a mob angered over reports that he burned a Quran."
17961,4/7/2012,Afghanistan,Marjeh,1,3,4,A woman is taken out by a Taliban roadside bomb.
17962,5/7/2012,Iraq,Baqubah,1,2,3,An al-Qaeda bomb leaves one person dead.
17963,5/7/2012,Iraq,Mosul,5,20,25,"A Shahid suicide bomber detonates inside a barber shop, sending at least five others to Allah."
17964,5/7/2012,Nigeria,Maiduguri,2,0,2,Sharia advocates slit the throats of two people.
17965,6/7/2012,South Africa,Philippi,14,0,14,al-Shabaab is suspected in the serial killings of fourteen Christians.
17966,6/7/2012,Egypt,Giza,0,4,4,Fundamentalists enter a pool hall and shoot four people after telling them to stop playing and start praying.
17967,6/7/2012,Pakistan,Sariab,1,0,1,A religious scholar is assassinated by devout rivals.
17968,6/7/2012,Iraq,Hit,3,6,9,Terrorists kill three policemen outside a mosque.
17969,6/7/2012,Iraq,Anbar,5,9,14,"An entire family of four, including two children, bleed to death following a suicide attack on their home."
17970,7/7/2012,Nigeria,Kushen,80,300,380,"Muslim terrorists attack twelve Christian villages and massacre eighty innocents, including fifty taking refuge in a church."
17971,7/7/2012,India,Pampore,1,1,2,Islamic militants gun down a local security officer.
17972,7/7/2012,Afghanistan,Chora,6,1,7,Three children are among six civilians blown to bits by Sunni hardliners.
17973,7/7/2012,Afghanistan,Farah,1,26,27,A Taliban rocket attack on a residence leaves one dead.
17974,7/7/2012,Afghanistan,Gereshk,1,1,2,A child is dismantled by a Taliban bomb.
17975,7/7/2012,Iraq,Ramadi,10,38,48,"A suicide bomber detonates in the house of a family member, killing ten relatives, most of whom were women."
17976,7/7/2012,Thailand,Narathiwat,1,3,4,Muslim 'separatists' set off a bomb that kills a local soldier and leaves three others badly wounded.
17977,7/7/2012,Kosovo,Pristina,2,0,2,A middle-aged Christian couple is found shot to death in their home in what is presumed to be a targeted attack by members of the Muslim majority.
17978,7/7/2012,Somalia,Shabelle,4,3,7,"al-Shabaab militants open fire on a passenger bus, killing at least four."
17979,7/7/2012,Pakistan,Sharifabad,1,0,1,A 55-year-odl Shiite is brought down by Sunni snipers.
17980,7/7/2012,Pakistan,Karachi,2,1,3,Two brothers are murdered by sectarian Jihadis.
17981,7/7/2012,Pakistan,Peshawar,1,3,4,A policeman bleeds to death from shrapnel injuries following a Religion of Peace bombing.
17982,7/7/2012,Pakistan,Buggan,1,0,1,Sunni hardliners assassinate a pro-government tribal leader.
17983,7/7/2012,Pakistan,Tiyarza,4,3,7,Four local police officers are blown to bits by Islamic militia.
17984,8/7/2012,Afghanistan,Musa Qala,5,0,5,Sunni fundamentalists massacre five local cops with a roadside bomb.
17985,8/7/2012,Afghanistan,Arghistan,18,30,48,"Eighteen civilians, including women and children, are torn to shreds by Taliban bombers."
17986,8/7/2012,Nigeria,Barkin-Ladi,23,1,24,"Two politicians are among twenty-three Christians, including women and children, slaughtered by Muslims during a funeral for other victims of Islamic terror."
17987,8/7/2012,Pakistan,Kot Ghulam,1,0,1,A Christian laborer is pulled out of his truck and shot point-blank by a Muslim.
17988,9/7/2012,India,Gaziabad,1,0,1,A Hindu man is the victim of a targeted killing by Muslims.
17989,9/7/2012,Iraq,Mosul,7,7,14,Seven Iraqis are murdered by Islamic 'insurgents'.
17990,9/7/2012,Iraq,Samarrah,2,0,2,Two Iraqis are shot to death by al-Qaeda.
17991,9/7/2012,Afghanistan,Kandahar,5,30,35,Two children are among five people pulled into pieces by three Shahid suicide bombers.
17992,9/7/2012,Pakistan,Gujrat,8,4,12,"Hardline Islamists open fire on a group of security personnel, killing eight."
17993,9/7/2012,Saudi Arabia,Awamiya,2,1,3,"Sunni cops are accused of firing randomly at Shiites, killing two."
17994,10/7/2012,Iraq,Baghdad,3,14,17,"Sunnis bomb a bus carrying Shiites, killing three and injuring fourteen."
17995,10/7/2012,Pakistan,Shamsabad,1,0,1,A teacher is shot dead on the way to work on the same day that Taliban militants blow up two schools.
17996,10/7/2012,Iraq,Ramadi,4,4,8,A shocking attack and brutal by Mujahideen on a police checkpoint leaves four officers dead.
17997,10/7/2012,Philippines,Sumisip,0,8,8,An Abu Sayyaf bomb injures eight local soldiers.
17998,11/7/2012,Yemen,Sanaa,22,24,46,"An al-Qaeda suicide bomber targets a police academy, slaughtering about two dozen young aspirants."
17999,11/7/2012,Philippines,Tumahubong,6,27,33,Six rubber plantation workers are shredded by Abu Sayyaf bombers while on their way to work.
18000,11/7/2012,Afghanistan,Zhari,4,2,6,Taliban infiltrators shoot four local cops to death in their sleep.
18001,11/7/2012,Pakistan,Karachi,1,23,24,One person is killed when terrorists attempt to blow up a bus carrying space agency employees.
18002,11/7/2012,Pakistan,Mian Gundi,2,0,2,A prayer leader is among two Shiites kidnapped and beheaded by Lashkar-e-Jhangvi Sunnis.
18003,11/7/2012,Pakistan,Karachi,2,0,2,A man and his 2-year-old son are gunned down by sectarian Jihadis.
18004,11/7/2012,Syria,Aleppo,17,0,17,Seventeen Palestinians are kidnapped and murdered by Sunni terrorists.
18005,12/7/2012,Wales,Cardiff,1,0,1,A 7-year-old boy is beaten to death by his mother for failing to memorize the Quran.
18006,12/7/2012,Pakistan,Quetta,1,0,1,A Shiite boy is shot to death by Wahhabis.
18007,12/7/2012,Pakistan,Lahore,10,8,18,Tehreek-e-Taliban fundamentalists enter a barracks and shoot ten sleeping policemen to death.
18008,12/7/2012,Thailand,Yala,1,0,1,A 40-year-old man is shot six times in the torso by Islamic 'separatists'.
18009,12/7/2012,Pakistan,Jaffarabad,1,0,1,A Hindu is shot to death by drive-by Jihadis.
18010,12/7/2012,Iraq,Mosul,5,3,8,Terrorists take down five Iraqis.
18011,13/7/2012,India,Baghpat,0,2,2,Two policemen are beaten by an enraged mob of Muslims after arresting two clerics.
18012,13/7/2012,Afghanistan,Laghman,1,2,3,A women's ministry official bleeds out following a Taliban bombing of her family vehicle.
18013,13/7/2012,Pakistan,Karachi,1,0,1,A Shiite father of three is murdered by Sipah-e-Sahaba gunmen.
18014,13/7/2012,Pakistan,Quetta,7,22,29,"Islamic 'extremists' are suspected in a blast at a rally that leaves seven dead, including a 7-year-old girl."
18015,13/7/2012,Iraq,Baghdad,1,1,2,A woman is killed in her own home by Islamic 'insurgents'.
18016,13/7/2012,Indonesia,Bogor,0,4,4,A Sunni mob attacks Ahmadi minorities with knives and machetes.
18017,13/7/2012,Nigeria,Maiduguri,5,6,11,A Boko Haram suicide bomber murders five bystanders outside a mosque.
18018,14/7/2012,Pakistan,Haripur,1,0,1,A 21-year-old mother is beaten to death by her conservative brother on suspicion of an affair.
18019,14/7/2012,Pakistan,Karachi,1,0,1,"Lashkar Jhangvi kidnap, torture and murder a 16-year-old Shiite."
18020,14/7/2012,Somalia,Mogadishu,1,3,4,Militant Islamists kill a civilian with a roadside bomb.
18021,14/7/2012,Thailand,Pattani,1,0,1,A 41-year-old man is gunned down in a Muslim drive-by.
18022,14/7/2012,Syria,Muhrada,4,0,4,Two woman and a child are among four people torn to shreds by a Shahid suicide bomber.
18023,14/7/2012,Afghanistan,Aybak,23,60,83,"A Fedayeen suicide bomber detonates at a packed wedding, sending nearly two dozen souls to Allah."
18024,14/7/2012,Dagestan,Makhachkala,2,0,2,Two local cops are gunned down by suspected Islamists.
18025,14/7/2012,Pakistan,Baddar,3,5,8,Tehreek-e-Taliban militants murder three people.
18026,14/7/2012,Iraq,Mosul,4,0,4,Two civilians are among four Iraqis shot to death at a checkpoint by Mujahideen.
18027,14/7/2012,Iraq,Rashidiyah,5,2,7,Sunni militants machine-gun five local cops at point-blank range.
18028,15/7/2012,Pakistan,Sheehan,4,1,5,Three children between the ages of 2 and 9 are torn apart in their home by shrapnel from a Lashkar e-Islam mortar shell.
18029,15/7/2012,Iraq,Diyala,3,10,13,A 3-year-old girl is among three Iraqis taken down by Mujahideen attacks.
18030,15/7/2012,Syria,Damascus,2,0,2,"The al-Nusra terror group claims two killings, one of which was of a barber."
18031,15/7/2012,India,Kerala,1,0,1,A Hindu activist is attacked and murdered by Muslim radicals.
18032,15/7/2012,Pakistan,Mian Kalay Jandol,1,0,1,"A dozen Islamists assault a police post, killing the lone defender."
18033,16/7/2012,Pakistan,Sultanabad,1,0,1,A prayer leader is shot to death by rivals.
18034,16/7/2012,Kenya,Lagdera,1,1,2,A local cop dies during an al-Shabaab ambush.
18035,16/7/2012,Iraq,Mosul,2,0,2,'Insurgents' kill two local cops with a bomb.
18036,16/7/2012,Afghanistan,Spin Boldak,3,0,3,Three civilians are taken down by Taliban bombers.
18037,16/7/2012,Afghanistan,Khan Abad,1,8,9,An innocent person is killed when Islamic extremists blow up a car.
18038,16/7/2012,Yemen,Taez,4,4,8,A 5-year-old girl and her father are among four people gunned down in a brutal attack.
18039,16/7/2012,Somalia,Mogadishu,7,5,12,Proponents of Sharia detonate a bomb under a car that decapitates the driver and leaves six others dead.
18040,16/7/2012,Pakistan,Bannu,3,3,6,Taliban in burqas shoot three guards to death at a police station.
18041,17/7/2012,Pakistan,Karachi,0,2,2,The Taliban are suspected of firing on a polio vaccination team trying to treat children.
18042,17/7/2012,Thailand,Narathiwat,3,5,8,"Islamic militants open up on a group of local soldiers, killing a bystander as well."
18043,17/7/2012,Nigeria,Jos,1,0,1,A 10-year-old boy dies from splinter injuries from a Boko Haram RPG attack on his home.
18044,17/7/2012,Afghanistan,Washer,9,7,16,Sunni radicals stage an ambush that leaves nine Afghans dead.
18045,18/7/2012,Pakistan,Spai,14,0,14,"Eight members of one family, including women and young children, are disassembled along with six others by a bus bomb attack on Shia pilgrims deemed 'enemies of Islam.'"
18046,18/7/2012,Somalia,Damascus,2,2,4,A suicide bomber kills two officials.
18047,18/7/2012,Iraq,Mosul,11,3,14,A woman and her son sitting in their house are among eleven people murdered by terrorists.
18048,18/7/2012,India,Kerala,1,2,3,"Campus Islamists stab three Hindu students, one of whom bleeds to death."
18049,18/7/2012,Bulgaria,Burgas,7,30,37,"A Shahid suicide bomber detonates on a bus carrying Israeli tourists, killing seven and injuring dozens more."
18050,18/7/2012,Pal. Auth.,al-Shati,1,0,1,A 17-year-old girl is strangled by her father and brother over a moral issue.
18051,18/7/2012,Lebanon,Tripoli,1,8,9,"Sunni snipers fire into an Alawite neighborhood, taking out a child."
18052,18/7/2012,Pakistan,Jahanian,2,0,2,Two teen lovers are tortured and shot for having eloped without the permission of the girl's conservative family.
18053,19/7/2012,Pakistan,Bajaur,3,0,3,"Three people are kidnapped, tortured and executed by Islamic radicals."
18054,19/7/2012,Yemen,Bayda,1,0,1,A security officer is picked off by two al-Qaeda gunmen.
18055,19/7/2012,Pakistan,Karachi,1,0,1,Sipah-e-Sahab terrorists gun down a 50-year-old Shiite.
18056,19/7/2012,Pakistan,Karachi,1,0,1,A 52-year-old leader of the Ahmadi minority is shot in the head by defenders of mainstream Islam.
18057,19/7/2012,Nigeria,Maiduguri,2,0,2,Two traders at a market are murdered in cold blood by Boko Haram gunmen.
18058,19/7/2012,Thailand,Yala,1,3,4,Two bombings by Islamic 'separatists' leave one person dead.
18059,19/7/2012,Thailand,Pattani,1,0,1,Muslim terrorists shoot a 25-year-old man to death.
18060,19/7/2012,Russia,Kazan,1,1,2,Two advocates of peaceful Islam are targeted by radicals. One is shot to death and the other injured in a car bomb.
18061,19/7/2012,Egypt,Sheikh Zweid,2,0,2,Bearded Islamists in robes machine-gun two local soldiers along a city street at point blank range.
18062,19/7/2012,Afghanistan,Faryab,8,6,14,A woman and child are among eight civilians ripped to pieces by a Taliban bomb.
18063,19/7/2012,Yemen,Aden,1,0,1,A local official is killed by an Ansar al-Sharia car bomb.
18064,19/7/2012,Thailand,Pattani,1,0,1,Muslim 'separatists' pursue 43-year-old man and shoot him.
18065,20/7/2012,India,Jayapur,4,0,4,Four Hindu youth are hacked to death by a Muslim mob.
18066,20/7/2012,India,Kupwara,1,0,1,Muslim terrorists murder a local soldier.
18067,20/7/2012,Pakistan,Shalozan,1,1,2,"Islamic militants fire a rocket into a populated area, killing a 16-year-old girl and injuring her brother."
18068,20/7/2012,Iraq,Kadhimiya,2,0,2,Two brothers are shot to death by 'insurgents'.
18069,20/7/2012,Afghanistan,Sarab,5,0,5,All five Afghans riding in a car are blown to bits by fundamentalist bombers.
18070,20/7/2012,Pakistan,Shahdara,1,0,1,A young woman is beaten and then shot by her brothers for not heeding their warning about wearing pants.
18071,21/7/2012,Tajikistan,Khorog,1,0,1,A government official is stabbed to death by an Islamic radical.
18072,21/7/2012,Ingushetia,Magas,2,3,5,Two security personnel die in a grenade and small arms ambush on their vehicle.
18073,21/7/2012,Pakistan,Spin Thall,12,8,20,Eight young children are among a dozen people disassembled by a Fedayeen suicide bomber.
18074,21/7/2012,Pakistan,Dhog Darra,3,0,3,Taliban bombers take down three civilians in a pick-up truck.
18075,21/7/2012,Pakistan,Gadap,1,0,1,A medical worker is assassinated by the Taliban for assisting an anti-polio drive.
18076,21/7/2012,Pakistan,Dir Bala,4,7,11,"Fundamentalists bomb a peace committee bus, killing four riders."
18077,22/7/2012,Somalia,Lower Shabelle,3,0,3,Three 'spies' are executed by al-Shabaab.
18078,22/7/2012,Philippines,Tumahubong,0,4,4,There are four casualties when suspected Abu Sayyaf gunmen ambush a group of priests.
18079,22/7/2012,Afghanistan,Helmand,2,0,2,A father shoots his two daughters to death for leaving home with a man.
18080,22/7/2012,Afghanistan,Kabul,3,2,5,"A terrorist disguised in uniform turns his weapon on civilian workers, killing three."
18081,22/7/2012,Afghanistan,Jalrez,5,0,5,"Five civilians are captured by the Taliban, then bound and executed."
18082,22/7/2012,Saudi Arabia,Riyadh,1,0,1,Extremists assassinate a government official with a bomb.
18083,22/7/2012,Iraq,Najaf,4,28,32,"A busy trading street is the target of Mujahideen bomber, who kill four innocents."
18084,22/7/2012,Iraq,Madaen,15,60,75,Sunni bombers take out fifteen Shia shoppers at a packed market.
18085,22/7/2012,Iraq,Mahmudiya,11,38,49,Three Ramadan bombs leave eleven Iraqis dead.
18086,22/7/2012,Iraq,Baghdad,1,0,1,The bodyguard of a Shiite politician is gunned down by suspected Sunni shooters.
18087,22/7/2012,Iraq,Najaf,0,23,23,A Sunni attempt to car bomb a Shia shrine leaves two dozen injured.
18088,22/7/2012,Pakistan,Hyderabad,2,0,2,Two Christians are shot to death by Muslim radicals.
18089,22/7/2012,Syria,Damascus,4,0,4,"The 'Islamic Brigade' stops a car carrying a Christian family, force them out and then massacre them, including the two children."
18090,23/7/2012,Nigeria,Bulumkutu,3,0,3,Three men are assassinated by suspected Islamists in separate attacks.
18091,23/7/2012,Nigeria,Maiduguri,5,0,5,Five people lose their lives to Boko Haram gunmen.
18092,23/7/2012,Nigeria,Bauchi,1,10,11,"Sharia advocates set off a bomb near a local bar, killing a 6-year-old boy."
18093,23/7/2012,Iraq,Baghdad,17,96,113,An additional seventeen Iraqis are reported dead from small arms attacks and bombings claimed by the Islamic State of Iraq.
18094,23/7/2012,Iraq,Kirkuk,12,47,59,At least a dozen people are shot or blown up by a series of al-Qaeda attacks.
18095,23/7/2012,Iraq,Mosul,9,0,9,Holy Warriors take down nine locals in armed attacks.
18096,23/7/2012,Iraq,Sadr City,21,73,94,"Sunni bombers strike at the heart of a Shiite slum, slaughtering at least twenty-one with two car bombs."
18097,23/7/2012,Iraq,Taji,42,48,90,Forty-two people are killed in a series of al-Qaeda bombings outside a housing complex.
18098,23/7/2012,Iraq,Dhuluiya,16,4,20,Sixteen Iraqis are taken out by a Mujahideen grenade and shooting attack.
18099,23/7/2012,Iraq,Diwaniya,5,32,37,"al-Qaeda 'insurgents' car bomb a vegetable market, killing at least five patrons."
18100,23/7/2012,Iraq,Udhaim,13,23,36,Thirteen Iraqis are mowed down at point blank range by al-Qaeda gunmen.
18101,23/7/2012,Iraq,Baquban,3,7,10,Jihadis exterminate three Iraqis with a roadside bomb.
18102,23/7/2012,Iraq,Baghdad,6,24,30,Six Shiites are blown to bits by Sunni bombers while relaxing at a cafe.
18103,24/7/2012,Pakistan,Darra Adamkhel,0,7,7,A Taliban 'toy bomb' injures seven children.
18104,24/7/2012,Pakistan,Jamrud,1,1,2,"Islamic militants fire on a truck, killing the driver."
18105,24/7/2012,Iraq,Kirkuk,1,2,3,A 10-year-old girl is pulled into pieces by an 'insurgent' bomb.
18106,24/7/2012,Afghanistan,Parwan,3,0,3,Two Afghans and an American engineer are machine-gunned by Sunni fundamentalists.
18107,24/7/2012,Iraq,Tuz Khormato,6,0,6,al-Qaeda is suspected in the murder of six Kurdish intelligence officers.
18108,24/7/2012,Iraq,Baqubah,3,29,32,Three passersby are killed when terrorists blow up a parked bus.
18109,24/7/2012,Nigeria,Kano,2,0,2,A married couple are murdered by pro-Sharia gunmen.
18110,24/7/2012,Nigeria,Kano,1,0,1,A high-school teacher is shot to death by Boko Haram.
18111,24/7/2012,Nigeria,Gwamaja,1,0,1,A cleric is gunned down by Religion of Peace rivals.
18112,24/7/2012,Afghanistan,Ghor,7,0,7,Seven children are torn to shreds by a Taliban bomb.
18113,25/7/2012,Pakistan,Bara,1,0,1,"Islamists kidnap a 70-year-old man, slit his throat and then spray him with bullets."
18114,25/7/2012,Iraq,Diyala,4,12,16,Four local cops are killed by Muslim terrorists.
18115,25/7/2012,Nigeria,Borno,3,0,3,Three people are killed in an Islamist ambush.
18116,25/7/2012,Nigeria,Maiduguri,2,3,5,Sharia fanatics attack an Indian-owned business and murder the owners.
18117,25/7/2012,Jordan,Jerash,1,0,1,An honor killer stabs his sister and then runs over her several times with a truck after suspecting her of 'immoral behavior'.
18118,25/7/2012,Iraq,Ad-Dawr,5,4,9,Four children under the age of 10 are dismantled along with their mother by Religion of Peace bombers.
18119,25/7/2012,Thailand,Yala,5,1,6,Muslim 'separatists' kill five police officers with a bomb hidden in a car.
18120,25/7/2012,Pakistan,Gulbehar,1,0,1,A 14-year-old girl is murdered when Lashkar e Jhangvi gunmen attack a Shia ceremony.
18121,25/7/2012,Syria,Homs,9,0,9,News breaks of nine Alawite bus passengers are split off from the rest and decapitated by Sunnis.
18122,25/7/2012,Pakistan,Dabori,3,0,3,Three defenders are killed during a Taliban ambush of a local post.
18123,26/7/2012,Pakistan,Akka Khel,3,4,7,Three people outside a mosque are blown to bits by Religion of Peace rivals.
18124,26/7/2012,Egypt,Shubra el Khayma,0,1,1,A Christian doctor is brutally blinded by Salafist Muslims after asking them to stop firing weapons in celebration.
18125,26/7/2012,Philippines,Sumisip,5,22,27,"Abu Sayyaf terrorists attack a Christian farming village, killing at least five."
18126,26/7/2012,Thailand,Yala,2,0,2,Two villagers are machine-gunned by Islamic 'insurgents'.
18127,26/7/2012,Philippines,Sumisip,10,17,27,An Abu Sayyaf clash with local troops responding to a prior massacre leaves ten dead.
18128,26/7/2012,Nigeria,Bauchi,3,1,4,"Suspected Islamists ambush a group of policemen, killing three."
18129,26/7/2012,Thailand,Yala,1,0,1,Muslim militants shoot a local several times in the torso.
18130,26/7/2012,Pakistan,Khar,15,23,38,"Religion of Peace militants detonate a shrapnel bomb at a crowded market which kills fifteen people, including those dying later in the hospital."
18131,26/7/2012,Iraq,Hadid,11,0,11,Eleven security personnel are killed in an al-Qaeda ambush.
18132,27/7/2012,Pakistan,Quetta,1,0,1,Wahhabi terrorists torture a Shiite man with knives and then kill him.
18133,27/7/2012,Nigeria,Maiduguri,7,0,7,Suspected Boko Haram barge into four homes and murder seven residents.
18134,27/7/2012,Thailand,Pattani,1,1,2,"Militant Muslims fire on a young married couple, killing the 18-year-old woman."
18135,27/7/2012,Thailand,Pattani,1,0,1,A 66-year-old man is gunned down in a Muslim ambush.
18136,27/7/2012,Dagestan,Makhachkala,1,0,1,A police officer is shot to death in his car by Islamic militants.
18137,27/7/2012,Somalia,Baidoa,4,3,7,Four local soldiers are killed by an al-Shabaab bomb blast.
18138,27/7/2012,Dagestan,Makhachkala,3,0,3,Three people are killed when Islamic extremists set off a car bomb.
18139,27/7/2012,Pakistan,Mardan,6,0,6,Jihadists shoot six people to death in separate attacks.
18140,28/7/2012,Yemen,Sanaa,1,0,1,"al-Qaeda radicals hand a 12-year-old a packaged bomb, which is then detonated remotely, disassembling the child."
18141,28/7/2012,Thailand,Pattani,4,2,6,Four Thai soldiers are brutally shot to death at close range by Muslim terrorists.
18142,28/7/2012,Thailand,Pattani,2,0,2,A teenager is among two Buddhists murdered by Muslim 'separatists.'
18143,28/7/2012,India,Anantnag,2,4,6,Two tourists are killed when Muslim militants toss a hand grenade at a taxi.
18144,28/7/2012,Thailand,Yala,1,0,1,A Muslim 'separatist' assassinates a rival Muslim in a mosque.
18145,28/7/2012,Iraq,Samarrah,5,0,5,Mujahideen shoot five women to death in their own home.
18146,29/7/2012,Kenya,Mandera,1,0,1,Islamists gun down a driver for a telephone company.
18147,29/7/2012,Iraq,Muqdadiya,4,13,17,Jihadi bombers take down four civilians.
18148,29/7/2012,Iraq,Fallujah,7,9,16,Seven local cops are bombed or shot to death by Ramadan terrorists.
18149,29/7/2012,Nigeria,Kano,2,2,4,An air force officer is ambushed and killed by Muslim gunmen along with his aide.
18150,29/7/2012,Nigeria,Kano,2,0,2,Two Christians are gunned down outside their homes by Boko Haram Islamists.
18151,29/7/2012,Mali,Aguelhok,2,0,2,A married couple is buried up to their necks and stoned to death for adultery.
18152,29/7/2012,Thailand,Pattani,1,0,1,A 45-year-old man is shot three times in the head by Islamic terrorists.
18153,29/7/2012,Afghanistan,Chak,1,1,2,A man is killed and his young so injured in an ambush by Sunni fundamentalists.
18154,29/7/2012,Yemen,Radah,1,0,1,A 14-year-old boy is cut to pieces by an al-Qaeda bomb.
18155,29/7/2012,Pakistan,Mansehra,0,2,2,Fundamentalists bomb a CD shop selling music and a primary school for girls.
18156,30/7/2012,Pakistan,Mardan,4,0,4,Terrorists shoot four farm workers to death.
18157,30/7/2012,Kenya,Mandera,1,0,1,"al-Shabaab gunmen spray the car of a mobile phone dealer with bullets, killing the driver."
18158,30/7/2012,Afghanistan,Tarinkot,5,0,5,Five civilians at a mosque are sent straight to Allah by Religion of Peace bombers.
18159,30/7/2012,Nigeria,Sokoto,1,0,1,Three Boko Haram gunmen shoot a shoe-shine worker to death.
18160,30/7/2012,Nigeria,Sokoto,2,30,32,Fedayeen suicide car bombers take down a hairdresser and a cop.
18161,31/7/2012,Syria,Aleppo,40,0,40,Approximately forty 'loyalists' are beaten and executed to chants of 'Allah Akbar'.
18162,31/7/2012,Yemen,Jaar,2,3,5,"Ansar al-Sharia gunmen on motorcycles open fire on a police station, killing two."
18163,31/7/2012,Iraq,Baghdad,7,21,28,A car bombing outside a restaurant leaves seven dead.
18164,31/7/2012,Iraq,Saqlawiyah,2,2,4,Two family members are killed by an 'insurgent' roadside bomb.
18165,31/7/2012,Iraq,Baghdad,15,35,50,"Jihadis bomb a passport office, killing fifteen innocent people waiting in line."
18166,31/7/2012,Somalia,Mogadishu,1,9,10,An Islamist bomb outside a soft drink factory leaves one dead.
18167,31/7/2012,Iraq,Mosul,1,3,4,"A man is killed, and his baby, mother and wife injured in their own home by Muslim terrorists."
18168,31/7/2012,Pakistan,Karachi,0,11,11,Eleven nurses fall ill after hospital food is poisoned to punish Ramadan eaters.
18169,31/7/2012,Thailand,Pattani,2,4,6,"Islamic militants fire into a tea shop, killing two patrons."
18170,1/8/2012,Pakistan,Lagharai Thal,1,0,1,Religious radicals gun down a school teacher.
18171,1/8/2012,Pakistan,Lahore,0,23,23,Twenty-three casualties result from Islamists bombing a fruit market.
18172,1/8/2012,Pakistan,Hyderabad,1,0,1,A young woman is shot to death by her brother for marrying of her own free will.
18173,1/8/2012,Yemen,Abyan,5,0,5,Five people die during an al-Qaeda grenade and gunfire attack.
18174,1/8/2012,Afghanistan,Jalrez,4,0,4,Four civilians are kidnapped and murdered by the Taliban.
18175,1/8/2012,Somalia,Mogadishu,6,0,6,Six guards are taken apart by two Fedayeen suicide bombers.
18176,1/8/2012,Pal. Auth.,Tulkarm,1,0,1,A Palestinian man stabs his teenage daughter to death in a suspected honor killing.
18177,1/8/2012,Somalia,Mogadishu,1,0,1,A comedian is shot to death after mocking Islamists on stage.
18178,1/8/2012,Somalia,Mogadishu,1,0,1,At least one other person is killed when two suicide bombers detonate.
18179,1/8/2012,Pakistan,Tandlianwala,2,0,2,A woman is strangled by her brother over 'loose morals'.
18180,1/8/2012,Pakistan,Mochiwala,1,1,2,A woman is shot to death by her brother on suspicion of illicit relations.
18181,1/8/2012,Thailand,Pattani,1,0,1,Muslim gunmen murder a local official on his way home from work.
18182,2/8/2012,Algeria,Roubane,4,0,4,al-Qaeda claims credit for shooting four border guards to death.
18183,2/8/2012,Jordan,Baoun,1,0,1,A 22-year-old divorced woman is stabbed to death by her brother for not submitting to his control.
18184,2/8/2012,Dagestan,Kizilyurt,1,1,2,One police officer is dead and another loses a leg to Religion of Peace attacks.
18185,2/8/2012,India,Kasargod,1,0,1,A Hindu leader is shot to death by Muslim militants.
18186,2/8/2012,Iraq,Baghdad,9,32,41,Women are among the casualties when Sunnis bomb a market in a Shiite neighborhood.
18187,2/8/2012,Iraq,Balad,3,0,3,Three Iraqis are blown to bits by an 'insurgent' bomb.
18188,2/8/2012,Iraq,Tikrit,4,0,4,Four policemen are machine-gunned at close range by Sunni terrorists.
18189,2/8/2012,Iraq,Kirkuk,4,0,4,"Muslim terrorists enter a home and cut the throats of a father, mother and two daughters."
18190,2/8/2012,Pakistan,Akhorwal,1,0,1,Tehreek-e-Taliban gunmen murder a local man.
18191,3/8/2012,Syria,Damascus,21,17,38,"Militants with al-Qaeda ties are blamed for sending mortars into a refugee camp, killing at least twenty-one."
18192,3/8/2012,Iraq,Dhuluiyah,4,4,8,Four Iraqis are torn apart by an 'insurgent' roadside bomb.
18193,3/8/2012,Pakistan,Charsadda,0,2,2,Two workers are injured when Islamists throw a grenade into a humanitarian agency helping flood victims.
18194,3/8/2012,Yemen,Sanaa,1,0,1,"Suspected al-Qaeda gunmen strafe a car with bullets, killing the driver."
18195,3/8/2012,Saudi Arabia,Qatif,2,1,3,A clash between Sunni and Shia leaves two dead.
18196,3/8/2012,Afghanistan,Kunar,2,0,2,A woman is among two people killed in attack by Sunni hardliners.
18197,3/8/2012,Pakistan,Risalpur,11,23,34,"Mujahideen plant a bomb on a child's tricycle at a market, which rips eleven people to shreds."
18198,3/8/2012,Iraq,Baghdad,5,11,16,Drive-by Jihadis take down five Iraqis.
18199,3/8/2012,Kenya,Nairobi,1,9,10,"An Islamist throws a grenade into a supermarket, killing at least one."
18200,3/8/2012,Afghanistan,Daulatzai,0,23,23,Two dozen people are injured when Mujahideen set off a bomb at a rival mosque during prayers.
18201,3/8/2012,Syria,Damascus,1,0,1,al-Nusra terrorists kidnap and execute a television presenter.
18202,4/8/2012,Thailand,Pattani,1,0,1,A 57-year-old cop is ambushed and killed by Muslim militants.
18203,4/8/2012,Yemen,Jaar,49,37,86,An al-Qaeda suicide bomber blows forty-nine funeral-goers into pieces.
18204,4/8/2012,Afghanistan,Gala Joy,8,10,18,Eight are killed when two groups of Islamists work out their differences.
18205,4/8/2012,Afghanistan,Ghormach,3,12,15,"Taliban fundamentalists toss a bomb into a market, sending at least three souls to Allah."
18206,4/8/2012,Pakistan,Gilgit,1,0,1,A 34-year-old Shiite farmer is tortured and beheaded by Wahhabi radicals.
18207,5/8/2012,Pakistan,Faizabad,3,12,15,A Religion of Peace bomb kills two children and a woman.
18208,5/8/2012,Pakistan,Bahawalnagar,4,3,7,A woman and her daughters are hacked to death with an axe by her husband and sons on suspicion of 'relations with neighbors'.
18209,5/8/2012,Nigeria,Maiduguri,4,0,4,Four people are shot to death in their homes by Boko Haram Islamists.
18210,5/8/2012,Iraq,Tuz Khurmatu,4,2,6,Jihadi bombers send four Iraqis to Allah.
18211,5/8/2012,Syria,Jdaidet Artuz,1,0,1,A Shiite film director is assassinated by Sunni terrorists.
18212,5/8/2012,Egypt,Sinai,16,7,23,Gaza Jihadists cross the border and murder sixteen Egyptian border police.
18213,5/8/2012,Nigeria,Damaturu,7,9,16,Seven Nigerians are disassembled by a Shahid suicide car bomber.
18214,5/8/2012,Somalia,Mogadishu,1,0,1,al-Shabaab gunmen assassinate an airport manager.
18215,5/8/2012,Afghanistan,Bamiyan,6,12,18,Taliban ambush and kill four Afghans and two NATO troops coming to their defense.
18216,5/8/2012,Iraq,Mosul,3,0,3,Suspected al-Qaeda open up point-blank on three local cops.
18217,5/8/2012,Philippines,Maguindanao,1,11,12,At least one woman is killed when Bangsamoro Islamic Freedom Movement members overrun a Catholic village.
18218,5/8/2012,Pakistan,Gilgit,2,4,6,Two passengers bleed out from splinter injuries after Islamic militants toss a grenade into a bus.
18219,5/8/2012,Pakistan,Milwat,1,0,1,Lashkar-e-Islam militants murder a peace committee volunteer.
18220,6/8/2012,Azerbaijan,Tashkent,0,2,2,A mother and her physically disabled daughter are severely beaten in their home by radicals who urge them to embrace Islam.
18221,6/8/2012,Afghanistan,Charsadda,1,3,4,The Taliban tie a landmine to a donkey that fatally injures a local cop.
18222,6/8/2012,Iraq,al-Haswa,3,13,16,Jihadi car bombers take out three Iraqis.
18223,6/8/2012,Iraq,Khanaqin,2,2,4,"Sunnis bomb a Kurdish family home, killing two."
18224,6/8/2012,Chechnya,Khankala,3,3,6,Three local soldiers are killed by a Fedayeen suicide blast.
18225,6/8/2012,Pakistan,Jamrud,1,0,1,"Hardliners fire into a truck, killing the driver."
18226,6/8/2012,Iraq,Baghdad,2,0,2,Two local officials are murdered by Mujahid gunmen.
18227,6/8/2012,Iraq,Hillah,4,0,4,Four Iraqis on a minibus are torn to shreds by 'insurgent' bombers.
18228,6/8/2012,India,Sendabal,1,2,3,A youth dies when two groups clash at a mosque over a prayer disagreement.
18229,6/8/2012,Nigeria,Maiduguri,1,0,1,A church pastor is shot to death in his home by two Islamists.
18230,6/8/2012,Nigeria,Okene,20,9,29,"Sharia proponents enter a church and open up on members with machine-guns, slaughtering at least nineteen, including the pastor."
18231,6/8/2012,Syria,Damascus,6,0,6,"Sunni terrorists massacre an entire Shiite family in their home, including hanging the youngest child."
18232,6/8/2012,Thailand,Pattani,1,0,1,A non-Muslim motorcycle repairman is shot in the head by Islamic 'insurgents'.
18233,6/8/2012,Thailand,Pattani,1,0,1,Four Muslims murder a 55-year-old man with a shotgun.
18234,6/8/2012,Philippines,Shariff Aguak,2,1,3,"Bangsamoro Islamic Freedom Fighters kidnap, torture and execute two local soldiers."
18235,6/8/2012,Dagestan,Tsuntinsky,2,1,3,Islamic snipers pick off two local cops.
18236,7/8/2012,Syria,Homs,16,0,16,"Sunni militia attack a housing complex for religious minorities, killing sixteen."
18237,7/8/2012,Somalia,Garowe,1,0,1,A local lawmaker is shot to death outside a mosque by al-Shabaab.
18238,7/8/2012,Pakistan,Shah Khan,2,0,2,Two tribal elders are murdered by suspected Islamists.
18239,7/8/2012,Iraq,Hamiat,3,6,9,Three children are pulled into pieces by bombs planted in two homes.
18240,7/8/2012,Thailand,Pattani,0,9,9,Nine school guards are injured by a Muslim bomb.
18241,7/8/2012,Afghanistan,Paghman,9,3,12,"Hardline Islamists blow up a civilian minibus, sending nine souls to Allah."
18242,8/8/2012,Dagestan,Endireiaul,0,1,1,A former imam is shot after coming out against terror.
18243,8/8/2012,Iraq,Baiji,8,0,8,Islamic State of Iraq members enter a home and exterminate a family of eight.
18244,8/8/2012,Nigeria,Okene,3,0,3,A woman is among three people gunned down by terrorists 'chanting Islamic praises'.
18245,8/8/2012,Afghanistan,Asadabad,4,3,7,"Four people are slain by a Fedayeen suicide bomber, including an aid official."
18246,8/8/2012,Syria,Hourani,1,3,4,One person is killed during a clash between Sunni and Shia.
18247,8/8/2012,Iraq,Suwayra,13,30,43,Sunni car bombers massacre thirteen Shiite worshippers at a packed religious ceremony.
18248,8/8/2012,Iraq,Baghdad,1,1,2,The minister of Culture is assassinated in an attack that leaves his wife badly wounded.
18249,8/8/2012,Somalia,Mogadishu,8,2,10,An al-Shabaab roadside bomb leaves eight dead.
18250,9/8/2012,India,Baktoor,1,0,1,Islamic militants kill a border guard during an infiltration attempt.
18251,9/8/2012,Iraq,Baghdad,2,19,21,"Islamists bomb a marketplace, killing two patrons."
18252,9/8/2012,Iraq,Fallujah,4,4,8,Children are among the casualties when Islamic 'insurgents' blow up a family home.
18253,9/8/2012,Pakistan,Upper Dir,2,0,2,Two border guards are murdered during a Taliban assault.
18254,9/8/2012,Afghanistan,Helmand,3,0,3,"Three American soldiers are invited to dinner by local police, and then murdered."
18255,9/8/2012,Dagestan,Botlikh,5,0,5,"Islamists open fire on a group of police, killing five."
18256,10/8/2012,Yemen,Mukalla,2,1,3,Two men are killed following an al-Qaeda car bomb blast.
18257,10/8/2012,Thailand,Pattani,1,0,1,A 28-year-old man is shot off his motorbike by Muslim 'separatists.'
18258,10/8/2012,India,Moominabad,1,0,1,The Islamic Movement of Kashmir murders a retiree outside a mosque.
18259,10/8/2012,Philippines,Datu Unsay,1,0,1,A local cop is slain by Bangsamoro Islamic Freedom Fighters.
18260,10/8/2012,Afghanistan,Musa Qala,6,1,7,Women and children are among six civilians torn to shreds by a Taliban bomb.
18261,10/8/2012,Iraq,Mosul,5,70,75,"A Shahid suicide bomber targets a Shiite mosque, slaughtering at least five worshippers."
18262,10/8/2012,Iraq,al-Muqdadiyah,3,2,5,Mujahideen bombers send three Iraqis to Allah.
18263,10/8/2012,Iraq,Dujail,4,0,4,al-Qaeda gunmen take down four Sunnis.
18264,10/8/2012,Philippines,Jolo,1,0,1,A Christian man is gunned down by Abu Sayyaf terrorists on his way home from church.
18265,10/8/2012,Nigeria,Kaduna,0,1,1,Muslim's yell 'Allah Akbar' as they set fire to a church and shoot at a pastor and his family.
18266,10/8/2012,Lebanon,Akkar,1,9,10,Religious clashes leave one dead.
18267,10/8/2012,Syria,al-Bab,3,0,3,Unarmed men are thrown from a roof to shouts of 'Allah Akbar'.
18268,10/8/2012,Afghanistan,Balkh,1,0,1,A female school principal is murdered in her own home by suspected fundamentalists.
18269,10/8/2012,Nigeria,Kombul,4,3,7,Four Christians are cut down in their homes by a Muslim raid on their village.
18270,10/8/2012,Iraq,Haditha,3,0,3,Terrorists kill three members of the same family.
18271,11/8/2012,Somalia,Mogadishu,2,2,4,Two Somalis bleed to death from shrapnel injuries suffered during an al-Shabaab attack.
18272,11/8/2012,Afghanistan,Jambaran,1,1,2,Religious radicals assassinate a tribal chief in his home.
18273,11/8/2012,Thailand,Pattani,1,0,1,A 41-year-old plantation worker is riddled with bullets by Muslim 'separatists'.
18274,11/8/2012,Iraq,Amerili,7,0,7,"Sunnis ride into a town, single out seven young Shiites and execute them in cold blood."
18275,11/8/2012,Afghanistan,Delaram,11,0,11,A Taliban in police uniform surprises eleven local cops and shoots them to death.
18276,11/8/2012,Syria,Jdeidet Artouz,1,0,1,A journalist is murdered following threats from al-Nusra.
18277,11/8/2012,Pakistan,Peshawar,1,0,1,A guard at a mosque dies preventing a shooting rampage by rivals.
18278,11/8/2012,Pakistan,Bara,4,1,5,Four local tribesmen are ambushed and killed by Lashkar-e-Islam militants.
18279,12/8/2012,Thailand,Pattani,1,0,1,Suspected Muslim terrorists murder a 55-year-old sleeping in his truck.
18280,12/8/2012,Iraq,Suleiman Bek,8,0,8,Eight more Shiite teens are rounded up and murdered by Sunni gunmen.
18281,12/8/2012,Afghanistan,Alishang,4,0,4,Four Afghans are dismantled by a Taliban roadside bomb.
18282,12/8/2012,Philippines,Alip,2,4,6,Two people at a banana plantation are mowed down by Muslim militants.
18283,12/8/2012,Iraq,Baghdad,2,0,2,Two charity workers are assassinated by religious rivals.
18284,12/8/2012,Iraq,Jurf al-Sakhar,3,5,8,Mujahideen bombers take down three Iraqis.
18285,12/8/2012,Pakistan,Miranshah,3,3,6,Sunni terrorists kill three local soldiers with a roadside bomb.
18286,12/8/2012,Somalia,Mogadishu,1,0,1,A radio journalist is assassinated by suspected Islamists.
18287,12/8/2012,Pakistan,Mera Kachuri,2,0,2,A father and son are brutally tortured to death by militant Muslims.
18288,12/8/2012,Afghanistan,Panjwai,4,4,8,Four people are cut down by a Taliban ambush.
18289,13/8/2012,Kazakhstan,Almaty,12,0,12,Twelve people including a 76-year-old ranger and his family are brutally stabbed to death by two radical Muslims.
18290,13/8/2012,Pakistan,Karachi,3,0,3,Three people are murdered by the Tehreek-e-Taliban.
18291,13/8/2012,Afghanistan,Ishkamish,5,0,5,Islamic hardliners blow up five locals.
18292,13/8/2012,Egypt,Sinai,2,0,2,A man and his son are shot to death by Islamists shortly after denouncing them.
18293,13/8/2012,Pakistan,Charsadda,2,0,2,A young couple is shot to death by the woman's family for marrying without their permission.
18294,13/8/2012,Nigeria,Gombe,1,1,2,A guard is killed during a Religion of Peace assault on a Catholic church.
18295,13/8/2012,Pakistan,Saro Wano,1,1,2,A preacher is machine-gunned in his mosque by Religion of Peace rivals.
18296,14/8/2012,Egypt,Asyut,1,0,1,Salafis storm a Christian-owned store and murder the owner.
18297,14/8/2012,Pakistan,Sahiwal,1,0,1,A 14-year-old Christian girl is gang-raped and murdered by five Muslim men.
18298,14/8/2012,Dagestan,Buinaksk,1,0,1,"Islamists blow up a car, along with an occupant."
18299,14/8/2012,Thailand,Yala,1,0,1,A 52-year-old plantation worker is cut down by Muslim gunmen.
18300,14/8/2012,Afghanistan,Zaranj,36,110,146,"Four coordinated suicide bombers slaughter three dozen people, including women and children."
18301,14/8/2012,Afghanistan,Kunduz,12,30,42,A bomb planted on a motorcycle at a crowded bazaar sends a dozen shoppers to Allah.
18302,14/8/2012,Thailand,Narathiwat,1,1,2,Muslim 'insurgents' shoot a local villager several times in the head and torso.
18303,14/8/2012,Pakistan,Orakzai,5,18,23,Five innocents are cut down by a Taliban ambush on a police patrol.
18304,14/8/2012,Pakistan,Sangar,1,2,3,An innocent person is murdered during an attack by Islamists.
18305,14/8/2012,Indonesia,Sukabumi,1,0,1,A cleric is murdered by members of an Islamic sect.
18306,14/8/2012,Dagestan,Khasavyurt,2,1,3,Suspected Islamists shoot two police officers to death.
18307,14/8/2012,Nigeria,Damaturu,9,0,9,Nine people are slain by Boko Haram Islamists.
18308,15/8/2012,Nigeria,Maidugui,1,0,1,A Fedayeen suicide bomber kills a commuter.
18309,15/8/2012,Iraq,Muqdadiya,7,25,32,Ramadan car bombers send seven Shiite souls to Allah.
18310,15/8/2012,Iraq,Baqubah,2,9,11,A Jihad car bomb leaves two dead.
18311,15/8/2012,Nigeria,Kaduna,1,0,1,"A Boko Haram bomb intended for a moderate imam goes off prematurely, killing a passerby."
18312,15/8/2012,Iraq,Qahataniya,2,0,2,Two brothers are murdered in their house by Sunnis for being members of a religious minority.
18313,15/8/2012,Afghanistan,Heart,0,15,15,Taliban bombers leave fifteen shoppers at a market bloody and maimed.
18314,15/8/2012,Pakistan,Karachi,1,0,1,Sipah-e-Sahaba gunmen take down a Shiite.
18315,15/8/2012,Afghanistan,Bagh Sara,0,9,9,Three grenades into a rival mosque where people are praying.
18316,15/8/2012,Thailand,Yala,1,1,2,Muslim militants shoot a 47-year-old to death at a tea shop.
18317,15/8/2012,Pakistan,Kurram,3,31,34,Three security personnel bleed out following separate bombings by Muslim radicals.
18318,15/8/2012,Afghanistan,Peshawar,6,0,6,Six Taliban victims are found tortured and stuffed into gunny bags.
18319,16/8/2012,Pakistan,Rawalpindi,25,0,25,Twenty-five Shiites are pulled off a passenger bus by Sunni extremists and shot and beheaded.
18320,16/8/2012,Pakistan,Kamra,1,1,2,The Taliban kill at least one defender in an assault on an airport.
18321,16/8/2012,Iraq,Mosul,3,22,25,Various sectarian attacks leave at least three more dead.
18322,16/8/2012,Iraq,Kut,5,70,75,A Mujahid car bomb leaves five Iraqis dead.
18323,16/8/2012,Iraq,Tuz Khurmatu,1,4,5,"A woman is killed, and her children injured by 'insurgent' bombers."
18324,16/8/2012,Iraq,Husseiniyah,7,42,49,Sunni car bombers take down seven Shiites.
18325,16/8/2012,Iraq,al-Garma,4,3,7,Four local cops are machine-gunned at point blank range by Mujahideen.
18326,16/8/2012,Iraq,Daquq,6,25,31,A Shahid suicide bomber snuffs out the life of six other souls.
18327,16/8/2012,Iraq,Kirkuk,1,6,7,"Terrorists bomb a family home, killing one member and injuring six."
18328,16/8/2012,Iraq,Baghdad,26,58,84,A Religion of Peace blast at a Shiite produce market leaves twenty-six dead.
18329,16/8/2012,Iraq,Zafaniya,34,57,91,"Nearly three dozen people, mostly women and children, are slaughtered by a car bomb at an amusement park."
18330,16/8/2012,Pakistan,Quetta,3,0,3,Three members of the Hazara religious minority are exterminated by Sunni gunmen.
18331,16/8/2012,Tunisia,Bizerte,0,5,5,"Salafists attack a music festival, pummeling attendees with swords and sticks."
18332,16/8/2012,Nigeria,Maiduguri,1,0,1,Boko Haram shoot a community leader to death at a mosque.
18333,17/8/2012,Pakistan,Sadda,0,0,0,"Militants bomb a market, killing at least one patron."
18334,17/8/2012,Pakistan,Quetta,5,5,10,A Shahid suicide bomber takes out five Pakistanis.
18335,17/8/2012,Pakistan,Karachi,2,18,20,A bus carrying Shiite students is hit by a bombing that leaves at least two dead.
18336,17/8/2012,Afghanistan,Kinisk,2,0,2,Two Americans are shot in the back by a Taliban in police uniform.
18337,18/8/2012,Afghanistan,Herat,4,12,16,Fundamentalist bombers murder four people at a crowded market.
18338,18/8/2012,Afghanistan,Grish,1,0,1,The Taliban assassinate a local official with a bomb.
18339,18/8/2012,Yemen,Aden,21,9,30,An al-Qaeda rocket attack and suicide bombing leaves over twenty people dead.
18340,18/8/2012,Iraq,Mosul,6,0,6,Muslim terrorists kill six family members in their homes.
18341,18/8/2012,Iraq,Kirkuk,5,4,9,Five local security forces at a checkpoint are riddled with bullets by Mujahideen.
18342,18/8/2012,Dagestan,Khasavyurt,0,8,8,Suspected Islamists enter a rival mosque and open fire.
18343,18/8/2012,Pakistan,Michni,4,0,4,Four young men are brutally gunned down by radical Sunnis.
18344,19/8/2012,Pakistan,Karachi,16,1,17,A bloody shooting at a cafe is one of several that leave sixteen dead at the hands of sectarian Jihadis
18345,19/8/2012,Iraq,Baghdad,4,1,5,Four persons are killed in a bombing targeting a Sunni cleric.
18346,19/8/2012,Ingushetia,Malgobek,7,10,17,A Fedayeen suicide bomber enters a funeral and slaughters at least seven mourners.
18347,19/8/2012,Bangladesh,Sunamganj,0,30,30,Two groups of devout Muslims clash at a mosque over a disagreement over prayers.
18348,19/8/2012,Yemen,Abyan,3,2,5,An al-Qaeda suicide bomber takes out three souls.
18349,19/8/2012,Afghanistan,Kandahar,1,1,2,A terrorist in police uniform shoots a soldier in the back.
18350,19/8/2012,Afghanistan,Farah,2,0,2,Two brothers are shot to death in their car by Taliban gunmen.
18351,19/8/2012,Afghanistan,Lashkar Gah,3,8,11,Islamic bombers kill three people at a cemetery.
18352,19/8/2012,Afghanistan,Kabul,3,0,3,Authorities accuse the Taliban of beheading three people during Ramadan.
18353,19/8/2012,Pakistan,Haripur,0,6,6,Six people are attacked by fundamentalists for watching television during Eid ul Fitr.
18354,20/8/2012,Dagestan,Tsunta,1,0,1,"Islamic militants open up with automatic rifle fire at a police checkpoint, killing one cop."
18355,20/8/2012,Indonesia,Cisalopa,4,0,4,Four people are murdered on accusation of heresy.
18356,21/8/2012,Iraq,Mosul,1,0,1,A man is stoned to death for adultery by the Islamic State.
18357,21/8/2012,Lebanon,Tripoli,8,75,83,A clash between Sunnis and Shia leaves eight civilians dead.
18358,21/8/2012,Thailand,Narathiwat,1,1,2,A 34-year-old civilian is picked off in a Muslim drive-by.
18359,21/8/2012,Thailand,Narathiwat,1,2,3,"Muslim gunmen ambush a bus carrying civilian, killing one."
18360,21/8/2012,Pakistan,Faisalabad,1,0,1,A Muslim perpetrator is strongly suspected by the minority community in the targeted torture and murder of a 14-year-old Christian boy.
18361,21/8/2012,Nigeria,Goniri,2,0,2,Gunmen shouting 'Allah Akbar' burn down several buildings and shoot two villagers to death.
18362,21/8/2012,Nigeria,Borno,1,0,1,"Islamists open fire on a rival cleric, killing him outside his mosque."
18363,21/8/2012,Nigeria,Biu,1,0,1,Boko Haram gunmen assassinate a worshipper inside a mosque at close range.
18364,21/8/2012,Pakistan,Quetta,1,12,13,Islamists are suspected in a bombing that leaves one dead.
18365,22/8/2012,Dagestan,Babayurt,1,0,1,A policeman dies from wounds suffered during an earlier 'insurgent' attack.
18366,22/8/2012,Dagestan,Mokok,1,3,4,A soldier is killed by a Muslim sniper.
18367,22/8/2012,Lebanon,Tripoli,4,25,29,Four more people die in clashes between Sunni and Shia.
18368,22/8/2012,Pakistan,Joharabad,1,2,3,"A Muslim mob attacks a brothel, killing the owner's companion."
18369,22/8/2012,Pakistan,Islamabad,2,0,2,Video surfaces of the Lashkar-e-Jhangvi beheading two abducted Shiites.
18370,23/8/2012,Pakistan,Bakwa,2,0,2,Two local security guards are murdered by Sunni hardliners.
18371,23/8/2012,Somalia,Mogadishu,3,12,15,An al-Shabaab attack leaves three dead.
18372,23/8/2012,Pakistan,Chakwal,2,0,2,A couple that eloped without the girl's family's permission is snatched and hung from a tree.
18373,23/8/2012,Pakistan,Hangu,3,0,3,Three policemen are ambushed and murdered by Islamic militants.
18374,23/8/2012,Dagestan,Makhachkala,11,0,11,Five civilians are among eleven reported dead from Islamic terror attacks between the 11th and 17 of the month.
18375,23/8/2012,Tunisia,Sidi Bouzid,0,7,7,Salafists attack people drinking alcohol with knives and sticks.
18376,23/8/2012,Sudan,Kassab Camp,1,20,21,At least one person is reported killed when Arab militia invade an African refugee camp and rape dozens of women.
18377,23/8/2012,Afghanistan,Spin Boldak,6,0,6,Three children and two women are among six civilian blown into bits by a Taliban bomb.
18378,23/8/2012,Afghanistan,Ahmad Khil,3,0,3,Hardliners kidnap and kill three local soldiers who were on their way home to visit families.
18379,24/8/2012,Iraq,Khan Beni Saad,1,3,4,A Sunni bomb targeting a Shiite family kills one member.
18380,24/8/2012,Iraq,Baghdad,6,12,18,At least six people are murdered when Islamic terrorists throw grenades into a hotel.
18381,24/8/2012,Iraq,Baghdad,3,8,11,"Sunnis fire mortars into a group of Shiite worshippers, killing three."
18382,24/8/2012,Pakistan,Batwar,2,8,10,Women and children are among the casualties when Islamic militants open up on a village with automatic weapons.
18383,24/8/2012,Lebanon,Tripoli,3,41,44,A Sunni sheikh is shot dead by Shia gunmen.  Two other people are killed in the same sectarian clash.
18384,24/8/2012,Dagestan,Khasavyurt,1,1,2,Islamic 'militia' shoot one person to death.
18385,25/8/2012,Iraq,Mosul,3,0,3,Suspected al-Qaeda murder three people.
18386,25/8/2012,Afghanistan,Paktia,5,12,17,Four separate Taliban bomb attacks leave five Afghans dead.
18387,25/8/2012,Afghanistan,Zehi,2,4,6,Hardline bombers take out two Afghans.
18388,25/8/2012,Afghanistan,Panjwayi,5,3,8,Five local troops are killed Sunni fundamentalists in a roadside blast.
18389,25/8/2012,Pakistan,Bara,7,8,15,Seven members of a family are crushed to death when their home is hit by a Lashkar-e-Islam mortar shell.
18390,25/8/2012,Pakistan,Karachi,2,0,2,Two Shiites are murdered by sectarian rivals.
18391,25/8/2012,Afghanistan,Gereshk,1,6,7,A girl is killed by a Taliban rocket attack on her house.
18392,25/8/2012,Afghanistan,Sistani,1,0,1,A civilian bleeds to death following the detonation of this car by Islamic radicals.
18393,25/8/2012,Afghanistan,Gosfandi,1,0,1,A civilian is left dead following an ambush by Islamic militants.
18394,26/8/2012,Nigeria,Gashua,1,0,1,"A group 'committed to the Prophet's teachings' attacks a local bank, killing the guard."
18395,26/8/2012,Indonesia,Sampang,2,12,14,"'Mainstream' Muslims stop a group of Shia children and teachers, and proceed to hack at least two to death."
18396,26/8/2012,Afghanistan,Pailoch,3,0,3,A 'girl and two boys' are shot to death by the woman's brother for committing adultery.
18397,26/8/2012,Pakistan,Bajur,1,4,5,"Taliban militants Afghanistan cross the border from Afghanistan and attack a police check post, killing one defender."
18398,26/8/2012,Iraq,Garma,3,2,5,Mujahideen bring down three Iraqis with IEDs.
18399,26/8/2012,Iraq,Baghdad,5,1,6,Islamic terrorists shoot three security guards and two others to death at an amusement park in a Shiite neighborhood.
18400,27/8/2012,Kenya,Mombasa,1,1,2,A Muslim cleric is shot 17 times by a Muslim terrorist.
18401,27/8/2012,Pakistan,Katha Kanray,1,1,2,A member of a peace committee bleeds to death after Islamic militants set off a roadside bomb.
18402,27/8/2012,Mali,Ansongo,1,0,1,A man bleeds to death after his hand is cut off by Islamists.
18403,27/8/2012,Afghanistan,Washir,10,4,14,Taliban in uniform infiltrate a unit a shoot ten Afghan soldiers to death.
18404,27/8/2012,Kenya,Mombasa,1,0,1,A Muslim mob hacks a person to death after urged on by an imam.
18405,27/8/2012,Iraq,Mosul,2,5,7,Two civilians are murdered in separate terror attacks.
18406,27/8/2012,Pakistan,Quetta,3,2,5,"Sectarian Jihadis fire on a car carrying Shia civilians, killing three."
18407,27/8/2012,Afghanistan,Musa Qala,17,0,17,Fundamentalists interrupt a party and behead two women and fifteen men for dancing to music.
18408,28/8/2012,Thailand,Narathiwat,1,1,2,"Runda Kumpalan Kecil cadres open fire on a passenger train, killing a guard."
18409,28/8/2012,Syria,Jaramana,27,48,75,"Sunni terrorists are blamed for a car bombing attack on a Christian funeral that leaves twenty-seven dead, including children."
18410,28/8/2012,Dagestan,Chirkey,7,0,7,"A female suicide bomber takes down a 74-year-old Sufi cleric and six others at his home, including a 12-year-old boy."
18411,28/8/2012,Kenya,Mombasa,2,13,15,A civilian and a cop are killed when a Muslim militant hurls a grenade at them.
18412,28/8/2012,Afghanistan,Kandahar,4,20,24,Four civilians are sent to Allah by Fedayeen suicide truck bombers.
18413,28/8/2012,Afghanistan,Kunar,5,0,5,A suicide bomber on foot murders five local troops.
18414,28/8/2012,Afghanistan,Uruzgan,3,2,5,Three Australian soldiers are shot in the back by a Taliban in army uniform while they are relaxing.
18415,28/8/2012,Iraq,Waziriyah,2,0,2,Two Iraqis are murdered by suspected al-Qaeda.
18416,28/8/2012,Dagestan,Belidzhi,7,6,13,"Influence by 'Islamist literature', a border guard murders seven fellow soldiers."
18417,28/8/2012,Pakistan,Karachi,1,1,2,"Islamic militants open fire on a pastor, injuring him and killing a church member."
18418,28/8/2012,Somalia,Merka,1,0,1,A UN humanitarian worker is murdered by suspected al-Shabaab.
18419,29/8/2012,Afghanistan,Kandahar,1,0,1,A 12-year-old boy is kidnapped and beheaded by the Taliban.
18420,29/8/2012,Pakistan,Ghatbadr,8,6,14,"Armed Islamists attack a check post, leaving eight defenders dead."
18421,29/8/2012,Syria,Zamalka,7,0,7,"A family of seven Christians, including three children, are shot in the street by 'Liua Islam'."
18422,29/8/2012,Thailand,Yala,1,0,1,Islamic 'separatists' shoot a man in the head as he is eating noodles.
18423,29/8/2012,Germany,Berlin,0,1,1,A rabbi is beaten by Muslims in front of his young daughter for 'being Jewish'.
18424,29/8/2012,Iraq,Kirkuk,5,3,8,al-Qaeda bombers take down five people.
18425,29/8/2012,Iraq,Baghdad,1,0,1,A cleric is gunned down in his mosque by Religion of Peace rivals.
18426,29/8/2012,Afghanistan,Logar,1,0,1,A woman is killed inside her home by a Taliban rocket.
18427,29/8/2012,Georgia,Lapankuri,3,0,3,A doctor is among three people who die trying to rescue innocent hostages taken by Islamic radicals.
18428,30/8/2012,Thailand,Yala,1,0,1,A Buddhist trader sitting in his truck is shot and beheaded by Muslim militants.
18429,30/8/2012,Pakistan,Quetta,3,0,3,"Sunnis spray a car carrying a Shia judge with automatic fire, killing three occupants."
18430,30/8/2012,Pakistan,Batwar,12,0,12,Fundamentalists praise Allah as they videotape the beheading of a dozen captured Pakistani soldiers.
18431,30/8/2012,Indonesia,Solo,1,0,1,A jailed cleric's hardline followers gun down a cop in a drive-by.
18432,30/8/2012,Afghanistan,Kapisa,1,0,1,Islamic fundamentalists are thought responsible for the beheading of a 6-year-old girl.
18433,30/8/2012,Pakistan,Ghaziabad,5,0,5,"Suspecting his mother and four sisters of 'illicit relations', a man drugs the five and then butchers them in their sleep."
18434,30/8/2012,Afghanistan,Baraki Barak,5,10,15,"Islamic radicals fire a rocket into a bus stop, killing five civilians."
18435,30/8/2012,Pakistan,Peshawar,1,0,1,A Tehreek-e-Taliban member shoots a young man to death at a market.
18436,30/8/2012,Iraq,Hillah,2,0,2,'Insurgents' exterminate two Iraqis sitting in a car.
18437,30/8/2012,Syria,Damascus,2,0,2,Two policemen guarding the Lebanese embassy are brutally murdered in a sectarian attack.
18438,31/8/2012,Pakistan,Jacobabad,2,0,2,A Muslim shoots his sister-in-law and niece to death over alleged sexual misconduct.
18439,31/8/2012,Afghanistan,Sahib Khan,5,0,5,Five villagers are kidnapped and executed by the Taliban.
18440,31/8/2012,Egypt,Muqatta,1,0,1,Islamic extremists kidnap and behead a local man.
18441,31/8/2012,Pakistan,Peshawar,12,12,24,A dozen Pakistanis are torn to shreds by a Taliban bomb near a mosque.
18442,31/8/2012,Iraq,Baghdad,1,0,1,A Shiite imam is assassinated by Religion of Peace rivals.
18443,31/8/2012,Iraq,Baghdad,2,0,2,Two Shiite worshippers are shot to death on their way home.
18444,31/8/2012,Iraq,Baghdad,1,1,2,A Sunni attack on a Shiite cleric his driver dead.
18445,31/8/2012,Pakistan,Shor Kot,1,0,1,"Following a fatwa against women using cell phones, a girl is honor killed after her brother discovers her with one and suspects immoral activity."
18446,1/9/2012,Thailand,Narathiwat,0,2,2,Muslim bombers tear off the legs of two plantation workers.
18447,1/9/2012,Syria,Deir al-Zour,1,2,3,A Shahid suicide bomber takes out one other person.
18448,1/9/2012,Syria,Damascus,15,3,18,A Sunni group is blamed for a car bomb attack near a rival mosque that leaves fifteen dead.
18449,1/9/2012,Pakistan,Quetta,2,10,12,Two demonstrators are killed when Sunnis fire on Shias protesting an earlier murder.
18450,1/9/2012,Iraq,Basra,1,1,2,Knife-wielding 'insurgents' stab a judge to death in this home.
18451,1/9/2012,Afghanistan,Wardak,13,78,91,Twin suicide bombers incinerate over a dozen people including a child and two women.
18452,1/9/2012,Pakistan,Quetta,2,0,2,Two Shias walking along the side of the road are taken out by Sunnis on a motorbike.
18453,1/9/2012,Pakistan,Hazar Ganji,5,0,5,Sunnis pull five Shia vegetable seller off of a truck and calmly shoot them to death.
18454,1/9/2012,Iraq,Baghdad,2,11,13,"Terrorists set off a bomb outside a coffee shop, killing two patrons."
18455,2/9/2012,Mali,Gao,1,0,1,A kidnapped Algerian diplomat is executed in captivity by al-Qaeda.
18456,2/9/2012,Pakistan,Quetta,1,0,1,Another Shia minority dies from injuries suffered in a targeted attack by Sunni.
18457,2/9/2012,Pakistan,Bazarak Khwar,1,4,5,Muslim radicals ambush a police vehicle and kill the driver.
18458,3/9/2012,Syria,Jaramana,4,12,16,Sunni rebels are blamed for a car bomb blast targeting Christians in a residential neighborhood.
18459,3/9/2012,Nigeria,Maiduguri,2,0,2,A lecturer is among two people murdered by Islamist assassins.
18460,3/9/2012,Nigeria,New Marte,3,0,3,Two civilians and a cop are murdered by Boko Haram gunmen.
18461,3/9/2012,Pakistan,Peshawar,2,25,27,Two civilians are killed in a suicide car bomb attack on a U.S. Consulate vehicle.
18462,4/9/2012,Kenya,Mombasa,2,0,2,Two more people are reported killed by rioters whipped into frenzy by a radical imam.
18463,4/9/2012,Thailand,Pattani,1,0,1,A 28-year-old Buddhist villager is slain by Muslim gunmen.
18464,4/9/2012,Pakistan,Pirabad,2,0,2,Sunnis shoot two Shiites to death.
18465,4/9/2012,Pakistan,Karachi,1,0,1,Wahhabis shoot a Shia traffic cop three times in the head.
18466,4/9/2012,Iraq,Kirkuk,1,0,1,"A 16-year-old victim of 'insurgents' is found with his head, hands and feet cut off."
18467,4/9/2012,Iraq,Tuz Khurmatu,6,2,8,Terrorists massacre six Iraqis with automatic weapons.
18468,4/9/2012,Afghanistan,Dor Baba,25,35,60,Over two dozen mourners at a funeral are blasted into bits by a Fedayeen suicide bomber.
18469,4/9/2012,Iraq,Fallujah,1,0,1,Suspected al-Qaeda members machine-gun a judge in his own home.
18470,4/9/2012,Somalia,Barawe,2,0,2,al-Shabaab Islamists tie two men to a pole and open up on them with automatic weapons.
18471,4/9/2012,Nigeria,Gwange,4,0,4,Four people are shot and stabbed in their own homes by suspected Boko Haram.
18472,5/9/2012,Pakistan,Karachi,2,0,2,A 75-year-old Shiite is murdered along with his 17-year-old grandson in a targeted shooting by Sunnis.
18473,5/9/2012,Pakistan,Quetta,1,0,1,A Shiite dentist is taken out in a Sunni drive-by.
18474,5/9/2012,Iraq,Khalis,1,8,9,Jihadis kill one person with a car bomb blast near a clinic.
18475,5/9/2012,Iraq,Tikrit,2,0,2,Two Sunnis are ambushed and killed by al-Qaeda gunmen.
18476,5/9/2012,India,Kerala,1,0,1,A Hindu activist dies from a stabbing attack by Muslim 'activists'  at a university campus two months earlier.
18477,5/9/2012,Ingushetia,Datykh,6,1,7,Mujahideen ambush and kill six Russians.
18478,5/9/2012,Pakistan,Quetta,1,0,1,A Shia doctor is murdered in his clinic by Lashkar-e-Jhangvi.
18479,6/9/2012,Iraq,al-Sharqat,1,1,2,The leader of an Iraqi anti-terror unit is killed by a bomb.
18480,6/9/2012,Nigeria,Yobe,16,0,16,Boko Haram Islamists murder sixteen people in a series of attacks.
18481,6/9/2012,Pakistan,Gulistan Colony,1,0,1,An Ahmadi schoolteacher is gunned down in a targeted attack.
18482,6/9/2012,Pakistan,Sipah,3,8,11,A child is among three crushed to death by a Lashkar-e-Islam mortar shell slamming into their home.
18483,7/9/2012,Lebanon,Damour,1,0,1,A man is stabbed merely for belonging to the 'wrong' religious sect.
18484,7/9/2012,Syria,Damascus,5,6,11,Five security personnel are killed by a bomb blast as they leave a mosque.
18485,7/9/2012,Iraq,Kirkuk,9,80,89,Sunni bombers take out nine Shias near their mosque.
18486,7/9/2012,Philippines,Sumisip,1,35,36,"Seven Abu Sayyaf fire into a crowd of plantation workers on their lunch break, killing one."
18487,7/9/2012,Pakistan,Quetta,1,0,1,A policeman investigating Sunni sectarian killings is sprayed with bullets.
18488,7/9/2012,Lebanon,Ain al-Hilweh,1,0,1,Jund al-Sham terrorists are accused of assassinating a local official.
18489,7/9/2012,Afghanistan,Kabul,0,3,3,Three actresses are stabbed by religious hardliners for appearing with 'immodest' outfits.
18490,7/9/2012,Libya,Rajma,3,3,6,Three people are killed when Islamic fundamentalists attempt to blow up a rival shrine.
18491,8/9/2012,Syria,Aleppo,27,64,91,Over two dozen people are massacred by an al-Nusra suicide bomber.
18492,8/9/2012,Iraq,Qaim,1,0,1,A 5-year-old girl is killed instantly by an FSA rocket.
18493,8/9/2012,Afghanistan,Kabul,6,4,10,"Six civilians, mostly children, are torn to shreds by a Fedayeen suicide bomber."
18494,8/9/2012,Pakistan,Shalobar,2,0,2,A Religion of Peace blast sends two highway patrolmen to the mosque.
18495,8/9/2012,Afghanistan,Kajaki,5,2,7,Five Afghans are taken down by Taliban roadside bombers.
18496,9/9/2012,Iraq,Kirkuk,8,17,25,al-Qaeda car bombers slaughter eight oil company employees.
18497,9/9/2012,Thailand,Narathiwat,2,1,3,Two men are killed and a 9-year-old boy loses his leg to Muslim 'rebels'.
18498,9/9/2012,Iraq,Baghdad,3,14,17,"Holy warriors detonate a bomb outside a pet market, killing three people."
18499,9/9/2012,Iraq,Baghdad,5,21,26,A restaurant blast by the Islamic Army of Iraq kills five patrons.
18500,9/9/2012,Syria,Homs,4,24,28,Sukour al-Sham terrorists are suspected in a bus bombing that leaves four dead.
18501,9/9/2012,Iraq,uz Khormato,4,41,45,Four shoppers at a market are flattened by an al-Qaeda blast.
18502,9/9/2012,Iraq,Maysan,5,40,45,Five Shiites are blown to bits outside their own mosque by Sunni bombers.
18503,9/9/2012,Iraq,Tal Afar,2,7,9,al-Qaeda bombers take down two innocents.
18504,9/9/2012,Iraq,Basra,3,24,27,A vicious bombing along a city street kills three.
18505,9/9/2012,Iraq,Baghdad,7,21,28,A Mujahideen bomb targeting a market seven dead bodies.
18506,9/9/2012,Iraq,Nasiriyah,2,3,5,"Mujahideen bomb a hotel, killing at least two."
18507,9/9/2012,Iraq,Kirkuk,7,70,77,Two Islamic Army of Iraq bombs tear apart seven people outside of a police station.
18508,9/9/2012,Iraq,Amara,16,100,116,Dedicated Sunni car bombers massacre sixteen Shiites outside their shrine.
18509,9/9/2012,Iraq,Dujail,11,7,18,A Shahid suicide bomber sends seven Iraqis to Allah.
18510,9/9/2012,Afghanistan,Mula Khel,6,0,6,Religion of Peace extremists pull six civilians out of a vehicle and execute them.
18511,9/9/2012,Afghanistan,Farah,1,16,17,A 12-year-old boy is disassembled by a Taliban bomb.
18512,10/9/2012,Mali,Gao,0,5,5,Five cousins have their hands and feet cut off by Islamists citing the Quran.
18513,10/9/2012,India,Baramulla,1,0,1,Islamic terrorists shoot a village head to death.
18514,10/9/2012,Iraq,Hillah,2,3,5,Two civilians are taken down by Jihadi bombers.
18515,10/9/2012,Pakistan,Parachinar,14,45,59,Sunnis murder fourteen members of the minority Shiite sect with a car bomb that rips through a packed market.
18516,10/9/2012,Afghanistan,Kunduz,21,15,36,"A Holy Warrior blows himself up at a demonstration, sending twenty-one other souls to Allah."
18517,10/9/2012,Syria,Aleppo,17,40,57,A Sunni terror cell claims a bombing outside a hospital and school that leaves seventeen civilians dead.
18518,10/9/2012,Iraq,Bayaa,8,32,40,Eight people at a coffee shop are obliterated by a Mujahid car bomb.
18519,10/9/2012,Iraq,Mussayib,3,2,5,Sunni bombers take down three Shiites near their shrine.
18520,10/9/2012,Syria,Aleppo,20,0,20,Video surfaces of the Salman al-Farisi members executing twenty captured prisoners in cold blood while praising Allah.
18521,11/9/2012,Afghanistan,Bagram,3,2,5,Three Afghans are killed by a rocket attack from Islamic extremists.
18522,11/9/2012,Iraq,Dujail,3,0,3,Three security volunteers are shot to death by al-Qaeda.
18523,11/9/2012,Libya,Benghazi,4,17,21,An Ambassador is among four Americans killed when Ansar al-Sharia members storm the US consulate.
18524,11/9/2012,Iraq,Baghdad,4,0,4,The Islamic Army of Iraq executes four people in their home.
18525,11/9/2012,Yemen,Sanaa,12,12,24,Twelve people bleed out in the aftermath of a suspected al-Qaeda blast.
18526,11/9/2012,Afghanistan,Kushki Kuhna,5,6,11,A Shahid suicide bomber snuffs out five lives at a tea shop.
18527,12/9/2012,Pakistan,Orangi,1,0,1,An Ahmadi is gunned down on account of his religious faith.
18528,12/9/2012,Somalia,Mogadishu,8,10,18,Eight people are turned into 'pieces of meat' by a suicide bombing at a hotel.
18529,12/9/2012,Syria,Aleppo,4,13,17,Four foreign civilians are killed by suspected Sunni terrorists.
18530,12/9/2012,Iraq,Qaidiriya,1,0,1,The imam of a mosque is assassinated by Religion of Peace rivals.
18531,12/9/2012,Iraq,Hillah,1,1,2,'Insurgents' murder a shepherd and injure his son.
18532,13/9/2012,Pakistan,Quetta,3,4,7,A 2-year-old is among the casualties when Sunnis spray a car carrying Shias with automatic weapons fire.
18533,13/9/2012,Syria,Damascus,3,16,19,Sunnis attempt to attack a Shia shrine.  At least three people are killed in the clash.
18534,13/9/2012,Pakistan,Landi Kotal,4,0,4,Four Taliban opponents are blown to bits by a roadside bomb.
18535,13/9/2012,Nigeria,Maiduguri,4,0,4,Four people are killed in a Boko Haram terror attack.
18536,13/9/2012,Dagestan,Khasavyurt,1,2,3,"Following the death of their leader, Kizlyar Islamists ambush police, killing one."
18537,13/9/2012,Pakistan,Akkakhel,4,2,6,Two children are among four members of a family crushed in their own home by a Lashkar-e-Islam rocket.
18538,13/9/2012,Pakistan,Bara,5,0,5,Five civilians are sent to Allah by Sunni bombers.
18539,14/9/2012,Thailand,Pattani,1,2,3,Muslim 'separatists' shoot a villager in the head in front of his wife and 7-year-old daughter.
18540,14/9/2012,Iraq,Samarah,2,18,20,"Islamist terrorists set off a bomb at a crowded market, killing at least two."
18541,14/9/2012,Afghanistan,Helmand,2,9,11,"Two US Marines are murdered by Taliban ""in revenge"" for a film mocking Muhammad."
18542,14/9/2012,Pakistan,Malir,1,1,2,Two young men are shot by sectarian Jihadis.
18543,15/9/2012,Pakistan,Karachi,2,4,6,Six Christians are shot at close range in their homes by Religion of Peace gunmen.
18544,15/9/2012,Iraq,Hajj Ali,3,0,3,Three cousins are murdered in their own home by Mujahideen.
18545,15/9/2012,Afghanistan,Helmand,2,4,6,A terrorist in police uniform shoots two British soldiers coming to help him after he fakes an injury.
18546,15/9/2012,India,Ghaziabad,0,3,3,Three policemen are critically injured by rioters angry over rumors of a Quran found with marks.
18547,15/9/2012,Afghanistan,Jogak,5,0,5,Five local cops are murdered by Sunni fundamentalists.
18548,15/9/2012,Dagestan,Khutrakh,3,2,5,Fundamentalists shoot three policemen to death.
18549,15/9/2012,Pakistan,Gulistan-e-Jauhar,1,0,1,An Ahmadi shopkeeper is murdered after being labeled a Kafir by Sunnis.
18550,15/9/2012,Thailand,Pattani,4,0,4,Muslim militants ambush a vehicle and shoot four occupants to death including a housekeeper.
18551,16/9/2012,Pakistan,Hyderabad,0,1,1,Islamists angered over a Muhammad film ambush a nun and her driver outside a cathedral.
18552,16/9/2012,Pakistan,Ghareebabad,1,0,1,A Shiite youth is found beheaded four days after being kidnapped by Wahhabis.
18553,16/9/2012,Nigeria,Zango,6,9,15,"Islamic radicals attack a group of civilians playing cards, killing at least six."
18554,16/9/2012,Israel,Tira,1,0,1,A 22-year-old woman is stabbed to death by her younger brother on suspicion of immorality.
18555,16/9/2012,Afghanistan,Zabol,4,2,6,Four US troops are shot in the back by Taliban in police uniforms.
18556,16/9/2012,Egypt,Sinai,1,7,8,A border guard dies after being shot in the stomach by Salafis.
18557,16/9/2012,Nigeria,Kano,4,0,4,"Islamists enter a home and shoot a 3-year-old girl to death along with her family, which includes a crippled uncle."
18558,16/9/2012,Pakistan,Jandool,16,7,23,Three women and three children are among sixteen civilians taken apart by a Sunni hardliner bomb.
18559,16/9/2012,Afghanistan,Gereshk,12,0,12,A dozen women and young children are destroyed by Taliban bombers.
18560,16/9/2012,Yemen,Mukalla,3,4,7,"al-Qaeda militants level two vehicles, killing three Yemenis."
18561,17/9/2012,Iraq,Baghdad,7,24,31,Seven commuters are obliterated by a Shahid suicide car bomber during rush hour.
18562,17/9/2012,Pakistan,Mustafa,1,0,1,A 45-year-old doctor is shot to death by sectarian Jihadis.
18563,17/9/2012,Iraq,Mosul,1,0,1,Terrorists assassinate a rival imam.
18564,17/9/2012,Nigeria,Borno,1,0,1,A top judge is assassinated by Boko Haram gunmen.
18565,17/9/2012,Nigeria,Azare,2,0,2,Islamists gun down a retired prison official and his bodyguard.
18566,17/9/2012,Thailand,Yala,2,0,2,A Buddhist couple is ambushed in their truck and slaughtered by Muslims with shotguns.
18567,17/9/2012,Dagestan,Gubden,1,0,1,A businessman is shot to death by Muslim militants.
18568,18/9/2012,Pakistan,Gorakhpur,1,0,1,A conservative Muslim ties his daughter to a tree and hacks her to death for disobeying him.
18569,18/9/2012,Pakistan,Karachi,8,21,29,A 12-year-old girl is among eight members of the Dawoodi Bohra (Shia) minority are blasted into the next world by Sunni bombers.
18570,18/9/2012,Pakistan,Mastung,3,9,12,Three Shia pilgrims are sent to Allah in a targeted attack by a Sunni suicide bomber.
18571,18/9/2012,Afghanistan,Kabul,12,11,23,"A female suicide bomber massacres a busload of foreigners ""in revenge"" for a film about Muhammad that the victims had nothing to do with."
18572,18/9/2012,Afghanistan,Kunar,1,4,5,Sunni extremists claim a suicide bombing that leaves a civilian dead.
18573,18/9/2012,Iraq,Muqdadiya,2,0,2,Muslim terrorists machine-gun two farmers in their orchard.
18574,18/9/2012,Iraq,Kirkuk,4,2,6,The Islamic Army of Iraq guns down four people near a university.
18575,19/9/2012,Iraq,Baqubah,3,5,8,Three Iraqis are disassembled by a Fedayeen suicide bomber.
18576,19/9/2012,Pakistan,Scheme Chowk,9,34,43,Nine people along a city street are obliterated by a Taliban bomb containing ball bearings.
18577,19/9/2012,France,Sarcelles,0,1,1,A member of an Islamist cell throws a grenade into a kosher grocery store.
18578,19/9/2012,Iraq,Tal Afar,2,0,2,A female suicide bomber sends two other souls to Allah.
18579,19/9/2012,Iraq,Mosul,7,0,7,Seven Iraqis are murdered by Islamic 'insurgents'
18580,20/9/2012,Philippines,Basilan,4,6,10,Abu Sayyaf gunmen shoot dead four unarmed laborers.
18581,20/9/2012,Afghanistan,Dehrawood,5,0,5,Two boys and two women are blown to bits by fundamentalist bombers.
18582,20/9/2012,Somalia,Mogadishu,15,22,37,"Two Religion of Peace suicide bombers detonate in a restaurant, taking out fifteen patrons."
18583,20/9/2012,Iraq,Baghdad,6,2,8,A children's doctor is among six Iraqis who lose their lives to Muslim terrorists.
18584,21/9/2012,Pakistan,Peshawar,2,0,2,Two people are killed by a mob protesting a film of Muhammad.
18585,21/9/2012,Thailand,Pattani,6,40,46,Muslims detonate a car bomb to punish businesses for staying open during an Islamic holy day.
18586,21/9/2012,Pakistan,Karachi,1,0,1,A policeman is gunned down by a mob celebrating Muhammad's 'Day of Love'.
18587,21/9/2012,Afghanistan,Nawa,5,0,5,Woman and children are among five people exterminated by Taliban bombers.
18588,21/9/2012,Israel,Sinai,1,0,1,"Terrorists shoot fire at a group of IDF soldiers providing water to migrants, killing one."
18589,21/9/2012,Syria,Damascus,20,0,20,Twenty victims of a Sunni terror group are discovered defaced and burned.
18590,21/9/2012,Pakistan,Mardan,0,12,12,Thousands of burn down a Lutheran church and thrash a dozen Christians.
18591,21/9/2012,Yemen,Rada,1,3,4,Shiites storm a Sunni mosque and murder a cleric.
18592,21/9/2012,Somalia,Mogadishu,1,0,1,A lawmaker is shot to death along a city street by Islamic militia.
18593,22/9/2012,Yemen,Amran,8,12,20,Eight people are killed when Sunnis and Shias clash over their differences.
18594,22/9/2012,Pakistan,Kurram,2,0,2,Roadside bomber pick off a couple of pedestrians.
18595,22/9/2012,Iraq,Duluiyah,5,4,9,Sunni bombers send five Iraqis to Allah.
18596,22/9/2012,Pakistan,Karachi,1,0,1,A 25-year-old Shiite is murdered by sectarian Jihadis.
18597,22/9/2012,Pakistan,Karachi,1,0,1,A 60-year-old member of the Ahmadi religious minority is gunned down by Sunnis.
18598,23/9/2012,Afghanistan,Shinkot,5,0,5,The Taliban murder five local police.
18599,23/9/2012,Nigeria,Bauchi,2,48,50,A woman and a child at a church service are murdered by a Shahid suicide car bomber.
18600,23/9/2012,Iraq,Baghdad,3,7,10,"Terrorists bomb a mini-bus, killing three passengers."
18601,23/9/2012,Yemen,Amran,12,9,21,A dozen more people are killed in a second day of clashes between Sunni and Shia.
18602,23/9/2012,India,Baramulla,1,0,1,A local official is assassinated by suspected Hizbul Mujahideen.
18603,23/9/2012,Pakistan,Sheikh Uttar,1,0,1,A villager is shot to death by Muslim militants.
18604,24/9/2012,Dagestan,Khasavyurt,1,0,1,A professor is assassinated after denouncing Islamic extremism.
18605,24/9/2012,Iraq,Hit,4,6,10,Four schoolchildren are disassembled by a Holy Warrior with a car full of explosives.
18606,24/9/2012,Pakistan,Nankana Sahib,1,0,1,A caretaker at a Shia shrine is assassinated by Sunni gunmen.
18607,24/9/2012,Pakistan,Karachi,4,1,5,Four men are brought down along the side of the road by sectarian gunmen.
18608,24/9/2012,Iraq,Baghdad,4,0,4,al-Qaeda snipers pick off four security guards at a roadblock.
18609,25/9/2012,Pakistan,Layyah,1,30,31,A bomb blast targeting pilgrims leaves one dead.
18610,25/9/2012,Iraq,Baghdad,9,11,20,Terrorists kill nine Iraqi security personnel in a series of attacks.
18611,25/9/2012,Pakistan,Karachi,3,1,4,Suspected Sipah-e-Mohammad gunmen murder a man and his two sons for belonging to a rival Sunni sect.
18612,26/9/2012,Pakistan,Quetta,1,0,1,A Shiite professional is brutally gunned down outside his office by devout Sunnis
18613,26/9/2012,Syria,Barzeh,16,0,16,Six women and three children are among sixteen Sunni civilians pulled from their homes and executed by Shia militia.
18614,26/9/2012,Pakistan,Shawal,2,14,16,A Taliban bomb leaves two dead and fourteen injured.
18615,26/9/2012,Afghanistan,Logar,2,1,3,Two NATO soldiers are killed by a Shahid suicide bomber.
18616,26/9/2012,Pakistan,Gulberg,1,0,1,A 32-year-old Shiite father is cut down by Shia snipers after dropping off his children at school.
18617,26/9/2012,Iraq,Baghdad,7,4,11,A second day of 'insurgent' bombings leaves seven locals dead.
18618,26/9/2012,Pakistan,Karachi,2,2,4,A Shia man and a passerby die following a Sunni drive-by.
18619,26/9/2012,Syria,Damascus,4,14,18,A Shahid suicide bomber takes out four security guards.
18620,27/9/2012,Yemen,Hadramout,3,0,3,Three children are pulled into pieces by al-Qaeda bombers.
18621,27/9/2012,Iraq,Tikrit,13,34,47,A Fedayeen assault on a prison leave thirteen guards dead.
18622,27/9/2012,Somalia,Mogadishu,1,3,4,A woman is killed when an Islamic terrorist throws a grenade into the street.
18623,27/9/2012,Pakistan,Jhalaka Mela,2,7,9,Two students are torn to shreds by a Tehreek-e-Taliban bomb.
18624,27/9/2012,Pakistan,Quetta,2,0,2,Two Shia civilians are assassinated in separate Sunni drive-by attacks.
18625,27/9/2012,Pakistan,Bilal,1,0,1,A mosque caretaker is sprayed with bullets by sectarian rivals.
18626,28/9/2012,Pakistan,Sheikhan,1,0,1,A police officer is killed trying to defuse a Taliban bomb.
18627,28/9/2012,Thailand,Yala,2,0,2,An elderly couple is slain outside a plantation by Muslim militants.
18628,28/9/2012,Somalia,Mogadishu,1,0,1,al-Shabaab is thought responsible for the beheading of a journalist.
18629,28/9/2012,Pakistan,Youhanaabad,0,1,1,A protestant bishop is assaulted and by angry Muslims and beaten outside his church.
18630,28/9/2012,Pakistan,Karachi,1,0,1,A prayer leader is sprayed with bullets by sectarian rivals.
18631,28/9/2012,Pakistan,Karachi,1,0,1,A 45-year-old lab technician is murdered for being Sunni.
18632,28/9/2012,Pakistan,Karachi,1,0,1,A 35-year-old tailor is assassinated in his shop by sectarian Jihadis.
18633,28/9/2012,Pakistan,Karachi,1,0,1,A 38-year-old garage owner is shot to death for his religious affiliation.
18634,28/9/2012,Thailand,Pattani,1,0,1,A police officer is laid out by a Muslim drive-by.
18635,29/9/2012,Syria,Zeinab,2,0,2,"Two Shia youth are abducted, tortured and beheaded by the Sunni FSA."
18636,29/9/2012,Afghanistan,Herat,2,2,4,Two people are blown to bits by a Taliban roadside bomb.
18637,29/9/2012,Iraq,Baqubah,2,4,6,Jihadi car bombers send two Iraqis to Allah.
18638,29/9/2012,Iraq,Mosul,2,3,5,Sunni gunmen take out a religious minority and his son.
18639,29/9/2012,Yemen,Lawdar,1,9,10,A Shahid suicide bomber kills a civilian.
18640,29/9/2012,Thailand,Yala,1,3,4,Muslim 'separatists' shoot a married woman in the back as she is riding a motorcycle with her husband.
18641,29/9/2012,Pakistan,Karachi,1,0,1,A 55-year-old Shia is gunned down by Sunnis.
18642,29/9/2012,Thailand,Pattani,1,0,1,A traditional medicine trader is murdered by Muslim gunmen.
18643,29/9/2012,Thailand,Yala,1,0,1,Brave Mujahideen shoot a 74-year-old Buddhist man to death.
18644,29/9/2012,Thailand,Narathiwat,1,1,2,A 42-year-old Buddhist woman is machine-gunned by Runda Kumpulan Kecil while riding with her husband.
18645,29/9/2012,Saudi Arabia,Sadad,1,0,1,"Sunni security forces open fire on a peaceful Shiite demonstration, killing a teenager."
18646,30/9/2012,Thailand,Yala,1,4,5,A Buddhist married couple and other villagers are the victims of targeted shootings by Muslim 'separatists'.
18647,30/9/2012,Thailand,Pattani,1,2,3,A 20-year-old man is gunned down outside a teashop by Muslim 'separatists'.
18648,30/9/2012,Kenya,Garissa,2,0,2,Two border policemen are shot to death by suspected al-Shabaab sympathizers.
18649,30/9/2012,Syria,Qamishli,30,80,110,A Shahid suicide car bomber takes thirty other souls with him.
18650,30/9/2012,Kenya,Nairobi,1,6,7,A child is killed when Religion of Peace proponents toss a grenade into a church.
18651,30/9/2012,Iraq,Baghdad,3,12,15,Three civilians are blown to bits by Mujahideen bombers.
18652,30/9/2012,Iraq,Baghdad,12,43,55,A series of al-Qaeda terror attacks around the country leaves fifteen more Iraqis dead.
18653,30/9/2012,Iraq,Taji,8,28,36,The Islamic Army of Iraq takes down eight people with three car bombs.
18654,30/9/2012,Iraq,Madain,3,11,14,Three Shia pilgrims riding a minibus are exterminated by Sunni bombers.
18655,30/9/2012,Thailand,Narathiwat,0,30,30,Islamists fire grenades into a local fair.
18656,30/9/2012,Iraq,Kut,6,10,16,Six Iraqis are blown to bits by Islamic State of Iraq car bombers.
18657,1/10/2012,Afghanistan,Kunduz,1,0,1,A 20-year-old woman is beheaded by Islamic fundamentalists.
18658,1/10/2012,Afghanistan,Khost,14,37,51,"A Fedayeen suicide bomber murders fourteen people, including three Americans."
18659,1/10/2012,Thailand,Narathiwat,1,0,1,A 40-year-old Buddhist teacher is shot three times in the head by Muslim militants.
18660,1/10/2012,Syria,Said Naya,3,0,3,Three Christians are abducted and murdered by a Muslim 'gang'.
18661,2/10/2012,Pakistan,Mattani,1,4,5,A civilian is left dead following a Taliban rocket attack.
18662,2/10/2012,Nigeria,Mubi,26,15,41,"At least twenty-six Christian students are singled out and executed by Islamists at their campus.  Some are shot, others have their throats cut."
18663,2/10/2012,Thailand,Pattani,2,0,2,Two people are machine-gunned in their pickup truck by Muslim militants.
18664,2/10/2012,Iraq,Baghdad,6,5,11,A garbage collector is among six people killed in Mujahideen attacks around the country.
18665,3/10/2012,India,Kerala,1,0,1,A Hindu boy is burned alive by angry Muslims after falling in love with a Muslim girl.
18666,3/10/2012,Thailand,Narathiwat,1,0,1,Islamic 'separatists' shoot a shop owner to death in his store.
18667,3/10/2012,Syria,Aleppo,60,100,160,Three suicide car bombings by al-Nusra terrorists eventually leave sixty dead.
18668,3/10/2012,Yemen,Lahj,2,3,5,An al-Qaeda ambush leaves three dead.
18669,3/10/2012,Libya,Susa,3,1,4,Religious radicals murder three local police.
18670,3/10/2012,Ingushetia,Magas,4,2,6,Four Russian policemen are ambushed and killed by Religion of Peace extremists.
18671,3/10/2012,Pakistan,Layyah,1,0,1,A girl is murdered by her parents for marrying without their permission.
18672,4/10/2012,Iran,Tehran,4,0,4,Four women are stoned to death for adultery.
18673,4/10/2012,Iraq,Baghdad,5,13,18,Mujahid bombers take out five Iraqis.
18674,4/10/2012,Pakistan,Karachi,1,0,1,A famed singer is murdered by Sunnis for belonging to the Shiite sect.
18675,4/10/2012,Thailand,Yala,1,0,1,Muslim 'separatists' gun down a retired civilian on his way home.
18676,4/10/2012,Pakistan,Badhaber,2,0,2,Suspected Taliban gunmen murder a cop and a boy in separate attacks.
18677,4/10/2012,Pakistan,Lundianwala,1,0,1,A man stabs his daughter to death on suspicion of immoral behavior.
18678,5/10/2012,Cameroon,Makary,1,0,1,Nigerian Islamists cross the border and murder a town's mayor.
18679,5/10/2012,Afghanistan,Sargadana,1,3,4,An Afghan refugee is killed by a Shahid suicide bomber.
18680,5/10/2012,Mali,Douentza,2,0,2,"Islamists fire on a civilian vehicle, killing two passengers"
18681,5/10/2012,Nigeria,Jalingo,2,11,13,"Fundamentalists bomb two bars, killing two people."
18682,5/10/2012,Thailand,Pattani,1,1,2,"A Buddhist man is killed, and his wife wounded when Islamic 'separatists' fire into their car."
18683,5/10/2012,Iraq,Baghdad,5,26,31,Five people are killed when Sunnis set off two bombs outside a Shiite mosque after prayers.
18684,5/10/2012,Israel,Ramle,1,0,1,An imam is murdered in his own mosque following a religious dispute with members.
18685,5/10/2012,Tunisia,Gabes,0,5,5,Salafis shout 'No God but Allah' as they beat Shias with sticks and batons.
18686,6/10/2012,Pakistan,Quetta,3,0,3,Sipah-e-Sahaba terrorists shoot three Shias to death including two teens.
18687,6/10/2012,Nigeria,Jalingo,1,5,6,Boko Haram bombers kill a woman and injure her five children.
18688,6/10/2012,Iraq,Baghdad,4,11,15,Mujahideen bombers take down four vendors at a vegetable market.
18689,6/10/2012,Pakistan,Bara,5,4,9,Five villagers are cut down by a Lashkar-e-Islam attack.
18690,6/10/2012,Thailand,Pattani,1,0,1,"A Muslim terrorist with a handgun shoots at a Buddhist couple at a petrol station, killing the husband."
18691,6/10/2012,Pakistan,Gosal,1,1,2,One defender is killed when Tehreek-i-Taliban militants fire RPGs at a check post.
18692,6/10/2012,Nigeria,Dogon Kuka,17,12,29,Seventeen civilians are killed during an Islamist assault on their village.
18693,6/10/2012,Afghanistan,Edgah,2,0,2,"Two children, ages 9 and 16, are shot to death by Taliban to punish their father for refusing to quit the police force."
18694,7/10/2012,Syria,Damascus,1,8,9,Jabhat al-Nusra is suspected of a car bomb attack that leaves one dead.
18695,7/10/2012,Dagestan,Buinaksk,1,0,1,"A local cop is abducted by Islamists, bound and then executed."
18696,7/10/2012,Pakistan,Musa Colony,1,0,1,Sunnis spray a Shia man with bullets.
18697,7/10/2012,Somalia,Mogadishu,4,0,4,Four people are reported dead following an al-Shabaab ambush.
18698,8/10/2012,Nigeria,Maiduguri,7,1,8,"Boko Haram set off a bomb, killing seven local soldiers."
18699,8/10/2012,Afghanistan,Laskgar Gah,2,15,17,A Taliban bomb takes out two security guards.
18700,8/10/2012,Thailand,Pattani,3,0,3,Three villagers in a pickup truck are riddled with machine-gun fire by Muslim 'separatists'.
18701,8/10/2012,Thailand,Pattani,2,0,2,A Buddhist married couple in their sixties are slain in cold blood by Islamic terrorists.
18702,8/10/2012,Nigeria,Maiduguri,13,20,33,Thirteen civilians are reportedly killed in a Boko Haram blast prior to a shooting rampage.
18703,8/10/2012,Pakistan,Karachi,1,0,1,Lashkar-e-Jhangv is suspected in the targeted killing of a young Shia.
18704,8/10/2012,Kenya,Dadaab,1,0,1,al-Shabaab is thought responsible for the murder of a tribal elder at a refugee camp.
18705,9/10/2012,Nigeria,Kano,2,0,2,Devout Muslims kill two cops guarding health workers administering polio immunizations to children following a rumor at their mosque.
18706,9/10/2012,Syria,Harasta,75,60,135,Seventy-five people eventually die from two massive al-Nusra suicide blasts.
18707,9/10/2012,Pakistan,Sipah,7,0,7,"Lashkar-e-Islam kidnap, torture and kill seven Muslim rivals."
18708,9/10/2012,Pakistan,Karachi,1,0,1,A 38-year-old Shiite is picked off by Sipah-e-Sahaba snipers.
18709,9/10/2012,Afghanistan,Helmand,3,0,3,Three civilians are sent to Allah by Taliban bombers.
18710,9/10/2012,Iraq,Mosul,5,1,6,A judge is among five people killed in Mujahideen attacks.
18711,9/10/2012,Somalia,Kismayo,1,3,4,A boy bleeds to death following a suspected al-Shabaab grenade attack on a tea shop.
18712,9/10/2012,Somalia,Alanley,2,5,7,A suspected Islamist bomb leaves two dead.
18713,9/10/2012,Pakistan,Nazimabad,1,0,1,A Shiite is shot to death by sectarian Jihadis.
18714,9/10/2012,Thailand,Songkhla,2,0,2,Two vegetable vendors are murdered by Islamic 'insurgents'.
18715,9/10/2012,Thailand,Pattani,2,0,2,Two more Buddhist rubber tappers are shot to death hours after a similar attack.
18716,9/10/2012,Yemen,Marib,3,0,3,al-Qaeda beheads three Yemenis for the 'crime' of spying for their own government.
18717,9/10/2012,Thailand,Narathiwat,1,0,1,A female health volunteer is murdered by Islamic 'separatists'.
18718,9/10/2012,Thailand,Pattani,3,0,3,A father and son are among three Buddhists gunned down by Muslim militants.
18719,9/10/2012,Pakistan,Peshawar,0,3,3,A 14-year-old girl who won an award for trying to restore peace in the region survives being shot in the head by Islamic fundamentalists.
18720,9/10/2012,Afghanistan,Tarin Kot,1,0,1,A cleric is assassinated by Religion of Peace rivals.
18721,10/10/2012,Afghanistan,Nad Ali,6,0,6,Six local policemen are blown to bits by a roadside bomb planted by religious fundamentalists.
18722,10/10/2012,Philippines,Cagayan de Oro,2,6,8,A Moro Islamist faction is thought responsible for a hotel bombing that leaves two dead.
18723,10/10/2012,Pakistan,Upper Dir,1,0,1,Tehreek-e-Taliban militants gun down a village guard.
18724,10/10/2012,Nigeria,Riyom,14,5,19,Three children and their mother are among over a dozen Christians are slaughtered during a Muslim raid on their village.
18725,10/10/2012,Nigeria,Dallyam,4,4,8,Muslim terrorists shoot four members of a Christian family at close range.
18726,10/10/2012,Nigeria,Kano,2,1,3,Two people are shot to death in an unprovoked Islamist attack.
18727,10/10/2012,Nigeria,Barkin Ladi,2,0,2,Two Christians are machine-gunned while sitting in their car.
18728,10/10/2012,Israel,Beitar Illit,0,1,1,A Jewish man is stabbed in the neck by a Palestinian.
18729,10/10/2012,Pakistan,Dera Ismail Khan,1,0,1,A Shiite police officer is gunned down on the job by Sunni terrorists.
18730,10/10/2012,Somalia,Kismayo,1,2,3,A civilian is taken out by an al-Shabaab IED.
18731,11/10/2012,Pakistan,Landikotal,2,3,5,Two locals are taken down by Lashkar-e-Islam bomb blasts.
18732,11/10/2012,Afghanistan,Maidan Shar,2,2,4,Two civilians are dismantled by a Taliban rocket.
18733,11/10/2012,Syria,Arida,8,8,16,Eight bus passengers are massacred by gunmen after being beaten.
18734,11/10/2012,Yemen,Sanaa,1,0,1,The head of security at a US embassy is assassinated by al-Qaeda.
18735,11/10/2012,Pakistan,Sunzu Darra,8,22,30,Islamists strap a bomb to a donkey that destroys eight people at a market.
18736,11/10/2012,Pakistan,Derga Mandai,3,1,4,Suspected Taliban murder three people sitting in a car.
18737,11/10/2012,Iraq,Mosul,3,8,11,Mujahideen gunmen take down three Iraqis.
18738,12/10/2012,Maldives,Male,1,0,1,A liberal religious scholar is stabbed four times in the head at his home by fundamentalists angered over his stance on music.
18739,12/10/2012,Nigeria,Maidugur,2,0,2,Boko Haram shoot two businessmen to death outside a mosque.
18740,12/10/2012,Pakistan,Bakhshi Pul,1,0,1,A policeman is gunned down outside a mosque.
18741,12/10/2012,Nigeria,Rankum,3,2,5,"Muslim raiders shoot indiscriminately at villagers, killing three."
18742,12/10/2012,Thailand,Narathiwat,1,0,1,Islamic 'separatists' shoot a 55-year-old man twice in the head.
18743,12/10/2012,Pakistan,Parachinar,0,3,3,Sunnis spray Shia students with gunfire and acid.
18744,12/10/2012,Afghanistan,Kajaki,1,1,2,A 12-year-old boy is disassembled by a bomb planted by Sunni hardliners.
18745,13/10/2012,Afghanistan,Maruf,6,3,9,A half-dozen people are torn to shreds by a Fedayeen suicide bomber.
18746,13/10/2012,Afghanistan,Qalat,2,3,5,Taliban bombers murder two local cops.
18747,13/10/2012,Pakistan,Darra Adam Khel,18,40,58,Eighteen souls are sent to Allah by Shahid suicide car bombers.
18748,13/10/2012,Philippines,Lamitan,3,0,3,Three unarmed soldiers are murdered by Abu Sayyaf as they are buying food.
18749,14/10/2012,Nigeria,Yogbo,30,0,30,"Thirty people are left dead when Muslims resolve a ""land dispute"" by massacring thirty Christian villagers, mostly women and children."
18750,14/10/2012,Egypt,Abdelmassih,2,3,5,Two members of a Christian family are shot to death in their own home by a Muslim gang attempting to kidnap and convert a 24-year-old female relative.
18751,14/10/2012,Nigeria,Maiduguri,3,0,3,A family of three is cut down outside their church by Islamist gunmen.
18752,14/10/2012,Pakistan,Matni,7,12,19,Religion of Peace militants overrun a police station and behead seven officers.
18753,14/10/2012,Pakistan,Quetta,1,4,5,A Shia businessman is taken down by Lashkar-e-Jhagvi.
18754,14/10/2012,Pakistan,Karachi,1,0,1,A 30-year-old Shia man is gunned down in cold blood by Sipah-e-Sahaba terrorists.
18755,14/10/2012,Nigeria,Gwange,1,1,2,A tribal leader is assassinated by Boko Haram after being accused of 'betraying Islam'.
18756,15/10/2012,Iraq,Samarrah,3,0,3,A father and two sons are murdered in their own home by al-Qaeda.
18757,15/10/2012,Iraq,Tuz Khurmatu,2,2,4,Two local cops are machine-gunned at a checkpoint by Jihadis.
18758,15/10/2012,Pakistan,Karachi,5,2,7,Five men are shot to death over 'religious differences'.
18759,15/10/2012,Thailand,Narathiwat,1,2,3,"Islamic 'separatists' fire into a car carrying two women and a man, killing at least one."
18760,15/10/2012,Iraq,Mosul,1,3,4,A child is disassembled by Mujahid bombers.
18761,15/10/2012,Iraq,Kirkuk,3,23,26,Jihadi car bombers take out three Iraqis.
18762,15/10/2012,Iraq,Sinsil,4,0,4,"An 'insurgent' bursts into a home and machine-guns four family members to death, including two women."
18763,16/10/2012,Yemen,Sanaa,1,0,1,al-Qaeda on motorbikes shoot a man in the head.
18764,16/10/2012,Pakistan,Quetta,4,0,4,Four Shia minorities workers at a scrap market bleed to death following a targeted shooting by Sunnis.
18765,16/10/2012,Pakistan,Karachi,1,0,1,"A Shiite is gunned down by Sunni militants, who also fire on a rival mosque."
18766,16/10/2012,Kenya,Kulan,1,0,1,al-Shabaab Islamists murder a telecom engineer.
18767,16/10/2012,Yemen,Abyan,2,5,7,A Fedayeen suicide bomber kills two others.
18768,16/10/2012,Indonesia,Masani,2,0,2,Jamaah Anshorut Tauhid murder two investigators of a church bombing by stabbing them in the neck.
18769,17/10/2012,Pakistan,Qasba,1,0,1,Sectarian Jihadis gun down a father of three outside his shop.
18770,17/10/2012,Pakistan,Killi Jeo,1,0,1,Suspected Taliban shoot a medical worker to death as he is trying to vaccinate children.
18771,17/10/2012,Iraq,Baghdad,3,15,18,A bomb at a grocery is one of several that leave three civilians dead.
18772,17/10/2012,Afghanistan,Zurmat,0,45,45,A Shahid suicide bomber injures forty-five others.
18773,17/10/2012,Kenya,Likoni,1,9,10,Ten police officers are casualties of an al-Shabaab grenade.
18774,17/10/2012,Iraq,Muqdadiyah,2,0,2,Sunni gunmen take out two Shia civilians.
18775,18/10/2012,Thailand,Yala,1,0,1,A 53-year-old Buddhist man is hit several times in the torso by Muslim 'separatists'.
18776,18/10/2012,Pakistan,Dera Ismail Khan,1,1,2,A targeted assassination attempt on a Shia doctor leaves her driver dead.
18777,18/10/2012,Pakistan,Karachi,1,0,1,Sipah-e-Sahaba cadres torture a 28-year-old Shiite with a metal rod before dispatching him with three shots.
18778,18/10/2012,Tunisia,Tataouine,1,0,1,Islamic protesters murder a secular politician.
18779,18/10/2012,Nigeria,Angwan Alaku,12,3,15,"Fulani raiders fire on villagers, killing at least a dozen."
18780,18/10/2012,Somalia,Baidoa,4,0,4,al-Shabaab ambush and kill four Ugandan peacekeepers.
18781,19/10/2012,Lebanon,Tripoli,1,0,1,A cleric is shot in the head by a mob after appealing for peace.
18782,19/10/2012,Afghanistan,Herat,1,0,1,A mother of two is stabbed to death by her husband for defying his order not to work outside the house.
18783,19/10/2012,India,Srinagar,1,2,3,"Three Muslim terrorists opens fire inside a hotel, killing a bellboy."
18784,19/10/2012,Iran,Chabahar,2,6,8,"A suicide bomber is prevented from entering a mosque, but manages to kill two guards."
18785,19/10/2012,Yemen,Shuqra,21,15,36,Sixteen local soldiers and five civilians are exterminated at their base by al-Qaeda suicide bombers.
18786,19/10/2012,Pakistan,Zeridar,3,6,9,Three people are brought down by an Islamic IED attack on a passenger vehicle.
18787,19/10/2012,Afghanistan,Dawlat Abad,19,14,33,"Religion of Peace bombers massacre nineteen members of a wedding party, mostly women and children."
18788,19/10/2012,Iraq,Balad,4,11,15,Four Shiite pilgrims on a bus are sent straight to Allah by Sunni bombers
18789,19/10/2012,Nigeria,Potiskum,5,0,5,A raid on several schools by religious radicals leaves at least five dead.
18790,19/10/2012,Nigeria,Maiduguri,1,0,1,A Chinese construction worker is picked off by Islamic snipers.
18791,19/10/2012,Lebanon,Beirut,8,78,86,"A car bomb blast in a Christian suburb leaves eight dead, including children."
18792,19/10/2012,Pakistan,Lahore,1,0,1,A Shiite lawyer is taken down at a traffic light by Sunni assassins.
18793,19/10/2012,Pakistan,Baldia,1,2,3,"Sunnis fire on an Ahmadi minority family, killing one member."
18794,19/10/2012,Pakistan,Karachi,3,0,3,Three young seminary students on bicycles are murdered by sectarian rivals.
18795,19/10/2012,Afghanistan,Gereskh,6,0,6,Six local police officers are poisoned and shot by Taliban.
18796,20/10/2012,Iraq,Baghdad,4,1,5,Mujahideen shoot four Iraqis to death.
18797,20/10/2012,Pakistan,Gujranwala,1,0,1,A man is shot to death after being acquitted of defaming Muhammad.
18798,20/10/2012,Ukraine,Lviv,1,0,1,Three Muslims murder a Jewish doctor who was also a professor.
18799,20/10/2012,Nigeria,Potiskum,7,0,7,Three children and a woman are among seven family members abducted from their home and executed by Boko Haram.
18800,20/10/2012,Thailand,Pattani,1,0,1,A 59-year-old Buddhist is shot several times in the head by Muslim 'insurgents'.
18801,20/10/2012,Iraq,Baghdad,11,35,46,Vicious back-to-back bombings outside a Shia shrine leave at least eleven dead.
18802,20/10/2012,Nigeria,Potiskum,19,0,19,Nineteen additional bodies are discovered following an assault on a town by Islamic extremists.
18803,21/10/2012,Thailand,Narathiwat,2,7,9,Bombs planted by Muslim extremists leave two dead.
18804,21/10/2012,Nigeria,Atagara,2,0,2,Two people are killed when Islamic radicals torch a church.
18805,21/10/2012,Thailand,Narathiwat,1,0,1,A Buddhist teacher is shot to death by Muslim 'separatists'.
18806,21/10/2012,Syria,Damascus,13,29,42,A bomb targeting Christians on their way to church leaves thirteen dead.
18807,21/10/2012,Lebanon,Beirut,2,16,18,A clash between Sunni and Shia leaves two dead.
18808,21/10/2012,Jordan,Border,1,0,1,"Islamic extremists fire on a group of border guards, killing one."
18809,22/10/2012,Ethiopia,Gerba,1,2,3,A guard is killed when a Muslim mob attacks a government facility over an alleged threat to Islam.
18810,22/10/2012,Lebanon,Tripoli,7,12,19,"A 9-year-old girl is picked off by a sectarian sniper, one of seven who lose their lives in a Sunni-Shia clash."
18811,22/10/2012,Kenya,Likoni,1,7,8,A policemen dies from splinter injuries suffered when an al-Shabaab cadre lobs a grenade at him.
18812,22/10/2012,Afghanistan,Genewa,10,0,10,Ten Afghans are murdered during a Taliban attack on their convoy.
18813,22/10/2012,Afghanistan,Ismael Khel,2,4,6,Two local police officers lose their lives to a well-placed Taliban landmine.
18814,22/10/2012,Somalia,Afmadow,5,12,17,"Islamists shell a town's sleeping residents in the early morning hours, killing at least five."
18815,23/10/2012,Pakistan,Nazimabad,1,2,3,"Sipah-e-Sahaba militants fire on three Shias at a grocery store, killing one."
18816,23/10/2012,Russia,North Ossetia,1,3,4,A Fedayeen suicide bomber takes out a local cop.
18817,23/10/2012,Pakistan,Lyari,1,0,1,A reporter dies from injuries a few days after being shot by Sunnis who labeled him an 'impure Muslim'.
18818,23/10/2012,Iraq,Shuala,9,26,35,Targeted car bombings in a Shiite neighborhood leave at least nine residents dead.
18819,24/10/2012,Israel,Ashkelon,0,7,7,Palestinian militants fire 68 rockets toward an Israeli town over a 24-hour period.
18820,24/10/2012,Syria,Daf al-Shok,6,20,26,A Shahid suicide car bomber sends six other souls to Allah.
18821,24/10/2012,Russia,Kazan,1,1,2,A police officer dies from injuries suffered when an Islamic militant self-detonates.
18822,24/10/2012,Iraq,Kazaniyah,2,0,2,Sunni gunmen pick off two civilians.
18823,24/10/2012,Iraq,Kirkuk,1,2,3,Mujahideen take out a small child with a roadside bomb.
18824,24/10/2012,Iraq,Mishahada,6,0,6,Six employees at a parts factory are brutally machine-gunned by al-Qaeda on their way home.
18825,24/10/2012,Pakistan,Gulshan,1,3,4,Militants kill a teenage girl in a bomb attack on her family home.
18826,25/10/2012,Syria,Qatana,1,0,1,An Orthodox priest is horribly tortured and murdered by Muslim 'criminals'.  His eyes were gouged out.
18827,25/10/2012,Pakistan,Karachi,1,0,1,A 40-year-old Shiite is gunned down at a market by Wahhabi terrorists.
18828,25/10/2012,Somalia,Jamama,1,0,1,A woman is stoned to death by Islamists in the town square for adultery.
18829,25/10/2012,Pakistan,Gilgit,1,0,1,Qazi Aisar members shoot a Shiite in the head at a bazaar.
18830,25/10/2012,Pakistan,Karachi,5,0,5,Sectarian Jihadis take down five people from a rival mosque at a restaurant.
18831,25/10/2012,Yemen,Damar,2,0,2,An al-Qaeda drive-by leaves two dead.
18832,25/10/2012,Afghanistan,Faryab,7,0,7,Seven innocents are killed when religious radicals take over a bazaar.
18833,25/10/2012,Pakistan,Charbagh,2,0,2,"Islamists open fire in front of a mosque, taking down two members of a peace committee."
18834,25/10/2012,Afghanistan,Uruzgan,2,0,2,A Taliban in police uniform shoots two American soldiers in the back.
18835,25/10/2012,Somalia,Wanlaweyn,8,12,20,"A suspected al-Shabaab mortar hits a bus, obliterating eight passengers."
18836,26/10/2012,Kenya,Daadab,1,0,1,al-Shabaab assassinate a police officer at a mosque.
18837,26/10/2012,Iran,Sarbaz,2,0,2,Sunni terrorists are suspected in a drive-by attack that leaves two dead.
18838,26/10/2012,Syria,Damascus,5,32,37,Terrorists blow up several children at a playground.
18839,26/10/2012,Afghanistan,Maimana,41,70,111,"A suicide bomber detonates at a rival mosque, sending at least forty-one worshippers to Allah, including five children."
18840,26/10/2012,Afghanistan,Andar,5,0,5,Five minority Shiite civilians are pulled off a bus and executed in cold blood by religious radicals.
18841,26/10/2012,Iraq,al-Mahawil,2,6,8,A Sunni car bomb at a Shia mosque leaves two worshippers dead.
18842,27/10/2012,Syria,Deir Ezzor,5,24,29,"Terrorists set off a car bomb in front of a church, killing five innocents."
18843,27/10/2012,Iraq,Bawiya,8,24,32,Four children are among eight people disassembled by Islamic State of Iraq bombers at a playground.
18844,27/10/2012,Iraq,Mosul,5,7,12,Mujahideen take out five Iraqis in a series of bombing and shooting attacks.
18845,27/10/2012,Iraq,Baghdad,12,27,39,Twelve patrons at a market in a Shiite neighborhood are obliterated by Jihadi bombers.
18846,27/10/2012,Iraq,Taji,5,9,14,Sunnis murder five Shia pilgrims on their way to a shrine by attaching a bomb to their bus.
18847,27/10/2012,Pakistan,Latifabad,1,0,1,"A Hindu is shot to death by Muslims, apparently with sectarian motives."
18848,27/10/2012,Iraq,Sadr City,10,31,41,al-Qaeda bombers take out ten innocents waiting for a bus.
18849,27/10/2012,Pakistan,Dera Islamael Khan,2,6,8,Two Shiite teenagers die from splinter injuries suffered when a Sipah-e-Sahaba cadre throws a grenade at them.
18850,27/10/2012,Somalia,Kismayo,5,14,19,Five local soldiers bleed to death from an Islamist bomb planted at a police station.
18851,28/10/2012,Egypt,Cairo,0,5,5,Five Christians are injured by Muslims trying to block their way into church.
18852,28/10/2012,Iraq,Kadhimiyah,13,28,41,Thirteen Shiites celebrating their Eid are slaughtered in their own neighborhood by Sunni bombers.
18853,28/10/2012,Thailand,Yala,1,16,17,Muslim 'separatists' shoot a plantation worker in the head and throw a grenade into restaurant.
18854,28/10/2012,Nigeria,Kaduna,7,100,107,Seven worshippers are murdered when a suicide car bomber plows into a Catholic church during mass.
18855,28/10/2012,Pakistan,Kaka Sahib,4,23,27,"Militants following a 'strict version of Islam' bomb the shrine of a saint, killing four patrons."
18856,28/10/2012,Iraq,Madain,3,8,11,Marketplace bombers murder three shoppers.
18857,28/10/2012,Somalia,Merca,5,0,5,An al-Shabaab ambush leaves five Somali soldiers dead.
18858,28/10/2012,Syria,Jaramana,12,69,81,Twelve people outside a bakery in a Christian district are exterminated in a targeted bomb attack.
18859,28/10/2012,Sudan,Delami,1,9,10,"The Islamic Republic of Sudan aerial bombs several Christian villages, killing a 1-year-old baby."
18860,28/10/2012,Pakistan,Karachi,1,0,1,A 37-year-old printer is murdered by Lashkar-e-Jhangvi for not being Sunni.
18861,28/10/2012,Nigeria,Gashish,4,7,11,Suspected fundamentalists storm a local bar and murder four alcohol drinkers.
18862,29/10/2012,Syria,Damascus,10,41,51,"Sunni terrorists detonate a car bomb in a suburb that leaves fifteen residents dead, mostly women and children."
18863,29/10/2012,Pakistan,Battagram,2,0,2,A woman and her alleged lover are taken into a house and machine-gunned by a conservative family member.
18864,29/10/2012,Pakistan,Nala,3,0,3,Lashkar-e-Islam ambush and kill three security personnel.
18865,29/10/2012,Tunisia,La Manouba,0,2,2,"Fundamentalists target alcohol vendors, cutting off the fingers of one."
18866,29/10/2012,Somalia,Mogadishu,1,0,1,A famous composer and comedian who poked fun of Islamic fundamentalists is assassinated.
18867,29/10/2012,Somalia,Bardale,1,1,2,"Islamists fire into a family home, killing one occupant."
18868,30/10/2012,Dagestan,Derbent,3,0,3,A 'pro-peace' cleric is assassinated in his car along with his father and brother.
18869,30/10/2012,Syria,Homs,1,0,1,An 84-year-old Christian is murdered by Sunnis.
18870,30/10/2012,Afghanistan,Nahr-e Saraj,2,0,2,A terrorist dons a police uniform and shoots two British troops in the back.
18871,30/10/2012,Afghanistan,Maruf,6,0,6,Six civilians in a minivan are sent to Allah by a bomb planted by religious radicals.
18872,30/10/2012,Somalia,Kismayo,4,24,28,"al-Shabaab militants toss a grenade into a tea shop, slaughtering four civilians."
18873,31/10/2012,Libya,Derna,1,0,1,Islamists are suspected in the assassination of a former official.
18874,31/10/2012,Syria,Al-Mazzeh,1,2,3,Sunni rebels plant a bomb near a rival mosque that leaves one dead.
18875,31/10/2012,Thailand,Pattani,2,4,6,"Muslim gunmen open fire on employees at an 'UnIslamic' gambling site at a fair, killing two."
18876,31/10/2012,Afghanistan,Kanjak,1,3,4,A man is killed and three children injured by Sunni bombers.
18877,31/10/2012,Pakistan,Karachi,4,5,9,The Tehreek-e-Taliban murder four people in targeted attacks.
18878,31/10/2012,Syria,Sayyida Zeinab,8,14,22,"Eight people, including two children are killed when Abu Al-Baraa bin Malek terrorists car bomb a Shiite mosque."
18879,31/10/2012,Afghanistan,Musa Qala,10,2,12,Three women and seven small children are torn to shreds by a Taliban bomb.
18880,31/10/2012,Iraq,Mosul,4,0,4,Post Eid al-Adha targeted killings leave four Shiites dead.
18881,31/10/2012,Pakistan,Khoi Ratta,1,0,1,A Muslim couple honor kill their daughter for talking to a man by dousing her with acid.
18882,31/10/2012,Jordan,Zarqa,1,0,1,A 22-year-old woman is strangled by her father on suspicion of having 'relations' with a man.
18883,1/11/2012,Pakistan,Jai,1,1,2,A 4-year-old girl is killed when Religion of Peace militants fire into her home.
18884,1/11/2012,Syria,Saraqeb,10,0,10,Ten captured soldiers are beaten and then executed by Sunni rebels to shouts of 'Allah Akbar'.
18885,2/11/2012,Sudan,Sigili,13,5,18,Janjaweed militia attack a village and kill over a dozen residents.
18886,2/11/2012,Afghanistan,Gereshk,4,0,4,Four local cops are gunned down by Taliban terrorists in uniform.
18887,2/11/2012,Libya,Benghazi,1,0,1,A 70-year-old cleric is shot to death in front of his mosque by hardline rivals.
18888,3/11/2012,Iran,Tehran,1,0,1,A blogger is arrested by the Islamic republic and quickly tortured to death in custody.
18889,3/11/2012,Pakistan,Karachi,2,0,2,Two Shiite victims of a Lashkar-e-Jhangvi attack expire from their injuries.
18890,3/11/2012,Thailand,Pattani,1,0,1,A 63-year-old man is shot off his motorcycle by Islamic 'separatists'.
18891,3/11/2012,Somalia,Mogadishu,2,10,12,Two people at a restaurant are sent to Allah by Fedayeen suicide bombers.
18892,3/11/2012,Pakistan,Buner,6,3,9,"A Shahid suicide bomber on a motorcycle detonates, killing six others."
18893,3/11/2012,Egypt,al-Arish,3,0,3,Jihadi gunmen murder three police officers.
18894,3/11/2012,Afghanistan,Dand,1,0,1,Fundamentalists take down a local cop with a roadside bomb.
18895,3/11/2012,Pakistan,Bahawalpur,1,0,1,A young woman is attacked and killed by her brothers for marrying of her own free will.
18896,3/11/2012,Afghanistan,Mehterlam,1,0,1,Sunni hardliners assassinate a rival cleric on his way to a seminary.
18897,3/11/2012,Iraq,Taji,3,2,5,Islamic 'insurgents' roll up on a checkpoint and machine-gun three local security personnel.
18898,3/11/2012,Iraq,Baghdad,1,0,1,A civilian defense volunteer is kidnapped and executed by al-Qaeda
18899,3/11/2012,Thailand,Narathiwat,3,8,11,Muslim car bombers take out three people near a school.
18900,3/11/2012,Jordan,Amman,1,0,1,A young woman's throat is cut by her uncle to claim family honor after she divorced her husband.
18901,4/11/2012,Nigeria,Borno,3,0,3,Boko Haram gunmen take down three patrons at a cattle market.
18902,4/11/2012,Thailand,Pattani,1,0,1,Muslim 'insurgents' are suspected of shooting a local civilian four times during a drive-by.
18903,4/11/2012,Kenya,Garissa,1,10,11,One person dies from splinter injuries when Islamists toss a grenade at a church.
18904,4/11/2012,Nigeria,Fika,2,0,2,At least two people are killed when Boko Haram militants attack a police station and primary school.
18905,4/11/2012,Pakistan,Quetta,1,0,1,Lashkar-e-Jhangvi shoot a Shia man to death in front of his mother and sister.
18906,4/11/2012,Pakistan,Sorsorang,3,0,3,"Tehreek-e-Taliban gunmen open fire on a group of Shia believers, killing at least three."
18907,4/11/2012,Pakistan,Chinar Kot,1,0,1,An anti-Taliban tribal activist is gunned down by Mujahideen.
18908,5/11/2012,Syria,al-Yarmouk,18,70,88,"al-Motasem terrorists reportedly target a bus packed with civilians, killing eighteen and injuring bystanders."
18909,5/11/2012,Saudi Arabia,Sharurah,2,0,2,Recently-released Islamic militants ambush and murder two border guards.
18910,5/11/2012,Bahrain,Manama,2,1,3,Five bombs planted by Shia militants linked to Hezbollah leave two dead.
18911,5/11/2012,Jordan,Ruseifa,1,0,1,Three brothers are accused of stabbing their married sister seventeen times over an immoral relationship.
18912,5/11/2012,Pakistan,Saddar,2,0,2,"Sectarian Jihadis shoot two Shia to death in their car, including a scholar."
18913,5/11/2012,Syria,Sahl al-Ghab,50,12,62,An Islamist group claims that fifty people were killed by a Shahid suicide bomb attack on an attack on a 'rural development center.'
18914,5/11/2012,Syria,Mezzeh,11,24,35,A dozen people are incinerated in a Seif-al-Sham car bomb blast.
18915,5/11/2012,Iraq,Baghdad,4,8,12,"Sunnis bomb a market near a Shiite mosque, killing four shoppers."
18916,5/11/2012,Pakistan,Mir Ali,3,0,3,Three local tribesmen are ambushed and killed by local Taliban.
18917,6/11/2012,Pakistan,Quetta,6,2,8,Three minority Shiites are shot to death in two sectarian attacks.
18918,6/11/2012,Thailand,Narathiwat,1,0,1,Muslim 'separatists' shoot and kill a 31-year-old man riding on a motorcycle.
18919,6/11/2012,Syria,Qudsaya,19,40,59,A Sunni car bomb in a Shia neighborhood leaves nineteen dead.
18920,6/11/2012,Syria,Damascus,3,7,10,"Sunnis target a Shiite residential district with mortars, killing at least three."
18921,6/11/2012,Iraq,Taji,33,56,89,Nearly three dozen Iraqis are dismantled by a Shahid suicide car bomber.
18922,6/11/2012,Pakistan,Hangu,1,5,6,"Mullah Nabi Hanafi terrorists storm a home, shoot the father to death and then beat his wife and children."
18923,6/11/2012,Pakistan,Hub,1,0,1,Wahhabis are blamed for the murder of a Shiite.
18924,7/11/2012,Egypt,Sohaj,2,0,2,A conservative family regains its honor by murdering a wayward daughter and her boyfriend.
18925,7/11/2012,Pakistan,Karachi,5,0,5,Five Shia civilians are picked off by Sipah-e-Sahaba snipers in three shootings.
18926,7/11/2012,Pakistan,Musharraf Colony,3,0,3,A father and son are among three Shiites kidnapped by Lashkar-e-Jhangvi and tortured to death.
18927,7/11/2012,Yemen,Sanaa,1,0,1,al-Qaeda assassinate a government official.
18928,7/11/2012,Somalia,Mogadishu,1,0,1,A guard is killed when Islamic militia set off a car bomb near the parliament.
18929,7/11/2012,Nigeria,Mubi,2,5,7,Children are among the casualties when Islamists set off a bomb along a city street.
18930,7/11/2012,Pakistan,Peshawar,6,36,42,A Fedayeen suicide bomber murders six others along a crowded street.
18931,7/11/2012,Nigeria,Benisheikh,2,0,2,Two Chinese engineers are murdered by suspected Islamist gunmen.
18932,7/11/2012,Pakistan,Ajab Khan Chowk,1,14,15,One person bleeds to death following a Taliban bomb attack on a market.
18933,7/11/2012,Iraq,Mosul,2,21,23,Sunni car bombers obliterate two religious minorities.
18934,8/11/2012,Syria,Damascus,3,24,27,Sunnis set off a car bomb outside a Shiite mosque that kills three worshippers.
18935,8/11/2012,Iraq,Hillah,1,9,10,"The Islamic Army of Iraq car-bombs a commercial district, killing a bystander."
18936,8/11/2012,Pakistan,Karachi,1,0,1,The 35-year-old owner of a pet shop is murdered by sectarian fundamentalists.
18937,8/11/2012,Pakistan,Orangi,2,0,2,An uncle and nephew are shot to death by Sunnis because they are Shia.
18938,8/11/2012,Pakistan,Karachi,3,20,23,A Shahid suicide bomber rams a government building because the occupants are 'doing nothing to serve Islam'.
18939,8/11/2012,Iraq,Mohmoudiya,3,7,10,"Sunni bombers target their sectarian rivals in a residential area, killing three."
18940,8/11/2012,Afghanistan,Badpakh,5,1,6,Sunni hardliners detonate a bomb that ends the lives of five local security personnel.
18941,8/11/2012,Dagestan,Makhachkala,1,7,8,A Muslim sniper murders a local cop.
18942,8/11/2012,Afghanistan,Musa Qala,10,7,17,Women and children are amply represented among the victims of a roadside bombing against a wedding party by religious radicals.
18943,8/11/2012,Afghanistan,Kandahar,3,2,5,A Fedayeen suicide bomber takes out three Afghans.
18944,8/11/2012,Afghanistan,Zabul,2,0,2,"Two boys, ages 12 and 14, are pulled into pieces by Religion of Peace bombers."
18945,8/11/2012,Iran,Tehran,1,0,1,A 'secular' blogger is abducted off the street and tortured to death.
18946,8/11/2012,Nigeria,Kachin,2,0,2,A man and his wife are murdered in their home by Muslim raiders.
18947,9/11/2012,Iraq,Mosul,2,1,3,Muslim 'insurgents' invade a home and shoot an old woman and her grandson to death.
18948,9/11/2012,Pakistan,Quetta,1,0,1,A Hazara Shia is murdered in a sectarian attack.
18949,9/11/2012,Nigeria,Damaturu,3,0,3,Boko Haram ambush and kill three police officers.
18950,9/11/2012,Pakistan,Karachi,1,0,1,A Shia scholar is gunned down by Sipah-e-Sahaba radicals.
18951,10/11/2012,Israel,Ashkelon,0,3,3,A border guard is blinded by Palestinian terrorists.
18952,10/11/2012,Nigeria,Gwange,1,0,1,Islamists shoot a refrigerator repair man to death in his shop.
18953,10/11/2012,Nigeria,Gaidam,5,0,5,Five Christian iron welders are slaughtered in their own home by Boko Haram gunmen.
18954,10/11/2012,Pakistan,Quetta,1,0,1,A Hazara religious minority is shot to death by Sunni radicals.
18955,10/11/2012,Pakistan,Quetta,2,2,4,Four Shiites riding in a cab are sprayed with bullets by Religion of Peace rivals.
18956,10/11/2012,Syria,Daraa,24,9,33,Suicide car bombers kill about two dozen Syrian troops at their base.
18957,10/11/2012,Pakistan,Kamalia,1,0,1,A teenager is hacked to death with an axe by her father for unIslamic behavior.
18958,10/11/2012,Pakistan,Mochiwala,1,0,1,A woman is killed in her home by an uncle on suspicion of extra-marital sex.
18959,10/11/2012,Iraq,Hillah,2,0,2,A woman and child are killed in their home by Jihadi bombers.
18960,11/11/2012,Pakistan,Karachi,6,9,15,Six Sunni seminary students are machine-gunned at a tea shop by angry Shiites.
18961,11/11/2012,Pakistan,Organi Town,3,2,5,A Shia father and his two sons are sent to Allah by Sunni gunmen at their repair shop.
18962,11/11/2012,Pakistan,Karachi,1,0,1,Sipah-e-Sahaba terrorists shoot a Shiite four times at a market.
18963,11/11/2012,Afghanistan,Khakrez,2,0,2,Two civilians on foot are blown into pieces by a Taliban bomb.
18964,11/11/2012,Israel,Sderot,0,4,4,Islamic Jihad rocket fire into a neighborhood leaves four Israeli casualties.
18965,11/11/2012,Pakistan,Faisalabad,2,0,2,Two woman are 'honor killed' by their families for unIslamic behavior.
18966,11/11/2012,Afghanistan,Helmand,3,0,3,Three civilians are taken out by a Taliban landmine.
18967,11/11/2012,Lebanon,Sidon,3,7,10,"Hezbollah attacks supporters of a rival cleric, killing three."
18968,11/11/2012,Dagestan,Levashi,1,0,1,A moderate Muslim cleric is murdered by his more radical co-religionists.
18969,11/11/2012,Pakistan,Sultanabad,1,0,1,A prayer leader is murdered in his own mosque by Religion of Peace rivals.
18970,11/11/2012,Afghanistan,Sabari,6,0,6,A mother and newborn child are among a family of six exterminated by Islamists on their way home from the hospital.
18971,12/11/2012,USA,"Houston, TX",1,0,1,A 28-year-old man is shot to death by a conservative Muslim over an alleged role in converting a woman to Christianity.
18972,12/11/2012,Somalia,Baidoa,3,3,6,At least three civilians are killed during an al-Shabaab ambush.
18973,12/11/2012,Pakistan,Bolan,4,1,5,Four religious minorities lose their lives in a targeted killing by Sunni radicals.
18974,12/11/2012,Pakistan,Karachi,2,0,2,A cleric is among two Sunnis killed by suspected Shia militants.
18975,12/11/2012,Iraq,Muqdadiya,2,3,5,Two Iraqis are taken down by a roadside bomb.
18976,12/11/2012,Afghanistan,Akazai,4,2,6,A brutal landmine attack by Sunni hardliners leaves four local security personnel dead.
18977,13/11/2012,Afghanistan,Kabul,1,3,4,"The Taliban fire a rocket at an airport, killing a local civilian."
18978,13/11/2012,Thailand,Narathiwat,1,0,1,Islamic 'separatists' shoot a 52-year-old civilian several times in the head and body.
18979,13/11/2012,Pakistan,Orangi,1,0,1,Sipah-e-Sahaba terrorists take down a Shiite with four bullets to the head.
18980,13/11/2012,Nigeria,Maiduguri,2,0,2,"Islamists murder two in their homes, including a university lecturer."
18981,13/11/2012,Thailand,Pattani,1,0,1,A 58-year-old villager is machine-gunned by suspected Islamic 'insurgents'.
18982,13/11/2012,Thailand,Narathiwat,1,0,1,Muslim militants shoot a 52-year-old man to death.
18983,13/11/2012,Thailand,Narathiwat,1,0,1,A 63-year-old man is murdered in front of his wife by Muslim terrorists.
18984,14/11/2012,Afghanistan,Farah,2,0,2,Two drivers are burned alive when Islamic fundamentalists torch a fuel truck.
18985,14/11/2012,Iraq,Kut,3,15,18,Three civilians at a restaurant are blown to bits by 'insurgent' bombers.
18986,14/11/2012,Iraq,Hillah,7,44,51,At least seven people are pulled into pieces when al-Qaeda detonate a car bomb near a crowded marketplace.
18987,14/11/2012,Iraq,Kirkuk,5,34,39,Five children are disassembled by Islamic Army of Iraq bombers at a Kurdish neighborhood.
18988,14/11/2012,Iraq,Hawijah,4,5,9,Municipal street cleaners are among the victims of an al-Qaeda bomb blast at a commercial district.
18989,14/11/2012,Pakistan,Karachi,1,0,1,A mosque official is gunned down by Religion of Peace rivals.
18990,14/11/2012,Afghanistan,Logar,2,0,2,Two young local men are dragged from their car and brutally shot to death by the Taliban.
18991,14/11/2012,India,Nowgam,3,2,5,Three border guards are killed when Islamic militants from Pakistan open fire.
18992,14/11/2012,Pakistan,Bahadurabad,1,0,1,A Sunni seminary teacher is assassinated by sectarian Jihadis.
18993,14/11/2012,Pakistan,Orangi,1,0,1,A Shia teenager is shot to death by Sunnis.
18994,14/11/2012,Thailand,Yala,1,0,1,A religious leader is gunned down by suspected Islamic 'insurgents'.
18995,15/11/2012,Thailand,Narathiwat,1,0,1,A 46-year-old man is assassinated in front of his home in a Muslim drive-by.
18996,15/11/2012,Thailand,Narathiwat,1,0,1,Islamic 'separatists' shoot the 49-year-owner of a rubber farm three times in the head.
18997,15/11/2012,Israel,Kiryat Malach,3,3,6,Two babies and a child are among the casualties when Hamas fires a rocket into an apartment building.
18998,15/11/2012,India,Srinagar,2,3,5,"Hizb-ul-Mujahideen fundamentalists fire into a store selling alcohol, killing a hotel employee and a patron."
18999,15/11/2012,Nigeria,Madauchi-Zonkwa,5,0,5,Muslim radicals are suspected in the slaughter and burning of a Christian family in their home.
19000,16/11/2012,Pal. Auth.,Gaza,2,4,6,A rocket fired by Hamas kills a 4-year-old boy and one other civilian.
19001,16/11/2012,Nigeria,Maiduguri,3,0,3,Three Christian traders are shot to death by Boko Haram.
19002,16/11/2012,Afghanistan,Dawlat Abad,19,16,35,Six children and seven women are among nineteen members of a wedding party slaughtered by Sunni bombers.
19003,16/11/2012,Yemen,Zinjibar,3,4,7,Three civilians are ripped to pieces by a Shahid suicide bomber.
19004,16/11/2012,Syria,Aleppo,20,60,80,Sunnis detonate a bomb outside an Orthodox church that leaves at least twenty dead.
19005,16/11/2012,Somalia,Barawa,1,0,1,A Christian convert is beheaded for leaving the Religion of Peace.
19006,17/11/2012,Sudan,South Kordofan,3,3,6,Three Christian villagers are killed in two targeted bombing attacks by the Islamic republic.
19007,17/11/2012,Syria,Aleppo,1,4,5,One person is killed by a Fedayeen suicide bomber.
19008,17/11/2012,Thailand,Yala,1,20,21,Islamists kill a woman with a motorcycle bomb.
19009,17/11/2012,Indonesia,Bireuen,3,10,13,Three 'heretics' are hacked to death by a mainstream mob.
19010,18/11/2012,Nigeria,Maiduguri,1,0,1,An 70-year-old retired Protestant pastor is executed in cold blood by Islamic extremists.
19011,18/11/2012,Kenya,Nairobi,10,30,40,An al-Shabaab bomber slaughters ten minibus passengers
19012,18/11/2012,Iraq,Khalis,3,16,19,A Fedayeen suicide bomber murders three Iraqis.
19013,18/11/2012,Kenya,Garissa,3,0,3,Three Kenyan soldiers are murdered by suspected Islamic radicals.
19014,18/11/2012,Yemen,Ataq,1,0,1,"A local soldier is kidnapped by al-Qaeda, tortured to death and then dumped at his family's house."
19015,18/11/2012,Yemen,Sanaa,1,0,1,al-Qaeda is suspected of shooting an intelligence officer to death.
19016,18/11/2012,Pakistan,Shin Qamar,3,3,6,Three laborers bleed to death following a Taliban bombing attack at a construction site.
19017,18/11/2012,Pakistan,Abbas,3,23,26,"A bomb targeting Shiites goes off outside a mosque, killing three people, including a woman."
19018,18/11/2012,Nigeria,Kano,1,0,1,A prominent politician is assassinated by Boko Haram gunmen while sitting at a restaurant.
19019,18/11/2012,Iraq,Balad,7,25,32,Seven Shiite pilgrims are sent straight to Allah by Sunni bus bombers.
19020,18/11/2012,India,Jammu,1,5,6,One person is killed when fundamentalists throw a grenade into a wine shop.
19021,18/11/2012,Pakistan,Mir Ali,2,7,9,Religious extremists plant a bomb that leaves two local soldiers dead.
19022,18/11/2012,Thailand,Narathiwat,1,1,2,"A woman is killed, and her son injured, when Islamic 'insurgents' open fire on a plantation."
19023,18/11/2012,Thailand,Narathiwat,3,35,38,Three people are killed when Muslim militants set off a bomb at a railway station.
19024,19/11/2012,Syria,Barad,20,0,20,al-Nusra claims a suicide bombing that leaves twenty dead.
19025,19/11/2012,Pakistan,Charmang,1,2,3,Rockets fired by Islamic militants crush a 6-year-old girl.
19026,20/11/2012,Pal. Auth.,Gaza City,6,0,6,Six torture victims are brutally murdered by a Hamas lynch mob and then dragged through the streets on motorcycles.
19027,20/11/2012,Libya,Benghazi,1,0,1,A government official is shot in the head by suspected Islamists.
19028,20/11/2012,Israel,Eshkol,2,23,25,Two Israelis are killed during a Hamas rocket attack.
19029,20/11/2012,Pakistan,Jamrud,1,1,2,A truck driver is shot in the head by Taliban militants.
19030,20/11/2012,Pakistan,Kulachi,1,0,1,A tribal elder is shot to death by Muslim extremists.
19031,20/11/2012,Iraq,Baghdad,3,26,29,Sectarian attacks leave three dead and two dozen injured.
19032,20/11/2012,Pakistan,Karachi,1,0,1,Sipah-e-Sahaba gunmen pick off a Shia civilian.
19033,21/11/2012,India,Srinagar,1,2,3,A police officer dies following an ambush by Islamic militants.
19034,21/11/2012,Israel,Tel Aviv,0,27,27,Arab terrorists bomb a passenger bus.
19035,21/11/2012,Afghanistan,Kabul,2,3,5,A Shahid suicide bomber sends two Afghans to Allah.
19036,21/11/2012,Pakistan,Rawalpindi,23,62,85,"Children are among the casualties when a Shahid suicide bomber plows into a Shiite procession and detonates, killing dozens."
19037,21/11/2012,Pakistan,Karachi,2,17,19,A suicide bombing is among two bomb blasts outside a Shiite mosque that leave two innocents dead.
19038,21/11/2012,Dagestan,Shamilkala,3,1,4,Islamic 'insurgents' plant a bomb at a bank that kills two disposal experts and a civilian.
19039,22/11/2012,Thailand,Pattani,1,0,1,A female Buddhist school principal dies from injuries after being hit by automatic weapons fire in a target attack.
19040,22/11/2012,Pakistan,Qabar,2,0,2,Islamic militants attack a local police post and murder two officers after taking one hostage.
19041,22/11/2012,Pakistan,Bannu,4,6,10,The Tehreek-e-Taliban murder four Pakistanis in two attacks.
19042,22/11/2012,Nigeria,Bichi,4,2,6,"Angry Muslims riot, burn churches and kills four Christians over a rumor of blasphemy concerning a t-shirt."
19043,22/11/2012,Nigeria,Maiduguri,18,12,30,Three young children are among eighteen people murdered by Boko Haram in a series of terror attacks.
19044,23/11/2012,Pakistan,Bara,2,0,2,Two members of a peace committee are blown up by Sunni militants.
19045,23/11/2012,Iraq,Mosul,1,0,1,Gunmen take out the head of a Sunni charity.
19046,23/11/2012,Afghanistan,Maidan Shar,3,90,93,"A Fedayeen suicide bomber kills three others, including a woman."
19047,24/11/2012,Afghanistan,Nangarhar,1,0,1,A civilian loses his life to a Taliban ambush.
19048,24/11/2012,Afghanistan,Kabul,1,28,29,At least one student is killed in a sectarian clash between Shia and Sunni students.
19049,24/11/2012,Yemen,Sanaa,4,10,14,A rocket fired at Shiites celebrating a religious holiday sends at least four straight to Allah.
19050,24/11/2012,Pakistan,Dera Ismail Khan,10,22,32,Four children are among ten members of a Shia funeral procession disassembled by Religion of Peace rival bombers.
19051,24/11/2012,Somalia,Bulohawo,2,10,12,At least two civilians are killed when al-Shabaab militia attack a small town.
19052,25/11/2012,Pakistan,Dera Ismail Khan,6,90,96,Six more innocents are pulled apart when a second Shiite religious procession is hit with a Sunni bombing.
19053,25/11/2012,Somalia,Kismayo,1,2,3,A woman is torn to pieces by an al-Shabaab bomb.
19054,25/11/2012,Somalia,Kismayo,4,0,4,An Islamist bomb at a market place leaves at least four dead.
19055,25/11/2012,Nigeria,Jaji,15,30,45,Two suicide bombers massacre fifteen worshippers at a Protestant church.
19056,25/11/2012,Nigeria,Gamboru Ngala,1,0,1,A tailor is shot to death by fundamentalists for making clothes deemed 'inappropriate for women.'
19057,25/11/2012,Iraq,Kirkuk,1,1,2,Mujahideen take out a 13-year-old boy with an IED.
19058,26/11/2012,Israel,Tel Sheva,1,0,1,A 15-year-old girl is stabbed to death by her brothers for dating a boy.
19059,26/11/2012,Pakistan,Karachi,1,4,5,A bomb targeting a Shia procession kills at least one passerby.
19060,26/11/2012,Pakistan,Gulbahar,1,0,1,A 30-year-old Shiite bleeds to death following a drive-by attack by Sunnis.
19061,26/11/2012,India,Adoli,1,0,1,A man is 'honor killed' by his wife's family for marrying without their permission.
19062,26/11/2012,Afghanistan,Khost,2,19,21,Two civilians bleed to death following remote detonation of a Taliban bomb on a bicycle.
19063,26/11/2012,Nigeria,Abuja,2,0,2,Jama’atu Ansarul Muslimina terrorists attack a police station and kill two officers.
19064,26/11/2012,Nigeria,Barkinladi,10,3,13,"Fundamentalists fire into a bar selling alcohol, killing at least ten patrons."
19065,26/11/2012,Iran,Isfahan,1,0,1,A 57-year-old Jewish woman is stabbed to death in her home after refusing orders to leave by Muslims interested in expanding a mosque.
19066,27/11/2012,Nigeria,Rann,5,1,6,A Boko Haram assault on a police station leaves five officers dead.
19067,27/11/2012,Iraq,Kirkuk,5,58,63,Mujahideen car bombers murder five Iraqis.
19068,27/11/2012,Iraq,Baghdad,7,21,28,Seven Shiite worshippers are taken out by an Islamic Army of Iraq car bomb outside their mosque.
19069,27/11/2012,Iraq,Baghdad,6,32,38,Six people are killed by an al-Qaeda bomb detonated near a Shia mosque.
19070,27/11/2012,Iraq,Baghdad,9,20,29,Nine Shiites are slaughtered by Sunni bombers.
19071,27/11/2012,Pakistan,Karachi,1,0,1,A 25-year-old Shiite is shot in the head and chest by Sunni radicals.
19072,27/11/2012,Pakistan,Khairpur,1,6,7,"Sipah-e-Sahaba terrorists open fire on a Shia procession, killing one member."
19073,27/11/2012,Iraq,Kirkuk,2,7,9,A Sunni bomb near a Kurdish youth club leaves two dead.
19074,27/11/2012,Iraq,Ramadi,6,13,19,Two car bombs leave six Iraqis dead.
19075,28/11/2012,Iraq,Tarmiyah,7,0,7,Four young children are among a family of seven massacred in their home by al-Qaeda.
19076,28/11/2012,Yemen,Sanaa,2,0,2,A Saudi diplomat is one of two people assassinated by suspected al-Qaeda gunmen.
19077,28/11/2012,Thailand,Pattani,1,0,1,Muslim 'separatists' shoot a Buddhist man to death.
19078,28/11/2012,Somalia,Shalanbod,3,7,10,An al-Shabaab ambush leaves three dead.
19079,28/11/2012,Thailand,Pattani,1,0,1,A 55-year-old man is gunned down at a tea shop by suspected terrorists.
19080,28/11/2012,Syria,Jaramana,54,120,174,Fifty-four people are blown to bits by two Fedayeen suicide bombers in a residential neighborhood.
19081,28/11/2012,Afghanistan,Quro,5,0,5,Five civilians are kidnapped by the Taliban and executed.
19082,28/11/2012,Afghanistan,Nawzad,4,0,4,Four civilians are sent to Allah by Taliban bombers.
19083,28/11/2012,Afghanistan,Maqur,3,4,7,Three local troops are slaughtered by Sunni fundamentalists.
19084,29/11/2012,Afghanistan,Dih Rawud,10,8,18,A woman and five children are among ten civilians torn to shreds by a Taliban roadside bomb.
19085,29/11/2012,Iraq,Basmaiyah,2,11,13,"Muslim terrorists bomb a restaurant, killing two patrons."
19086,29/11/2012,Iraq,Hilla,33,166,199,"Two bomb blasts at a restaurant packed with Shia pilgrims, obliterating over thirty."
19087,29/11/2012,Iraq,Mosul,2,2,4,Mujahid car bombers send two souls to Allah.
19088,29/11/2012,Iraq,Fallujah,3,8,11,A Fedayeen suicide bomber at a bank takes out three Iraqis.
19089,29/11/2012,Pakistan,Wana,3,7,10,A 13-year-old suicide bomber kills three other people at a market.
19090,29/11/2012,Iraq,Karbala,8,22,30,An Islamic Army of Iraq car bomb kills eight at the entrance of Shia Shrine.
19091,29/11/2012,Syria,Daraa,4,0,4,Four people are killed when suspected Islamists bomb a house.
19092,29/11/2012,Pakistan,Karachi,1,0,1,A 60-year-old caretaker at a Shia mosque is picked off by Sipah-e-Sahaba gunmen.
19093,29/11/2012,Pakistan,Gunjaan Abad,1,0,1,Wahhabi gunmen murder a Shiite shop owner.
19094,29/11/2012,Pakistan,Karachi,2,0,2,A Shia man and his wife are chased down along a city street and shot to death by Religion of Peace radicals.
19095,30/11/2012,Nigeria,Damasak,5,0,5,Two bakery workers and two boys are among five people machine-gunned by Boko Haram Islamists.
19096,30/11/2012,Afghanistan,Kandlan,2,0,2,Two agricultural workers are kidnapped and executed by Sunni fundamentalists.
19097,30/11/2012,Afghanistan,Qala-e-Naw,4,0,4,Four Afghans lose their lives to a Taliban ambush.
19098,30/11/2012,Pakistan,Chamarkand,3,6,9,Two brothers are among three civilians who lose their lives to a bomb attack by Muslim militants.
19099,30/11/2012,Iraq,Alexandria,4,0,4,Terrorists kill four Iraqis with a roadside bomb.
19100,30/11/2012,Thailand,Pattani,1,5,6,Islamic 'separatists' kill a local soldier with a bomb.
19101,30/11/2012,Pakistan,Karachi,2,0,2,A 12-year-old girl and her father are murdered by Sipah-e-Sahaba gunmen.
19102,30/11/2012,Pakistan,Baldia,2,0,2,A Shia father and son are brought down by Sunni snipers.
19103,1/12/2012,Nigeria,Gamboru Ngala,2,0,2,Two guards die when Muslims shouting 'Allah Akbar' burn churches.
19104,1/12/2012,Pakistan,Dera Ismail Khan,7,30,37,Three children in a Shia religious procession are disassembled by Sunni bombers along with four others.
19105,1/12/2012,Pakistan,Orangi,1,0,1,A 40-year-old Shiite is murdered on the street by Sunni terrorists.
19106,1/12/2012,Somalia,Kismayo,1,5,6,Islamic militia is suspected of killing a civilian with a grenade.
19107,1/12/2012,Afghanistan,Dehrawud,3,0,3,Two children are among three people blown to bits by a Shahid suicide bomber.
19108,1/12/2012,India,Kuri Rawana,1,0,1,A 22-year-old Muslim woman is beaten to death for loving a Hindu man.
19109,2/12/2012,Afghanistan,Kapisa,1,0,1,A 16-year-old girl is murdered by fundamentalists for ignoring orders to stop working on a polio campaign.
19110,2/12/2012,Nigeria,Maiduguri,3,0,3,Two teachers are among three civilians shot to death by Boko Haram.
19111,2/12/2012,Pakistan,Dera Ismail Khan,2,35,37,A second bombing on a Shia religious procession in as many days leaves at least two dead.
19112,2/12/2012,Syria,Homs,15,24,39,"Islamists are suspected of car bombing a Shia mosque, killing at least fifteen."
19113,2/12/2012,Afghanistan,Jalalabad,5,18,23,Two medical students are among five Afghans killed during a Fedayeen suicide attack on a base.
19114,2/12/2012,Nigeria,Chibok,10,0,10,Religion of Peace proponents invade a Christian village in the middle of the night and massacre ten residents.
19115,2/12/2012,Iraq,Samarrah,3,0,3,A man and his two sons are murdered in their home by al-Qaeda gunmen.
19116,2/12/2012,Iraq,Nineveh,3,0,3,Three professionals including a doctor are assassinated by gunmen as they leave their homes.
19117,2/12/2012,Pakistan,Lahore,1,0,1,A young man dies after being tortured over allegations that he burned a Quran.
19118,3/12/2012,Thailand,Narathiwat,1,0,1,A 32-year-old female teacher is shot four times by Muslim 'separatists' while on her way to school.
19119,3/12/2012,Afghanistan,Trin Kot,5,8,13,Two women are among five people torn to shreds by a Taliban roadside bomb.
19120,3/12/2012,Thailand,Pattani,1,0,1,Muslim 'separatists' execute a 45-year-old man.
19121,3/12/2012,Pakistan,Qalagey,3,1,4,Suspected fundamentalists murder three family members and torch two schools.
19122,3/12/2012,Pakistan,Peshawar,2,2,4,Islamic militants kill two local cops with a roadside bomb.
19123,3/12/2012,Pakistan,Karachi,1,0,1,A senior cleric is brought down in a hail of bullets from Religion of Peace rivals.
19124,3/12/2012,Thailand,Pattani,1,0,1,A 59-year-old female Buddhist plantation worker is stabbed to death by suspected 'insurgents'.
19125,3/12/2012,Pakistan,Lahore,1,0,1,A 72-year-old female Christian charity worker is shot in the neck by suspected Islamists.
19126,4/12/2012,Iraq,Zayouna,6,0,6,al-Qaeda gunmen force their way into a home and shoot four children to death along with their mother and father.
19127,4/12/2012,Thailand,Narathiwat,0,1,1,A Buddhist teacher is shot and badly wounded by militant Muslims.
19128,4/12/2012,Pakistan,Larkana,2,0,2,A Shiite cleric and his 4-year-old daughter are shot to death by Wahhabi terrorists.
19129,4/12/2012,Pakistan,Swat,1,7,8,A woman is killed in a Taliban blast thought to have targeted a schoolgirl.
19130,4/12/2012,Pakistan,Bannu,0,6,6,A Shahid suicide bomber slams his car into a checkpoint.
19131,4/12/2012,Egypt,Giza,1,0,1,A 20-year-old woman's throat is slashed by her brother over adultery.
19132,4/12/2012,Somalia,Galgala,12,9,21,A dozen local soldiers are killed in the Puntland region by an al-Shabaab roadside bomb.
19133,4/12/2012,Pakistan,Quetta,2,0,2,A targeted attack on two Shia brothers leaves both dead.
19134,4/12/2012,Nigeria,Kano,2,2,4,Two people are left dead following a violent rampage by Boko Haram Islamists.
19135,4/12/2012,Lebanon,Tripoli,2,14,16,Two people are killed when Sunni and Shia shoot at each other.
19136,5/12/2012,Iraq,Fallujah,2,1,3,Muslim 'insurgents' take down two civilians with a roadside bomb.
19137,5/12/2012,Pakistan,Karachi,1,0,1,A prayer leader is shot to death inside a seminary by sectarian rivals.
19138,5/12/2012,Pakistan,Wana,3,9,12,Two Fedayeen suicide car bombers take out three Pakistanis.
19139,5/12/2012,Somalia,Leego,3,0,3,al-Shabaab Islamists attack and kill three cattle herders.
19140,5/12/2012,Pakistan,Khudadad,1,0,1,A Shia activist is slain by loyal Sunnis outside a car showroom.
19141,5/12/2012,Russia,Nalchik,1,0,1,A television journalist is murdered by suspected Muslim extremists.
19142,6/12/2012,Nigeria,Yankaba,2,0,2,"Two Christian teenagers are executed by gunmen on a motorcycle yelling, 'Allah akbar'."
19143,6/12/2012,Egypt,Cairo,2,0,2,"Two unarmed protesters are surrounded, beaten and stabbed to death by Muslim Brotherhood."
19144,6/12/2012,Nigeria,Gamboru,6,0,6,Six people are executed in cold blood by Islamists after being unable to recite from the Quran.
19145,6/12/2012,Lebanon,Tripoli,11,20,31,A 13-year-old boy is among eleven civilians taken out by sectarian snipers.
19146,6/12/2012,Iraq,Jisr Diyala,5,0,5,Five policemen are shot in their sleep by Islamic Army of Iraq terrorists.
19147,7/12/2012,Pakistan,Much,1,0,1,Wahhabi terrorists storm a market and open fire on a Shia trader.
19148,7/12/2012,India,Kolkata,1,0,1,A young woman is pulled out onto the street and beheaded by her brother for immorality.
19149,7/12/2012,Pakistan,Pishin,1,3,4,A Sunni drive-by attack leaves at least one Shia dead.
19150,8/12/2012,Somalia,Beledweyne,1,0,1,Religion of Peace activists shoot 55-year-old Christian to death for leaving Islam.
19151,8/12/2012,Pakistan,Datta Khel,1,3,4,A tribesman cutting wood with family is killed during a mortar strike by militant Muslims.
19152,8/12/2012,Kenya,Nairobi,5,13,18,"Islamists throw a grenade into a crowd of moderates leaving a mosque, killing at least five."
19153,8/12/2012,Yemen,Maarib,17,0,17,Seventeen local security personnel are killed in an al-Qaeda ambush while guarding a pipeline.
19154,9/12/2012,Nigeria,Potiskum,1,0,1,At least one local is killed during a Boko Haram attack.
19155,9/12/2012,Afghanistan,Ghorak,2,2,4,Religious extremists kill two civilians with a roadside bomb.
19156,9/12/2012,Iraq,Iskandariyah,3,3,6,An 8-year-old is among three family members slain in their home by al-Qaeda bombers.
19157,9/12/2012,Pakistan,Shaikh Yousuf Chowk,5,3,8,Islamic militants are thought responsible for opening fire on a group of vegetable traders on their way to market.
19158,9/12/2012,Lebanon,Tripoli,4,40,44,Sniper and rocket fire between Sunni and Shia residents leaves four dead.
19159,9/12/2012,Pakistan,Bara,1,1,2,A sapper is killed trying to defuse a bomb planted by Muslim extremists.
19160,9/12/2012,Pakistan,Miramshah,2,0,2,Two local soldiers are kidnapped by the Taliban and executed.
19161,10/12/2012,Algeria,Kasrine,1,0,1,Salafists murder a border guard.
19162,10/12/2012,Iraq,Yathrib,3,2,5,Three Iraqis are machine-gunned by Muslim terrorists.
19163,10/12/2012,Afghanistan,Laghman,1,0,1,The acting head of women's affairs is brutally shot to death by fundamentalists on her way to work.
19164,10/12/2012,Afghanistan,Nimroz,1,0,1,A local police chief is blown up by the Taliban.
19165,10/12/2012,Pakistan,Kaki,6,8,14,At least six innocents are killed when Shahid suicide bombers assault a police station near a mosque.
19166,10/12/2012,Tunisia,Bou Chebka,1,0,1,Suspected Salafis pick off a border guard.
19167,10/12/2012,Pakistan,Gulbahar,1,0,1,A Shia police officer is gunned down by Sunni terrorists.
19168,11/12/2012,Thailand,Pattani,2,0,2,A school director and teacher are murdered in the cafeteria by Islamic 'insurgents'.
19169,11/12/2012,Yemen,Mukalla,1,0,1,An official is assassinated by al-Qaeda on his way to work.
19170,11/12/2012,Pakistan,Karachi,1,1,2,Wahhabi terrorists gun down a 23-year-old Shiite shopkeeper.
19171,11/12/2012,Thailand,Narathiwat,4,4,8,A baby and woman are among four shot to death in a tea shop by Islamic terrorists.
19172,11/12/2012,Nigeria,Dalwa,2,0,2,A man and his son are shot to death in front of other family members in their home by Islamic extremists.
19173,11/12/2012,Pakistan,Hasan Owlia,1,0,1,A Hindu is shot to death by Muslim terrorists.
19174,12/12/2012,Pakistan,Karachi,2,0,2,The custodian of a Shiite mosque and his nephew are mowed down by a Sunni drive-by.
19175,12/12/2012,Pakistan,FATA,3,0,3,Two peace committee volunteers are among three Pakistanis murdered by religious radicals.
19176,12/12/2012,Pakistan,Gilgit,3,7,10,Three students are killed during a clash between Sunni and Shia.
19177,12/12/2012,Pakistan,Karachi,2,8,10,Tehreek-e-Taliban bombers take out two locals.
19178,12/12/2012,Iraq,Fallujah,4,0,4,Four Iraqi policemen are machine-gunned at a checkpoint by Islamist 'insurgents'.
19179,12/12/2012,Iraq,Tikrit,2,1,3,Muslim terrorists kill two university students with an IED.
19180,12/12/2012,Syria,Damascus,9,50,59,Two Fedayeen suicide car bombers rack up nine kills.
19181,12/12/2012,Yemen,Maarib,1,0,1,A tribesman is ambushed and killed by al-Qaeda.
19182,12/12/2012,India,Macherla,1,0,1,A Hindu man is hacked to death for eloping with a Muslim woman against the will of religious leaders.
19183,13/12/2012,Pakistan,Karachi,2,0,2,A father of two is among two Shiites picked off by Sunni snipers.
19184,13/12/2012,Pakistan,Mastung,1,0,1,A Hindu doctor is murdered by an Islamic fanatic.
19185,13/12/2012,Afghanistan,Kandahar,2,15,17,Two civilians and a US soldier are blown up by a Shahid suicide bomber.
19186,13/12/2012,Syria,Qatana,24,30,54,Women and children are among two dozen innocents slaughtered by a Sunni 'rebel' car bomb attack on a residential neighborhood.
19187,13/12/2012,Pakistan,Quetta,1,1,2,A Shiite is brought down in a targeted attack by Sunnis.
19188,13/12/2012,Pakistan,Quetta,2,0,2,Lashkar-e-Jhangvi gunmen take out two sectarian rivals at a tailor shop.
19189,13/12/2012,Iraq,Baghdad,6,8,14,Holy Warriors set off two car bombs in populated areas which leave six dead.
19190,14/12/2012,Nigeria,Maiduguri,1,0,1,Boko Haram Islamists murder a man in front of his wife and children.
19191,14/12/2012,Somalia,Mogadishu,3,3,6,Three people are left dead after an al-Shabaab car bomb.
19192,14/12/2012,Pakistan,Lahore,2,0,2,A 24-year-old woman is shot to death along with her lover by her conservative brother.
19193,14/12/2012,Nigeria,Kano,1,0,1,Boko Haram is suspected of assassinating a local lawmaker.
19194,14/12/2012,Iraq,Samarrah,2,20,22,Sunni bombers kill two Shia pilgrims in an attack on their bus.
19195,15/12/2012,Pakistan,Peshawar,5,45,50,"Islamic militants fire rockets into an airport, killing at least five civilians."
19196,15/12/2012,Pakistan,Makan Bagh,1,0,1,A 16-year-old girl dies in a hospital from an earlier Taliban blast targeting schoolgirls.
19197,16/12/2012,Libya,Benghazi,4,0,4,Four police officers are killed during an attack by suspected Islamic militants.
19198,16/12/2012,Iraq,Qara-Tabba,3,0,3,A woman and child are among three Iraqis exterminated in their home by Mujahideen.
19199,16/12/2012,Yemen,Hadramout,1,0,1,Suspected al-Qaeda gunmen kill a man on a motorcycle.
19200,16/12/2012,Thailand,Narathiwat,1,0,1,A 26-year-old Buddhist woman is murdered by Muslim 'separatist' gunmen.
19201,16/12/2012,Iraq,Kirkuk,9,55,64,"Determined Sunni bombers set a series of bombs outside two Shia mosques that leave nine worshippers dead, including two children."
19202,16/12/2012,Iraq,Tarmiya,3,4,7,Three local cops are machine-gunned by Muslim 'insurgents'.
19203,16/12/2012,Iraq,Jalula,2,15,17,al-Qaeda bombers murder two police recruits.
19204,17/12/2012,Iraq,Tikrit,5,5,10,A Fedayeen suicide bomber kills five Iraqis.
19205,17/12/2012,Iraq,al-Buslaib,3,0,3,Three local cops are murdered by al-Qaeda bombers.
19206,17/12/2012,Iraq,Baqubah,3,10,13,Islamic Army of Iraq bombers send three civilians to Allah.
19207,17/12/2012,Iraq,Khaldiyah,4,7,11,Jihadi car bombers take out four Iraqis.
19208,17/12/2012,Iraq,Rutba,2,9,11,"al-Qaeda send mortars into a town, killing two residents."
19209,17/12/2012,Iraq,Baladruz,2,0,2,Two Kurds are blown to bits by Sunni bombers.
19210,17/12/2012,Iraq,Dujail,1,10,11,A car bomb targeting Shia pilgrims leaves one dead.
19211,17/12/2012,Thailand,Narathiwat,2,5,7,Two people die from gunshot injuries after Muslims open fire on a group of Buddhist professionals.
19212,17/12/2012,Pakistan,Lakki Marwat,3,3,6,Sunni hardliners storm a security check post and kill three local defenders.
19213,17/12/2012,Pakistan,Karachi,2,0,2,Sectarian Jihadis wipe out two rival Shiites.
19214,17/12/2012,Iraq,Kirkuk,2,0,2,Two al-Qaeda torture victims are found burned to death.
19215,17/12/2012,Iraq,Balad,6,18,24,Muslim 'insurgents' slaughter six Iraqis with a car bomb.
19216,17/12/2012,Iraq,Qara-Tabba,3,10,13,"Islamists bomb a funeral for three civilians murdered the day before, killing at least three mourners."
19217,17/12/2012,Iraq,Baghdad,11,40,51,Islamic Army of Iraq bombers slaughter eleven people at a car dealership.
19218,17/12/2012,Pakistan,Quetta,3,1,4,Sunni radicals shoot three people to death in a targeted attack on Shia.
19219,17/12/2012,Pakistan,Jamrud,21,74,95,Five boys and two women are among twenty-one civilians dismantled by Religion of Peace bombers at a bus stop.
19220,17/12/2012,Afghanistan,Kabul,2,30,32,Two civilians are killed by a Taliban blast.
19221,17/12/2012,Iraq,Tuz Khurmatu,5,26,31,Sunni bombers murder five Shiites outside their mosque.
19222,17/12/2012,Iraq,Khaznah,7,12,19,"A community of Shabak religious minorities is the target of a Sunni car bomb that leaves seven dead, mostly women and children."
19223,17/12/2012,Iraq,Tuz Khurmatu,4,21,25,Four people are taken out by Mujahideen bombers at a hospital.
19224,17/12/2012,Pakistan,Karachi,1,0,1,Islamists shoot a medical worker to death.
19225,18/12/2012,Sudan,Eire,5,1,6,Two 4-year-olds and a baby are among a Christian family of five killed in an Islamic bombing.
19226,18/12/2012,Iraq,Karbalah,3,15,18,"Militant Sunnis detonate a car bomb outside a Shia shrine, sending three pilgrims to Allah."
19227,18/12/2012,Iraq,Mosul,1,0,1,A religious minority is shot to death.
19228,18/12/2012,Pakistan,Peshawar,1,0,1,A woman is murdered by fundamentalists for working on an anti-polio drive.
19229,18/12/2012,Pakistan,Karachi,3,5,8,"Three female humanitarian workers are shot to death by the Taliban, including a 50-year-old shot five times in the head."
19230,18/12/2012,Pakistan,Landhi,1,0,1,A Shia doctor is murdered in his own clinic by Sunni gunmen.
19231,19/12/2012,Pakistan,Charsadda,2,0,2,Islamic militants shoot a female polio vaccine worker and her driver to death.
19232,19/12/2012,Pakistan,Peshawar,1,0,1,An 18-year-old humanitarian worker is shot in the head by Muslim hardliners.
19233,20/12/2012,Pakistan,Lines,1,0,1,A Shia banker is shot to death by sectarian rivals.
19234,20/12/2012,Afghanistan,Zaranj,7,2,9,Five civilians are among seven Afghans taken out be a Religion of Peace roadside bomb.
19235,20/12/2012,Thailand,Yala,1,0,1,Muslim snipers pick off a Buddhist policeman.
19236,20/12/2012,Pakistan,Peshawar,1,0,1,A health worker is murdered by Jundullah gunmen.
19237,20/12/2012,Indonesia,Tambarana,3,3,6,Suspected Jamaah Anshoru Tauhid terrorists ambush and kill three local cops.
19238,20/12/2012,Libya,Benghazi,3,9,12,Two civilians and a police officer are killed when Islamic militants turn violent.
19239,20/12/2012,Yemen,Aden,1,0,1,A woman is shot to death by fundamentalists for drinking alcohol.
19240,21/12/2012,Pakistan,Wana,5,4,9,Five people are killed by a suicide bomber at a vegetable market.
19241,21/12/2012,Iraq,Mosul,1,0,1,Muslim 'insurgents' shoot a female professional to death.
19242,22/12/2012,Nigeria,Kano,4,0,4,Four people are reported killed when two suicide car bombers attack a telecom firm.
19243,22/12/2012,Pakistan,Peshawar,9,30,39,"A Religion of Peace suicide bomber detonates at a rally, killing nine innocents."
19244,22/12/2012,Syria,Damascus,5,24,29,At least five are killed by a Sunni car bomb.
19245,22/12/2012,Pakistan,Dadu,1,0,1,"A man accused of burning a Quran is pulled from a police station, tortured, beaten and then set on fire by a mob."
19246,22/12/2012,Iraq,Qazaniyah,4,11,15,A shop selling 'unIslamic' DVDs is the target of a bomb that leaves four dead.
19247,22/12/2012,Pakistan,Miyaani,2,0,2,A conservative Muslim kills his sister and her suspected lover.
19248,23/12/2012,Iraq,Mishahada,3,1,4,Terrorists murder three construction workers with a bomb planted under their house.
19249,23/12/2012,Pakistan,Karachi,1,0,1,A Shia trader is murdered by Sunni gunmen.
19250,24/12/2012,Germany,Bonn,0,1,1,Islamic extremists slash the tongue of an Indian student who refused their offer to embrace Islam.
19251,24/12/2012,Pakistan,Karachi,1,1,2,"Sunnis fire on two Shia brothers at a vegetable market, killing one."
19252,24/12/2012,Pakistan,Orangi,3,0,3,Two Sunnis and a Shia are killed in separate sectarian attacks.
19253,24/12/2012,Nigeria,Maiduguri,6,0,6,Six people are killed in a Christmas Eve church attack by Religion of Peace gunmen.
19254,24/12/2012,Afghanistan,Darzab,5,0,5,Five local police are slaughtered by Taliban militants.
19255,24/12/2012,Pakistan,Quetta,2,0,2,Sectarian rivals target and kill two seminary students.
19256,24/12/2012,Iraq,Samarrah,2,0,2,Suspected al-Qaeda assassinate two guards at a Shia shrine.
19257,24/12/2012,Iraq,Baqubah,2,0,2,Mujahideen kill two brothers.
19258,24/12/2012,Pakistan,Karachi,2,0,2,A Sunni cleric and university student are gunned down by sectarian rivals.
19259,24/12/2012,Pakistan,Karachi,3,0,3,Two brothers are among three Shiites murdered by Sunni gunmen.
19260,25/12/2012,Russia,Nalchik,1,0,1,Suspected Islamists shoot a non-Muslim twice in the head.
19261,25/12/2012,Nigeria,Peri,6,4,10,A pastor and five worshippers are slaughtered in a Religion of Peace attack on a Christmas morning church service.
19262,25/12/2012,Pakistan,Karachi,6,1,7,An attack on a Sunni cleric leaves six dead.
19263,25/12/2012,Yemen,Marib,14,0,14,Fourteen tribesmen are killed in an attack by al-Qaeda linked militants.
19264,25/12/2012,Yemen,Sanaa,2,0,2,Two Yemenis are gunned down by al-Qaeda.
19265,25/12/2012,Nigeria,Kano,2,0,2,Boko Haram gun down two people in separate attacks.
19266,25/12/2012,Pakistan,Yar Hussain,6,0,6,Three young women and a child are among a family of six machine-gunned by honor killers over two women wanting a divorce.
19267,25/12/2012,Pakistan,Iqbal,0,12,12,"At least a dozen Christian men, women and children s are set on with guns and iron rods by a Muslim mob outside their church."
19268,25/12/2012,Nigeria,Rim,1,0,1,A Christian is killed in his home by Fulani gunmen in front of his family.
19269,25/12/2012,Tanzania,Zanzibar City,0,1,1,A Catholic priest is shot in the chest by Muslim gunmen.
19270,26/12/2012,Nigeria,Bachit,5,0,5,"Suspected Fulani murder three villagers, including a married couple,  in attacks on two Christian homes."
19271,26/12/2012,Sudan,Buram,4,0,4,A 70-year-old woman and two children are among four Christians killed in an Islamic bomb attack.
19272,26/12/2012,Afghanistan,Khost,3,7,10,Three Afghans are blown to bits by a Shahid suicide bomber.
19273,26/12/2012,Thailand,Narathiwat,1,0,1,A 47-year-old Buddhist woman is shot to death while on a motorcycle by suspected 'insurgents'.
19274,26/12/2012,Turkey,Batman,1,0,1,A young woman is strangled by her family to restore honor in the wake of a rape by her cousins.
19275,26/12/2012,Russia,Vladikavkaz,1,0,1,A moderate mufti is assassinated by Islamic radicals.
19276,27/12/2012,Pakistan,Charsadda,0,4,4,Four children are injured when radicals set off a bomb outside a rival mosque.
19277,27/12/2012,Afghanistan,Tarin Kot,4,2,6,A religious policeman helps his Sunni brothers slaughter four fellow officers in their sleep.
19278,27/12/2012,Pakistan,Quetta,1,0,1,A Christian girl is shot execution style through the head.
19279,27/12/2012,Pakistan,Hasankhel,2,22,24,Two security personnel are murdered in a Taliban ambush.
19280,27/12/2012,Algeria,Bouira,2,0,2,"Two children, ages 12 and 14, are ripped to shreds by an Islamist bomb."
19281,27/12/2012,Kenya,Mandera,1,0,1,Islamists ambush and kill a local cop.
19282,27/12/2012,Nigeria,Maiduguri,4,0,4,Boko Haram murder three local cops and a businessman.
19283,27/12/2012,Yemen,Hadramawt,1,0,1,The body of a horribly mutilated al-Qaeda victim is discovered.
19284,28/12/2012,Turkey,Samatya,1,0,1,An 84-year-old Christian woman is stabbed to death by a Muslim in what is called a 'racist' attack.
19285,28/12/2012,Nigeria,Kaduna,1,1,2,A university professor is cut down by Muslim gunfire.
19286,28/12/2012,Nigeria,Musari,15,0,15,"Islamists tie up fifteen women and children inside a church, then slit their throats while shouting praises to Allah."
19287,28/12/2012,Nigeria,Potiskum,2,0,2,Two people are killed when Boko Haram assault a bank branch.
19288,28/12/2012,Nigeria,Bigi,3,5,8,Suspected Islamic terrorists murder three villagers.
19289,28/12/2012,Syria,Damascus,4,10,14,A Sunni car bomb in a Shia neighborhood leaves four dead.
19290,29/12/2012,Iran,Tehran,1,0,1,"A Jewish man is murdered by a Muslim woman, whom police congratulate for 'doing a good deed.'"
19291,29/12/2012,Syria,Damascus,4,4,8,"Sunni terrorists send rockets into a Shia shrine, killing at least four."
19292,29/12/2012,Pakistan,Peshawar,21,1,22,Twenty-one captured soldiers are executed in cold blood by Sunni fundamentalists at a cricket field.
19293,29/12/2012,Pakistan,Karachi,7,48,55,Terrorists send seven souls to Allah with a brutal suicide bomb attack on a bus.
19294,29/12/2012,Pakistan,Rahim Yar Khan,1,0,1,An 18-year-old girl is strangled by her family on suspicion of a love affair.
19295,30/12/2012,Libya,Misrata,2,2,4,"Islamists toss a hand grenade at worshippers leaving a Coptic church, killing two."
19296,30/12/2012,Pakistan,Baluchistan,20,24,44,Twenty innocents are slain in a targeted Lashkar-e-Jhangvi suicide attack on a bus carrying Shia pilgrims
19297,30/12/2012,Pakistan,Karachi,1,0,1,A cleric is gunned down by Religion of Peace rivals.
19298,30/12/2012,Algeria,Mellakou,0,1,1,An imam is stabbed shortly after denouncing Islamic extremism.
19299,30/12/2012,Pakistan,Sargodha,4,0,4,"Four Shiites are beheaded by Sunni rivals, including a religious scholar."
19300,30/12/2012,Pakistan,Ittehad Chowk,1,1,2,Gunmen fire at two Christian brothers in a targeted attack.  One later dies of injuries.
19301,30/12/2012,Pakistan,Yousaf Talab,1,4,5,"Muslim militants are suspected of firing a mortar into home, killing a woman."
19302,30/12/2012,Nigeria,Kyachi,15,0,15,"Islamists invade a church service on Sunday morning, tie up fifteen worshippers and execute them.  (Follows similar attack elsewhere two days earlier)."
19303,31/12/2012,Pakistan,Bilal,1,0,1,A prayer leader is assassinated by Religion of Peace rivals.
19304,31/12/2012,Syria,Ras al-Ayn,1,0,1,A pregnant Christian woman is left widowed after her husband is beheaded by Islamic radicals and fed to dogs.
19305,31/12/2012,Pakistan,Chiniot,1,4,5,Two Shia children are among the casualties of a Sunni drive-by.
19306,31/12/2012,Pakistan,Bakarabad,1,0,1,One civilian is killed when religious hardliners blow a girls' school.
19307,31/12/2012,Iraq,Bani Wais,4,1,5,A woman and child are among the casualties of a Mujahideen bombing.
19308,31/12/2012,Pakistan,Karachi,1,0,1,Sunnis shoot a 40-year-old Shiite man to death at a market.
19309,31/12/2012,Iraq,Khalis,3,36,39,al-Qaeda bombers murder three Shia pilgrims in two attacks.
19310,31/12/2012,Iraq,Hillah,3,21,24,A bomb targeting Shia pilgrims leaves three dead.
19311,31/12/2012,Iraq,Musayyib,7,6,13,Four women and children are among seven innocents slain in their homes by the Islamic Army of Iraq.
19312,31/12/2012,Iraq,Karrada,5,25,30,"Sunnis set off a bomb next to a group of Shi pilgrims, killing five."
19313,1/1/2013,Iraq,Bahrka,1,0,1,A 23-year-old mother of two is murdered by her family for unIslamic behavior.
19314,1/1/2013,Pakistan,Akkakhel,2,5,7,Two girls are killed when suspected Taliban shell their school.
19315,1/1/2013,Pakistan,Bolan,1,0,1,A religious minority is murdered by Sunni gunmen.
19316,1/1/2013,Iraq,Tuz-Khormato,5,2,7,Mujahid bombers take out five Iraqis.
19317,1/1/2013,Pakistan,Karachi,6,40,46,"Tehreek-e-Taliban set off a bomb at a political rally, taking out at least six participants."
19318,1/1/2013,Pakistan,Swabi,7,1,8,Six women are among seven humanitarian workers brutally machine-gunned by Mujahideen.
19319,1/1/2013,Italy,Venice,0,1,1,"Fifteen Arab youth set upon a Jewish-American tourist with sharp objects, beating him into unconsciousness."
19320,2/1/2013,Pakistan,Miranshah,3,3,6,A woman and child are killed when Islamic militants fire a rocket into their home.
19321,2/1/2013,Nigeria,Marte,2,0,2,Boko Haram militants ambush and kill two security personnel.
19322,2/1/2013,Iraq,Karbalah,2,8,10,Two Shia pilgrims on foot are sent straight to Allah by Sunni bombers.
19323,2/1/2013,Iraq,Tarmiyah,3,0,3,Three Iraqis are machine-gunned point-blank by Islamic 'insurgents'.
19324,3/1/2013,Somalia,Boo,1,3,4,"al-Shabaab gunmen open fire on women at a wedding party, killing at least one."
19325,3/1/2013,Syria,Damascus,2,0,2,Video surfaces of members of a Shia militia stoning and stabbing two Sunnis.
19326,3/1/2013,Iraq,Baghdad,4,15,19,"Sunnis target a minibus carrying Shia pilgrims, managing to kill just four."
19327,3/1/2013,Pakistan,Swabi,1,0,1,A prayer leader is assassinated by sectarian rivals.
19328,3/1/2013,Afghanistan,Nawa-i-Barakzayi,1,0,1,A cleric is gunned down in his own mosque by religious hardliners.
19329,3/1/2013,Iraq,Musayyib,28,49,77,Twenty-eight Shiite pilgrims are blown apart by a Shahid suicide car bomber.
19330,3/1/2013,Nigeria,Song,4,0,4,"Four people are burned to death by Religion of Peace radicals, including a child."
19331,4/1/2013,Pakistan,Mach,1,0,1,Sipah-e-Yazeed gunmen assassinate a Shiite at close range.
19332,4/1/2013,Thailand,Pattani,1,4,5,Islamic militants ambush and kill a local soldier.
19333,4/1/2013,Kenya,Garissa,2,7,9,Two refugees bleed to death after al-Shabaab cadres toss a grenade into their camp.
19334,4/1/2013,Syria,Idlib,1,0,1,A cleric is assassinated by Religion of Peace rivals.
19335,4/1/2013,Pakistan,Peshawar,2,1,3,A Taliban bomb snuffs the lives of two civilians.
19336,4/1/2013,Syria,Damascus,11,4,15,Two children are among eleven civilians dismantled by a Sunni bomb in a residential neighborhood.
19337,5/1/2013,Syria,Deir az-Zour,3,0,3,Three captured Syrians are executed by al-Nusra proclaiming their Muslim faith.
19338,5/1/2013,Pakistan,Utmanzai,2,0,2,Two charity workers involved in an education project are murdered by Religion of Peace radicals.
19339,5/1/2013,Pakistan,Faisalabad,1,0,1,A girl is stabbed to death by her conservative brother for having an affair.
19340,5/1/2013,Libya,Sidi Faraj,1,0,1,A local cop is shot to death by suspected Islamists.
19341,5/1/2013,Afghanistan,Uruzgan,4,1,5,Taliban extremists murder four commuters with a roadside bomb.
19342,5/1/2013,Iraq,Karbalah,1,11,12,A Shiite girl on a minibus is taken out by Sunni Holy Warriors.
19343,5/1/2013,Iraq,Hillah,3,23,26,Terrorists blow up three civilians.
19344,5/1/2013,Iraq,Diyala,5,10,15,Mujahideen take down five Iraqis in various attacks.
19345,6/1/2013,Afghanistan,Spin Boldak,4,15,19,Two suicide bombers murder four other people at a community meeting.
19346,6/1/2013,Pakistan,Chiniot,1,0,1,A Shiite child dies of injuries one week after being shot by Sipah-e-Sahaba.
19347,6/1/2013,Thailand,Narathiwat,1,1,2,A Buddhist woman dies after being shot in the neck and body by Muslim 'insurgents'.
19348,6/1/2013,Pakistan,Jamrud,5,1,6,Five tribesmen are machine-gunned by militant Muslims.
19349,7/1/2013,Pakistan,Gulshan-e-Iqbal,1,0,1,A 26-year-old bank employee is murdered for belonging to the wrong mosque.
19350,7/1/2013,Iraq,Mosul,3,4,7,al-Qaeda gunmen roll up on a checkpoint and machine-gun local cops point-blank.
19351,7/1/2013,Nigeria,Kano,3,1,4,"Boko Haram gunmen fire into a group of civilians leaving a rival mosque, killing three."
19352,7/1/2013,Iraq,Mosul,1,0,1,A female Christian teacher's throat is cut by dedicated Muslims.
19353,7/1/2013,Nigeria,Baban Layi,3,2,5,Islamists murder three traders at a market.
19354,7/1/2013,Pakistan,Karachi,2,0,2,Sectarian Jihadis take down a father and daughter.
19355,7/1/2013,Pakistan,Quetta,1,3,4,"Sunnis fire into a taxi carrying Shias, killing just one."
19356,7/1/2013,Afghanistan,Laghman,1,0,1,An acting imam shoots a British soldier in the back after leading prayers.
19357,8/1/2013,Pakistan,Bokhar,1,1,2,Islamic bombers take down a member of a peace committee.
19358,8/1/2013,Pakistan,Choura,1,0,1,A Sikh businessman is kidnapped and beheaded by Lashkar-e-Islam.
19359,8/1/2013,Iraq,Mosul,1,12,13,A car bomb at a supermarket in a Christian area kills a medical student.
19360,8/1/2013,Pakistan,Karachi,1,0,1,A Shiite father is shot to death in front of his child by Sunnis.
19361,9/1/2013,Mali,Konna,7,0,7,"Seven captives, five of whom were severely wounded, are executed by militants shouting praises to Allah."
19362,9/1/2013,Pakistan,Bahawalpur,1,0,1,Muslim stab a 19-year-old Christian to death for seeing a Muslim girl.
19363,9/1/2013,Pakistan,Quetta,1,0,1,A Sunni cleric is brought down in a targeted attack by Shia.
19364,9/1/2013,Pakistan,Peshawar,1,0,1,An influential Shia doctor is murdered outside his clinic by devoted Sunnis.
19365,10/1/2013,Pakistan,Quetta,4,0,4,Four Shias are summarily executed by Sunnis
19366,10/1/2013,Nigeria,Maiduguri,1,0,1,A female police officer is murdered by Boko Haram.
19367,10/1/2013,Iraq,Diyala,6,6,12,Mujahideen murder six Iraqis in a series of attacks.
19368,10/1/2013,Iraq,Baghdad,5,15,20,"Sunni bombers strike a bus stop in a Shia neighborhood, sending five residents to Allah."
19369,10/1/2013,Pakistan,Quetta,105,200,305,Over one-hundred people are massacred by two Lashkar-e-Jhangvi suicide blasts at a billiards hall in a Shiite area.
19370,10/1/2013,Pakistan,Mingora,30,70,100,Thirty people are ripped to shreds by a Fedayeen suicide bomber at a rival preaching center.
19371,10/1/2013,Yemen,Abyan,1,2,3,al-Qaeda assassins shoot a mediator to death.
19372,10/1/2013,Iraq,Diyala,2,4,6,Two people are killed when Mujahid bombers target a university chancellor.
19373,10/1/2013,Pakistan,Karachi,1,0,1,A court worker is shot four times by religious extremists.
19374,11/1/2013,India,Sopore,1,0,1,A local official is assassinated by Islamic militants.
19375,11/1/2013,Thailand,Pattani,2,0,2,Muslim 'insurgents' shoot two local cops to death.
19376,11/1/2013,Pakistan,Quetta,2,5,7,Tehreek-e-Taliban kill two people with a rocket.
19377,11/1/2013,Thailand,Pattani,2,2,4,A Muslim bomb aimed at teachers leaves two guards dead.
19378,11/1/2013,Afghanistan,Badghis,5,5,10,Five Afghans lose their lives to Taliban attacks.
19379,11/1/2013,Iraq,Mosul,2,2,4,al-Qaeda gunmen enter a family home and shoot a 7-year-old boy and his father to death.
19380,12/1/2013,Somalia,Jilib,2,0,2,Two civilians are pulled off of a bus and shot in the back of the head by fundamentalists.
19381,12/1/2013,Iraq,Kirkuk,2,4,6,Islamic terrorists kill two soccer players with a bomb outside their stadium.
19382,12/1/2013,Somalia,Bulomarer,1,0,1,Islamists execute a French hostage following a rescue attempt.
19383,12/1/2013,Pakistan,Quetta,1,1,2,A child is killed in a bomb attack targeting Shias at an Internet cafe.
19384,12/1/2013,Pakistan,Rahim Bux Banglani,1,0,1,"An 18-year-old girl is ""honor killed"" by her brother for having sex."
19385,12/1/2013,Pakistan,Nowshera,1,0,1,A female nurse is slain execution style by suspected Taliban.
19386,13/1/2013,Nigeria,Kano,2,2,4,Two locals are killed by Boko Haram gunmen.
19387,13/1/2013,Afghanistan,Chak,2,0,2,A girl is among two civilians executed in cold blood by religious extremists.
19388,13/1/2013,Iraq,Samarrah,3,0,3,Sunni militants machine-gun three Iraqis at a checkpoint.
19389,13/1/2013,Pakistan,Miranshah,14,25,39,Fourteen local soldiers are exterminated by a Taliban roadside bomb.
19390,13/1/2013,Afghanistan,Sayed Abad,7,2,9,Seven civilians are killed by a suspected Taliban bomb at a mosque.
19391,13/1/2013,India,Pulwama,1,0,1,A 40-year-old civilian is kidnapped and executed by Islamic militants.
19392,13/1/2013,Iraq,Fallujah,1,3,4,A 7-year-old boy is pulled apart by an 'insurgent' bomb.
19393,13/1/2013,Yemen,Rada,1,3,4,One civilian is killed during an al-Qaeda ambush.
19394,13/1/2013,Pakistan,Swabi,1,0,1,Islamic radicals shoot a police officer in the head.
19395,13/1/2013,Pakistan,Shabqadar,1,3,4,A 12-year-old boy is disassembled by a Mujahid bomb.
19396,14/1/2013,Pakistan,Khar Kallay,1,8,9,A bombing attack on a van full of Shia leaves one dead.
19397,14/1/2013,Pakistan,Kohikhel,3,0,3,Islamic extremists behead three captured tribesmen.
19398,15/1/2013,Syria,Haswiya,106,0,106,"Shiite militia and Sunni Islamists are blamed by the other for the massacre of over one hundred civilians, mostly family members."
19399,15/1/2013,Norway,Haugesund,0,2,2,A Muslim stabs two Christians who converted from Islam.
19400,15/1/2013,Dagestan,Makhachkala,1,0,1,Suspected Islamic 'separatists' assassinate a prominent judge.
19401,15/1/2013,Pakistan,Surjani,1,0,1,A 30-year-old Shia is gunned down by sectarian Jihadis.
19402,15/1/2013,Philippines,Midsayap,2,0,2,Moro Islamists are blamed for a shooting that leaves two dead.
19403,15/1/2013,Dagestan,Makhachkala,1,0,1,Suspected Islamists assassinate a judge.
19404,15/1/2013,Nigeria,Kano,4,0,4,Four policemen are massacred by Boko Haram Islamists.
19405,15/1/2013,Iraq,Fallujah,7,6,13,A Fedayeen suicide bomber takes out seven Iraqis.
19406,15/1/2013,Pakistan,Shalobar,6,28,34,Attacks by Lashkar-e-Islam on local security posts leave six innocents dead.
19407,15/1/2013,Pakistan,Karachi,1,0,1,Sipah-e-Sahaba gunmen pick off a Shiite.
19408,15/1/2013,Libya,Misrata,1,5,6,An child loses an eye and an imam loses his life when rivals throw a grenade at him.
19409,16/1/2013,Pakistan,Karachi,1,0,1,A 58-year-old Shiite is murdered by Wahhabi gunmen.
19410,16/1/2013,Bangladesh,Dhaka,0,1,1,An atheist blogger is stabbed by three Islamic fundamentalists.
19411,16/1/2013,Syria,Idlib,22,30,52,al-Nusra suicide bombers massacre two dozen Syrians in an urban area.
19412,16/1/2013,Yemen,Dhammar,1,0,1,A security official is assassinated by al-Qaeda.
19413,16/1/2013,Nigeria,Jos,4,2,6,Four Christians are the victims of a Muslim drive-by.
19414,16/1/2013,Algeria,Tigantourine,2,6,8,"Armed Islamists attack an oil field, killing two people they identified as Christians and kidnapping over a hundred workers."
19415,16/1/2013,Iraq,Baji,7,0,7,Seven Iraqis are killed in a handful of Mujahideen attacks.
19416,16/1/2013,Iraq,Kirkuk,21,170,191,Two-dozen shoppers are massacred by suicide truck bombers in a commercial district.
19417,16/1/2013,Iraq,Tuz Khurmato,3,37,40,Holy Warriors take out three locals.
19418,16/1/2013,Afghanistan,Kabul,3,30,33,Three civilians are murdered by Fedayeen suicide bombers.
19419,17/1/2013,Thailand,Narathiwat,1,0,1,Islamic 'insurgents' murder a school truck driver in front of seven children.
19420,17/1/2013,Thailand,Pattani,1,0,1,A 78-year-old farmer is shot to death in a bath tub by Muslim terrorists.
19421,17/1/2013,Thailand,Pattani,0,3,3,"Islamic militants shoot three sanitation workers, one in the head."
19422,17/1/2013,Pakistan,Karachi,4,0,4,A prominent anti-Taliban politician and three body guards are murdered by Jihadis.
19423,17/1/2013,Iraq,Qassim,5,20,25,Five Shia pilgrims on foot are torn to shreds following an Islamic Army of Iraq bomb at a bus stop.
19424,17/1/2013,Iraq,Karbala,4,12,16,Four lives are lost when a bus carrying Shia pilgrims is targeted by al-Qaeda bombers.
19425,17/1/2013,Iraq,Hilla,7,17,24,"al-Qaeda detonate a car bomb outside a soccer stadium in a Shia neighborhood, killing at least seven."
19426,17/1/2013,Iraq,Dujail,11,60,71,Eleven Shia pilgrims are sent to Allah by dedicated Sunni car bombers.
19427,17/1/2013,Kenya,Garissa,5,4,9,Religious extremists burst into a restaurant and gun down five patrons.
19428,17/1/2013,Pakistan,Karachi,1,0,1,A Shia civilian is murdered by Sunni gunmen at a market.
19429,17/1/2013,Thailand,Yala,1,0,1,A 28-year-old villager is murdered by Muslim extremists.
19430,18/1/2013,Lebanon,Roumieh,1,0,1,An inmate at a prison is murdered by hardcore Fatah al-Islam fundamentalists.
19431,18/1/2013,Nigeria,Kaduna,1,1,2,A 7-month-old baby is shot during an Islamic terror attack.
19432,18/1/2013,Syria,Daraa,5,12,17,"Suicide car bombers attack a rival mosque, killing at least five."
19433,18/1/2013,Pakistan,Khuzdar,1,0,1,A Shiite is gunned down by Sipah-e-Sahaba terrorists at a market.
19434,18/1/2013,Pakistan,Sur Kas,2,1,3,"Laskhar-e-Islam mortar a family home, killing the mother and father and severely injuring their girl."
19435,18/1/2013,Somalia,Mogadishu,1,0,1,A journalist is picked off by alleged al-Shabaab gunmen.
19436,18/1/2013,Thailand,Pattani,1,1,2,"Islamic gunmen fire into a pickup truck, killing the driver."
19437,18/1/2013,Nigeria,Kaduna,2,0,2,Two police officers are gunned down by Boko Haram.
19438,19/1/2013,Algeria,Tigantourine,48,0,48,Twenty three hostages are killed by their Islamic captors during a rescue attempt.  Twenty-five more are found summarily executed
19439,19/1/2013,Nigeria,Okene,2,5,7,Islamists ambush a luxury bus and murder two riders.
19440,19/1/2013,Nigeria,Kano,5,0,5,At least five people are killed in an attempted Boko Haram assassination of a popular emir.
19441,19/1/2013,Cameroon,Kousseri,1,0,1,Islamists shoot a man execution style.
19442,19/1/2013,Somalia,Afmadow,7,0,7,At least seven civilians are slain during an al-Shabaab attack.
19443,20/1/2013,Iraq,Baqubah,1,1,2,Terrorists kill a civilian with a bomb near her home.
19444,20/1/2013,Nigeria,Kaduna,2,2,4,A 6-year-old girl is killed by suspected Boko Haram.
19445,21/1/2013,Thailand,Pattani,1,1,2,A 12-year-old Buddhist boy is brought down by Runda Kumpulan Kecil Islamists.
19446,21/1/2013,Pakistan,Dawizai,2,9,11,A Taliban bomb leaves two dead.
19447,21/1/2013,Pakistan,Gakhar Mandi,1,0,1,The throat of a 45-year-old woman is cut by her conservative brother after she elopes by choice.
19448,21/1/2013,Syria,Salmiyeh,30,50,80,Shahid suicide car bombers destroy thirty lives in a commercial district.
19449,21/1/2013,Afghanistan,Kabul,3,0,3,At least three innocents are killed during a Fedayeen suicide assault on a traffic police headquarters.
19450,22/1/2013,Pakistan,Kari Haider Khel,2,0,2,Two tribesmen are taken out by a Tehreek-e-Taliban drive-by.
19451,22/1/2013,Nigeria,Kano,5,2,7,Five people playing an outdoor board game are shot to death by Islamic fundamentalists.
19452,22/1/2013,Iraq,Mahmoudiyyah,4,0,4,Four young children ages 6 to 12 are disassembled by a Mujahideen bomb outside their home.
19453,22/1/2013,Nigeria,Damboa,18,0,18,Fundamentalists massacre eighteen villagers at a market selling meat forbidden to Muslims.
19454,22/1/2013,Iraq,Shula,5,15,20,Sunni car bombers slaughter five Shiites in their own neighborhood.
19455,22/1/2013,Iraq,Taji,7,26,33,Seven people are torn to shreds by a Fedayeen suicide bomber.
19456,22/1/2013,Iraq,Mahmoudiya,5,15,20,al-Qaeda set off a car bomb along a city street that leaves five dead.
19457,22/1/2013,Pakistan,Peshawar,1,0,1,A Shia eye specialist is cut down outside his clinic by Sunni gunmen.
19458,22/1/2013,Pakistan,Karachi,2,0,2,A prominent doctor is among two Shias gunned down by Sunni radicals.
19459,23/1/2013,Pakistan,Gulbara,4,0,4,Four rival Islamists are murdered by Lashkar e-Islam.
19460,23/1/2013,Nigeria,Maiduguri,4,0,4,Boko Haram Islamists burn down a school and shoot four people to death.
19461,23/1/2013,Nigeria,Maiduguri,5,0,5,Religion of Peace proponents behead five people in their homes.
19462,23/1/2013,Iraq,Tuz Khurmatu,42,75,117,"A Shahid self-detonates inside a packed mosque, sending at least forty-two souls to Allah."
19463,23/1/2013,Yemen,al-Bayda,1,3,4,One person is killed by al-Qaeda bombers.
19464,23/1/2013,Iraq,Mosul,3,0,3,A school principal is among three Iraqis gunned down by Mujahideen.
19465,23/1/2013,Thailand,Narathiwat,1,0,1,A teacher is shot to death by Muslim 'insurgents' in front of dozens of children.
19466,23/1/2013,Pakistan,Orakzai,5,3,8,A Sunni bomb blast rips five people apart.
19467,23/1/2013,Pakistan,Hangu,2,0,2,Two clerics are gunned down at their own mosque by Religion of Peace rivals.
19468,23/1/2013,Pakistan,Quetta,1,0,1,A prayer leader dies after being shot by Religion of Peace rivals.
19469,24/1/2013,Pakistan,Gilgit,1,0,1,Sipah-e-Sahaba gunmen pick off a Shia water department employee.
19470,24/1/2013,Thailand,Pattani,1,0,1,A man is murdered in his own bed by Muslim terrorists.
19471,24/1/2013,Pakistan,Landhi,4,12,16,Terrorists murder four police officers with two bombs.
19472,24/1/2013,Syria,Saasa,8,5,13,al-Nusra Islamists murder eight people with a car bomb.
19473,24/1/2013,Iraq,Baghdad,3,0,3,Three Iraqis are brought down by al-Qaeda with silencers.
19474,24/1/2013,India,Hyderabad,1,2,3,A passerby is killed when religious hardliners start shooting at each others.
19475,25/1/2013,Pakistan,Parachinar,1,0,1,Wahhabi terrorists gun down a Shiite.
19476,25/1/2013,Afghanistan,Kapisa,5,10,15,Five civilians are dismantled by a Fedayeen suicide bomber.
19477,25/1/2013,Nigeria,Ngwa,1,0,1,An ex-official is assassinated by Boko Haram.
19478,26/1/2013,Afghanistan,Qale Sabaz,2,13,15,A suicide bomber takes out two people.
19479,26/1/2013,Afghanistan,Kunduz,10,20,30,Ten Afghans are blown to bits by a Shahid suicide bomber at a busy market.
19480,26/1/2013,Iraq,Fallujah,2,3,5,Mujahideen shoot two local soldiers to death.
19481,26/1/2013,Iraq,Baqubah,1,0,1,A woman is murdered in her own home by the Islamic Army of Iraq.
19482,27/1/2013,Nigeria,Borno,8,0,8,Eight people are abducted and murdered by Boko Haram.
19483,27/1/2013,Afghanistan,Kandahar,10,6,16,Islamic fundamentalists kill ten Afghans with a roadside bomb.
19484,27/1/2013,Pakistan,Tirah,61,40,101,Sixty-one people are killed in clashes between Tahrik-e-Taliban and Ansarul Islam.
19485,27/1/2013,Nigeria,Mangu,5,0,5,Five people are beheaded by Sharia advocates.
19486,27/1/2013,Algeria,Djebahia,2,5,7,Two gas pipeline guards are shot to death by Muslim militants.
19487,28/1/2013,Iraq,Mosul,2,0,2,A 4-year-old girl is among two civilians taken out by Mujahid gunmen.
19488,28/1/2013,Iraq,Fallujah,2,3,5,An al-Qaeda rocket attack leaves two dead Iraqis.
19489,28/1/2013,Turkey,Istanbul,1,0,1,An 85-year-old Christian woman is stabbed to death by an attacker who then carves a cross on her body.
19490,28/1/2013,Bangladesh,Motijheel,0,50,50,At least fifty people are injured in rioting by Islamic extremists standing up for war criminals.
19491,28/1/2013,Yemen,al-Bayda,8,12,20,Eight locals are disassembled by a Fedayeen suicide bomber.
19492,28/1/2013,Yemen,Rida,11,17,28,An al-Qaeda car bomb leaves eleven dead.
19493,28/1/2013,Russia,Kabardino-Balkaria,1,0,1,An off-duty police officer is assassinated by suspected Islamic 'separatists'.
19494,28/1/2013,Pakistan,Karachi,5,1,6,Four Sunni activists are murdered by sectarian rivals.  A 2-year-old later dies of injuries.
19495,29/1/2013,Pakistan,Kala,1,0,1,A guard for a polio vaccination team is gunned down by Islamists.
19496,29/1/2013,Iraq,Kirkuk,1,2,3,A cleric is taken out by sectarian rivals.
19497,29/1/2013,Thailand,Narathiwat,2,0,2,"A Buddhist married couple, who worked as school janitors, are brutally shot to death  by Islamic 'insurgents'."
19498,29/1/2013,Pakistan,Karachi,1,2,3,Terrorists from a religious outfit attack a police station and murder an officer.
19499,29/1/2013,Somalia,Mogadishu,6,12,18,A Shahid suicide bomber takes out six locals.
19500,29/1/2013,Pakistan,Quetta,2,0,2,Two Shia are shot to death by Sunni radicals during 'Unity Week'.
19501,30/1/2013,Iraq,Abu Ghraib,18,0,18,A mass grave containing eighteen al-Qaeda execution victims is discovered.
19502,30/1/2013,Pakistan,Golimar,1,0,1,Sipah-e-Sahaba gunmen pick off a 32-year-old Shiite.
19503,30/1/2013,Afghanistan,Sabari,2,4,6,Two small children are pulled into pieces by a Taliban bomb planted at a market.
19504,30/1/2013,Thailand,Narathiwat,1,2,3,Militant Muslims blow up a security guard for teachers.
19505,30/1/2013,Yemen,Raida,0,1,1,A Jewish man is badly injured in an anti-Semitic Muslim attack.
19506,30/1/2013,Pakistan,Ghani Gul,6,0,6,Six members of a family are killed when a mortar hits their home amidst fighting between two Islamist groups.
19507,31/1/2013,Syria,Damascus,3,0,3,"Hardliners kill three people on a bus, including a woman."
19508,31/1/2013,Mali,Douentza,2,0,2,Islamists murder two local soldiers.
19509,31/1/2013,Nigeria,Gombe,2,0,2,Two local cops are gunned down by Boko Haram.
19510,31/1/2013,Pakistan,Karachi,3,0,3,Two Sunni clerics are among three killed in a Shia drive-by.
19511,31/1/2013,Afghanistan,Greshk,1,8,9,A 13-year-old boy is killed when fundamentalists bomb a gambling event.
19512,31/1/2013,Pakistan,Malikhel,2,0,2,Religion of Peace bombers murder two polio workers who were on their way to vaccinate children.
19513,31/1/2013,Pakistan,Tirah,2,6,8,At least two bystanders are killed when Islamist groups clash.
19514,31/1/2013,Thailand,Yala,1,0,1,A 62-year-old villager is cut down by Muslim gunmen.
19515,31/1/2013,Pakistan,Quetta,1,1,2,A Shia barber is cut down by Sunnis firing into his shop.
19516,1/2/2013,Nigeria,Samunaka,15,1,16,"Islamists attack and burn three churches, killing at least fifteen innocents, including two children."
19517,1/2/2013,Pakistan,Lakai Sar,11,6,17,Lashkar-e-Islam terrorists assault a village and kill eleven defenders.
19518,1/2/2013,Afghanistan,Takhar,2,0,2,A Sunni hardliner suddenly shoots two police officers to death.
19519,1/2/2013,Pakistan,Hangu,30,56,86,A Fedayeen suicide bomber slaughters over two dozen worshippers outside a Shia mosque.
19520,1/2/2013,Syria,Damascus,53,90,143,al-Nusra suicide bombers massacre over fifty people in a single attack.
19521,1/2/2013,Lebanon,Beqaa,2,0,2,Islamists shoot two Lebanese policemen to death.
19522,1/2/2013,Egypt,Alexandria,0,1,1,A Christian woman is stabbed on the street by Muslim hardliners.
19523,1/2/2013,Thailand,Pattani,3,10,13,Three are killed when Islamic 'separatists' spray a group of farmers with machine-gun fire.
19524,1/2/2013,Nigeria,Zaria,3,0,3,A Muslim cleric is murdered along with his wife and baby after criticizing Boko Haram.
19525,2/2/2013,Philippines,Zamboanga,0,5,5,Islamic terrorists throw a bomb into a Catholic church during a service.
19526,2/2/2013,Pakistan,Karachi,2,0,2,Two human rights activists are shot to death by sectarian Jihadis.
19527,2/2/2013,Pakistan,Ghunda Mela,2,3,5,Taliban militants murder two local soldiers.
19528,2/2/2013,Pakistan,Sarai Nawrang,26,15,41,Women and children are among the casualties of a brutal Fedayeen attack that included a suicide bombing in a family home.
19529,2/2/2013,Afghanistan,Musa Qala,2,0,2,Two local cops are incinerated by a Taliban bomb.
19530,2/2/2013,Afghanistan,Miyanishin,5,0,5,Two young children are among a family of five exterminated by a roadside bomb.
19531,2/2/2013,Pakistan,Agra Taj,1,0,1,Lashkar-e-Jhagvi brutally murder a Shiite.
19532,3/2/2013,Iraq,Kirkuk,33,90,123,Three dozen innocents are slaughtered by a suicide bombing followed by a grenade and shooting assault along a city street.
19533,3/2/2013,Afghanistan,Khakriz,1,6,7,Women are among the casualties of a Taliban roadside attack.
19534,4/2/2013,Iraq,Taji,23,44,67,"A Holy Warrior self-detonates in a thick crowd of Iraqis, leaving about two dozen dead."
19535,4/2/2013,Pakistan,Chaman,1,0,1,A Christian dies after being shot five times by Muslims angry that he would not embrace Islam.
19536,4/2/2013,Somalia,Mogadishu,1,0,1,Islamic extremists kill an African Union soldier.
19537,4/2/2013,Yemen,Kutaf,6,7,13,Six people are killed during an armed clash between Sunnis and Shias.
19538,4/2/2013,Kenya,Garissa,1,0,1,Islamists shoot a local cop to death.
19539,4/2/2013,Pakistan,Karachi,1,0,1,Sectarian Jihadis pick off a 35-year-old Sunni at a market.
19540,5/2/2013,Denmark,Copenhagen,0,0,0,A Danish cartoonist narrowly escapes an assassination attempt on his front stoop from a man who fires from a yard away.
19541,5/2/2013,Afghanistan,Faryab,5,7,12,Mujahideen set off a bomb at a restaurant that leaves five dead.
19542,5/2/2013,Iraq,Taji,6,12,18,A suicide car bomber murder six Iraqis.
19543,5/2/2013,Thailand,Yala,4,0,4,"Four Buddhist fruit traders, including a 17-year-old, are tied up and slaughtered by Islamic 'insurgents'."
19544,5/2/2013,Nigeria,Sambisa Reserve,6,0,6,At least six park rangers are brutally murdered by Sharia advocates.
19545,5/2/2013,Bangladesh,Dhaka,3,43,46,At least three people are killed during a rampage by Jamaat-e-Islam
19546,6/2/2013,Syria,Palmyra,35,30,65,An al-Nusra suicide bomber and a separate car bombing send over thirty souls to Allah.
19547,6/2/2013,Tunisia,Tunis,1,0,1,A leading critic of Islamism is shot in the head by Salafis at his home.
19548,6/2/2013,Pakistan,Karachi,1,0,1,Religious rivals murder a Sunni.
19549,6/2/2013,Iraq,Mussayib,4,4,8,Four Iraqis die after being sprayed with al-Qaeda gunfire.
19550,6/2/2013,Russia,Nalchik,1,1,2,A local cop is gunned down by Islamic militants.
19551,6/2/2013,Syria,Hama,54,2,56,"A brutal bombing of a bus by an Islamist faction leaves over fifty dead, including women."
19552,7/2/2013,Mexico,Pakal Kin,2,0,2,"A man embraces Islam, then slaughters his two infidel parents because the Quran 'told' him too."
19553,7/2/2013,USA,"Buena Vista, NJ",2,0,2,A Muslim targets and beheads two Christian Coptic immigrants.
19554,7/2/2013,Kenya,Garissa,1,1,2,"Islamists shoot two Christian pastors, killing one."
19555,7/2/2013,Dagestan,Kahdzhalmakhi,1,0,1,Islamic militants shoot a local cop to death.
19556,7/2/2013,Pakistan,Orangi,1,5,6,A Taliban bombing leaves one dead.
19557,7/2/2013,Pakistan,Karachi,1,0,1,A Shiite dies in the hospital from injuries suffered during a Sipah-e- Sahaba shooting attack.
19558,7/2/2013,Afghanistan,Kishindih,4,3,7,The Taliban take out four locals with a roadside bomb.
19559,7/2/2013,Iraq,Mahmoudiya,3,0,3,Three Iraqis are machine-gunned by al-Qaeda while sitting in their car.
19560,7/2/2013,Iraq,Abu Ghraib,6,9,15,al-Qaeda bombers murder six Iraqis.
19561,8/2/2013,Lebanon,al-Ouazzani,1,0,1,A teenager seven months pregnant is stabbed to death by her brother in a Muslim honor killing.  (The girl was reportedly impregnated by her killer).
19562,8/2/2013,Pakistan,Pattoki,0,3,3,Three Christian women are beaten and tortured by a Muslim mob in their own home.
19563,8/2/2013,Afghanistan,Nad Ali,6,0,6,Two women are among six member of a family torn to shreds by an Islamic bomb.
19564,8/2/2013,Syria,Aleppo,9,0,9,"Nine people, including women, children and a cleric are reportedly killed by a Sunni rocket attack on a Shiite mosque."
19565,8/2/2013,Pakistan,Peshawar,1,0,1,A Shiite professional is picked off by Sunni gunmen shortly after dropping his kids off at school.
19566,8/2/2013,Iraq,Shomali,14,26,40,Fourteen Iraqis at a bus stop are dismantled by Islamic State of Iraq bombers.
19567,8/2/2013,Iraq,Baghdad,17,44,61,"Holy Warriors detonate two car bombs at an animal market popular with Shias, slaughtering at least seventeen."
19568,8/2/2013,Iraq,Karbala,5,16,21,At least five Shiites are taken out by Sunni bombers.
19569,8/2/2013,Nigeria,Kano,10,5,15,Islamists gun down one male and nine female polio vaccination workers in two attacks after clerics accuse the program of being a conspiracy against Muslim children.
19570,8/2/2013,Pakistan,Kalaya,16,27,43,"Muslim fundamentalists bomb marketplace selling videos and CD's, killing at least sixteen."
19571,9/2/2013,Pakistan,Karachi,2,0,2,A seminary student and a Shiite are murdered by sectarian Jihadis in separate attacks.
19572,9/2/2013,Thailand,Pattani,1,0,1,A 56-year-old villager is shot in the head at his home by suspected Muslim 'separatists'
19573,9/2/2013,Nigeria,Potiskum,3,0,3,Three Korean doctors are hacked to death by Islamic radicals.
19574,9/2/2013,Iraq,Baghdad,6,40,46,"Terrorists send mortars into a camp housing Iranian dissidents, killing six."
19575,9/2/2013,Thailand,Pattani,1,1,2,Muslim 'separatists' ambush two locals.
19576,10/2/2013,Thailand,Yala,5,1,6,"Islamic militants overturn a truck with a bomb, then shoot five survivors to death."
19577,10/2/2013,Pakistan,Karachi,2,0,2,A teacher is among two Shiites shot to death in separate attacks - one in his home.
19578,10/2/2013,Pakistan,Orangi,2,0,2,A Shia father and son are murdered by Sipah-e-Sahaba gunmen.
19579,10/2/2013,Iraq,Samarrah,1,7,8,"al-Qaeda bomb a family home, killing one member."
19580,10/2/2013,Iraq,Mosul,4,0,4,Mujahideen shoot murder four Iraqis in separate attacks.
19581,11/2/2013,Tanzania,Buseresere,1,0,1,A pastor is beheaded by a group of Muslim youth.
19582,11/2/2013,Nigeria,Maiduguri,1,0,1,Islamic radicals shoot a city councilor to death at his residence.
19583,11/2/2013,Iraq,Mosul,8,8,16,"A Shahid suicide bomber takes out eight Iraqis, including a 7-year-old boy."
19584,11/2/2013,Pakistan,Peshawar,1,0,1,A doctor is gunned down outside his clinic by sectarian Jihadis.
19585,11/2/2013,Syria,al-Shadada,14,12,26,Two al-Nusra suicide bombings reduce fourteen people to body parts.
19586,11/2/2013,Pakistan,Tirah,10,10,20,Ten more people die during a clash between radical Islamist groups.
19587,11/2/2013,Pakistan,Gulshan-e-Iqbal,1,0,1,A Quran teacher is gunned down by Religion of Peace rivals.
19588,11/2/2013,Turkey,Cilvegozu,7,12,19,A Fedayeen suicide bomber self-detonates at a border crossing.
19589,11/2/2013,Somalia,Galkayo,4,6,10,A suicide blast by a religious fanatic leaves four others dead.
19590,11/2/2013,Iraq,Rawah,3,2,5,Mujahideen take out three people with a bomb at a parking lot.
19591,12/2/2013,Pakistan,Gulbahar,2,3,5,Sectarian Jihadis gun down two people at a hardware store.
19592,12/2/2013,Pakistan,Lahore,1,0,1,Sunnis shoot a banker to death because he is Shiite.
19593,12/2/2013,Pakistan,Tirah,19,7,26,A day of back and forth attacks by Ansarul Islam and the Taliban leave nineteen dead.
19594,12/2/2013,Pakistan,Pasban,1,0,1,A 45-year-old Shiite is assassinated by Sipah-e-Sabada.
19595,12/2/2013,Nigeria,Maiduguri,4,1,5,A child is among the casualties of two Boko Haram home invasions that leave four dead.
19596,13/2/2013,Pakistan,Karachi,2,0,2,"Two Shias are murdered by devoted Sunnis, including one who died during torture."
19597,13/2/2013,Pakistan,Shunglai,1,0,1,A young woman is honor killed by her family and dumped near a mosque.
19598,13/2/2013,Pakistan,Hassanzo,9,23,32,Two roadside bombings leave nine people dead.
19599,14/2/2013,Pakistan,Hangu,11,11,22,Two women are among eleven people torn to shreds by a Fedayeen suicide bomber.
19600,14/2/2013,Bahrain,Manama,1,0,1,Shiite terrorists kill a security official with a firebomb.
19601,14/2/2013,Dagestan,Khasavyurt,4,6,10,Four local cops are blown to bits by a Shahid suicide bomber.
19602,14/2/2013,Iraq,Mosul,4,0,4,Two brothers are among four Iraqis murdered by Mujahideen.
19603,14/2/2013,Pakistan,Hassanzai Dara,4,0,4,Militants kill four locals with a roadside bomb.
19604,15/2/2013,Pakistan,Orangi,1,0,1,A Shiite is gunned down by Sunnis.
19605,15/2/2013,Iraq,Abu Ghraib,4,2,6,Four Iraqis are taken out by a terrorist landmine.
19606,15/2/2013,Bangladesh,Pallabi,1,0,1,A 30-year-old blogger who opposed Islamic fundamentalists is stabbed to death outside his home.
19607,15/2/2013,Somalia,Garowe,1,2,3,A cleric is murdered between prayers in his mosque by Islamist rivals.
19608,15/2/2013,Afghanistan,Ghazni,2,1,3,Two civilians are killed by a Taliban bomb placed outside a mosque.
19609,15/2/2013,Somalia,Janalle,1,0,1,A captured Kenyan soldier is executed by al-Shabaab.
19610,15/2/2013,Iraq,al-Mahmoudiyyah,1,3,4,An innocent person is machine-gunned by al-Qaeda.
19611,16/2/2013,Pakistan,Bannu,3,0,3,Three people are shot to death by Muslim radicals.
19612,16/2/2013,Pakistan,Quetta,91,180,271,"Women and children are amply represented in the carnage as a Lashkar-e-Jhangvi bomb rips through a Shiite marketplace, leaving over ninety dead."
19613,16/2/2013,Somalia,Mogadishu,1,2,3,al-Shabaab bombers kill one person at a restaurant.
19614,16/2/2013,Iraq,Mosul,3,0,3,A suicide blast leaves three others dead.
19615,16/2/2013,Nigeria,Bauchi,1,7,8,A guard is killed and seven construction workers kidnapped by Ansuru Islamists.
19616,16/2/2013,Pakistan,Karachi,2,0,2,Sunni terrorists shoot two Shia to death.
19617,16/2/2013,Pakistan,Tando Adam,1,0,1,Lashkar-e-Jhangvi gunmen on motorcycles take out a Shiite.
19618,16/2/2013,Pakistan,Lahore,1,0,1,A 45-year-old Christian is murdered in cold blood by a Muslim arguing religion.
19619,17/2/2013,Tunisia,Sfax,0,1,1,A young man is stabbed in the head during a Salafist assault on a labor union office.
19620,17/2/2013,Pakistan,Mattani,1,0,1,A teenage boy sent by the Taliban assassinates a man at a market.
19621,17/2/2013,Thailand,Pattani,3,9,12,Three civilians are killed when Muslim militants detonate a bomb in a commercial district.
19622,17/2/2013,Iraq,Baghdad,37,100,137,At least thirty-seven people are pulled into pieces at a market by Islamic State of Iraq bombers.
19623,17/2/2013,Pakistan,Karachi,1,0,1,A cleric is shot to death by Religion of Peace rivals.
19624,17/2/2013,Tanzania,Zanzibar,1,0,1,A priest is murdered by Muslim extremists on his way to church.
19625,18/2/2013,Thailand,Pattani,0,1,1,A Buddhist teacher survives a targeted Muslim shooting with injuries.
19626,18/2/2013,Pakistan,Swabi,1,0,1,Muslim militants gun down a cop at close range.
19627,18/2/2013,Pakistan,Karachi,3,0,3,Three people are murdered in a sectarian drive-by.
19628,18/2/2013,Pakistan,Lahore,2,0,2,A Shia doctor and his 11-year-old son are brutally gunned down by sectarian Jihadis.
19629,18/2/2013,Pakistan,Peshawar,6,7,13,"Suicide bombers detonate at a government office, killing six."
19630,18/2/2013,Somalia,Alanley,1,0,1,A 42-year-old Christian teacher and father of four is brutally executed by al-Shabaab outside his home.
19631,18/2/2013,Iraq,Kirkuk,1,16,17,Mujahideen plant a bomb on a child's tricycle that leaves one dead.
19632,18/2/2013,Pakistan,Landi Kotal,2,0,2,Taliban shoot two civilians to death.
19633,18/2/2013,Pakistan,Darzaab,1,1,2,A civilian is killed during a Taliban attack.
19634,18/2/2013,Netherlands,Brabant,1,0,1,Islamists are suspected in the murder of a Christian convert from Iran.
19635,19/2/2013,Cameroon,Lake Chad,2,1,3,Two Christian converts are lined up and shot to death for leaving Islam.
19636,19/2/2013,Nigeria,Naibawa,6,6,12,"Muslim terrorists fire into a restaurant, killing six patrons."
19637,19/2/2013,Bangladesh,Naliakhali,1,20,21,A young boy is burned alive during a rampage by a Muslim mob through a Hindu village.
19638,19/2/2013,Thailand,Pattani,1,0,1,Islamic 'separatists' shoot a 44-year-old several times in the head.
19639,19/2/2013,Pakistan,Karachi,1,0,1,A 24-year-old Shiite is shot to death by Sunnis on his way from a rally protesting Sunni violence.
19640,19/2/2013,Iraq,Tikrit,2,6,8,Islamic State of Iraq bombers murder two people.
19641,19/2/2013,Iraq,Mosul,7,0,7,At least two women are among seven civilians gunned down in their own homes in two al-Qaeda attacks.
19642,19/2/2013,Iraq,Madaen,3,0,3,A boy is among three people shot to death in their home by al-Qaeda.
19643,20/2/2013,Pakistan,Jacobabad,1,4,5,"Rivals set off a bomb at a religious rally organized by a peaceful cleric, killing his grandson."
19644,20/2/2013,Nigeria,Maiduguri,3,2,5,A Fedayeen suicide bomber takes out three people.
19645,21/2/2013,Iraq,Dhuluiyah,9,27,36,Nine Iraqis are blown to bits by al-Qaeda bombers.
19646,21/2/2013,India,Hyderabad,17,119,136,A series of Indian Mujahideen bomb blasts at a bus stop and outside a cinema leave seventeen dead.
19647,21/2/2013,Syria,Damascus,90,200,290,"Sunnis set off four car bombs in Shia neighborhoods, killing at least ninety, including children."
19648,21/2/2013,Kenya,Dadaab,7,0,7,Two women are among seven people machine-gunned outside a mosque.
19649,21/2/2013,Pakistan,Peshawar,2,18,20,Two people are killed when fundamentalists set off a bomb at a shopping mall.
19650,21/2/2013,Mali,Kidal,2,0,2,An Islamist car bomb leaves two dead.
19651,21/2/2013,Iraq,Hammam al-Alil,2,0,2,Terrorists storm a home and murder a construction worker and his wife.
19652,21/2/2013,Iraq,Baqubah,1,7,8,A teacher is killed in a Mujahideen Islamist shooting attack and seven female university students injured in a separate bombing.
19653,21/2/2013,Afghanistan,Kandhar,1,2,3,Fundamentalists kill one local with a grenade.
19654,21/2/2013,Afghanistan,Kohistanat,2,6,8,Two local cops are gunned down by the Taliban.
19655,21/2/2013,Iraq,Mosul,3,0,3,A Shahid suicide bomber snuffs out three other lives.
19656,22/2/2013,Nigeria,Kogom,10,2,12,Fulani Muslims hack ten Christian family members to death including five small children.
19657,22/2/2013,Mali,Khalil,3,3,6,Three other people are killed by Fedayeen suicide bombers.
19658,22/2/2013,Iraq,Halaiwat,7,1,8,Seven volunteers at a checkpoint are executed in cold blood by al-Qaeda gunmen.
19659,22/2/2013,Iraq,Mosul,3,0,3,Three Iraqis are machine-gunned by al-Qaeda.
19660,23/2/2013,Nigeria,Aduwan,5,11,16,A baby and a 13-year-old are among five innocents slain when Muslim extremists rake churches with machine-gun fire.
19661,23/2/2013,Nigeria,Abuja,17,1,18,"Fundamentalists storm a factory, separate Christian from Muslim workers and then murder seventeen of the former in cold blood."
19662,23/2/2013,Egypt,Alexandria,5,0,5,Islamists murder four Christians and a guard outside a church.
19663,23/2/2013,Nigeria,Ngalda,6,12,18,Fundamentalists storm a small town late at night and indiscriminately murder six people at a bar.
19664,23/2/2013,Pakistan,Karachi,1,0,1,A young Shia student is gunned down near a college by Sipah-e-Sahaba.
19665,23/2/2013,Pakistan,Rashakai,1,2,3,"Islamic militants ambush a police van, killing one occupant."
19666,23/2/2013,Nigeria,Gombe,5,3,8,Fundamentalists drive by a card game and shoot five people to death.
19667,23/2/2013,Iraq,Baqubah,2,6,8,"A suicide bomber detonates outside a house, obliterating two bystanders."
19668,23/2/2013,Pakistan,Bhittai,1,0,1,A cleric is gunned down outside his mosque by Religion of Peace rivals.
19669,24/2/2013,Yemen,Baida,1,0,1,al-Qaeda gunmen take down a local cop.
19670,24/2/2013,Afghanistan,Logar,1,2,3,At least one innocent person is taken out by a Shahid suicide bomber.
19671,24/2/2013,Afghanistan,Jalalabad,2,3,5,A Fedayeen suicide bomber sends two souls to Allah.
19672,24/2/2013,Pakistan,Toheedabad,1,0,1,Terrorists assassinate a counter-terror constable.
19673,24/2/2013,Israel,Negev,1,0,1,A Muslim man throws his 16-year-old daughter down a well over unauthorized relations with a boy.
19674,24/2/2013,Nigeria,Gulak,1,0,1,Boko Haram slit a man's throat in front of his wife and children.
19675,24/2/2013,Nigeria,Fika,5,3,8,"Islamists rampage through a Christian village, killing five people in attacks that included a church."
19676,25/2/2013,Pakistan,Marjah,4,4,8,Children are among the casualties of an Islamic landmine attack.
19677,25/2/2013,Pakistan,Kunwari,1,0,1,Sipah-e-Sahaba terrorists shoot a 50-year-old Shia businessman in the head.
19678,25/2/2013,Somalia,Gedo,2,0,2,Sharia advocates walk into a restaurant and gun down two officials having lunch.
19679,25/2/2013,Nigeria,Ngelzarma,7,3,10,Seven people at a motor park are massacred by Boko Haram gunmen.
19680,25/2/2013,Iraq,Bani Saad,4,15,19,Mujahideen blow up four Iraqis with a marketplace car bomb.
19681,25/2/2013,Iraq,Baqubah,2,4,6,Two civilians are murdered by al-Qaeda terrorists in separate attacks.
19682,25/2/2013,Pakistan,Shikarpur,2,10,12,"Sunnis bomb a Sufi shrine, killing two worshippers."
19683,25/2/2013,Iraq,Mosul,3,0,3,An 8-year-old is among three people torn to pieces by an 'insurgent' bomb.
19684,26/2/2013,Iraq,Madain,2,0,2,A teacher and his son are dragged out of their home and shot in the street by al-Qaeda.
19685,26/2/2013,Syria,Damascus,5,0,5,A suicide bomber kills five people.
19686,26/2/2013,Pakistan,Mardan,1,0,1,Muslim radicals gun down a guard for a polio vaccination team.
19687,26/2/2013,Nigeria,Kano,1,0,1,Islamic radicals gun down a cop in cold blood.
19688,27/2/2013,Mali,Kidal,7,3,10,At least seven people are killed by a suicide bomber.
19689,27/2/2013,Nigeria,Maiduguri,3,4,7,Three people lost their lives to Boko Haram bombers.
19690,27/2/2013,Afghanistan,Kandahar,3,0,3,A religious extremist shoots three local cops to death.
19691,27/2/2013,Afghanistan,Ghazni,17,0,17,Seventeen Afghan policemen are drugged by the Taliban and summarily executed.
19692,27/2/2013,Pakistan,Miranshah,1,0,1,A journalist is shot to death shortly after publishing stories that promoted anti-polio drives.
19693,27/2/2013,Pakistan,Karachi,2,0,2,A Sunni and Shia are killed in separate sectarian shooting attacks.
19694,27/2/2013,Afghanistan,Kabul,0,10,10,A suicide bomber detonates next to a bus.
19695,28/2/2013,Iraq,Baghdad,23,60,83,Two dozen innocents at a soccer field are blown to bits by Mujahid bombers.
19696,28/2/2013,Iraq,Mahmoudiya,3,6,9,Three Iraqis are pulled into pieces by a Mujahideen bomb.
19697,28/2/2013,Iraq,Aziziyah,3,8,11,"Jihadis car bomb a crowded livestock market, killing at least three."
19698,28/2/2013,Somalia,Hirran,1,0,1,An al-Shabaab victim is found butchered and discarded.
19699,28/2/2013,Bangladesh,Gaibandha,4,0,4,A mob of religious fanatics beat four policemen to death with sticks.
19700,28/2/2013,Syria,Homs,1,30,31,A Sunni car bomb in a residential area leaves one dead.
19701,28/2/2013,Iraq,Baghdad,11,32,43,"Sunnis set off a car bomb at a packed Shiite restaurant, leaving eleven dead and three dozen more in agony."
19702,1/3/2013,Somalia,Mogadishu,1,0,1,Two suicide bombers manage to take out one civilian at a beachfront restaurant.
19703,1/3/2013,Afghanistan,Kunar,9,1,10,Hardliner fundamentalists murder nine locals with a roadside bomb.
19704,1/3/2013,Iraq,Diwaniyah,5,45,50,Five people at a sheep market are sent to Allah by 'insurgent' bombers.
19705,1/3/2013,Thailand,Narathiwat,0,6,6,Five schoolchildren are among the casualties of a 'separatist' motorcycle bomb.
19706,1/3/2013,Egypt,Kom Ombo,0,23,23,Muslims firebomb a church on a false rumor of a conversion.
19707,1/3/2013,Pakistan,Karachi,1,0,1,A seminary student is gunned down by sectarian rivals.
19708,1/3/2013,Pakistan,Peshawar,1,0,1,Sunnis shoot a trader to death at a market for no reason other than being Shia.
19709,2/3/2013,Libya,Benghazi,0,11,11,A priest and ten parishioners are beaten and humiliated in their own church by Muslim activists.
19710,2/3/2013,Tanzania,Dar Es Salaam,0,1,1,An Islamist attempt to hack a church bishop to death is thwarted by a guard who suffers horrific injuries.
19711,2/3/2013,Egypt,Cairo,3,0,3,Three Christian brothers are machine-gunned in their home by Islamists angered over a church-building rumor.
19712,2/3/2013,Thailand,Yala,2,12,14,Muslim 'insurgents' kill two people with a bomb hidden on a motorcycle.
19713,2/3/2013,India,Kupwara,2,0,2,Mujahideen shoot two guards to death at a bus stop.
19714,2/3/2013,Pakistan,Karachi,2,0,2,Two Shiites are murdered by Sipah-e-Sahaba terrorists.
19715,2/3/2013,Afghanistan,Warduj,3,3,6,Sunni fundamentalists ambush and kill three Afghans.
19716,3/3/2013,Pakistan,Karachi,48,180,228,Four dozen worshippers are massacred when Lashkar-e-Jhangvi set off a massive suicide car bomb outside a Shia shrine.
19717,3/3/2013,Iraq,Karbalah,0,10,10,A suicide bomber detonates outside a Shia shrine.
19718,3/3/2013,Iraq,Baghdad,4,11,15,Bomb blasts in two Shia neighborhoods leave four dead.
19719,3/3/2013,Dagestan,Gubden,1,0,1,A moderate cleric is murdered in his home by Islamic extremists.
19720,3/3/2013,Pakistan,Safar,1,0,1,Sunni terrorists shoot an innocent Shia to death.
19721,3/3/2013,Nigeria,Monguno,1,0,1,At least one villager is killed during a Boko Haram attack.
19722,3/3/2013,Bangladesh,Dhaka,23,200,223,"About two dozen innocent people, including women, children and police are thought killed during violent rioting by Jamaat-e-Islami."
19723,3/3/2013,Iraq,Mosul,1,1,2,al-Qaeda gunmen shoot a man to death in his own home.
19724,4/3/2013,Iraq,Mosul,5,8,13,An al-Qaeda suicide bomber takes out five Iraqis.
19725,4/3/2013,Yemen,Loder,12,8,20,A Fedayeen suicide bomber sends a dozen souls to Allah.
19726,4/3/2013,Iraq,Ratba,57,0,57,al-Nusra terrorists from Syria shoot fifty-seven surrendered soldiers and Iraqi guards in cold blood.
19727,4/3/2013,Thailand,Narathiwat,1,0,1,Muslim gunmen knock a 37-year-old off his motorcycle and then shoot him in the head.
19728,4/3/2013,Nigeria,Gwoza,10,0,10,Eight civilians are among ten killed during a Boko Haram attack on police station and bank.
19729,4/3/2013,Pakistan,Khaisuri,1,0,1,A man is kidnapped and executed by Shaheen Bhittani.
19730,5/3/2013,Bangladesh,Rangpur,2,0,2,A policeman and one other die of injuries suffered during a Jamaat-e-Islami rampage.
19731,5/3/2013,Iraq,Kirkuk,7,18,25,Islamic State of Iraq terrorists kill seven Iraqis in two attacks.
19732,5/3/2013,Iraq,Baqubah,3,17,20,"Mujahideen bomb a soccer field, killing three spectators."
19733,5/3/2013,Iraq,Taji,3,0,3,al-Qaeda gunmen murder three people.
19734,5/3/2013,Pakistan,Jamrud,0,1,1,"A polio clinic narrowly escapes disaster as a bomb detonates at the wrong time, injuring only a nurse."
19735,5/3/2013,Iraq,Baghdad,1,0,1,A man dies in an al-Qaeda drive-by.
19736,6/3/2013,Kenya,Garissa,1,0,1,An Islamist shoots a refugee camp guard at close range.
19737,6/3/2013,Pakistan,Tandlianwala,2,0,2,An 18-year-old girl and her lover are 'honor' killed by her uncle on suspicion of sex.
19738,6/3/2013,Bangladesh,Tangail,1,0,1,A 65-year-old citizen is murdered by Jamaat-e-Islami.
19739,6/3/2013,Thailand,Pattani,1,0,1,Muslim gunmen pick off a 42-year-old man in front of his home.
19740,6/3/2013,Afghanistan,Badakhshan,17,0,17,Islamic extremists execute seventeen captured Afghan soldiers in cold blood.
19741,6/3/2013,Iraq,Ramadi,5,0,5,At least five Iraqis are taken out by the Mujahideen.
19742,6/3/2013,Iraq,Hawija,2,1,3,Two people are picked off by al-Qaeda gunmen.
19743,6/3/2013,Pakistan,Abbas Town,2,0,2,Sipah-e-Sahaba gunmen murder two Shia returning from a funeral
19744,7/3/2013,China,Korla,5,7,12,"At least one Muslim goes on a stabbing spree, killing five people in a suspected sectarian attack on Han."
19745,8/3/2013,India,Tangmarg,1,0,1,A man is abducted from his home and shot to death by Islamic terrorists.
19746,8/3/2013,Iraq,Tikrit,5,2,7,A family of five is slaughtered in their home by Sunni 'insurgents'.
19747,8/3/2013,Iraq,Samarrah,5,4,9,al-Qaeda gunmen murder five Iraqis on the street.
19748,8/3/2013,Thailand,Narathiwat,0,1,1,At least one child is hit when Muslim 'insurgents' spray a playground with gunfire.
19749,9/3/2013,Pakistan,Lahore,0,35,35,"A Muslim mob rampages through a Christian neighborhood, burning more than 100 homes and injuring three dozen."
19750,9/3/2013,Dagestan,Izberbash,1,0,1,Islamic separatists shoot a Russian judge to death.
19751,9/3/2013,Pakistan,Peshawar,6,28,34,Six worshippers are ripped apart by a bomb placed inside a Barelvi (Sufi) mosque.
19752,9/3/2013,Afghanistan,Khost,9,2,11,Eight children are among nine innocents shredded by a Fedayeen suicide bomber.
19753,9/3/2013,Afghanistan,Kabul,9,13,22,"A suicide bomber on a bicycle pedals to paradise, taking nine others with him."
19754,10/3/2013,Libya,Benghazi,1,0,1,A Christian arrested by Islamists for 'proselytizing' dies from 'natural causes' while being tortured.
19755,10/3/2013,Afghanistan,Badakhshan,2,0,2,Two local cops are murdered by religious extremists.
19756,10/3/2013,Nigeria,Jama'are,7,0,7,Ansaru Islamists summarily execute seven 'Christian' hostages.
19757,10/3/2013,Pakistan,Landi Kotal,1,3,4,A 4-year-old girl bleeds out after radicals detonate a bomb outside a rival mosque.
19758,10/3/2013,Bangladesh,Khulna,3,3,6,Three more policemen are reported dead from Jamaat-e-Islami violence.
19759,10/3/2013,Thailand,Pattani,1,1,2,A 50-year-old villager is gunned down by Muslim terrorists outside a mosque.
19760,10/3/2013,Thailand,Pattani,1,0,1,A 52-year-old woman is shot in the head by Islamic 'insurgents' while returning from a trip to the market.
19761,10/3/2013,Thailand,Pattani,1,0,1,A 42-year-old man driving a BMW is machine-gunned on the road by Muslim terrorists.
19762,10/3/2013,Syria,Harasta,1,9,10,"Terrorists fire on a bus carrying kindergarteners, killing at least one child."
19763,10/3/2013,Nigeria,Dakata,5,3,8,Five Christians are shot to death by Islamic extremists while returning home from church.
19764,10/3/2013,Dagestan,Buinaksk,1,0,1,A healer is shot several times in his own home by militant Islamists.
19765,11/3/2013,Israel,Jerusalem,0,9,9,Nine Israelis are injured when Muslims hurl firebombs at them on the Temple Mount.
19766,11/3/2013,Pakistan,Landhi,2,4,6,A bomb placed outside a Shia-owned shop leaves a father and son dead.
19767,11/3/2013,Iraq,Dibis,5,165,170,"A Shahid suicide bomber detonates next to a girl's school, killing at least five."
19768,11/3/2013,Pakistan,Masuzai,3,2,5,Islamists take down three local soldiers on patrol with an IED.
19769,11/3/2013,Pakistan,Peshawar,1,0,1,A Shiite shop owner is cut down by Sipah-e-Sahaba gunmen.
19770,11/3/2013,Iraq,Baghdad,3,0,3,Mujahideen murder three people including a man and wife in their home.
19771,12/3/2013,Pakistan,Karachi,1,0,1,A Shia business man is murdered by Sunni gunmen on his way to work.
19772,12/3/2013,Pakistan,Saddar,3,18,21,A Fedayeen suicide bomber takes out five people.
19773,12/3/2013,Pakistan,Pabbi,0,6,6,Children are among the casualties of a bombing outside the house of an anti-Taliban politician.
19774,12/3/2013,Nigeria,Kano,0,4,4,Four teachers at a primary school are shot by Boko Haram.
19775,12/3/2013,Pakistan,Bannu,4,16,20,A father and son on their way home are taken out by a remote-controlled bomb.  Two of the injured later die in the hospital.
19776,13/3/2013,Iraq,Tikrit,2,0,2,A man and wife are shot to death in their own home by al-Qaeda.
19777,13/3/2013,India,Srinagar,5,7,12,"Islamic terrorists throw grenades into an Indian camp, killing five security personnel."
19778,13/3/2013,Nigeria,Borno,2,0,2,A woman is among two people murdered in their own homes by Boko Haram.
19779,13/3/2013,Pakistan,Orangi Town,1,0,1,A female social worker is murdered by Religion of Peace gunmen.
19780,13/3/2013,Afghanistan,Kunduz,10,10,20,"A Fedayeen bomber self-detonates at a polo game, killing at least ten spectators."
19781,13/3/2013,Afghanistan,Zhranda,1,1,2,At least one cop is killed during a Taliban assault on a checkpoint.
19782,13/3/2013,Pakistan,Kharadar,1,0,1,Sectarian Jihadis kidnap and torture a rival to death.
19783,14/3/2013,USA,"Vancouver, WA",0,2,2,Two people suffer knife injuries when a Muslim convert attempts to stab a non-Muslim to death over religious views outside a coffee shop.
19784,14/3/2013,Iraq,Baghdad,30,57,87,A coordinated Fedayeen attack on a government building by the 'Islamic State of Iraq' leaves thirty dead.
19785,14/3/2013,Pakistan,Tirah,18,14,32,Eighteen people are killed during a clash between two hardline Islamic groups.
19786,14/3/2013,Thailand,Narathiwat,1,0,1,Muslim 'insurgents' shoot a 45-year-old villager to death.
19787,14/3/2013,Nigeria,Gwoza,1,0,1,"A civilian is killed during a raid on a prison by 'Allah Akbar' shouting gunmen, shortly after they prayed at a mosque."
19788,14/3/2013,Pakistan,Gulistan,1,0,1,Ahl-e-Sunnat Wal-Jamaat gunmen take down a 25-year-old Shiite.
19789,15/3/2013,Iraq,Baqubah,4,0,4,"al-Qaeda gunmen invade a home, tie a man and his three sons up and execute them in cold blood."
19790,15/3/2013,Israel,Ariel,0,5,5,"Two brutal rock attacks by Arabs leave a baby severely injured.  Other victims include her two sisters, ages 6 and 4."
19791,15/3/2013,Thailand,Narathiwat,4,0,4,Four local cops die from a bomb planted by Muslim 'separatists'.
19792,15/3/2013,Pakistan,Karachi,3,5,8,The Tehrik-e-Taliban is suspected to be behind the bombing of a TV station in which three are killed.
19793,15/3/2013,Iraq,Baiji,9,2,11,Nine Iraqis are massacred at point blank range by Mujahid gunmen.
19794,15/3/2013,Iraq,Bani-Sa'ad,1,2,3,A woman is blown up by Muslim 'insurgents'.
19795,15/3/2013,Somalia,Barawe,1,0,1,An 18-year-old is buried in the ground and stoned to death for being gay.
19796,16/3/2013,Pakistan,Peshawar,1,1,2,"Religion of Peace community activists fire on two suspected prostitutes, killing one."
19797,16/3/2013,Pakistan,Landhi,1,0,1,Sipah-e-Sahaba shoot a handicapped Shiite to death at a market.
19798,16/3/2013,Iraq,Garmat Ali,10,16,26,Jihadi car bombers take down ten Iraqis waiting at a bus station in a Shia area.
19799,16/3/2013,Thailand,Yala,1,0,1,Muslim 'separatists' shoot a 37-year-old twice in the head.
19800,17/3/2013,Nigeria,Torok,2,3,5,"A Muslim fires on a Christian family, killing a baby and a 5-year-old and injuring three women."
19801,17/3/2013,Thailand,Narathiwat,1,0,1,A 64-year-old Buddhist is shot in the head by Muslim 'separatists'.
19802,17/3/2013,Iraq,Mosul,2,0,2,A man and his daughter are brutally murdered by Mujahideen.
19803,18/3/2013,Somalia,Hudur,1,0,1,A 75-year-old imam is beheaded by Religion of Peace rivals.
19804,18/3/2013,Nigeria,Kano,41,44,85,Over 40 Christians are blown to bits by Shahid suicide car bombers in a brutal attack.
19805,18/3/2013,Thailand,Yala,1,0,1,Muslim 'insurgents' tie a 42-year-old's hands behind him and shoot him several times in the head.
19806,18/3/2013,Iraq,Abu Ghraib,3,3,6,Mujahideen murder three people by planting a bomb under their bus.
19807,18/3/2013,Iraq,Balad Ruz,5,16,21,Five people at a market are sent to Allah by a Shahid suicide bomber.
19808,18/3/2013,Pakistan,Karachi,2,0,2,A university professor and a lawyer are killed in separate targeted Sipah-e-Sahaba shooting attacks.
19809,18/3/2013,Pakistan,Karachi,1,0,1,Terrorists take out a poet.
19810,18/3/2013,Somalia,Mogadishu,13,15,28,A suicide car bomber slaughters thirteen people.
19811,18/3/2013,Pakistan,Karachi,1,0,1,A young Shiite student is cut down by Sunni gunmen.
19812,18/3/2013,Pakistan,Kalaswala,0,1,1,A Christian missionary is severely beaten by Muslim extremists.
19813,18/3/2013,Thailand,Pattani,2,0,2,Two middle-aged villagers are slain by Muslim gunmen in separate attacks.
19814,18/3/2013,Pakistan,Peshawar,4,40,44,At least four people are killed by two Shahid suicide bombers at a courtroom.
19815,18/3/2013,Nigeria,Maiduguri,6,3,9,"Islamists attack a school, killing four teachers and two others."
19816,19/3/2013,Nigeria,Maiduguri,6,2,8,A Boko Haram blast at a bank leaves six dead.
19817,19/3/2013,Pakistan,Nazimabad,2,0,2,An accomplished Sunni doctor and his guard are gunned down by Shia terrorists.
19818,19/3/2013,Pakistan,Tirah,46,12,58,A Lashkar-e-Islam suicide bomber takes out forty-six Religion of Peace rivals.
19819,19/3/2013,Iraq,Musayab,2,12,14,Two people are killed when al-Qaeda set off a car bomb at a market.
19820,19/3/2013,Iraq,Mahmoudiya,8,17,25,A suicide bombing is among two that leave eight Iraqis dead.
19821,19/3/2013,Iraq,Iskandariya,3,8,11,An al-Qaeda blast in a commercial district snuffs out three lives.
19822,19/3/2013,Iraq,Iskandariya,5,12,17,Mujahideen bombers take down five people waiting for a bus.
19823,19/3/2013,Iraq,Sadr City,14,22,36,Fourteen Shiites are sent to Allah by al-Qaeda bombers.
19824,19/3/2013,Iraq,Baghdad,24,92,116,Coordinated terror attacks on Shia neighborhoods by the Islamic State of Iraq leave over two dozen dead.
19825,19/3/2013,Iraq,Baghdad,4,18,22,At least four people are killed when Islamists bomb a rival shrine.
19826,19/3/2013,Iraq,Baghdad,6,15,21,A half-dozen people are killed when Islamic State of Iraq bombers blow up a restaurant.
19827,19/3/2013,Iraq,Baghdad,7,21,28,An al-Qaeda bombing of a government building kills seven Iraqis.
19828,19/3/2013,Iraq,Baghdad,4,12,16,Four day laborers are shredded by an al-Qaeda bomb attack.
19829,19/3/2013,Iraq,Baghdad,4,8,12,An al-Qaeda bomb at a restaurant leaves four dead.
19830,19/3/2013,Yemen,Aden,1,0,1,A woman is tracked down and killed by her conservative brothers for marrying without their permission.
19831,19/3/2013,India,Sopore,1,0,1,Lashkar-e-Toiba militants shoot an 18-year-old to death in a mosque.
19832,19/3/2013,Thailand,Pattani,1,0,1,Muslim militants shoot a 56-year-old father to death as he is riding to visit his daughter.
19833,20/3/2013,Mali,Hombori,1,0,1,al-Qaeda behead a French geologist after holding him captive for over a year.
19834,20/3/2013,Nigeria,Maiduguri,1,0,1,A tea vendor is shot to death by Muslim terrorists.
19835,20/3/2013,Lebanon,Tripoli,1,20,21,A sectarian clash between Sunni and Shia leaves one dead.
19836,20/3/2013,Mali,Timbuktu,1,2,3,A suicide bomber kills a local soldier.
19837,20/3/2013,Myanmar,Meikhtila,1,0,1,A Buddhist monk is pulled off a motorcycle and burned alive by a Muslim mob.
19838,20/3/2013,Pakistan,Karachi,4,0,4,Four Shiites are shot to death by Sunni extremists.
19839,20/3/2013,Iraq,Baghdad,7,34,41,A series of Mujahideen bomb blasts leave seven dead.
19840,20/3/2013,Iraq,Balad,1,4,5,Children are among the casualties of a bomb placed in a family car.
19841,21/3/2013,Bangladesh,Jessore,1,12,13,At least one person is killed when mosque preachers incite a mob to attack police officers.
19842,21/3/2013,Syria,Damascus,49,84,133,Four dozen people at a mosque are reduced to body parts by a Shahid suicide bomber.
19843,21/3/2013,India,Srinagar,1,2,3,"Islamic terrorists machine-gun a police patrol, killing at least one cop."
19844,21/3/2013,Afghanistan,Marja,5,6,11,Five people are killed when a suicide vest explodes inside a religious school.
19845,21/3/2013,Thailand,Pattani,1,10,11,An 8-year-old boy standing outside an ice cream shop is exterminated by Muslim bombers.
19846,21/3/2013,Afghanistan,Takhar,3,0,3,A fundamentalist group claims responsibility for a bomb that leaves three locals dead.
19847,21/3/2013,Pakistan,Jalozai,17,28,45,"Sunni extremists car bomb a refugee camp, killing over a dozen people lining up for food."
19848,21/3/2013,Afghanistan,Musa Qala,5,21,26,At least five people are killed during a rampage by a mob protesting the burning of a Quran.
19849,21/3/2013,Lebanon,Tripoli,2,18,20,Shooting between Sunnis and Shia leave two dead.
19850,22/3/2013,Iraq,Salaheddin,5,0,5,Five Iraqis are killed in targeted al-Qaeda attacks.
19851,22/3/2013,Thailand,Pattani,1,0,1,A Muslim 'separatist' walks up to a villager at a bird-singing event and shoots him in the head.
19852,22/3/2013,Nigeria,Ganye,25,65,90,Islamic extremists storm a small town and murdered twenty-five people.
19853,22/3/2013,Pakistan,Wazir Dandh,1,2,3,"Muslim radicals fire on a truck, killing the driver."
19854,22/3/2013,Iraq,Algehlah,4,0,4,"al-Qaeda militants shoot a man and his two sons to death in front of their wife, then kill the woman."
19855,23/3/2013,Somalia,Bulo Marer,0,1,1,A Christian convert is jailed and tortured for leaving Islam.
19856,23/3/2013,Egypt,Cairo,0,1,1,Muslim Brotherhood cadres abduct a Christian and take him to a mosque for a brutal round of torture.
19857,23/3/2013,Afghanistan,Kandahar,4,2,6,Four children are killed by a bomb left by religious fundamentalists.
19858,23/3/2013,Yemen,Sanaa,3,0,3,Three Shiites are gunned down in the street by sectarian Jihadis.
19859,23/3/2013,Somalia,Mogadishu,1,0,1,A woman working for a human rights agency is assassinated by suspected al-Shabaab.
19860,23/3/2013,Somalia,Haraale,2,3,5,Two children are killed when a bomb is brought into a Quran school.
19861,23/3/2013,Thailand,Pattani,1,1,2,Muslim gunmen on motorcycles murder a 46-year-old official on his way to work.
19862,23/3/2013,Pakistan,Miranshah,22,35,57,A suicide bomber obliterates two dozen Pakistanis.
19863,23/3/2013,Nigeria,Dakata,1,0,1,One person is shot to death by Boko Haram.
19864,24/3/2013,Thailand,Narathiwat,1,1,2,A man is killed and his wife injured when Islamic 'separatists' fire on them as they are working their farm.
19865,24/3/2013,India,Sopore,1,1,2,An elderly man dies from injuries after being shot by in the neck by Muslim terrorists at a market.
19866,24/3/2013,Mali,Gao,3,0,3,Two civilians and a local soldier are killed during an Islamist assault on a town.
19867,24/3/2013,Somalia,Mogadishu,1,0,1,A female journalist is shot to death in an attack blamed on Islamists.
19868,24/3/2013,Iraq,Mosul,12,20,32,A dozen Iraqis are taken out by Mujahideen.
19869,24/3/2013,USA,"Ashtabula, OH",1,0,1,A Muslim convert walks into a church service with a Quran and guns down his Christian father while praising Allah.
19870,25/3/2013,Pakistan,Shamsabad,0,5,5,A Sunni mob attacks an Ahmadi home and beats the family.
19871,25/3/2013,Thailand,Pattani,1,0,1,A Buddhist woman is murdered by Muslim 'separatists'.
19872,26/3/2013,Iraq,Tikrit,3,0,3,Three family members are machine-gunned in their home by Mujahideen.
19873,26/3/2013,Nigeria,Riyom,36,12,48,"Fulani 'militia' attack two Christian villages, hacking and shooting three dozen to death."
19874,26/3/2013,Syria,Damascus,3,3,6,A Shahid suicide bomber wipes out three locals.
19875,26/3/2013,Pakistan,Kasur,0,5,5,Muslim clerics enter the home of an Ahmadi family and severely beat them into unconsciousness.
19876,26/3/2013,Pakistan,Shakas,1,0,1,Religious militants shoot a female teacher to death near a girls' school.
19877,26/3/2013,Pakistan,Karachi,1,2,3,A Shiite factory owner is killed when Sipah-e-Sahaba gunmen open up on him.
19878,26/3/2013,Afghanistan,Jalalabad,5,4,9,"Fedayeen bombers attack a local police station, killing at least five officers."
19879,27/3/2013,Iraq,Baghdad,4,26,30,Terrorists kill four Iraqis in separate attacks.
19880,27/3/2013,Lebanon,Hasbaya,1,0,1,A Druze cleric is shot to death in a suspected sectarian attack.
19881,27/3/2013,Pakistan,Gulbahar,1,1,2,Sectarian Jihadis kill a Shia man and severely injure his son.
19882,27/3/2013,Afghanistan,Shinwar,1,0,1,An American soldier playing with children is stabbed in the neck by an Islamic militant.
19883,28/3/2013,Nigeria,Barkin Ladi,9,3,12,Nine Christians are machine-gunned during a Muslim raid on their village.
19884,28/3/2013,Thailand,Narathiwat,3,5,8,Muslim bombers kill three local soldiers.
19885,28/3/2013,Syria,Damascus,15,30,45,"Sunni terrorists deliberately send mortars into a university, massacring at least fifteen innocents."
19886,28/3/2013,Pakistan,Damadola,2,0,2,Taliban bombers take down two local soldiers on patrol.
19887,29/3/2013,Iraq,Kirkuk,3,70,73,"A suicide car bomber targets Shiites leaving a mosque, killing at least three."
19888,29/3/2013,Iraq,Binook,5,14,19,Five Shiites are blown to bits by al-Qaeda bombers.
19889,29/3/2013,Iraq,Zafaraniyah,3,15,18,Sunni bombers slay three Shiites outside their mosque.
19890,29/3/2013,Iraq,Qahira,4,20,24,Four Shiites are taken down by Islamic Army of Iraq bombers.
19891,29/3/2013,Iraq,Baghdad,7,25,32,al-Qaeda car bombers murder seven worshipper as at a Shiite mosque.
19892,29/3/2013,Nigeria,Ratas,9,0,9,Fulani 'militias' murder nine villagers.
19893,29/3/2013,Thailand,Narathiwat,1,14,15,Muslim 'separatists' kill one Thai with a planted bomb.
19894,29/3/2013,Pakistan,Saddar,12,16,28,"A dozen people are torn to shreds by a Shahid suicide bomber at a parking lot, including women and children."
19895,29/3/2013,Syria,Aleppo,1,0,1,Muslim rebels behead a rival cleric and parade his body.
19896,29/3/2013,Thailand,Pattani,1,1,2,Islamic 'separatists' murder a 75-year-old plantation worker and severely injure his son.
19897,29/3/2013,Iraq,Kut,2,0,2,Two primary school teachers are shot to death by suspected Islamists.
19898,29/3/2013,Pakistan,Karachi,1,0,1,Muslims shoot a Hindu man to death.
19899,29/3/2013,Pakistan,Risalpur,1,0,1,A cleric is shot to death in his own mosque during prayers after trying to stop sectarian Jihadis from pasting hateful posters.
19900,30/3/2013,Pakistan,Tirah Valley,2,1,3,An 18-year-old is among two women killed in their home by a mortar fired by an Islamist group.
19901,30/3/2013,Israel,Samaria,0,1,1,A young woman suffers a head injury when young Arabs hurl rocks at her car.
19902,30/3/2013,Pakistan,Karachi,1,8,9,"Terrorists throw a grenade at a middle school, killing the principal."
19903,30/3/2013,Thailand,Pattani,2,4,6,A Religion of Peace motorcycle bomb leaves two dead.
19904,30/3/2013,Pakistan,Mardan,1,6,7,A Fedayeen suicide bomber takes out one other person.
19905,31/3/2013,Nigeria,Ataka,19,12,31,"Muslim 'nomads' attack a Christian village, butchering nineteen people, including women and children."
19906,31/3/2013,Pakistan,Darsamand,3,0,3,Islamic militants kidnap and murder three villagers.
19907,31/3/2013,Pakistan,Wali Noor,2,6,8,Two members of a 'secular-leaning' party are blown to bits by religious radicals.
19908,31/3/2013,Mali,Asongo,2,0,2,Two people are dismantled by an Islamist landmine.
19909,31/3/2013,Bangladesh,Rajshahi,0,50,50,"Jamaat-e-Islami radicals injure 50 people with bombs and bricks, including an innocent who had both hands blown off."
19910,31/3/2013,Iraq,Abu Ghraib,2,11,13,Two other people are blown up by a Shahid suicide bomber.
19911,31/3/2013,Pakistan,Gulbahar,1,0,1,A 30-year-old Shiite is gunned down by Sipah-e-Sahaba.
19912,31/3/2013,Iraq,Fallujah,3,1,4,An imam is shot to death along with two others by Religion of Peace rivals.
19913,1/4/2013,Pakistan,Jani Khel,2,7,9,The Tehreek-e-Taliban murder two tribal elders with a planted bomb.
19914,1/4/2013,Nigeria,Pulka,1,0,1,Religion of Peace radicals shoot a man to death in front of his wife and children.
19915,1/4/2013,Iraq,Tikrit,11,59,70,A Fedayeen suicide bomber massacres eleven Iraqis.
19916,1/4/2013,Iraq,Akkas,3,2,5,"al-Qaeda attack an oil field, killing several engineers."
19917,1/4/2013,Somalia,Mogadishu,1,0,1,A boy is gunned down by al-Shabaab fundamentalists.
19918,1/4/2013,Yemen,Ghail Bawazir,1,0,1,Suspected al-Qaeda gunmen murder a man on his way home.
19919,2/4/2013,Pakistan,Malir,1,0,1,Sunnis shoot a Shia shop owner to death.
19920,2/4/2013,Iraq,Baghdad,2,5,7,Two civilians are sent to Allah by Mujahid bombers.
19921,2/4/2013,Thailand,Narathiwat,1,0,1,"Muslims abduct a local soldier from his home, blindfold and execute him behind a mosque."
19922,2/4/2013,Pakistan,Peshawar,7,4,11,"Sunni extremists attack a power station, killing two on the spot and then executing five people taken as hostages."
19923,2/4/2013,Kenya,Garissa,3,0,3,Three guards at an Internet cafe are shot to death at point blank range by Islamists.
19924,2/4/2013,Ingushetia,Sunzhensky,1,5,6,Islamic 'insurgents' set off two bombs that leave one person dead.
19925,2/4/2013,Iraq,Abu Ghraib,2,2,4,al-Qaeda bombers take out two Iraqis.
19926,2/4/2013,Iraq,Anbar,2,2,4,Two civilians are murdered by al-Qaeda gunmen.
19927,3/4/2013,Syria,Tel Goran,1,0,1,Jihadists kidnap and kill a Christian.
19928,3/4/2013,Pakistan,Karachi,4,5,9,Four security personnel die when Islamic militants throw a grenade at their vehicle.
19929,3/4/2013,Thailand,Yala,1,19,20,Muslim bombers take out a bus passenger.
19930,3/4/2013,Pakistan,Gujranwala,0,18,18,Eighteen Christians are injured by a Muslim mob whipped into a frenzy by a cleric.
19931,3/4/2013,Afghanistan,Farah,53,91,144,Over fifty people are slaughtered when nine religious radicals storm a court and self-detonate.
19932,3/4/2013,Tanzania,Tunduma,2,3,5,Two Christians are murdered by Muslim extremists for selling non-halal meat.
19933,3/4/2013,Iraq,Baghdad,3,0,3,al-Qaeda gunmen enter a home and shoot a woman and her two sons to death.
19934,4/4/2013,Pakistan,Manga Mandi,1,0,1,A 20-year-old Christian is shot in the head by Muslims calling their religion 'supreme'.
19935,4/4/2013,Kenya,Garissa,3,24,27,"al-Shabaab Islamists toss a hand grenade into a packed restaurant, killing three patrons."
19936,4/4/2013,Somalia,Marka,1,0,1,An elderly man is gunned down by suspected al-Shabaab.
19937,4/4/2013,Afghanistan,Batikot,3,2,5,Three schoolchildren are dismantled by a Taliban roadside bomb.
19938,5/4/2013,Pakistan,Hayatabad,1,5,6,A young boy is killed when Islamic terrorists shell a town.
19939,5/4/2013,Iraq,Hillah,5,15,20,"Mujahideen murder five people in a series of attacks, including a bombing at vegetable market."
19940,5/4/2013,Indonesia,Medan,8,6,14,Eight Buddhists are beaten to death by Muslims in an attack at a detention center.
19941,5/4/2013,Thailand,Yala,2,1,3,Muslim bombers kill two people and put another into a coma.
19942,5/4/2013,Afghanistan,Alingar,1,3,4,Terrorists kill a cop with a bomb attached to a donkey.
19943,5/4/2013,Bangladesh,Dhaka,1,0,1,Hifazat-e-Islam murder a fruit vendor.
19944,5/4/2013,Pakistan,Syedabad,1,0,1,A Shia schoolteacher is murdered in a suspected sectarian attack.
19945,6/4/2013,Afghanistan,Asadabad,2,0,2,Two children are obliterated by a Taliban rocket.
19946,6/4/2013,Iraq,Samarrah,3,5,8,A teenage boy is among the casualties of a Mujahideen bombing.
19947,6/4/2013,Iraq,Baqubah,22,60,82,A Fedayeen suicide bomber sends two dozen souls to Allah.
19948,6/4/2013,Afghanistan,Qalat,6,3,9,American civilians and a doctor are among six killed by a Shahid suicide bomber as they are delivering books to a school.
19949,6/4/2013,Egypt,Khusus,7,17,24,Angry Muslims torch a church and kill seven Christians over alleged desecration.
19950,6/4/2013,Pakistan,Orangi,1,0,1,Militants associated with a Sunni seminary gun down a Shiite.
19951,6/4/2013,Pakistan,Karachi,1,0,1,A Shia schoolteacher loses his life to sectarian Jihadis.
19952,7/4/2013,Pakistan,Jaffar Tayyar,1,0,1,Lashkar-e-Jhagvi gunmen murder a Shiite near a cricket field.
19953,7/4/2013,Nigeria,Midlu Shalmi,14,5,19,"Muslim radicals shoot, hack and slit the throats of fourteen Christians."
19954,7/4/2013,Thailand,Yala,1,0,1,Muslim militants behead a plantation worker.
19955,7/4/2013,Iraq,Mosul,4,7,11,al-Qaeda bombers take out four Iraqis.
19956,7/4/2013,Pakistan,Peshawar,1,1,2,"Sunnis fire on a Shia mosque, killing the custodian."
19957,7/4/2013,Pakistan,Taunsa,1,0,1,A 15-year-old boy is gunned down in a mosque by Sipah-e-Sahaba because he is Shia.
19958,7/4/2013,Egypt,Cairo,2,89,91,"Muslim radicals attack a group of mourners leaving a church, killing one on the spot and another in subsequent clashes."
19959,7/4/2013,Thailand,Narathiwat,2,0,2,"Two local soldiers are knocked off their motorcycle by Muslim militants, who  proceed to execute them at point-blank range."
19960,7/4/2013,Pakistan,Mathra,1,0,1,The body of a man kidnapped and tortured to death by the Taliban is found along a roadside.
19961,8/4/2013,Nigeria,Borno,1,0,1,A guard at a market is killed during a Boko Haram attack.
19962,8/4/2013,Somalia,Hiran,1,0,1,A 22-year-old woman is executed by Islamic militia.
19963,8/4/2013,Syria,Damascus,15,53,68,"A Fedayeen suicide car bomb rips through a crowded street, leaving at least fifteen dead."
19964,8/4/2013,Afghanistan,Wardak,9,22,31,"Religion of Peace hardliners detonate a bomb under a bus, killing nine passengers."
19965,8/4/2013,Bangladesh,Chittagong,0,20,20,Twenty people are hurt when Hifazat-e-Islam riot over a decision not to impose a blasphemy law.
19966,8/4/2013,Iraq,Abu Ghraib,4,4,8,Two bombings kill four local cops.
19967,9/4/2013,Afghanistan,Paron,2,0,2,A Taliban attack leaves two local cops dead.
19968,9/4/2013,India,Pulwama,1,0,1,Islamic militants gun down a 45-year-old man in his own home.
19969,9/4/2013,Philippines,Ungkaya Pukan,1,0,1,A local soldier is murdered by Abu Sayyaf.
19970,9/4/2013,Afghanistan,Char Borjak,4,2,6,Sunni extremists kill four local cops with a roadside bomb.
19971,9/4/2013,Pakistan,Hayatabad,0,23,23,Two dozen people are injured when Islamic militants send mortars into a residential neighborhood.
19972,9/4/2013,Afghanistan,Marjah,5,4,9,A bomb planted by Sunni extremists leaves five dead civilians along a city street.
19973,9/4/2013,Nigeria,Gwoza,3,0,3,"Islamists shoot three people in the head while they are playing cards, including a pastor's son."
19974,10/4/2013,Nigeria,Bama,4,0,4,Two teachers and the wife and 12-year-old child one are slaughtered and burned by Sharia advocates.
19975,10/4/2013,Nigeria,Dikwa,4,0,4,"Islamists brutally murder three education officials and their driver, including one in charge of a program to feed poor students."
19976,10/4/2013,Pakistan,Shahkas,1,0,1,Terrorists gun down a 28-year-old man at a cricket match.
19977,10/4/2013,Pakistan,Mardan,1,1,2,A guard for a polio vaccination team is shot to death on the job by fundamentalists.
19978,10/4/2013,Thailand,Pattani,2,6,8,"Muslim 'insurgents' bomb a community center, killing two people."
19979,10/4/2013,India,Srinigar,0,9,9,Two children and five women are among nine Christians attacked in their home by a mob whipped into a frenzy by an imam.
19980,11/4/2013,Egypt,Khusus,1,0,1,A 26-year-old Christian is doused with gasoline and set ablaze.
19981,11/4/2013,Syria,Homs,20,0,20,"Six children, including a baby, are among twenty people executed by Hezbollah."
19982,11/4/2013,Iraq,Fallujah,2,0,2,"Mujahid snipers pick off two civilians, including a young boy."
19983,11/4/2013,Nigeria,Babangida,4,2,6,Islamic extremists enter a police station and gun down four officers in cold blood.
19984,11/4/2013,Afghanistan,Marjah,1,2,3,One civilian is killed by Sunni bombers.
19985,11/4/2013,Afghanistan,Chora,3,0,3,Taliban militants murder three local cops.
19986,11/4/2013,Bangladesh,Kazirhat,3,100,103,Jamaat-e-Islami radicals bludgeon three people with sticks and knives.
19987,11/4/2013,Pakistan,Sindh,1,0,1,The Tehreek-e-Taliban assassinate a secular politician.
19988,12/4/2013,Afghanistan,Nari,13,0,13,"More than 100 Sunni fundamentalists pump rockets and grenades into a remote outpost, killing thirteen Afghan defenders."
19989,12/4/2013,Iraq,Kanaan,12,30,42,"Mujahideen detonate two bombs at a Sunni mosque, leaving a dozen worshippers dead."
19990,12/4/2013,Iraq,Mosul,3,0,3,Three security personnel are kidnapped and executed by al-Qaeda.
19991,12/4/2013,Afghanistan,Shiberghan,1,0,1,A man beheads his wife over 'moral crime'.
19992,12/4/2013,Thailand,Pattani,1,0,1,Muslim militants machine-gun a 46-year man on his way home.
19993,12/4/2013,Mali,Kidal,3,0,3,At least three people are killed by a suicide bomber.
19994,12/4/2013,Dagestan,Buinaksk,1,3,4,One person is killed when Islamists set off a bomb near a school.
19995,12/4/2013,Pakistan,Karachi,1,0,1,A Shia religious scholar is murdered by Sunni rivals from the Ahl-e-Sunnat wal Jamaat terror group.
19996,12/4/2013,Pakistan,Mach,1,0,1,Sipah-e-Sahaba gunmen take out a Shia civilian.
19997,13/4/2013,CAR,Bangui,1,0,1,A pastor is shot to death by Islamic militants at a funeral.
19998,13/4/2013,Somalia,Buulodbarde,1,0,1,Islamists murder a Christian mother of five only four months after doing the same to her husband.  Both were killed for leaving Islam.
19999,13/4/2013,Nigeria,Monguno,3,0,3,"Sharia advocates ambush students from a local university, tie them up and slit their throats."
20000,13/4/2013,Pakistan,Karachi,1,0,1,A secular political activist is found tortured to death following Taliban threats.
20001,13/4/2013,Yemen,Hadramout,1,0,1,Two al-Qaeda gunmen assassinate a government official.
20002,13/4/2013,Pakistan,Matani,9,19,28,Women are among nine killed when Mujahideen bomb a passenger bus.
20003,14/4/2013,Pakistan,Gulshan-i-Iqbal,2,0,2,Sectarian Jihadis murder a father and son at a mobile phone shop.
20004,14/4/2013,Jordan,Amman,1,0,1,"A pregnant woman's throat is slit in an honor killing, after which her body is burned."
20005,14/4/2013,Afghanistan,Darzab,2,6,8,Two Afghan policemen are shot to death by Taliban fundamentalists.
20006,14/4/2013,Somalia,Mogadishu,5,0,5,Aid workers are among those killed by Islamists bombers.
20007,14/4/2013,Somalia,Mogadishu,29,58,87,Twenty-nine civilians are sent to Allah when six suicide bombers storm a courthouse.
20008,14/4/2013,Iraq,Diyala,4,0,4,A moderate and three family members are blown to bits by radical Sunnis.
20009,14/4/2013,Iraq,Shura,6,14,20,Five policemen are killed when Islamic militants booby-trap the body of another murdered policeman.
20010,14/4/2013,Iraq,Baji,1,0,1,A secular politician is assassinated by suspected Islamists.
20011,14/4/2013,Pakistan,Manglawar,1,0,1,Taliban bombers take out a peace committee member.
20012,15/4/2013,USA,"Boston, MA",3,264,267,"Foreign-born Muslims describing themselves as 'very religious' detonate two bombs packed with ball bearings at the Boston Marathon, killing three people and causing several more to lose limbs."
20013,15/4/2013,Pakistan,Banjot,1,0,1,A secular-leaning politician is blown to bits by fundamentalist bombers.
20014,15/4/2013,Pakistan,Karachi,1,0,1,Lashkar-e-Jhangvi murder a man for being a Shiite.
20015,15/4/2013,Pakistan,Dera Ismail Khan,2,3,5,Sunni militants murder two election workers.
20016,15/4/2013,Afghanistan,Mali Zai,7,4,11,Seven civilians are pulled into pieces by Taliban bombers.
20017,15/4/2013,Iraq,Mussayab,2,13,15,"Religious extremists car bomb an open air market, killing at least two."
20018,15/4/2013,Iraq,Fallujah,2,14,16,A Fedayeen suicide bomber takes out two innocents along a city street.
20019,15/4/2013,Iraq,Nasiriyah,2,14,16,Two civilians are sent to Allah by al-Qaeda bombers.
20020,15/4/2013,Iraq,Kirkuk,9,79,88,Six car bombs leave at least nine Iraqis dead.
20021,15/4/2013,Iraq,Tuz Khurmatu,6,67,73,Six people are torn to shreds by al-Qaeda bombers.
20022,15/4/2013,Iraq,Baghdad,4,29,33,Two Mujahid bombings leave four dead at a commercial district.
20023,15/4/2013,Iraq,Umm al-Maalif,4,15,19,"Islamic bombers destroy a market, along with four patrons."
20024,15/4/2013,Iraq,Habibiya,10,12,22,At least ten Iraqis at an auto mall are taken out by Mujahid car bombers.
20025,15/4/2013,Iraq,Kamaliya,4,13,17,An al-Qaeda bombing near an elementary school leaves four dead.
20026,15/4/2013,Iraq,Khalis,1,8,9,Mujahideen bombers murder a child.
20027,16/4/2013,Nigeria,Kaduna,2,0,2,Islamists gun down two police officers on their way home from work.
20028,16/4/2013,Thailand,Pattani,1,3,4,Muslim terrorists kill a local soldier with a bomb.
20029,16/4/2013,Pakistan,Khuzdar,3,0,3,Islamists are thought responsible for the cold-blooded murder of a politician's family.
20030,16/4/2013,Afghanistan,Mali Zai,8,0,8,Religion of Peace bombers take down eight members of the same family.
20031,16/4/2013,Pakistan,Syed Gai,9,8,17,A Shahid suicide bomber at a checkpoint sends other nine souls to Allah.
20032,16/4/2013,Pakistan,Peshawar,16,35,51,Two children are among sixteen innocents torn to shreds by a Holy Warrior suicide bomber.
20033,16/4/2013,Pakistan,Jamaldinwali,2,0,2,Two women are 'honor killed' by their families for moral crime.
20034,16/4/2013,Afghanistan,Jawzjan,2,1,3,Two health care workers are brutally gunned down by Islamic radicals.
20035,17/4/2013,Iraq,Baghdad,3,16,19,Three people are killed by Mujahid bombers.
20036,17/4/2013,Afghanistan,Jowzjan,6,0,6,Six Afghans are kidnapped an beheaded by terrorists fighting for an Islamic state.
20037,17/4/2013,Afghanistan,Laghman,4,0,4,Four local cops are shot to death by Islamic extremists.
20038,17/4/2013,Afghanistan,Qarabagh,5,0,5,Five Afghans are murdered by the Taliban.
20039,17/4/2013,Afghanistan,Shindad,7,4,11,Seven women and children are dismantled by a Mujahid shrapnel bomb.
20040,17/4/2013,India,Bangalore,0,16,16,The Indian Mujahideen detonate a bomb outside a Hindu party office.
20041,18/4/2013,Pakistan,Miranshah,1,0,1,A grocery trader is taken out by an Islamist ambush.
20042,18/4/2013,Thailand,Pattani,1,0,1,A man working his vegetable garden is shot to death by Muslim 'insurgents'.
20043,18/4/2013,Iraq,Baghdad,32,65,97,Children are among nearly three dozen people at a coffee shop obliterated by a Shahid suicide bomber.
20044,18/4/2013,Kenya,Garissa,9,3,12,al-Shabaab gunmen burst into a hotel and mow down nine people having dinner.
20045,18/4/2013,Pakistan,Hyderabad,1,0,1,A secular politician is assassinated by religious radicals.
20046,18/4/2013,Iraq,Mosul,3,5,8,An al-Qaeda car bomb takes out three Iraqis.
20047,19/4/2013,USA,"Boston, MA",1,1,2,Jihadists gun down a university police officer sitting in his car.
20048,19/4/2013,Thailand,Pattani,1,0,1,A man is shot to death in his car by militant Muslims outside a rubber plantation.
20049,19/4/2013,Pakistan,Wana,4,8,12,"Taliban extremists send rockets into an election rally, killing four people."
20050,19/4/2013,Pakistan,Khyber Pakhtunkhwa,3,0,3,Terrorists kill a woman and two girls with a bomb disguised as a toy.
20051,19/4/2013,Iraq,Kirkuk,2,14,16,"Sunni bombers target Shia worshippers as they leave a mosque, killing two."
20052,19/4/2013,Thailand,Pattani,1,0,1,Muslim 'insurgents' shoot a resident to death as he is walking home.
20053,19/4/2013,Afghanistan,Andar,13,0,13,Thirteen policemen are machine-gunned in their sleep by Sunni hardliners.
20054,19/4/2013,Iraq,Khalis,7,14,21,A Mujahideen mortar attack on a rival mosque leaves seven dead.
20055,19/4/2013,Nigeria,Bui,3,0,3,Boko Haram extremists pull three men out of a vehicle and execute them on the spot.
20056,19/4/2013,Nigeria,Gbajimba,9,0,9,Nine passengers are feared dead following an ambush on a passenger bush by Fulani militia.
20057,20/4/2013,Pakistan,Khar,4,4,8,"A female Fedayeen blows herself up outside a hospital, taking four innocents with her."
20058,20/4/2013,Pakistan,Karachi,2,1,3,Two secular party workers are shot to death by suspected Taliban.
20059,21/4/2013,Thailand,Pattani,1,1,2,A 49-year-old Buddhist woman is gunned down in a targeted attack by Muslim militants.
20060,21/4/2013,Afghanistan,Paktika,3,5,8,Three civilians at a shopping mall are blown to bits by a Shahid suicide bomber.
20061,21/4/2013,Afghanistan,Ghazni,6,1,7,Six Afghans are shot in their sleep by fundamentalists.
20062,21/4/2013,Pakistan,Haider Khel,4,6,10,Islamic militants murder four local soldiers with a roadside bomb.
20063,21/4/2013,Yemen,Maareb,2,1,3,An al-Qaeda attack leaves two dead.
20064,21/4/2013,Pakistan,Kharadar,0,12,12,Children are among the casualties when Sunnis hurl homemade bombs into a Shia bakery.
20065,21/4/2013,Iraq,Karrada,3,13,16,A suicide bomber blows three people in a commercial district to the great beyond.
20066,22/4/2013,Turkey,Hatay,3,0,3,Three priests are beheaded by Muslim terrorists.
20067,22/4/2013,Afghanistan,Aabkamari,1,0,1,A woman is executed by her father in front of 300 others after dishonoring her family by leaving her husband.
20068,22/4/2013,Iraq,Fallujah,9,24,33,Nine people at a restaurant are taken out in mid-bite by Mujahid bombers.
20069,22/4/2013,Thailand,Pattani,0,2,2,Two Buddhist sisters are shot by suspected Muslim 'separatists'.
20070,23/4/2013,China,Xinjiang,15,11,26,Six policemen and nine civilians are hacked and burned to death by an enraged gang of Muslim terrorists.
20071,23/4/2013,Iraq,Tikrit,6,11,17,al-Qaeda gunmen storm a police station and shoot six people to death.
20072,23/4/2013,Pakistan,Quetta,6,47,53,"A suicide car bomber detonates in a Shiite neighborhood, taking six innocents with him."
20073,23/4/2013,Pakistan,Karachi,3,30,33,At least three people lose their lives to Lashkar-e-Jhangvi bombers at an election rally.
20074,23/4/2013,Iraq,Muqdadiya,9,25,34,Nine people bleed to death as Shiites send mortars into a Sunni mosque.
20075,23/4/2013,France,Paris,0,2,2,An Iranian national attacks a Jewish father and son along a city street.
20076,23/4/2013,Thailand,Narathiwat,3,0,3,"A bomb, planted by terrorists on a bridge, ultimately takes the lives of three security personnel."
20077,23/4/2013,Iraq,Baghdad,7,17,24,"Muslims bomb a rival mosque, killing seven worshippers."
20078,23/4/2013,Dagestan,Buinaksk,3,1,4,Islamic snipers pick off three local cops.
20079,24/4/2013,Iraq,Baghdad,8,23,31,Eight Shiites at a bus stop are obliterated by Sunni bombers.
20080,24/4/2013,Afghanistan,Karak,2,0,2,Two local police officers are killed during a Taliban assault on a station.
20081,25/4/2013,Somalia,Mogadishu,1,0,1,A chief prosecutor is assassinated by suspected al-Shabaab.
20082,25/4/2013,Pakistan,Quetta,1,1,2,The Tehreek-e-Taliban is suspected of a grenade attack that leaves one person dead.
20083,25/4/2013,Pakistan,Karachi,6,13,19,"The Taliban bomb the offices of a secular-leaning political party, killing at six."
20084,25/4/2013,Nigeria,Gashua,11,17,28,Eleven people are killed in two Boko Haram attacks.
20085,25/4/2013,Pakistan,Safora Goth,1,0,1,A secular political worker is murdered by Tehreek-e-Taliban.
20086,25/4/2013,Iraq,Najaf,4,22,26,Muslim bombers kill four people at a bus stop.
20087,25/4/2013,Bangladesh,Satkania,1,12,13,A young girl is killed during a clash between two Islamic student groups.
20088,25/4/2013,Afghanistan,Kunduz,6,0,6,Six local cops are drugged and shot to death by the Taliban.
20089,26/4/2013,Iraq,Mahmoudiya,3,4,7,Three Iraqis are take out by an IED.
20090,26/4/2013,Iraq,Sadr City,5,19,24,Five people are disassembled by a Mujahid bomb at a motorcycle shop.
20091,26/4/2013,Iraq,Baghdad,7,13,20,Jihadis bomb a shopping center killing seven patrons.
20092,26/4/2013,Iraq,Tikrit,5,0,5,Five volunteers manning a checkpoint are machine-gunned by al-Qaeda.
20093,26/4/2013,Syria,Damascus,4,12,16,"al-Nusra Islamists send mortars into a residential area, killing four."
20094,26/4/2013,Pakistan,Karachi,11,45,56,Children are among the casualties when fundamentalists detonate a bomb at the office of a moderate political party.
20095,26/4/2013,Afghanistan,Kandahar,45,10,55,"The Taliban bomb a tanker which is then run into by a bus, killing forty-five passengers."
20096,26/4/2013,India,Haigam,4,0,4,Four policemen are gunned down in cold blood by Islamic terrorists.
20097,26/4/2013,Iraq,Baghdad,8,36,44,Bombs planted by sectarian rivals outside mosques kill eight worshippers.
20098,27/4/2013,Yemen,Radda,6,0,6,Six Yemenis are killed during an al-Qaeda attack.
20099,27/4/2013,Pakistan,Karachi,1,1,2,Sectarian Jihadis gun down a Shiite.
20100,27/4/2013,Thailand,Pattani,1,2,3,Muslim 'separatists' shoot a man to death on his way to work.
20101,27/4/2013,Pakistan,Karachi,2,10,12,Islamic fundamentalists car bomb a secular party office ahead of an election.
20102,28/4/2013,Bangladesh,Bakhrabaj,1,0,1,Islami Chatra Shibir terrorists cut the throat of a secular youth leader.
20103,28/4/2013,Algeria,Tipaza,3,0,3,Armed Islamists mow down three police volunteers by the side of the road.
20104,28/4/2013,Pakistan,Parachinar,1,3,4,"Sipah-e-Sahaba terrorists set off a bomb outside a sports stadium in a Shiite area, killing one."
20105,28/4/2013,Pakistan,Peshawar,3,12,15,Three secular activists bleed to death from a bombing attack by religious radicals.
20106,28/4/2013,Pakistan,Kohat,6,10,16,"Fundamentalists bomb the headquarters of a left-leaning political party, killing six."
20107,28/4/2013,Afghanistan,Ghazni,3,2,5,Three local policemen are murdered by Taliban bombers.
20108,28/4/2013,Bangladesh,Umarpur,3,50,53,"Jamaat-e-Islami attack participants at a meeting of a secular-leaning political party, killing three."
20109,28/4/2013,Pakistan,Swabi,2,16,18,A 7-year-old girl is among two people disassembled by Tehreek-e-Taliban bombers.
20110,28/4/2013,Philippines,Ubit,2,0,2,Abu Sayyaf militants murder two local soldiers.
20111,29/4/2013,Nigeria,Ringim,5,0,5,"Sharia proponents send rocket-propelled grenades into a bank and police station, killing five."
20112,29/4/2013,Pakistan,Charsadda,1,15,16,Children are among the casualties of a suspected Islamist bombing.
20113,29/4/2013,Syria,Nubbol,20,0,20,Twenty Shiite adults are reportedly abducted and beheaded by Sunni militia.
20114,29/4/2013,Pakistan,Peshawar,9,60,69,Sunni hardliners plant a bomb on a motorcycle that kills at least nine people waiting for a bus.
20115,29/4/2013,Iraq,Mahmoudiya,6,14,20,"Sunni radicals detonate a car bomb in a Shia neighborhood, sending a half dozen resident to Allah."
20116,29/4/2013,Iraq,Karbala,3,14,17,Three Shia pilgrims are brought down by and al-Qaeda bomb.
20117,29/4/2013,Iraq,Diwaniyah,9,23,32,Nine Iraqis at a restaurant are exterminated by al-Qaeda car bombers.
20118,29/4/2013,Iraq,Amarah,18,42,60,Eighteen Shiites standing in a market are ripped to pieces by Sunni bombers.
20119,29/4/2013,Syria,Damascus,6,0,6,Six bystanders are laid out by a suspected al-Nusra car bomb.
20120,29/4/2013,Pakistan,Adamkot,3,0,3,Religious radicals kidnap and execute three local security personnel.
20121,30/4/2013,Tunisia,Mount Chaambi,0,6,6,A half-dozen local soldiers and police are injured when Islamists set off land mines.
20122,30/4/2013,Pakistan,Karachi,2,0,2,Muslim extremists shoot two liberal party workers to death.
20123,30/4/2013,Iraq,Sulaiman Beg,2,5,7,A Shahid suicide bomber takes two Iraqis with him.
20124,30/4/2013,Iraq,Baghdad,4,20,24,"Religion of Peace rivals bomb a Sunni mosque, killing four worshippers."
20125,30/4/2013,Israel,Tapuah,1,0,1,A Palestinian stabs a 31-year-old Jewish father of five to death in an unprovoked attack at a bus stop.
20126,30/4/2013,Syria,Marjeh,14,103,117,"Terrorists bomb a commercial district, killing over a dozen."
20127,30/4/2013,Jordan,Amman,1,0,1,A young woman is stabbed 20 times and beheaded by her brother after 'dishonoring' the family.
20128,1/5/2013,Dagestan,Makhachkala,2,2,4,Two teens are killed by a bomb planted by Jihadis outside a store that refused to pay zakat.
20129,1/5/2013,Nigeria,Gashua,7,0,7,Five civilians are among seven shot to death by Islamic extremists.
20130,1/5/2013,Afghanistan,Gereshk,3,4,7,The Taliban murder a peace envoy and two guards.
20131,1/5/2013,Pakistan,Karachi,2,0,2,Two Shiites are assassinated by Sipah-e-Sahaba terrorists.
20132,1/5/2013,Iraq,Baquba,3,11,14,Mujahideen bomb a restaurant and murder a rival cleric in separate attacks.
20133,1/5/2013,Iraq,Ramadi,2,10,12,Two Iraqis bleed to death following a shrapnel bombing by 'insurgents'
20134,1/5/2013,Iraq,Baji,5,0,5,Five police officers are taken down by an al-Qaeda blast.
20135,1/5/2013,Iraq,Garma,6,15,21,"A suicide bomber detonates in a crowd, slaughtering at least a half-dozen."
20136,1/5/2013,Iraq,Hussainya,4,12,16,A brutal Sunni car bomb in a Shia suburb leaves four residents dead.
20137,1/5/2013,Syria,Damascus,1,15,16,Sunni terrorists are blamed for a car bomb that kills at least one.
20138,2/5/2013,Afghanistan,Barg-e-Matal,1,0,1,An Afghan policeman is picked off by a Taliban sniper.
20139,2/5/2013,Pakistan,Manghopir,2,2,4,Two watchmen are shot dead during an attack by the Taliban on a Belgian missionary school.
20140,2/5/2013,Thailand,Pattani,6,0,6,Muslim 'insurgents' murder a 3-year-old boy and five others when they fire into a Buddhist convenience store.
20141,2/5/2013,Afghanistan,Pula-i- Alam,8,0,8,Sunni hardliners murder eight local cops with a roadside bomb.
20142,2/5/2013,Iraq,Albu Faraj,1,4,5,A Fedayeen suicide bomber kills one other person.
20143,2/5/2013,Egypt,Qattawiya,1,0,1,A Facebook user is shot to death by the Muslim Brotherhood after criticizing the group.
20144,2/5/2013,Syria,Bayda,51,0,51,Fifty-one villagers are slaughtered because of their sectarian status according to a human rights group.
20145,3/5/2013,Syria,Banias,145,0,145,Thirty-four children and forty women are among one-hundred forty-five victims of a sectarian massacre.
20146,3/5/2013,Pakistan,Karachi,2,0,2,A 3-year-old boy and his father are brutally gunned down by the Tehreek-e-Taliban.
20147,3/5/2013,Iraq,Baghdad,7,30,37,"Sectarian Jihadis detonate a bomb at a rival mosque, killing seven worshippers."
20148,3/5/2013,Pakistan,Islamabad,1,0,1,The prosecutor investigating a prominent assassination by terrorists is himself gunned down on his way home.
20149,4/5/2013,Mali,Gao,2,4,6,Two local soldiers are taken out by a Fedayeen suicide bomber.
20150,4/5/2013,Pakistan,Karachi,3,40,43,Children are among the casualties when Religion of Peace activists blow up a secular-leaning party office.
20151,4/5/2013,Afghanistan,Farah,2,0,2,Two American trainers are murdered by a Taliban in uniform.
20152,4/5/2013,Nigeria,Ngamdu,4,0,4,Religion of Peace activists tie up four villagers and cut their throats.
20153,4/5/2013,Thailand,Narathiwat,1,0,1,A 59-year-old truck driver is murdered by Muslim militants.
20154,4/5/2013,Thailand,Pattani,1,0,1,Muslim terrorists shoot a 50-year-old civilian twice in the head.
20155,5/5/2013,Pakistan,Sibi,4,7,11,"The Tehrik-i-Taliban is suspected of attacking the convoy of a secular political candidate, killing four."
20156,5/5/2013,Iraq,Baghdad,1,6,7,"Muslims set off a bomb at a rival mosque, killing a passerby."
20157,5/5/2013,Iraq,Mahmoudiya,2,0,2,Mujahideen invade a home and shoot a man and his son to death.
20158,5/5/2013,Nigeria,Njilan,10,0,10,"Islamic extremists stage a Sunday morning attack on a church and a nearby cattle market, killing at least ten."
20159,5/5/2013,Tanzania,Arusha,3,57,60,"A 9-year-old child, a teenager and a woman bleed to death when a Muslim convert tosses a bomb into a church."
20160,5/5/2013,Somalia,Mogadishu,11,20,31,Eleven people are ripped to pieces by a Fedayeen suicide bomber.
20161,5/5/2013,Iraq,Jamiyah,3,13,16,Three patrons are killed by a Fundamentalist bomb at an Internet cafe.
20162,5/5/2013,Thailand,Narathiwat,2,3,5,Two Thais are killed by a Muslim 'separatist' bomb.
20163,5/5/2013,Pakistan,Orangi,5,0,5,A 9-year-old girl and three women are among five shot to death during an honor killing at a brothel.
20164,5/5/2013,Somalia,Buulo Sheekh,2,0,2,A 95-year-old man and his grandson are murdered in their home by al-Shabaab activists.
20165,5/5/2013,Bangladesh,Dhaka,4,24,28,At least four civilians are killed by a Hefajat-e-Islam 'siege'.
20166,5/5/2013,Afghanistan,Korghan,4,5,9,Sunni hardliners dismantle four civilians with a roadside bomb.
20167,5/5/2013,Egypt,al-Arish,1,0,1,Four fundamentalists shoot a bartender to death for serving alcohol.
20168,6/5/2013,Syria,al-Quasair,20,0,20,"Hezbollah is accused of butchering twenty people, mostly women and children, with knives."
20169,6/5/2013,Iraq,Baghdad,7,26,33,Jihadi car bombers take out seven Iraqis near a restaurant.
20170,6/5/2013,Thailand,Narathiwat,1,0,1,Muslim militants gun down a 62-year-old man on his way home from work.
20171,6/5/2013,Pakistan,Peshawar,25,64,89,"A Shahid suicide bomber detonates at an election rally, slaughtering over two dozen innocents."
20172,6/5/2013,Philippines,Basilan,2,0,2,An Abu Sayyaf ambush leaves two dead.
20173,6/5/2013,Bangladesh,Motijheel,1,0,1,A policeman is hacked to death by Islamists chanting 'death to those who insult Allah'.
20174,6/5/2013,Bangladesh,Kanchpur,4,0,4,Four security officials are beaten to death by anti-blasphemy activists.
20175,6/5/2013,Iraq,Mosul,5,0,5,"Two bombings, one by a Shahid, leave five Iraqis dead."
20176,6/5/2013,Iraq,Baghdad,6,13,19,"Mujahideen roll grenades into a rival mosque, sending at least six worshippers straight to Allah."
20177,7/5/2013,Nigeria,Bale,1,0,1,Boko Haram murder a man in front of his wives and children.
20178,7/5/2013,Thailand,Pattani,1,0,1,Militant Muslims shoot a clerk to death at a restaurant.
20179,7/5/2013,Pakistan,Hangu,12,35,47,At least a dozen people are obliterate when a Fedayeen suicide bomber detonates at an election rally.
20180,7/5/2013,France,Roussillon,0,1,1,A Muslim who had recently returned from the Haj shouts 'Allah Akbar' and stabs a police officer at random.
20181,7/5/2013,Afghanistan,Ghazni,4,1,5,Taliban bombers send four Afghan cops to Allah.
20182,7/5/2013,Pakistan,Korangi,2,0,2,Two activists of a secular-leaning party are assassinated by religious fundamentalists.
20183,7/5/2013,Nigeria,Bama,26,0,26,"Twenty-six people, including three children, are burnt alive as Islamists set fire to a police barracks."
20184,7/5/2013,Nigeria,Bama,14,0,14,"Boko Haram attack a prison housing Islamist prisoners, killing fourteen guards."
20185,7/5/2013,Pakistan,Upper Dir,1,3,4,Suspected Taliban bombers take out a young boy.
20186,7/5/2013,Pakistan,Lower Dir,5,0,5,Five people are killed in a Taliban attack on a secular party official.
20187,7/5/2013,Algeria,Keddara,2,0,2,Two guards at a quarry are murdered by Islamic fundamentalists.
20188,8/5/2013,Iraq,Abu Ghraib,2,3,5,"Religion of Peace rivals set off an IED at a mosque that leaves two dead, including the imam."
20189,8/5/2013,Iraq,Kirkuk,2,49,51,Two suicide bombers take down two Iraqis and injure about fifty others.
20190,8/5/2013,Iraq,Salaheddin,1,1,2,A suicide bomber manages to kill one other person.
20191,8/5/2013,Pakistan,Bannu,2,23,25,A woman is among two people blown away by a Shahid suicide bomber.
20192,8/5/2013,Yemen,Lahij,3,0,3,Three men in a car are wasted by al-Qaeda gunmen.
20193,8/5/2013,Afghanistan,Kandahar,3,0,3,At least three drivers are killed by Taliban gunmen at a protest.
20194,8/5/2013,Iraq,Fallujah,3,2,5,"al-Qaeda gunmen open fire on police officers at a checkpoint, killing two."
20195,8/5/2013,Iraq,Mosul,1,4,5,A Fedayeen suicide bomber kills a civilian.
20196,8/5/2013,Thailand,Narathiwat,1,1,2,A 45-year-old woman is shot to death by Muslim terrorists.
20197,8/5/2013,Pakistan,Hangu,2,18,20,Women and children are among the casualties when Islamic militants set off a bomb at a market.
20198,9/5/2013,Pakistan,Karachi,1,0,1,Sipah-e-Sahaba gunmen murder a 35-year-old Shiite.
20199,9/5/2013,Pakistan,Multan,1,8,9,"Fundamentalists are suspected of opening fire on a political rally, killing one."
20200,9/5/2013,Yemen,Lahij,1,0,1,al-Qaeda gunmen take down a local traffic cop.
20201,9/5/2013,Egypt,Cairo,0,1,1,An American professor is stabbed five times by a well-educated terrorist.
20202,9/5/2013,Pakistan,Torghar,6,10,16,A half-dozen people are disassembled by Islamic bombers.
20203,9/5/2013,Iraq,Baghdad,3,2,5,Terrorists kill three university students with a bomb placed on a bus.
20204,9/5/2013,Iraq,Hawija,1,11,12,al-Qaeda bombers take out an Iraqi child.
20205,10/5/2013,Pakistan,Miranshah,4,21,25,Religious fanatics take out four locals with a bomb blast at a market.
20206,10/5/2013,India,Lassipora,1,0,1,An imam is shot to death outside his mosque by Religion of Peace rivals.
20207,10/5/2013,India,Pulwama,1,0,1,Hizb-ul-Mujahideen gun down a police officer.
20208,10/5/2013,Iraq,Mahaweel,3,7,10,"Religion of Peace rivals bomb a mosque, killing three worshippers."
20209,10/5/2013,Pakistan,Kurram,3,0,3,The Taliban gun down three security personnel.
20210,10/5/2013,India,Rajpora,1,0,1,A farmer is murdered inside his home by Muslim militants.
20211,10/5/2013,Iraq,al-Dhera,1,5,6,A 2-year-old child is pulled into pieces by Mujahid bombers.
20212,10/5/2013,Pakistan,Karachi,1,0,1,Lashkar-e-Jhagvi kidnap and murder a Shiite civilian.
20213,11/5/2013,Pakistan,Panj Khata,1,35,36,A 10-year-old boy is taken out by a bomb planted by Sunni hardliners.
20214,11/5/2013,Iraq,Shurqat,3,19,22,Three people are incinerated by a suicide truck bomber.
20215,11/5/2013,Iraq,Nineveh,3,21,24,A Fedayeen suicide bomber kills two women and a child.
20216,11/5/2013,Pakistan,Peshawar,1,10,11,A bomb outside a polling station leaves one dead.
20217,11/5/2013,Pakistan,Karachi,11,40,51,Children are among the casualties when Islamists set off a bomb blast targeting voters.
20218,11/5/2013,Pakistan,Manghopir,2,3,5,A suicide bomber sends two souls to Allah.
20219,11/5/2013,Afghanistan,Nuristan,1,0,1,A man is murdered in his own home by the Taliban.
20220,11/5/2013,Kenya,Mandera,2,4,6,Islamists throw a grenade at a group of Kenyans and then shoot them in the head.
20221,12/5/2013,Pakistan,Muslim Colony,1,0,1,A 19-year-old woman is strangled by her conservative family for getting pregnant.
20222,12/5/2013,Iraq,Basra,1,0,1,Religion of Peace rivals gun down a cleric outside his mosque.
20223,12/5/2013,Pakistan,Quetta,8,97,105,A child is among eight people blown to bits by a Lashkar-e-Jhangvi suicide car bomber.
20224,12/5/2013,Iraq,Mosul,5,0,5,Five suspected al-Qaeda victims are handcuffed and shot in the back of the head.
20225,12/5/2013,Iraq,Baghdad,4,0,4,Terrorists shoot four women to death in their own home.
20226,12/5/2013,Iraq,Mishahada,3,0,3,Mujahideen murder three men walking by the side of the road.
20227,13/5/2013,Pakistan,Bara,1,8,9,Taliban militants take out a child with a rocket.
20228,13/5/2013,Afghanistan,Helmand,3,0,3,Three Georgian soldiers are killed when a suicide truck bomber plows into their base.
20229,13/5/2013,Libya,Benghazi,15,41,56,"Islamists are thought responsible for a car bomb blast at a hospital that leaves over a dozen dead, including two children."
20230,13/5/2013,Afghanistan,Arghistan,10,12,22,Women and children are among ten civilians ripped to shreds by a bomb planted by religious radicals.
20231,13/5/2013,Afghanistan,Paktika,5,7,12,"Sunni hardliners bomb a van full of police recruits, killing five."
20232,13/5/2013,Iraq,Ramadi,3,7,10,"A Holy Warrior detonates a suicide vest, killing three Iraqis."
20233,14/5/2013,Syria,Raqqa,3,0,3,Video surfaces of the cold-blooded execution of three captives by al-Nusra Islamists.
20234,14/5/2013,Syria,Deir al-Zor,11,0,11,al-Nusra Islamists summarily execute eleven captives on video while praising Allah.
20235,14/5/2013,Iraq,Fallujah,2,0,2,al-Qaeda militants shoot two brothers to death.
20236,14/5/2013,Iraq,Mosul,1,14,15,A child is taken out by Mujahid car bombers.
20237,14/5/2013,Iraq,Baghdad,12,0,12,Fundamentalists execute a dozen people at a series of shops selling alcohol.
20238,14/5/2013,Afghanistan,Garmsir,3,7,10,Children are among the casualties when Sunni radicals set off a motorcycle bomb at a market.
20239,15/5/2013,Thailand,Pattani,1,0,1,Muslim 'insurgents' shoot a 50-year-old villager to death.
20240,15/5/2013,Iraq,Baghdad,14,68,82,At least five al-Qaeda bombs targeting Shiites leave a dozen dead and many more in agony.
20241,15/5/2013,Iraq,Sadr City,7,33,40,"Sunnis set off three car bombs in Shia neighborhoods, leaving seven dead."
20242,15/5/2013,Iraq,Kadhimiya,2,9,11,Two people are taken out by Jihad car bombers.
20243,15/5/2013,Iraq,Abu Ghraib,2,0,2,Two brothers are taken from their home and slain execution style by al-Qaeda.
20244,15/5/2013,Iraq,Mosul,2,0,2,A suicide bomber kills two Iraqis.
20245,15/5/2013,Iraq,Kirkuk,12,23,35,Two Jihad car bombings leave a dozen Iraqis dead.
20246,15/5/2013,Nigeria,Maiduguri,1,0,1,Religion of Peace activists shoot a pastor to death in his home in front of his daughter.
20247,16/5/2013,Somalia,Gof Gadud,5,10,15,An al-Shabaab ambush leaves five dead.
20248,16/5/2013,Iraq,Sadr City,9,16,25,A 7-year-old child is among nine killed when Sunnis bomb a bus stop in a Shia neighborhood.
20249,16/5/2013,Afghanistan,Kabul,15,40,55,"A dedicated Sunni blows himself up in a city street, exterminating fifteen souls, including two children"
20250,16/5/2013,Iraq,Kamaliya,3,14,17,Three civilians are laid out by a Mujahideen car bomb at a taxi stand.
20251,16/5/2013,Pakistan,Peshawar,2,0,2,Two truck drivers are shot to death by Muslim extremists.
20252,16/5/2013,Iraq,Kirkuk,12,18,30,A dozen people are torn to shreds when a suicide bomber self-detonates at a Shia mosque.
20253,16/5/2013,Pakistan,Mingora,2,1,3,A child activist and a peace committee member are shot by the Taliban in targeted attacks.
20254,16/5/2013,Pakistan,Matani,5,6,11,"Religious extremists open fire a convoy of local combat engineers, killing five."
20255,17/5/2013,Iraq,Baghdad,22,57,79,al-Qaeda bombers take down two dozen Iraqis with three bombs.
20256,17/5/2013,Pakistan,Baz Darrah,21,120,141,Twenty-one worshippers at two mosques are sent straight to Allah by Religion of Peace rivals.
20257,17/5/2013,Afghanistan,Kandahar,9,70,79,"Islamic hardliners bomb a family restaurant, killing nine innocents."
20258,17/5/2013,Iraq,Baqubah,43,57,100,A double bomb attack on a Sunni mosque leaves over forty worshippers dead.
20259,17/5/2013,Iraq,Madain,8,25,33,Eight mourners at a funeral are disassembled by sectarian bombers.
20260,17/5/2013,Iraq,Fallujah,2,8,10,"Terrorists bomb a coffee shop, killing two patrons."
20261,17/5/2013,Egypt,Alexandria,1,3,4,A Copt is killed during an assault by a Muslim bomb on a church.
20262,17/5/2013,Yemen,Mukalla,1,0,1,A security officer is assassinated by al-Qaeda gunmen on a motorcycle.
20263,17/5/2013,Pakistan,Mianwali,2,0,2,A faith healer and his wife are brutally murdered in their home by suspected fundamentalists.
20264,18/5/2013,Iraq,Basra,1,0,1,A Shia cleric is shot to death by Religion of Peace rivals.
20265,18/5/2013,Iraq,Baghdad,5,0,5,"Mujahideen enter a home and slaughter five family members, including two children ages 8 and 10."
20266,18/5/2013,Thailand,Narathiwat,1,4,5,One person bleeds to death after Muslim 'separatists' bomb a hotel.
20267,18/5/2013,Iraq,Garma,4,0,4,al-Qaeda gunmen take down four Iraqis.
20268,18/5/2013,Afghanistan,Khak-e-Safid,1,0,1,A local policeman is gunned down in his driveway by Sunni hardliners.
20269,18/5/2013,Afghanistan,Bakwa,4,0,4,Taliban militants murder four Afghan soldiers with a bomb.
20270,18/5/2013,Iraq,Latifiya,5,10,15,Jihad car bombers take out ten Iraqis.
20271,18/5/2013,India,Kupwara,1,0,1,Muslim militants from Pakistan shoot an Indian border guard to death.
20272,18/5/2013,Syria,Damascus,3,5,8,"Terrorists detonate a car bomb near a school, killing three people."
20273,19/5/2013,Egypt,Cairo,3,0,3,Three guards at a university are machine-gunned by religious extremists.
20274,19/5/2013,Pakistan,Basya Khel,1,5,6,A bomb targeting children leaves one dead.
20275,19/5/2013,Iraq,Rawa,3,2,5,Islamic 'insurgents' gun down three local cops in cold blood.
20276,19/5/2013,Afghanistan,Moqor,6,4,10,Six Afghans lose their lives to a Taliban ambush.
20277,19/5/2013,Tunisia,Tunis,0,11,11,Eleven policemen are injured when Salafists throw petrol bombs at them.
20278,19/5/2013,Lebanon,Tripoli,2,6,8,A boy is among two people killed during a sectarian clash between Sunni and Shia.
20279,19/5/2013,Pakistan,Khushpur,1,3,4,"Angry Muslims fire on a Christian village, killing a teenage student."
20280,19/5/2013,Iraq,Haditha,8,0,8,Al-Qaeda attack a police station and kill eight occupants.
20281,19/5/2013,Iraq,Baghdad,2,5,7,"Religious radicals open fire on a group of men playing checkers, killing two."
20282,19/5/2013,Iraq,Baqubah,2,0,2,Terrorists kill and man and his wife in their home.
20283,20/5/2013,Iraq,Baghdad,34,126,160,Over thirty people are murdered in a series of al-Qaeda bombings in Shiite areas.
20284,20/5/2013,Iraq,Tikrit,2,1,3,A married couple is laid out when terrorists bomb their car.
20285,20/5/2013,Iraq,Balad,14,13,27,Fourteen Shia pilgrims are disassembled by Sunni bombers.
20286,20/5/2013,Iraq,Basra,13,40,53,Over a dozen people at a restaurant are taken out in mid-bite by Mujahid bombers.
20287,20/5/2013,Iraq,Hillah,9,26,35,Nine people are cut down by Religion of Peace rivals while leaving a mosque.
20288,20/5/2013,Dagestan,Makhachkala,4,44,48,Four people are killed when Jihadists set off a bomb in front of a courthouse.
20289,20/5/2013,Iraq,Baghdad,12,20,32,A dozen Shiites are torn to shreds by sectarian bombers at a market.
20290,20/5/2013,Iraq,Samarrah,8,15,23,Eight Shia pilgrims are sent straight to Allah by Sunni car bombers.
20291,20/5/2013,Pakistan,Bajour,1,0,1,"Fundamentalists fire on a polio team, killing a guard."
20292,20/5/2013,Iraq,Anbar,13,0,13,Thirteen innocent kidnap victims are brutally executed by religious militants.
20293,20/5/2013,Afghanistan,Baghlan,14,11,25,A Fedayeen suicide bomber murders fourteen people.
20294,20/5/2013,Pakistan,Tank,1,0,1,A peace committee activist is shot dead by Muslim terrorists.
20295,21/5/2013,Afghanistan,Herat,7,0,7,Seven Afghans are exterminated by a Taliban roadside bomb.
20296,21/5/2013,Iraq,Kirkuk,5,46,51,"Holy warriors send razor-sharp shrapnel into patrons of a cattle market, taking out at least five."
20297,21/5/2013,Iraq,Baghdad,6,18,24,Six people bleed to death when Mujahideen set off a bomb outside a cafe.
20298,21/5/2013,Iraq,Tarmiyah,3,7,10,A suicide bomber snuffs out three other lives.
20299,21/5/2013,Pakistan,Dargai,1,0,1,A cleric is gunned down in his mosque by suspected terrorists.
20300,21/5/2013,Lebanon,Tripoli,11,70,81,A cleric is among eleven people killed in a sectarian clash between Shia and Sunni.
20301,21/5/2013,Iraq,Abu Ghraib,11,21,32,Eleven people at a mosque bleed out following a bombing by Religion of Peace rivals.
20302,21/5/2013,Pakistan,Quetta,1,0,1,A Sunni police officer deliberately kills a fellow officer for being a Shiite.
20303,21/5/2013,Pakistan,Pirabad,2,0,2,A man and wife are shot to death by her family for marrying of their own free will.
20304,21/5/2013,Pakistan,Dargai,2,7,9,Muslim bombers take out two guards at a power station.
20305,21/5/2013,Dagestan,Buinaksk,1,1,2,A police officer is gunned down by Islamists.
20306,21/5/2013,Afghanistan,Kandahar,2,5,7,Sunni fundamentalists claim credit for killing two local cops.
20307,22/5/2013,Afghanistan,Ghazni,1,5,6,Taliban bombers take out an Afghan civilian
20308,22/5/2013,Pakistan,Golimar,1,0,1,A Shia newspaper vendor is shot to death by Ahl-e-Sunnat wal Jamaat.
20309,22/5/2013,Kenya,Garissa,2,0,2,al-Shabaab is suspected in the cold-blooded killing of two civilians.
20310,22/5/2013,Thailand,Narathiwat,1,0,1,A grocery store owner is executed in his shop by Muslim 'insurgents'.
20311,22/5/2013,Afghanistan,Helmand,1,3,4,A motorcyclist is taken out by a Taliban roadside bomb.
20312,22/5/2013,Afghanistan,Moqur,4,14,18,"A suicide bomber detonates at a busy market, wiping out four bystanders."
20313,22/5/2013,England,London,1,0,1,An off-duty soldier is hacked to death in the name of Allah by two Muslims.
20314,22/5/2013,Iraq,Baghdad,12,0,12,Seven woman and five men are executed at a brothel by Islamic fundamentalists.
20315,22/5/2013,Pakistan,Sheikh Nala,1,3,4,A woman is killed when Islamic militants attack and burn four houses.
20316,22/5/2013,Pakistan,Karachi,1,0,1,A Christian man is gunned down by two men in a targeted attack.
20317,23/5/2013,Pakistan,Quetta,13,16,29,"The Tehreek-i-Taliban ""proudly claim"" a brutal bombing that leaves over a dozen dead."
20318,23/5/2013,Niger,Arlit,1,13,14,At least one civilians dies following a Mujao suicide car bombing at a uranium mine.
20319,23/5/2013,Niger,Agadez,20,16,36,"Suicide bombers detonate in a local army barracks, killing about twenty others."
20320,23/5/2013,Iraq,Taji,4,5,9,al-Qaeda gunmen murder four local soldiers at a checkpoint.
20321,23/5/2013,Pakistan,Karachi,1,0,1,A young Hindu is shot to death by a Muslim gang.
20322,23/5/2013,Egypt,Luxor,3,0,3,A woman and her two daughters are strangled and thrown into a river by seven male relatives concerned about unIslamic behavior.
20323,23/5/2013,Somalia,Beledweyne,3,0,3,"al-Shabaab terrorists attack a nomad community that refused to supply them with ""payment""."
20324,23/5/2013,Pakistan,Sibi,5,2,7,Fundamentalists are suspected of storming a brothel and killing five people.
20325,23/5/2013,Dagestan,Karabudakhkent,2,0,2,At least two innocent people are killed during a shooting and grenade attack by Islamic militants.
20326,24/5/2013,Nigeria,Borno,1,0,1,Members of Boko Haram murder an elderly Christian woman in her home.
20327,24/5/2013,Nigeria,Gwoza,2,0,2,A pastor and a church member are brutally slain by Islamist gunmen.
20328,24/5/2013,Saudi Arabia,Taif,1,0,1,An al-Qaeda prisoner kills a guard trying to save him from a fire.
20329,24/5/2013,Pakistan,Quetta,1,0,1,"Fundamentalists lob a hand grenade into a shop selling Western music, killing the owner."
20330,24/5/2013,Afghanistan,Kabul,4,4,8,"Fedayeen attack a humanitarian aid office, killing a 6-year-old child and three others."
20331,24/5/2013,Yemen,al-Thalib,2,0,2,An al-Qaeda attack on a local security post leaves two soldiers dead.
20332,24/5/2013,Pakistan,Landi Kotal,1,1,2,Religious extremists murder a truck driver.
20333,24/5/2013,Pakistan,Mattani,6,4,10,Religious radicals take out six local cops with RPGs.
20334,24/5/2013,Pakistan,Peshawar,2,3,5,Two other people are killed when a suicide bomber targets a rival cleric.
20335,24/5/2013,Thailand,Pattani,5,1,6,Muslim 'separatists' murder five security personnel with a roadside bomb.
20336,24/5/2013,India,Tral,3,0,3,Three Indian troops are killed in an ambush by Hizb-ul-Mujahideen.
20337,24/5/2013,Afghanistan,Andar,4,0,4,Four civilians at a mosque are killed when explosives carried by bombers detonate prematurely after the stop off for pre-blast prayer.
20338,25/5/2013,Dagestan,Makhachkala,1,14,15,Children are among the casualties when a female suicide bomber detonates in a public square.
20339,25/5/2013,Yemen,Hadramawt,2,2,4,A civilian and a cop bleed to death after al-Qaeda militants throw a grenade at them.
20340,25/5/2013,Pakistan,Orangi,0,2,2,Two children are hurt when suspected Taliban throw a bomb into a school yard.
20341,25/5/2013,Thailand,Pattani,1,0,1,A 44-year-old civilian is shot to death in his pickup truck by Muslim 'separatists'.
20342,25/5/2013,France,Paris,0,1,1,A soldier is wounded when a Muslim stabs him in the neck in a Paris shopping district.
20343,25/5/2013,Iraq,Samarrah,7,21,28,Seven Shia pilgrims on a bus are sent straight to Allah by Sunni bombers.
20344,25/5/2013,Somalia,Baidoa,1,14,15,At least one person is killed by an al-Shabaab blast at a market.
20345,26/5/2013,Egypt,Cairo,1,0,1,Muslims abduct and kill a 6-year-old Coptic boy.
20346,26/5/2013,Turkey,Ankara,0,1,1,At least one person is stabbed when Islamists shouting 'Allah Akbar' attack a couple kissing on the subway.
20347,26/5/2013,Syria,Damascus,6,15,21,A mother and child are among six killed by an al-Nusra car bomb.
20348,26/5/2013,Iraq,Mosul,5,21,26,Islamic terrorists take out five Iraqis in various attacks.
20349,26/5/2013,Thailand,Pattani,1,0,1,A 50-year-old coconut farmer is gunned down by suspected Muslim militants.
20350,26/5/2013,Thailand,Pattani,1,0,1,Muslim 'separatists' shoot a 44-year-old woman several times in the chest.
20351,26/5/2013,Pakistan,Bannu,6,6,12,Terrorists kill six security personnel in two attacks.
20352,26/5/2013,Afghanistan,Zherook,2,0,2,A 4-year-old child and her mother bleed to death following a Taliban rocket attack on their home.
20353,26/5/2013,Iraq,Baghdad,3,2,5,Three civilians are shot to death by Jihadi gunmen.
20354,26/5/2013,Kenya,Abdisugow,6,2,8,A teacher and a teenage boy are among six people murdered by Islamic militants.
20355,26/5/2013,Iraq,Baghdad,1,0,1,Mujahideen assassinate a promising soccer player.
20356,27/5/2013,Pakistan,Orangi,1,0,1,Sipah-e-Sahaba terrorists gun down a Shia activist.
20357,27/5/2013,Pakistan,Karachi,1,0,1,A seminary student is kidnapped and murdered by sectarian rivals.
20358,27/5/2013,Thailand,Pattani,1,3,4,One person is killed by a Muslim bomb blast near a school.
20359,27/5/2013,Lebanon,Hermel,3,1,4,A 17-year-old girl is among three civilians killed in a rocket attack blamed on religious extremists.
20360,27/5/2013,Iraq,Khalis,1,2,3,Terrorists gun down a teacher.
20361,27/5/2013,Iraq,Baladiyat,4,11,15,A Sunni bomb blast in a Shia neighborhood leaves four dead.
20362,27/5/2013,Iraq,Jisr Diyala,5,12,17,Five Shiites are obliterated by Sunni bombers.
20363,27/5/2013,Iraq,Sadria,3,11,14,Three Iraqis are sent to Allah by al-Qaeda bombers.
20364,27/5/2013,Iraq,Bayaa,6,16,22,An al-Qaeda bomb planted in a Shia neighborhood leaves six dead.
20365,27/5/2013,Iraq,Hurriyah,5,14,19,Five are killed A Shia neighborhood is bombed by Sunni extremists.
20366,27/5/2013,Iraq,Shaab,4,9,13,An al-Qaeda blast leaves four Shia dead.
20367,27/5/2013,Iraq,Kazimiyah,4,11,15,Four Shia waiting for a bus are sent to paradise by Sunni bombers.
20368,27/5/2013,Iraq,Sabi al-Boor,8,26,34,al-Qaeda bombers take out eight Iraqis with a bomb planted in a Shia neighborhood.
20369,27/5/2013,Iraq,Baghdad,5,14,19,Five civilians bleed to death following an al-Qaeda blast in a commercial area.
20370,27/5/2013,Iraq,al-Maalif,6,12,18,"Sunni bombers strike a Shiite open air market, killing at least a half dozen patrons."
20371,27/5/2013,Iraq,Sadr City,13,35,48,Thirteen shoppers are blown to bits by an al-Qaeda bomb at a shopping district.
20372,27/5/2013,Iraq,Tikrit,2,3,5,al-Qaeda bomber take down two Iraqis.
20373,27/5/2013,Iraq,Madain,3,9,12,Jihadi car bombers kill three and injure nine.
20374,27/5/2013,Pakistan,Shangla,5,0,5,A powerful bomb planted by radical Sunnis completely dismantles five local cops.
20375,27/5/2013,Pakistan,Bannu,1,0,1,A cleric is gunned down by Religion of Peace rivals.
20376,28/5/2013,Bahrain,Bani Jamra,0,7,7,Seven police are injured in a brutal shrapnel bomb attack by al-Ashtar Brigades.
20377,28/5/2013,Pakistan,Swat,1,5,6,A teenage boy is killed by a remote-controlled blast set off by Islamic militants.
20378,28/5/2013,Pakistan,Badbher,1,1,2,"Religious extremists fire on a team of polio workers, killing a woman."
20379,28/5/2013,Pakistan,Karachi,3,0,3,"A man and his two sons, ages 12 and 15, are brutally shot to death by sectarian Jihadis."
20380,28/5/2013,Thailand,Narathiwat,1,0,1,Muslim 'separatists' walk up to a plantation worker and shoot him three times in the chest.
20381,28/5/2013,Thailand,Pattani,2,0,2,Two local soldiers are cut down by Muslim terrorists.
20382,28/5/2013,Pakistan,Karachi,1,0,1,Lashkar-e-Jhangvi murder a man for being a Shiite.
20383,28/5/2013,Pakistan,Peshawar,2,17,19,Two people are killed when Sunnis set off a bomb at a Shia mosque.
20384,28/5/2013,Iraq,Mosul,11,2,13,A suicide bombing is among a series of Mujahid attacks that leave a dozen dead.
20385,28/5/2013,Iraq,Tikrit,3,2,5,Three Iraqis are shot to death by al-Qaeda.
20386,28/5/2013,Libya,Benghazi,1,3,4,A local soldier is gunned down by radical Islamists.
20387,28/5/2013,Iraq,Sadr City,5,26,31,"Sunnis detonate a shrapnel bomb at a Shia bus stop, taking down at least five civilians."
20388,28/5/2013,Iraq,Tarmiyah,4,8,12,A Fedayeen suicide bomber sends four Iraqis to Allah.
20389,28/5/2013,Afghanistan,Baghlan,5,0,5,Five family members are laid out by a Taliban roadside bomb.
20390,28/5/2013,Afghanistan,Arghistan,7,1,8,Taliban militants shoot seven local officers in the back after the police invite them in for dinner.
20391,29/5/2013,Iraq,Baghdad,12,31,43,al-Qaeda bombers send a dozen Iraqis to Allah.
20392,29/5/2013,Pakistan,Karachi,2,0,2,"Two men are shot to death in front of their children, apparently for belonging to a secular-leaning political party."
20393,29/5/2013,Iraq,Baghdad,9,15,24,Terrorists hit commercial districts with two bombs that leave nine dead.
20394,29/5/2013,Iraq,Baghdad,16,42,58,"Sectarian bombers blow up a wedding party, killing sixteen outright and leaving another forty in agony."
20395,29/5/2013,Iraq,Baqubah,7,11,18,Seven Iraqis are dismantled by a Mujahideen bomb blast.
20396,29/5/2013,Afghanistan,Jalalabad,1,1,2,"A suicide bomber attacks a Red Cross office, killing a guard."
20397,29/5/2013,Libya,Benghazi,3,3,6,"Islamists are suspected of tossing a grenade at a checkpoint, killing three soldiers."
20398,29/5/2013,Afghanistan,Panjshir,1,0,1,Six suicide bombers manage to kill one guard in an attack on a governor's office.
20399,30/5/2013,Iraq,Mosul,3,0,3,A Fedayeen suicide bomber takes out three Iraqis.
20400,30/5/2013,Iraq,Baghdad,3,6,9,Three people at a car parts market are disassembled by Sunni bombers.
20401,30/5/2013,Iraq,Baghdad,3,8,11,Terrorists plant a bomb on a minibus that kills three passengers.
20402,30/5/2013,Iraq,Tal Afar,4,8,12,Four people are taken out by a Shahid suicide car bomber.
20403,30/5/2013,Iraq,Karrada,3,16,19,Three Iraqis are sent to Allah by Muslim terrorists.
20404,30/5/2013,Iraq,Azamiyah,4,14,18,Four people are taken down by al-Qaeda bombers.
20405,30/5/2013,Iraq,Shaab,6,17,23,"Mujahideen bomb a Shiite commercial district, killing at least six innocents."
20406,30/5/2013,Iraq,Binouk,5,20,25,A pair of al-Qaeda car bombs leaves five dead.
20407,30/5/2013,Pakistan,Turbat,1,0,1,A prayer leader is gunned down by Religion of Peace rivals.
20408,30/5/2013,Thailand,Narathiwat,1,4,5,Muslim 'insurgent' attacks against a school headmaster and four others leave one dead.
20409,31/5/2013,Nigeria,Benue,17,12,29,Fulani 'mercenaries' storm a village market and slaughter seventeen civilians in an attack with sectarian overtones.
20410,31/5/2013,Myanmar,Selayang,2,0,2,Two Buddhists are beheaded in separate attacks.
20411,31/5/2013,Iraq,Baghdad,4,11,15,"Sectarian bombers target worshippers leaving a mosque, taking down four."
20412,31/5/2013,Pakistan,Peshawar,1,0,1,Taliban militants murder a peace committee member outside his home.
20413,31/5/2013,Pakistan,Nazimabad,3,0,3,A 14-year-old child is among three Shiites killed during a Sipah-e-Sahaba attack.
20414,31/5/2013,Pakistan,Karachi,2,0,2,A Shia professor and his driver are murdered by Wahhabi rivals.
20415,1/6/2013,Niger,Niamey,4,10,14,Mujao Islamists storm a prison and shoot dead three guards and a visitor.
20416,1/6/2013,Afghanistan,Khost,3,3,6,Taliban bombers take out three local cops.
20417,1/6/2013,Yemen,Hadramawt,1,0,1,An al-Qaeda gunmen praises Allah as he shoots a local air force officer to death at a traffic light.
20418,1/6/2013,Thailand,Narathiwat,1,6,7,"Muslim 'separatists' spray a group of local soldiers with bullets, killing at least one."
20419,1/6/2013,Thailand,Pattani,1,0,1,A villager is shot to death by suspected 'separatists.'
20420,1/6/2013,Pakistan,Karachi,1,0,1,Sipah-e-Sahaba murder a 30-year-old Shiite.
20421,1/6/2013,Afghanistan,Barkhol,3,11,14,The Taliban take out three members of a wedding party with a roadside blast.
20422,1/6/2013,Pakistan,Pastawana,1,0,1,Religious extremists gun down a public high school principal in cold blood at his home.
20423,1/6/2013,Afghanistan,Uruzgan,4,0,4,A child is among four civilians exterminated by fundamentalist bombers.
20424,2/6/2013,Tanzania,Geita,0,1,1,Religion of Peace activists enter the home of a Christian pastor and nearly hack him to death.
20425,2/6/2013,Yemen,Shabwa,9,5,14,An al-Qaeda suicide bomber sends nine people to paradise.
20426,2/6/2013,Afghanistan,Kamdesh,4,4,8,Four local cops are murdered by a Taliban attack.
20427,2/6/2013,Iraq,al-Rutba,3,0,3,Sunni terrorists murder three Syrian truck drivers.
20428,2/6/2013,Pakistan,Sukkor,1,0,1,Members of a conservative family pitch in to shoot a daughter to death who married without the father's permission.
20429,2/6/2013,Pakistan,Sanghar,1,0,1,A Muslim woman is honor-killed by her step brother on suspicion of illicit relations.
20430,2/6/2013,Syria,Jouber,3,3,6,A Jabhat al-Nusra car bomb leaves three dead.
20431,2/6/2013,Syria,Damascus,9,0,9,Nine people are reportedly murdered by al-Nusra.
20432,3/6/2013,Lebanon,Tripoli,4,21,25,A woman is among four killed during a clash between Sunni and Shia.
20433,3/6/2013,Afghanistan,Samkani,12,15,27,Ten schoolchildren are disassembled by a Holy Warrior suicide bomber at a market
20434,3/6/2013,Thailand,Pattani,1,0,1,A 53-year-old villager is murdered by Muslim 'separatists' as he is driving home.
20435,3/6/2013,Pakistan,Tank,1,1,2,Islamic militants gun down a man at a market.
20436,3/6/2013,Afghanistan,Laghman,7,0,7,Four children and two women are among a family of seven exterminated by fundamentalist bombers.
20437,3/6/2013,Pakistan,Garhi Habib Ullah,1,0,1,A woman is forced to recite Quran and then hacked to death with an axe after leaving the house without her husband's permission.
20438,3/6/2013,Kenya,Liboi,2,0,2,al-Shabaab militia murder two Kenyans in their cars.
20439,4/6/2013,Pakistan,Islamabad,1,0,1,A 16-year-old girl is tortured to death by her conservative father for an 'honor' violation.
20440,4/6/2013,Afghanistan,Farah,4,1,5,Three children and their father are exterminated by Holy Warriors.
20441,4/6/2013,Pakistan,Khairpur,1,0,1,Islamic radicals are suspected of pulling a university employee off a bus and executing him.
20442,4/6/2013,Iraq,Hillah,1,0,1,"Jihadis place a bomb in the car of an elementary school teacher, killing him instantly."
20443,4/6/2013,Afghanistan,Helmand,3,3,6,The Taliban murder three local soldiers with a roadside bomb.
20444,4/6/2013,Algeria,Djelfa,5,0,5,A conservative Muslim cleanses his family honor by shooting five members of his niece's lover to death.
20445,5/6/2013,Iraq,Nukhaib,14,0,14,Fourteen innocent Shiites are stopped and summarily executed by Sunni gunmen.
20446,5/6/2013,Malaysia,Kuala Lumpur,4,2,6,A man slashed to death at a car wash are among four Buddhists killed in targeted attacks by Muslims.
20447,6/6/2013,Bangladesh,Bolakipur,0,5,5,Muslim 'extremists' break in to a Catholic seminary and beat the rector and students 'with violence and brutality'.
20448,6/6/2013,Afghanistan,Nawzad,7,9,16,Seven NATO soldiers are killed when a suicide truck bomber detonates inside their base.
20449,6/6/2013,Pakistan,Peshawar,3,1,4,Taliban bombers murder three local cops.
20450,6/6/2013,Iraq,Bayaa,3,11,14,Three Iraqis are ripped to shreds by Jihad bombers.
20451,6/6/2013,Iraq,Nahrawan,4,22,26,Four people at a livestock market are obliterated by a Mujahideen bombing.
20452,6/6/2013,Afghanistan,Sar-e Pol,1,15,16,A civilian bleeds to death following a bomb blast at a hotel.
20453,6/6/2013,Pakistan,Quetta,2,0,2,Two women are killed when Taliban suicide bombers blow themselves up.
20454,6/6/2013,Tunisia,Mount Chaambi,2,2,4,Jihadists kill two local soldiers with a roadside bomb.
20455,6/6/2013,Iraq,Taji,7,12,19,Seven Iraqis are blown to bits by a Shahid suicide bomber.
20456,7/6/2013,Somalia,Jamaame,1,0,1,Islamists identify a Christian convert and publicly execute him.
20457,7/6/2013,Pakistan,Bahawal,0,1,1,A 70-year-old shepherd is severely beaten after a mob accuses him of tearing a page of the Quran.
20458,7/6/2013,Iraq,Muqdadiyah,12,45,57,A dozen Shia pilgrims are sent straight to Allah by Sunni car bombers.
20459,7/6/2013,Iraq,Ramadi,8,8,16,Suicide bombers take out at least eight Iraqis at an intersection.
20460,7/6/2013,Thailand,Yala,1,0,1,A 38-year-old man is shot to death by Muslim 'separatists' while on his way to pick up his child.
20461,7/6/2013,Pakistan,Karachi,1,0,1,Wahhabi militants murder a 30-year-old Shiite outside his shrine.
20462,7/6/2013,Pakistan,Badhaber,1,0,1,A female polio worker loses her life in a hospital a few days after a shooting attack by fundamentalists.
20463,8/6/2013,Somalia,Mogadishu,2,2,4,An al-Shabaab bomb blast leaves two people dead.
20464,8/6/2013,Iraq,Baghdad,5,20,25,"Sunni bombers target Shia commercial districts, killing at least five."
20465,8/6/2013,Afghanistan,Paktika,3,0,3,A civilian is among three Americans killed by a Taliban in NATO uniform.
20466,8/6/2013,Syria,Homs,8,10,18,A child and three woman are among eight civilians killed by an al-Nusra car bomb in a Shia neighborhood.
20467,8/6/2013,Nigeria,Maiduguri,13,5,18,Islamic extremists massacre thirteen civilians with guns hidden in a coffin.
20468,8/6/2013,Afghanistan,Kunduz,1,0,1,A conservative man shoots his 18-year-old sister to death for having an illicit affair.
20469,9/6/2013,Afghanistan,Kandahar,2,0,2,Two children are beheaded by the Taliban.
20470,9/6/2013,Lebanon,Beirut,1,0,1,Hezbollah is blamed for the murder of a young demonstrator.
20471,9/6/2013,Kenya,Mombasa,0,17,17,"Islamists throw a grenade into a church during Sunday service, nearly killing a baby."
20472,9/6/2013,Syria,Aleppo,1,0,1,Islamists execute a 15-year-old boy in front of his parents for the crime of disbelieving in God.
20473,9/6/2013,Egypt,al-Arish,1,0,1,Islamic terrorists gun down an Egyptian cop.
20474,9/6/2013,Pakistan,Razmak,3,4,7,Taliban militants kill three local soldiers with roadside bomb.
20475,9/6/2013,Iraq,Baghdad,7,22,29,"A Fedayeen suicide bomber strikes a Shia neighborhood during rush hour, killing seven."
20476,9/6/2013,Pakistan,Lyari,2,0,2,Sectarian Jihadis take out an 8-year-old girl and her father with a grenade at a park.
20477,10/6/2013,Afghanistan,Qalat,2,18,20,Two civilians are killed during a coordinated attack by Fedayeen suicide bombers.
20478,10/6/2013,Pakistan,Jamrud,6,0,6,Jaishi Asama murder six truck drivers.
20479,10/6/2013,Thailand,Narathiwat,1,0,1,A 58-year-old man at a tea shop is shot to death in mid-sip by Muslim 'insurgents'.
20480,10/6/2013,Iraq,Baqubah,7,0,7,Sunnis kidnap and execute seven Shia civilians.
20481,10/6/2013,Pakistan,Nazimabad,2,0,2,Sunni extremists murder two Shiites on their way to prayers.
20482,10/6/2013,Pakistan,Orangi,1,0,1,Sipah-e-Sahaba  murder a former Sunni for becoming Shia.
20483,10/6/2013,Iraq,Jidaidat al-Shatt,15,46,61,At least fifteen people are exterminated by Mujahideen bomb blasts at a fruit and vegetable market.
20484,10/6/2013,Iraq,Taji,7,25,32,An al-Qaeda bomb at a fish market leaves seven dead.
20485,10/6/2013,Iraq,Kirkuk,3,12,15,al-Qaeda bombers snuff out three lives.
20486,10/6/2013,Iraq,Kirkuk,1,14,15,An Iraqi loses his life to a Shahid suicide bomber.
20487,10/6/2013,Iraq,Madaen,3,10,13,Three people are torn apart by a Fedayeen suicide bomber.
20488,10/6/2013,Iraq,Sadr City,4,12,16,"Sunnis bomb a cafe popular with Shiites, killing at least four."
20489,10/6/2013,Iraq,Mosul,24,114,138,Five coordinated al-Qaeda bomb blasts leave two dozen people dead and over a hundred more in agony.
20490,10/6/2013,Lebanon,Hermel,1,0,1,Hezbollah is accused of murdering a truck driver.
20491,10/6/2013,Iraq,Tuz Khromato,3,38,41,Two al-Qaeda bomb blasts take out three Iraqis.
20492,11/6/2013,Pakistan,Sheikhupura,1,0,1,A Christian teen is tortured and killed on (false) suspicion of relations with a Muslim girl.
20493,11/6/2013,Dagestan,Novolak,2,2,4,Two local cops are gunned down by Islamic militants.
20494,11/6/2013,Syria,Hatla,30,0,30,At least two dozen Shia civilians are slaughtered in their homes by Sunni extremists praising Allah.
20495,11/6/2013,Pakistan,Karachi,1,2,3,A targeted shooting attack on three Ahmadi minorities at a bazaar leaves one dead.
20496,11/6/2013,Syria,Damascus,14,31,45,Fourteen people at a public square are ripped apart by Shahid suicide bombers.
20497,11/6/2013,Iraq,Mosul,6,0,6,Six Iraqis are murdered by Mujahideen bombers.
20498,11/6/2013,Iraq,Diyala,3,0,3,Three local truck drivers are gunned down in cold blood by Sunni extremists.
20499,11/6/2013,Afghanistan,Kabul,17,39,56,"A devout Muslim blows himself up outside a courthouse, taking seventeen other souls with him."
20500,11/6/2013,Pakistan,Peshawar,2,1,3,A doctor is among two Shiites shot to death by Lashkar-e-Jhagvi.
20501,12/6/2013,Thailand,Narathiwat,1,0,1,A working class man is gunned down by Muslim 'separatists' on his way to the job site.
20502,12/6/2013,Thailand,Pattani,1,0,1,A 30-year-old Buddhist is slain in front of his house by Muslim militants.
20503,12/6/2013,Thailand,Pattani,1,0,1,Militant Muslims machine-gun a 49-year-old man resting in his living room.
20504,12/6/2013,Afghanistan,Sangin,2,15,17,Sunni radicals take out two people with a bomb planted near a market.
20505,13/6/2013,Afghanistan,Helmand,6,0,6,A Taliban recruit helps the terrorists murder six fellow cops.
20506,13/6/2013,Afghanistan,Jaghato,2,2,4,Two small children are disassembled by a Religion of Peace rocket attack.
20507,13/6/2013,Afghanistan,Sar-i-pul,1,0,1,A doctor is dragged out of his clinic and stoned by a mob angry that he saw a female patient without an escort.
20508,13/6/2013,Pakistan,Karachi,1,0,1,A Shiite is shot to death by Sipah-e-Sahaba.
20509,14/6/2013,Afghanistan,Khost,8,0,8,Eight civilians are blown to bits by a Taliban bomb.
20510,14/6/2013,Iraq,Mosul,1,0,1,A local politician is assassinated by al-Qaeda gunmen.
20511,15/6/2013,Pakistan,Quetta,25,19,44,"Lashkar-e-Jhangvi blow up a bus carrying female students, then force their way into a hospital and shoot more to death."
20512,15/6/2013,Iraq,al-Ashraf,2,40,42,"Mortars are sent into a camp of Sunni dissidents, leaving two dead."
20513,15/6/2013,Libya,Benghazi,6,11,17,Six local soldiers are stabbed and shot to death by Islamic extremists.
20514,15/6/2013,Nigeria,Hwaa,1,0,1,A pastor's throat is slit by Islamists upon refusal to convert.
20515,16/6/2013,Iraq,Najaf,8,28,36,"Sunni bombers strike a watermelon market in a Shia area, sending at least eight patrons to Allah."
20516,16/6/2013,Iraq,Nasiriyah,2,35,37,al-Qaeda bombers take down two Iraqis.
20517,16/6/2013,Iraq,Kut,5,12,17,Five construction workers are ripped to shreds by Sunni bombers.
20518,16/6/2013,Iraq,Kut,6,15,21,"Hardline bombers send shrapnel through an industrial area, taking down six innocents."
20519,16/6/2013,Nigeria,Damaturu,9,4,13,Seven students and two teachers are killed during an assault on their school by Boko Haram.
20520,16/6/2013,Pakistan,Swabi,2,0,2,Two anti-polio workers are shot to death by Muslim fundamentalists.
20521,16/6/2013,Lebanon,Wadi Refeq,4,0,4,Four Shiites are machine-gunned by Sunnis .
20522,16/6/2013,Pakistan,Karachi,3,0,3,"Three members of a secular-leaning political party are kidnapped, tortured and murdered by suspected Taliban."
20523,16/6/2013,Iraq,Madaen,5,10,15,Mujahideen car bombers send five Iraqis to Allah.
20524,16/6/2013,Iraq,Baghdad,11,25,36,Eleven people at a packed cafe catering to Shiites are murdered by a Fedayeen suicide bomber.
20525,16/6/2013,Iraq,Mosul,6,5,11,Six guards at an oil pipeline are shot to death by suspected al-Qaeda.
20526,16/6/2013,Iraq,Basra,6,9,15,A half-dozen Shiites are dismantled by Sunni bombers.
20527,17/6/2013,Iraq,Taji,7,25,32,Two women and a 12-year-old child are among seven patron obliterated by Mujahid restaurant bombing.
20528,17/6/2013,Iraq,Fallujah,3,21,24,A Shahid suicide bomber exterminates three Iraqis.
20529,17/6/2013,Iraq,Taji,2,11,13,A bomb placed inside a minibus leaves two dead.
20530,17/6/2013,Pakistan,Killa Saifullah,3,0,3,Islamists walk up to a checkpoint and calmly shoot three local cops to death.
20531,17/6/2013,Afghanistan,Kabul,3,2,5,Three innocent truck drivers are torn to pieces by a Taliban rocket.
20532,17/6/2013,Syria,Damascus,60,10,70,Sixty security force members are reportedly killed by an al-Qaeda car bomb.
20533,17/6/2013,Iraq,Jabla,3,1,4,al-Qaeda gunmen walk into a restaurant and gun down three patrons.
20534,17/6/2013,Thailand,Yala,1,0,1,A cop praying inside a mosque is shot to death by a Muslim terrorist.
20535,18/6/2013,Nigeria,Bakin Rijiya,1,0,1,At least one resident is killed when Muslim terrorists attack a Christian village and burn four churches.
20536,18/6/2013,Egypt,Assiut,2,16,18,Fundamentalists are suspected of lobbing a shell at a group of local soldiers.
20537,18/6/2013,Pakistan,North Waziristan,2,0,2,Two local soldiers are machine-gunned at a checkpost by Islamic terrorists.
20538,18/6/2013,Afghanistan,Kabul,3,24,27,Religious extremists set off a bomb that leaves three civilians dead.
20539,18/6/2013,Pakistan,Mardan,35,61,96,"A Holy Warrior self-detonates at a funeral, killing three dozen mourners."
20540,18/6/2013,Iraq,Baghdad,37,57,94,A double suicide bombing at a Shia mosque leaves over thirty worshippers dead.
20541,18/6/2013,Nigeria,Alau Dam,13,0,13,Thirteen fishermen and tea vendor's are gunned down in cold blood by Islamic extremists.
20542,19/6/2013,Iraq,Ninevah,5,6,11,"A Shahid suicide bomber detonates inside the guesthouse of a local politician, killing him and four family members."
20543,19/6/2013,Somalia,Mogadishu,22,20,42,Suicide bombers storm a UN compound and massacre twenty-two innocents.
20544,19/6/2013,Pakistan,Green Town,1,0,1,An Ahmadi father of two is gunned down in a targeted attack based on his religion.
20545,19/6/2013,Yemen,Saada,2,11,13,A Fedayeen suicide bomber takes out two civilians.
20546,19/6/2013,Pakistan,Karachi,1,0,1,A Shia school bus driver is murdered by Sunnis.
20547,20/6/2013,Pakistan,Karachi,2,0,2,The Tehreek-e-Taliban murder a father and son in cold blood.
20548,20/6/2013,Iraq,Tikrit,2,0,2,Suspected al-Qaeda gunmen shoot two civilians to death.
20549,20/6/2013,Iraq,Ramadi,7,7,14,A suicide bomber dressed as a policeman walks into a vote counting center and slaughters seven people.
20550,21/6/2013,Pakistan,Peshawar,15,28,43,"A dedicated Sunni wades into a packed Shia mosque and detonates a suicide vest, while his friends fire automatic weapons into the crowd."
20551,21/6/2013,Iraq,Baghdad,2,9,11,Two patrons are killed when a Sunni bomb rips through a market.
20552,22/6/2013,Iraq,Mosul,4,15,19,Four people are ripped apart by a Fedayeen suicide car bomber.
20553,22/6/2013,Iraq,Tuz Khurmatu,3,1,4,"al-Qaeda gunmen open up on a group of Iraqis at point-blank range, taking down three."
20554,22/6/2013,Iraq,Sab al-Bor,14,32,46,A Shahid suicide bomber walks into a Shia mosque and sends fourteen worshippers straight to Allah.
20555,22/6/2013,India,Srinagar,2,0,2,Two traffic cops are gunned down by Islamic militants.
20556,22/6/2013,Thailand,Pattani,2,2,4,Muslim terrorists take out two local soldiers with a roadside bomb.
20557,22/6/2013,Pakistan,Chamarkand,2,0,2,Two tribal elders are sent to Allah by Taliban bombers.
20558,22/6/2013,Pakistan,Toba Tek Singh,5,0,5,"Three small children are among a family of five Shiites, tied up in their home and butchered by Sunnis with knives."
20559,22/6/2013,Afghanistan,Kunduz,2,0,2,At least two police officers are murdered in separate Taliban attacks.
20560,22/6/2013,Iraq,Anbar,5,0,5,Five local cops are massacred by a coordinated car bomb and rocket attack.
20561,22/6/2013,Iraq,Tikrit,4,4,8,al-Qaeda militants incinerate four truck drivers with thermal grenades.
20562,23/6/2013,Dagestan,Kohabrosso,0,3,3,"Islamic militants try to kill a moderate imam in his home, wounding him, his wife and son."
20563,23/6/2013,Syria,Damascus,3,10,13,Three people are blown to bits by a Fedayeen suicide bomber.
20564,23/6/2013,Iraq,Tuz Khurmatu,19,31,50,Car bombs targeting Shiites in a residential neighborhood leave at least nineteen dead.
20565,23/6/2013,Iraq,Riyadh,3,14,17,Three Iraqis are taken out by a Shahid suicide bomber.
20566,23/6/2013,Pakistan,Nanga Parbat,11,0,11,Religious extremists shoot ten foreign tourists and one guard to death at a mountain climbing camp.
20567,23/6/2013,Iraq,Baghdad,3,9,12,Three civilians are killed when terrorists send a rocket shell into a hotel.
20568,23/6/2013,Syria,Idlib,1,0,1,A Catholic monk is beheaded Islamists for defending nuns.
20569,23/6/2013,Lebanon,Sidon,6,0,6,Six local soldiers are murdered 'in cold blood' on orders of a Sunni cleric.
20570,23/6/2013,Egypt,Zawiyat,4,0,4,"Sunni hardliners throw petrol bombs into a house with Shia residents, burning and then stabbing and beating at least four to death."
20571,23/6/2013,Pakistan,Karachi,2,0,2,A lawyer and his son are shot to death in their car by sectarian Jihadis.
20572,23/6/2013,Pakistan,Gilgit,3,0,3,Two girls and their mother are honor killed by conservative family members over a video of them enjoying rain.
20573,24/6/2013,Pakistan,Madurai,1,0,1,A milk vendor is murdered in cold blood by Religion of Peace emissaries.
20574,24/6/2013,India,Srinagar,8,11,19,"Hizbul-Mujahideen ambush a group of local soldiers, killing eight."
20575,24/6/2013,Pakistan,Karachi,1,0,1,A Shiite shopkeeper is picked off by Sipah-e-Sahaba snipers.
20576,24/6/2013,Pakistan,Karachi,1,0,1,Sunnis kidnap and brutally torture a Shiite to death.
20577,24/6/2013,Pakistan,Khyber Pakhtunkhwa,2,0,2,Two people are brutally murdered by Islamic militants.
20578,24/6/2013,Iraq,Tikrit,3,5,8,Students are among the casualties when a Shahid suicide bomber detonates inside a university parking garage.
20579,24/6/2013,Iraq,Mosul,2,7,9,Two people are obliterated by a Fedayeen suicide bomber.
20580,24/6/2013,Iraq,Baghdad,11,37,48,Eleven Iraqis are torn to shreds by five al-Qaeda car bomb blasts.
20581,24/6/2013,Iraq,Nahrawan,4,15,19,Four people are ripped apart by al-Qaeda bombers.
20582,24/6/2013,Iraq,Baghdad,5,16,21,"Jihadis bomb a supermarket, killing at leave five Iraqis."
20583,24/6/2013,Iraq,Jihad,9,21,30,al-Qaeda bombers take out nine residents of a Shia neighborhood.
20584,24/6/2013,Iraq,Husseiniya,10,30,40,Two bombs placed at a Shiite market send eight patrons to Allah.
20585,24/6/2013,Iraq,Baghdad,1,2,3,"Jihadis bomb a Christian-owned store, killing a father of three."
20586,24/6/2013,Afghanistan,Deh-Sabz,7,3,10,Seven civilians are shot to death at a market by suspected Taliban.
20587,25/6/2013,Iraq,Baghdad,2,2,4,"Islamists set off a bomb near a church, killing two people."
20588,25/6/2013,Iraq,Baghdad,0,2,2,Two guards are wounded when Muslims open fire on a Catholic church.
20589,25/6/2013,Afghanistan,Kandahar,10,3,13,Two children and eight women are shredded by a bomb planted by Sunni fundamentalists.
20590,25/6/2013,Afghanistan,Kabul,3,4,7,A suicide attack on a government building leaves three guards dead.
20591,25/6/2013,Lebanon,Sirte,6,0,6,Six local soldiers are killed in an ambush by Islamic militia.
20592,25/6/2013,Pakistan,Peshawar,1,0,1,A bomb planted at a mosque kill a villager.
20593,25/6/2013,Iraq,Baghdad,4,15,19,Four minibus riders are torn to pieces by an al-Qaeda shrapnel bomb.
20594,25/6/2013,Iraq,Baqubah,8,18,26,Eight young people are tragically killed when Islamists set off a bomb near a soccer field.
20595,25/6/2013,Iraq,Iskandariya,5,13,18,Five Shiite pilgrims are sent straight to Allah by Sunni bombers.
20596,25/6/2013,Iraq,Tuz Khurmato,27,80,107,Twenty-seven demonstrators calling for better security are massacred by two Religion of Peace suicide bombers.
20597,25/6/2013,Pakistan,Karachi,1,0,1,"Sunnis fire on a Shia funeral, killing one mourner."
20598,26/6/2013,China,Lukqun,24,21,45,At least two-dozen people are stabbed or beaten to death by rioting Muslim extremists.
20599,26/6/2013,Afghanistan,Herat,5,0,5,Five local cops are exterminated by Sunni radicals.
20600,26/6/2013,Pakistan,Hayatabad,1,4,5,Islamic extremists murder a man at a market.
20601,26/6/2013,Pakistan,Janaikhel,3,0,3,Three family members are obliterated by an Islamist bomb.
20602,26/6/2013,Thailand,Pattani,1,5,6,Children are among the casualties of a roadside bombing by Muslim 'separatists'.
20603,26/6/2013,Libya,Benghazi,1,0,1,Suspected Islamists kill one person with a car bomb in a residential neighborhood.
20604,26/6/2013,Lebanon,Beirut,0,20,20,Twenty people on a bus are stabbed in a suspected sectarian attack.
20605,26/6/2013,Pakistan,Karachi,12,14,26,"Tehreek-e-Taliban bombers target a judge, killing a dozen people in the street."
20606,26/6/2013,Nigeria,Langtang,33,0,33,Thirty-three students and elderly villagers are massacred in a coordinated attack by Muslim militia.
20607,26/6/2013,India,Sopore,1,0,1,A local politician is assassinated by Hizb-ul-Mujahideen.
20608,26/6/2013,Iraq,Baghdad,10,16,26,"Religious radicals bomb a coffee shop showing a soccer game, taking out ten fans."
20609,26/6/2013,Iraq,Mosul,4,3,7,"Fundamentalists bomb a liquor store, killing four patrons."
20610,26/6/2013,Iraq,Kirkuk,1,1,2,Two brothers are shot by al-Qaeda.
20611,26/6/2013,Iraq,Kirkuk,3,0,3,"Three family members, including two women are sent to Allah by Mujahideen bombers."
20612,27/6/2013,Syria,Qatana,1,0,1,A Greek Orthodox priest is kidnapped and tortured to death by Religion of Peace proponents.
20613,27/6/2013,Syria,Damascus,4,8,12,"A suicide bomber detonates outside a church, killing four innocents."
20614,27/6/2013,Syria,Idlib,2,0,2,"Two Christians, including a priest, are reportedly kidnapped, bound and beheaded on video by Islamists."
20615,27/6/2013,Pakistan,Karachi,1,0,1,A man is murdered by Sipah-e-Sahaba.
20616,27/6/2013,Iraq,Baqubah,10,35,45,A coffee shop packed with soccer fans is the target of an al-Qaeda bomb blast that leaves at least ten dead.
20617,27/6/2013,Iraq,Madaen,1,6,7,A 3-year-old girl is disassembled by an al-Qaeda bomb planted at her home.
20618,27/6/2013,Iraq,Meseib,6,12,18,"Religion of Peace bombers target an auto show, taking out seven patrons."
20619,27/6/2013,Iraq,Baghdad,1,0,1,Islamic fundamentalists shoot a barber to death.
20620,27/6/2013,Iraq,Baghdad,8,40,48,Eight soccer fans are either blown up or shot to death by religious extremists.
20621,28/6/2013,Afghanistan,Farah,2,2,4,A Fedayeen suicide bomber ends the lives of two civilians.
20622,28/6/2013,Iraq,Baghdad,3,0,3,"Mujahideen bomb a bakery, laying out at least three innocents."
20623,28/6/2013,Iraq,Madain,4,15,19,Religious extremists set off a bomb at a soccer field that leave four dead.
20624,28/6/2013,Iraq,Dujail,4,12,16,A suicide bomber at a funeral sends four more souls to Allah.
20625,28/6/2013,Iraq,Zangoura,11,19,30,al-Qaeda bombers take out eleven Iraqis.
20626,28/6/2013,Thailand,Yala,1,1,2,"Muslim 'insurgents' fire on a mother and her two young sons, killing her and injuring the 2-year-old."
20627,28/6/2013,Afghanistan,Laghman,5,1,6,Five villagers are shredded by fundamentalist bombers.
20628,28/6/2013,Thailand,Narathiwat,1,0,1,Muslim 'separatists' shoot a 50-year-old man to death inside a mosque.
20629,28/6/2013,Thailand,Songkhla,2,7,9,Muslim terrorists kill two people with a bomb outside a tea shop.
20630,29/6/2013,Iraq,Garma,3,0,3,Three Iraqis are shot to death by suspected al-Qaeda.
20631,29/6/2013,Iraq,Abu Ghraib,4,12,16,"Sunnis set off a bomb at a marketplace, killing three patrons."
20632,29/6/2013,Thailand,Yala,8,4,12,A massive roadside bomb set off by Muslim 'rebels' leaves eight local soldiers dead.
20633,29/6/2013,Nigeria,Mugunu,10,0,10,Ten traders on a business trip are massacred by Sharia proponents.
20634,29/6/2013,Egypt,Sinai,1,0,1,Islamists shoot a local cop six times in the head.
20635,29/6/2013,Chechnya,Shatoi,1,14,15,Islamic militia kill a local police officer and injure fourteen others.
20636,29/6/2013,Nigeria,Potiskum,1,3,4,Boko Haram terrorists murder a local soldier.
20637,29/6/2013,Nigeria,Borno,15,10,25,"Islamists sack several small villages, killing about fifteen people."
20638,29/6/2013,Afghanistan,Zabul,3,2,5,Religious extremists kill three civilians with a roadside bomb.
20639,29/6/2013,Iraq,Qayara,3,5,8,Three Iraqis are taken out by a Shahid suicide bomber.
20640,30/6/2013,China,Atush,1,0,1,A Muslim extremist stabs a policeman.
20641,30/6/2013,Pakistan,Karachi,1,0,1,A secular political activist is murdered by suspected Tehreek-e-Taliban.
20642,30/6/2013,Iraq,Hillah,2,2,4,Mujahideen kill two bus passengers with a planted bomb.
20643,30/6/2013,Pakistan,Miranshah,7,16,23,The Taliban murder seven Pakistanis with an IED.
20644,30/6/2013,Thailand,Pattani,1,0,1,A 24-year-old civilian is gunned down by Muslim militants.
20645,30/6/2013,Pakistan,Dera Islmail Khan,4,15,19,Four people are killed when Islamic militants send rockets into a residential neighborhood.
20646,30/6/2013,Pakistan,Quetta,30,60,90,Nine women and five children are among thirty innocents slain outside a Shia mosque by a Lashkar-i-Jhangvi suicide bomber.
20647,30/6/2013,Pakistan,Peshawar,17,47,64,A Religion of Peace car bomb leaves seventeen people dead.
20648,30/6/2013,Iraq,Baghdad,12,25,37,A dozen young boys at a soccer field are ripped apart by an al-Qaeda bomb blast.
20649,30/6/2013,Iraq,Dawr,1,0,1,A 17-year-old girl's life is snuffed out by Mujahid bombers.
20650,1/7/2013,Pakistan,Madurai,1,0,1,A Hindu leader is murdered by Muslim radicals.
20651,1/7/2013,Afghanistan,Nahrin,4,0,4,Four people lose their lives to Taliban bombers.
20652,1/7/2013,Iraq,Mishahada,8,0,8,Eight men are pulled out of their homes and executed by al-Qaeda.
20653,1/7/2013,Pakistan,Punjab,1,0,1,A Shia is gunned down by Sipah-e-Sahaba.
20654,1/7/2013,India,Pulwama,1,0,1,"Terrorists open fire on a group of police officers, killing one."
20655,1/7/2013,Iraq,Baqubah,10,22,32,Ten Iraqis sitting in a cafe are blown to bits by a Shahid suicide bomber.
20656,1/7/2013,Iraq,Muqdadiyah,23,27,50,"A Sunni suicide bomber self-detonates inside a Shiite mosque, sending two dozen worshippers straight to Allah."
20657,1/7/2013,Pakistan,Pishtakhara,2,0,2,Two police officers are machine-gunned at point-blank range by Sharia proponents.
20658,1/7/2013,Syria,Qamishli,1,3,4,Muslim terrorists kill a young girl with an explosive device.
20659,1/7/2013,Egypt,Muqattam,8,0,8,Eight anti-Brotherhood protesters are shot to death by Hamas members.
20660,2/7/2013,Iraq,Baqubah,4,0,4,Terrorists machine-gun four patrons at a cafe.
20661,2/7/2013,Iraq,Baqubah,4,17,21,"A Shahid suicide bomber detonates at a funeral, killing four mourners."
20662,2/7/2013,Iraq,Baghdad,1,0,1,Suspected fundamentalists gun down a barber.
20663,2/7/2013,Iraq,Abu Ghraib,3,6,9,Three Iraqis are obliterated by a car bomb.
20664,2/7/2013,Iraq,Hurriyah,3,13,16,Three people bleed to death following an al-Qaeda bomb blast.
20665,2/7/2013,Iraq,Amiriyah,2,12,14,Terrorists take out two Iraqis with a car bomb.
20666,2/7/2013,Iraq,Dora,4,15,19,Four residents in a neighborhood are shredded by a Sunni bomb.
20667,2/7/2013,Iraq,Kamaliya,5,16,21,Five innocents lose their live to Sunni bombers at a Shia market.
20668,2/7/2013,Iraq,Baghdad,12,38,50,A dozen patrons at an open-air market are blown to bits by Mujahideen bombers.
20669,2/7/2013,Iraq,Baghdad,9,24,33,al-Qaeda car bombers take down nine people in a Shia commercial district.
20670,2/7/2013,Nigeria,Borno,1,0,1,A Pentecostal pastor is gunned down by Boko Haram.
20671,2/7/2013,Afghanistan,Kabul,7,5,12,Suicide truck bombers take out seven people.
20672,3/7/2013,Iraq,Mushahda,2,5,7,Two Iraqis are taken out by an al-Qaeda bomb blast.
20673,3/7/2013,Iraq,Mosul,1,12,13,"al-Qaeda bombers target a wedding, killing the groom."
20674,3/7/2013,Iraq,Mosul,4,12,16,A suicide bomber kills four Iraqis.
20675,4/7/2013,Afghanistan,Sarawza,2,0,2,"Two boys, ages 10 and 12, are torn to shreds by Islamic bombers."
20676,4/7/2013,Pakistan,Dera Ismail Khan,2,0,2,A female health worker and her young sister are shot to death by Islamic extremists.
20677,4/7/2013,Afghanistan,Pashtun Kot,5,2,7,Four women are among five civilians pulled into pieces by a Sunni bomb.
20678,4/7/2013,Afghanistan,Lashkar Gah,1,1,2,A senior policewoman is gunned down by suspected fundamentalists.
20679,4/7/2013,Thailand,Yala,1,1,2,"Muslim terrorists fire on two men driving a car, killing one."
20680,4/7/2013,Afghanistan,Helmand,4,0,4,"Four young girls, ages 7 to 12, are disassembled by a Taliban bomb."
20681,4/7/2013,Iraq,Tuz Khormato,2,19,21,Two people are killed when Sunnis bomb a soccer field.
20682,4/7/2013,Iraq,Baghdad,3,14,17,"Terrorists bomb a teahouse, murdering at least three patrons."
20683,4/7/2013,Iraq,Zafaraniyah,2,0,2,Muslim 'insurgents' gun down a female doctor and a school guard.
20684,4/7/2013,Pakistan,Bowia,5,3,8,Five local soldiers at a check post lose their lives to a Shahid suicide car bomber.
20685,5/7/2013,Iraq,Baghdad,15,32,47,A Sunni suicide bomber manages to take out over fifteen Shia worshippers at their mosque.
20686,5/7/2013,Egypt,Alexandria,1,2,3,Muslim Brotherhood supporters throw a teenager from a rooftop.
20687,5/7/2013,Egypt,Nagaa Hassan,4,4,8,Four Christians are brutally hacked to death by Muslim Brotherhood supporters.
20688,5/7/2013,Iraq,Kut,1,20,21,Muslim radicals plant a bomb at a rival mosque that leaves one dead.
20689,5/7/2013,Egypt,al-Arish,5,0,5,Five guards at an airport are gunned down by Islamists.
20690,5/7/2013,Pakistan,Islamabad,1,0,1,"Islamic fundamentalists attack a local church, shooting one person to death."
20691,5/7/2013,Afghanistan,Uruzgan,12,5,17,A dozen souls in a dining hall are taken out by a Shahid suicide bomber.
20692,5/7/2013,Iraq,Samarrah,7,10,17,"A Shahid suicide bomber detonates near a rival mosque, incinerating four worshippers."
20693,5/7/2013,Afghanistan,Bab-e-Dosti,4,10,14,A Fedayeen suicide bomber murders four other people.
20694,6/7/2013,Dagestan,Kizilyurt,1,1,2,"Islamic militia fire automatic weapons at a group of policemen, killing one."
20695,6/7/2013,Pakistan,Lahore,5,40,45,"Five people, including a child, are blown to bits by Muslim bombers along a busy food street."
20696,6/7/2013,Nigeria,Potsikum,42,6,48,"Islamists massacre over forty students and teachers at a school, in some cases burning children alive."
20697,6/7/2013,Egypt,al-Arish,1,0,1,Islamic gunmen murder a Coptic priest.
20698,6/7/2013,Yemen,Sanaa,3,1,4,al-Qaeda is suspected of planting a bomb that leaves three dead.
20699,6/7/2013,Iraq,Tikrit,5,9,14,Five civilians are wiped out by an al-Qaeda bomb blast near a hospital.
20700,6/7/2013,Iraq,Tikrit,4,1,5,Four Iraqis are killed when Sunni bombers target a judge.
20701,6/7/2013,Iraq,Rashad,4,0,4,Two woman are among four civilians cut down by Mujahid bombers.
20702,6/7/2013,Philippines,Pikit,2,7,9,"Islamists fire into a group of local soldiers, killing at least two."
20703,6/7/2013,Philippines,Datu Piang,3,0,3,The Bangsamoro Islamic Freedom Fighters set off a roadside bomb that leaves three locals soldiers dead.
20704,7/7/2013,Afghanistan,Ghazni,1,4,5,Taliban militants kill a civilian with a bomb.
20705,7/7/2013,India,Bodh Gaya,0,5,5,Two monks are injured when militant Muslims set off nine bombs at a Buddhist temple.
20706,7/7/2013,Egypt,Cairo,10,24,34,Bearded Islamists light into a crowd of 'infidels' with weapons following incitement by a cleric.
20707,7/7/2013,Thailand,Pattani,1,0,1,A Buddhist plantation worker is shot to death on the job by Muslim 'separatists'.
20708,7/7/2013,Bahrain,Sitra,1,5,6,Shiite terrorists detonate a bomb that kills a police officer.
20709,7/7/2013,Iraq,Musayyib,6,1,7,"al-Qaeda gunmen exterminate an entire family, including two children and two elderly parents."
20710,8/7/2013,Iraq,Mosul,1,5,6,A car bomb in a commercial district leaves one dead.
20711,8/7/2013,Iraq,Mosul,2,0,2,Two Iraqis are shot to death by terrorists in separate attacks.
20712,8/7/2013,Iraq,Madain,6,3,9,"Mujahideen bomb a youth center, killing six civilians."
20713,8/7/2013,Pakistan,Hangu,8,10,18,Eight people are blown apart by a Fedayeen suicide bomber.
20714,8/7/2013,Iraq,Tikrit,3,0,3,Three Iraqis are shot to death by al-Qaeda.
20715,8/7/2013,Thailand,Pattani,0,8,8,"Militant Muslims bomb a group of teachers and guards, injuring eight."
20716,8/7/2013,India,Sawjian,1,3,4,Pakistani-backed Mujahideen kill one person with an IED.
20717,8/7/2013,Iraq,Mosul,6,8,14,Three children are among six Iraqis torn to pieces by al-Qaeda bombers.
20718,8/7/2013,Yemen,Hadramawt,1,0,1,al-Qaeda gun down an army officer on his way in to work.
20719,8/7/2013,Pakistan,Swabi,2,0,2,Two bomb disposal team members are killed trying to defuse a bomb terrorists planted at a middle school.
20720,8/7/2013,Pakistan,Karachi,1,0,1,Sipah-e-Sahaba terrorists gun down a Shiite civilian.
20721,9/7/2013,Afghanistan,Kandahar,1,6,7,A Slovakian soldiers is killed by a Taliban terrorist in Afghan uniform.
20722,9/7/2013,Pakistan,Karachi,5,1,6,Five members of a secular political party are shot to death by suspected Taliban.
20723,9/7/2013,Somalia,Mogadishu,1,3,4,One person is killed when an al-Shabaab militants set off a bomb in a crowded marketplace.
20724,9/7/2013,Lebanon,Beirut,0,38,38,Nearly forty people are injured when Sunnis car-bomb a Shia district.
20725,9/7/2013,Egypt,North Sinai,2,6,8,"Islamic extremists fire rockets into a checkpoint, killing two locals."
20726,9/7/2013,Afghanistan,Helmand,3,2,5,"Sunni militants bomb a taxi stand, killing three civilians."
20727,9/7/2013,Afghanistan,Herat,17,0,17,Four children and a dozen women are turned into bloody pulp by Religion of Peace bombers.
20728,9/7/2013,Philippines,Cotabato,1,4,5,Bangsamoro Islamic Freedom Fighters are suspected in a rocket attack on a restaurant.
20729,9/7/2013,Iraq,al-Tarmiyah,1,0,1,A Christian 'infidel' is kidnapped and executed by Muslim terrorists.
20730,10/7/2013,Pakistan,Karachi,3,12,15,Three other people are killed when a suicide bomber walks up to a car and detonates.
20731,10/7/2013,Egypt,Zuwayed,1,0,1,A young girl is killed when Islamists open fire on a car.
20732,10/7/2013,Iraq,Baghdad,3,0,3,al-Qaeda gunmen are suspected of breaking into a home and shooting three women to death.
20733,11/7/2013,Thailand,Songkhla,3,3,6,"Extremists bomb a karaoke shop, killing three."
20734,11/7/2013,Pakistan,Dera Ghazi Khan,1,0,1,A young mother is stoned to death on the orders of a jirga for possessing a cell phone.
20735,11/7/2013,Iraq,Dujail,11,25,36,"Sunnis set off a bomb outside a Shia mosque, killing eleven worshippers outright."
20736,11/7/2013,Iraq,Barwana,14,4,18,Fourteen guards at an oil pipeline are shot to death by Islamic radicals as they are sitting down to dinner.
20737,11/7/2013,Iraq,Muqdadiyah,13,24,37,A Sunni suicide bomber rips apart thirteen mourners at a Shia funeral.
20738,11/7/2013,Iraq,Ramadi,5,0,5,Five local cops are murdered by two suicide bombers.
20739,11/7/2013,Egypt,Zweid,1,0,1,A Christian is found beheaded several days after being kidnapped by Muslim extremists.
20740,11/7/2013,Pakistan,Chaman,7,10,17,"A suicide bomber detonates at a ""friendship"" gate, sending seven others to Allah."
20741,11/7/2013,Pakistan,Kohat,2,7,9,"Muslim terrorists set off a bomb outside a mosque, killing two innocents."
20742,11/7/2013,Afghanistan,Helmand,5,1,6,A vicious double bombing leaves five people dead.
20743,11/7/2013,Iraq,Yathrib,10,18,28,"Mujahideen set off bombs near a coffee shop, sending ten patrons to Allah."
20744,11/7/2013,Iraq,Tuz Khurmatu,10,21,31,Jihad car bombers take out ten people in a residential district.
20745,11/7/2013,Iraq,Fallujah,7,17,24,Seven Iraqis are killed during an attack by Mujahideen.
20746,11/7/2013,Syria,Latakia,1,0,1,al-Qaeda linked rebels kill a senior member of the FSA rebels in cold blood.
20747,12/7/2013,Iraq,Kirkuk,41,35,76,Over forty people at a cafe are torn to pieces when a Holy Warrior yells 'Allah Akbar' and detonates a suicide vest.
20748,12/7/2013,Iraq,Mosul,4,2,6,A suicide bomber takes out four Iraqis.
20749,12/7/2013,Somalia,Mogadishu,7,15,22,Seven civilians lose their lives to a suicide car bomber.
20750,12/7/2013,Egypt,Sinai,1,1,2,"Islamic militants fire a rocket into a checkpoint, killing a policeman."
20751,12/7/2013,Egypt,Dabaaya,4,32,36,"A Muslim bomb attacks a Christian village, burning dozens of homes and killing four Copts."
20752,12/7/2013,Algeria,Khenchla,2,2,4,A journalist is among two people who bleed to death following a fundamentalist bombing attack on a group of friends.
20753,12/7/2013,Somalia,Mogadishu,2,10,12,"al-Shabaab members toss a grenade into a hotel lobby, killing two people."
20754,13/7/2013,Philippines,Guindulungan,2,0,2,"Bangsamoro Islamic Freedom Movement militants ambush a truck carrying soldiers, killing two."
20755,13/7/2013,Iraq,Baghdad,16,31,47,Sixteen people are mosque are disassembled by Religion of Peace rivals.
20756,13/7/2013,Iraq,Baghdad,7,19,26,Seven people are laid out by sectarian bombers at a Sunni worship center.
20757,13/7/2013,Iraq,Baqubah,4,10,14,"A Shahid suicide bomber targets a funeral, killing four people."
20758,13/7/2013,Iraq,Muqdadiyah,2,9,11,Sunnis plant a bomb in a Shia area that leaves two dead.
20759,13/7/2013,Iraq,Madaen,2,7,9,Fundamentalists murder two young people for playing a game during Ramadan.
20760,14/7/2013,Dagestan,Burshi,4,0,4,Islamists four cops sitting in their car.
20761,14/7/2013,Iraq,Baghdad,4,16,20,"Muslim terrorists target a commercial district, killing four innocents."
20762,14/7/2013,Iraq,Musayyib,6,21,27,A half-dozen worshippers at a Shia mosque are sent straight to Allah by Religion of Peace rivals.
20763,14/7/2013,Iraq,Nasiriyah,5,22,27,Five people are torn limb from limb by al-Qaeda bombers at a market.
20764,14/7/2013,Iraq,Karbala,9,22,31,Nine people are killed by a Sunni bomb in a Shia city.
20765,14/7/2013,Iraq,Kut,11,68,79,al-Qaeda bombers take out eleven Iraqis in a car bombing at a shopping district.
20766,14/7/2013,Iraq,Basra,8,15,23,At least eight people bleed out following a Mujahid car bombing.
20767,15/7/2013,Pakistan,Quetta,4,2,6,Four Shia civilians in a car are sprayed with bullets by sectarian Jihadis.
20768,15/7/2013,Syria,Damascus,13,7,20,Over a dozen people are killed by a suspected al-Nusra car bomb.
20769,15/7/2013,Iraq,Kirkuk,3,11,14,A Fedayeen suicide attack is one of two bombings that leave three Iraqis dead.
20770,15/7/2013,Iraq,Samarrah,4,11,15,A 4-year-old boy is among four people blown to bits by Mujahid mortars as they are preparing to swim.
20771,15/7/2013,Egypt,al-Arish,3,17,20,Three cement factory workers die when Islamic militants fire rockets at a bus.
20772,15/7/2013,Bangladesh,Satkhira,1,0,1,Jamaat-e-Islam cadres beat a local man to death.
20773,15/7/2013,Iraq,Mosul,2,6,8,Two other people are reduced to pulp by a Fedayeen suicide bomber.
20774,15/7/2013,Pakistan,Quetta,3,4,7,Three people are killed when a sectarian Jihadi on a motorcycle fires into a shop.
20775,15/7/2013,Pakistan,Quetta,1,0,1,Sipah-e-Sahaba terrorists kidnap and torture to death a former Sunni who converted to Shia.
20776,16/7/2013,Algeria,Tipaza,4,3,7,Four local soldiers are blown to bits by fundamentalist bombers.
20777,16/7/2013,Thailand,Yala,1,0,1,A rubber tapper is gunned down by militant Muslims.
20778,16/7/2013,Yemen,Huj,1,0,1,An accused homosexual is shot to death by al-Qaeda.
20779,16/7/2013,Afghanistan,Nangarhar,2,3,5,Two civilians bleed to death after a Taliban bomb planted on a bicycle detonates.
20780,16/7/2013,Bangladesh,Dinajpur,1,0,1,A 60-year-old bus driver is stoned to death by Jamaat-e-Islam.
20781,16/7/2013,Pakistan,Karachi,2,0,2,Suspected Tehreek-e-Taliban gun down two supporters of a secular party.
20782,16/7/2013,Israel,Jerusalem,0,1,1,An Orthodox Jew is stabbed by two Palestinians.
20783,16/7/2013,Iraq,Muqdadiyah,6,17,23,A half-dozen worshippers at a mosque are sent directly to paradise by Religion of Peace rivals.
20784,16/7/2013,Pakistan,Quetta,3,0,3,A cleric and his brother are among three people assassinated by sectarian rivals while sitting at a kiosk.
20785,17/7/2013,Afghanistan,Herat,1,0,1,Fundamentalists gun down a man outside a public bath.
20786,17/7/2013,Syria,Kanaker,7,6,13,"Seven people, mostly women and children, are disassembled by a Sunni car bomb."
20787,17/7/2013,Lebanon,Sarafand,1,0,1,A prominent leader is murdered by sectarian opponents.
20788,17/7/2013,Iraq,Muqdadiyah,4,0,4,Small children out swimming are among four Iraqis bagged by Mujahideen bombers.
20789,17/7/2013,Egypt,al-Arish,1,0,1,A security guard is murdered by Muslim radicals.
20790,17/7/2013,Somalia,Kismayo,2,3,5,An al-Shabaab bomb leaves two people dead.
20791,17/7/2013,Somalia,Mogadishu,1,0,1,al-Shabaab activists murder a female government official.
20792,17/7/2013,India,Srinagar,1,5,6,One person is killed when a Muslim terrorist throws a grenade into the street.
20793,18/7/2013,Indonesia,Kendal,1,3,4,"An FPI (Islam Defenders Front) member in a car intentionally rams a group of people outside a brothel, killing one."
20794,18/7/2013,Yemen,Saada,2,4,6,Two Shiites are shot to death by Sunnis over a dispute concerning a mosque.
20795,18/7/2013,Sudan,Garsila,1,1,2,Islamic militia murder a school guard.
20796,18/7/2013,Iraq,Baghdad,3,0,3,Fundamentalists break into a home and shoot three women to death on suspected immorality.
20797,18/7/2013,Pakistan,Badan,3,2,5,"Islamic hardliners blow up a van carrying local tribesmen, killing at least three."
20798,18/7/2013,Pakistan,Mamond,2,3,5,Two security personnel are shot to death in their vehicle by Muslim terrorists.
20799,18/7/2013,Iraq,Kirkuk,1,0,1,Holy warriors enter a home and shoot a woman to death.
20800,18/7/2013,Iraq,Baghdad,2,5,7,Two Iraqis are incinerated by a bomb blast.
20801,18/7/2013,Iraq,Wajihiyah,3,0,3,Three young men are tragically cut down by Islamist bombers.
20802,18/7/2013,Iraq,Balad,1,4,5,A farmer is picked off by Religion of Peace snipers.
20803,18/7/2013,Iraq,Dujail,2,0,2,Muslim terrorists gun down a man and his wife on their way to work.
20804,18/7/2013,India,Pampore,2,1,3,Two people are killed when Islamic militants target a heart surgeon.
20805,18/7/2013,Egypt,al-Arish,1,0,1,A man is gunned down outside his home by Islamists.
20806,18/7/2013,Egypt,Sheikh Zuweid,1,2,3,A local policeman bleeds to death after Islamic militants fire into a station.
20807,18/7/2013,Afghanistan,Logar,8,0,8,"Eight civilians are stopped by religious extremists on their way to work, forced to kneel and then summarily shot in the head."
20808,18/7/2013,Iraq,Mosul,7,21,28,A child is among seven people who lose their lives to a Religion of Peace shrapnel bomb at a teahouse.
20809,18/7/2013,Pakistan,Bajaur,2,4,6,Two local soldiers are ambushed and murdered by al-Qaeda linked militants.
20810,18/7/2013,India,Dharam,0,43,43,Angry Muslims riot over an alleged desecration of the Quran.
20811,18/7/2013,Pakistan,Karachi,2,0,2,Two cops are gunned down outside a furniture mart by suspected Islamists.
20812,19/7/2013,India,Salem,1,0,1,A Hindu policeman is hacked to death by Muslim radicals.
20813,19/7/2013,Iraq,Diyala,26,69,95,"Islamists blow up a rival mosque during midday prayers, exterminating at least two dozen worshippers."
20814,19/7/2013,Yemen,Huta,0,1,1,A gay man survives a targeted shooting by fundamentalists with injuries.
20815,19/7/2013,Syria,Damascus,1,0,1,Sunnis target a Shia mosque with a series of rockets that take out the custodian.
20816,19/7/2013,Pakistan,Karachi,1,1,2,Lashkar-e-Jhangvi is thought to be behind the murder of a man in front of his 14-year-old son.
20817,19/7/2013,Iraq,Hillah,1,5,6,A suicide bombing at a mosque leaves one other dead.
20818,19/7/2013,Iraq,Mosul,2,2,4,'Insurgents' kill two women when they fire a mortar into a residential neighborhood.
20819,19/7/2013,Pakistan,Bara,2,0,2,Two local soldiers pitching a tent are blown up by Sunni hardliners.
20820,19/7/2013,Egypt,al-Arish,2,1,3,"Islamic fanatics send a rocket into a family home, blowing the heads off two residents."
20821,19/7/2013,Libya,Benghazi,1,0,1,A man traveling to a funeral is abducted and murdered by suspected Islamists.
20822,19/7/2013,Yemen,Mudia,1,0,1,A man is shot to death by al-Qaeda.
20823,19/7/2013,Iraq,Samarrah,1,11,12,A child is killed when Holy Warriors bomb a soccer field.
20824,19/7/2013,Somalia,Mogadishu,1,0,1,A local doctor is shot to death by al-Shabaab cadres.
20825,19/7/2013,Afghanistan,Helmand,2,2,4,Two people are taken apart by Taliban bombers.
20826,19/7/2013,Afghanistan,Marjah,4,11,15,"Taliban use an IED to kill four people, including children."
20827,19/7/2013,Thailand,Narathiwat,1,1,2,"Muslim 'insurgents' fire on a married couple, killing the man and injuring his wife."
20828,20/7/2013,Pakistan,Karachi,3,0,3,Three people are killed by a Lashkar-e-Jhangvi bomb hidden in fruit.
20829,20/7/2013,Iraq,Baghdad,25,71,96,"A series of al-Qaeda bombs, late in the evening, leave an additional twenty-five Iraqis dead."
20830,20/7/2013,Iraq,Garma,1,2,3,A mother and child are among the casualties of a Mujahideen bomb blast.
20831,20/7/2013,Nigeria,Maiduguri,1,3,4,A young child is trampled during a reported attack by Boko Haram at a mosque.
20832,20/7/2013,Iraq,Baghdad,4,12,16,Four Shiites are blown to bits by a Sunni bomb.
20833,20/7/2013,Iraq,Baghdad,3,11,14,Three people at a bakery are torn to pieces by Sunni bombers.
20834,20/7/2013,Iraq,Zafaraniyah,6,15,21,al-Qaeda bombers send six Iraqis to Allah.
20835,20/7/2013,Iraq,Tobchi,8,29,37,Eight people in a Shiite neighborhood are exterminated by Sunni bombers.
20836,20/7/2013,Iraq,Baghdad,9,17,26,"Jihadis double-bomb a busy shopping district, killing at least nine patrons."
20837,20/7/2013,Iraq,Baqubah,3,0,3,Three Iraqis are shot to death by al-Qaeda.
20838,20/7/2013,Iraq,Mosul,8,35,43,A suicide bombing and several Mujahid shootings leave eight dead.
20839,21/7/2013,Iraq,Taji,4,15,19,Four people at a fish market are cut to shreds by a Religion of Peace shrapnel bomb.
20840,21/7/2013,Pakistan,Karachi,4,7,11,Two Lashkar-e-Jhangvi bombs leave four dead.
20841,21/7/2013,Egypt,al-Arish,3,2,5,Three security personnel are killed in separate attacks by Muslim militants.
20842,21/7/2013,Thailand,Narathiwat,2,0,2,A Buddhist married couple on their way to sell vegetables are ordered off their motorbike by Muslim 'insurgents' and summarily shot in the head.
20843,21/7/2013,Pakistan,Karachi,2,6,8,A Tehreek-e-Taliban bomb outside a secular-leaning political office leaves two dead.
20844,21/7/2013,Iraq,Hillah,1,0,1,An imam is shot to death by Religion of Peace rivals.
20845,21/7/2013,Iraq,Kirkuk,7,0,7,Seven policemen are machine-gunned by Islamists at two checkpoints.
20846,21/7/2013,Iraq,Basmaiya,2,4,6,"Islamic terrorists blow up a family home, killing two."
20847,21/7/2013,Afghanistan,Khost,6,0,6,"The Taliban attack a house, killing six residents."
20848,21/7/2013,Egypt,Sinai,5,11,16,Five people are killed during a series of terror attacks by Hamas-backed militants.
20849,21/7/2013,Egypt,al-Arish,1,0,1,Islamists shoot and kill a 32-year-old man driving a car.
20850,22/7/2013,Pakistan,Quetta,2,0,2,Two Shiite teenagers are shot to death in a taxi by Lashkar-e-Jhangvi.
20851,22/7/2013,Syria,Khan al-Assal,51,0,51,Fifty captured soldiers are executed in cold blood by al-Nusra.
20852,22/7/2013,Iraq,Fallujah,3,1,4,Three people are killed when 'freedom fighters' blow up a policeman's home.
20853,22/7/2013,Iraq,Taji,16,13,29,"al-Qaeda militants attack government building, shooting at least sixteen guards to death."
20854,22/7/2013,Iraq,Abu Ghraib,41,65,106,Forty-one guards and inmates at a prison are killed during a sustained Sunni assault that involved suicide car bombers.
20855,22/7/2013,Pakistan,Chaman,2,8,10,Two people are killed when a mosque is bombed by rival Muslims.
20856,22/7/2013,Iraq,Mosul,25,29,54,Thirteen people are torn to shreds by a Fedayeen suicide car bomber.
20857,22/7/2013,Iraq,Kirkuk,3,0,3,Suspected Sunni terrorists gun down three people.
20858,22/7/2013,Iraq,Madain,2,0,2,A bomb placed along a city street leaves two dead.
20859,22/7/2013,Afghanistan,Zabul,4,1,5,Four Afghans are sent to paradise by fundamentalist bombers.
20860,22/7/2013,Nigeria,Darazo,2,2,4,A child is among two people murdered by Boko Haram gunmen.
20861,23/7/2013,Algeria,Bouira,2,0,2,Fundamentalists kill two forest rangers with a planted bomb.
20862,23/7/2013,Philippines,Maguindanao,1,1,2,A child dies from splinter injuries after Moro Islamists toss a grenade into the street.
20863,23/7/2013,Thailand,Narathiwat,2,0,2,A Buddhist couple is shot to death by Muslim 'separatists' in front of their 4-year-old son.
20864,23/7/2013,Afghanistan,Wardak,8,5,13,A suicide bomber on a donkey kills eight other people.
20865,23/7/2013,Thailand,Pattani,1,1,2,A shop owner is gunned down in the middle of the night by suspected Muslim 'insurgents'.
20866,23/7/2013,Syria,Homs,1,19,20,A woman is killed when Ahrar al-Sham rocket a group of cars.
20867,23/7/2013,Thailand,Narathiwat,2,1,3,Two people are machine-gunned at a coffee shop by suspected Muslim 'rebels'.
20868,23/7/2013,Iraq,Baghdad,6,28,34,A half-dozen people at a restaurant are taken out in mid-bite by Islamic bombers.
20869,23/7/2013,Iraq,Baghdad,3,15,18,Hardline bombers target a rival mosque with a bomb that leaves three dead.
20870,23/7/2013,Iraq,Kirkuk,7,41,48,Seven worshippers at a mosque are sent to Allah by sectarian bombers.
20871,23/7/2013,Iraq,Kut,2,9,11,Two people at a mosque are brought down by rival bombers.
20872,23/7/2013,Iraq,Mosul,3,0,3,Three civilians are gunned down at a sheep market by Muslim 'insurgents'.
20873,23/7/2013,Iraq,Kirkuk,4,1,5,al-Qaeda terrorists kill four Iraqis in separate shooting attacks.
20874,23/7/2013,Iraq,Nineveh,4,0,4,Four local cops are kidnapped and murdered by al-Qaeda.
20875,24/7/2013,Iraq,Tikrit,4,4,8,"Religious radicals fire into a van carrying off-duty soldiers, killing four."
20876,24/7/2013,Iraq,Baghdad,4,10,14,"Mujahid bombers strike at a food fair, killing four patrons."
20877,24/7/2013,Iraq,Tuz Khormato,15,41,56,Fifteen people are massacred by al-Qaeda bombers at a market.
20878,24/7/2013,Egypt,Mansura,1,28,29,"Brotherhood supporters bomb a police station, killing one person."
20879,24/7/2013,Iraq,Sulaiman Pek,14,0,14,Fourteen Shiite truck drivers are summarily executed by Sunnis who first verified their religious status.
20880,24/7/2013,Pakistan,Sukkur,4,40,44,Five suicide car bombers manage to kill four other persons outside a government building.
20881,24/7/2013,Iraq,Shura,9,2,11,Nine Iraqi policemen are brutally machine-gunned at their post by Sunni Islamists.
20882,24/7/2013,Egypt,al-Arish,2,0,2,Two local soldiers are killed in separate shootings by Hamas-backed militants.
20883,24/7/2013,Somalia,Mogadishu,1,7,8,A civilian bleeds to death following an al-Shabaab car bombing.
20884,24/7/2013,Thailand,Narathiwat,3,2,5,"'Islamo-Socialists' detonate a bomb outside a hospital as a group of teachers pass by, killing two women and one man."
20885,24/7/2013,Dagestan,Derbent,0,1,1,A rabbi is shot at close range by dedicated Islamists.
20886,25/7/2013,Pakistan,Karachi,1,0,1,A 22-year-old Shiite is shot to death by Lashkar-e-Jhagvi.
20887,25/7/2013,Afghanistan,Kunduz,3,4,7,A Taliban shrapnel bomb takes the lives of three Afghans.
20888,25/7/2013,Pakistan,Karachi,1,0,1,"Islamists attack a rival mosque, killing a guard."
20889,25/7/2013,Iraq,Samarrah,2,2,4,Two Iraqis are murdered by al-Qaeda militants.
20890,25/7/2013,Iraq,Madaen,8,18,26,al-Qaeda bombers dismantle eight patrons at a popular coffee shop.
20891,25/7/2013,Iraq,Muqdadiya,14,8,22,Fourteen people at a busy outdoor market are pulled into pieces by Mujahid car bombers.
20892,25/7/2013,Pakistan,Upper Dir,2,0,2,A young couple is honor killed by her conservative Muslim family for marrying without permission.
20893,25/7/2013,Egypt,Sinai,2,4,6,Hamas-backed gunmen exterminate two Egyptian security guards.
20894,25/7/2013,Iraq,Baghdad,16,20,36,Sixteen diners at a restaurant are ripped to shreds by an Islamist bomb blast.
20895,25/7/2013,Iraq,Baghdad,2,6,8,Two people at an Internet cafe are slain by fundamentalist bombers .
20896,25/7/2013,Iraq,Baghdad,3,16,19,Women and children are among the casualties of a Mujahideen bomb blast at a wedding.
20897,25/7/2013,Iraq,Baghdad,4,0,4,Two street cleaners are among four people shot to death by Muslim terrorists in random attacks.
20898,25/7/2013,Afghanistan,Jowzjan,2,10,12,A bomb planted by Muslim fundamentalists leaves two dead.
20899,25/7/2013,Israel,Jerusalem,0,15,15,A baby is among fifteen Jewish civilians injured by Arab rock throwers at an overpass.
20900,25/7/2013,Syria,Damascus,17,70,87,An al-Qaeda linked organization claims credit for a car bombing in a Shia neighborhood that leaves seventeen residents dead.
20901,25/7/2013,Tunisia,Tunis,1,0,1,An Islamist riddles a critic's body with bullets in front of his wife and children.
20902,26/7/2013,Thailand,Yala,1,0,1,A teacher is shot to death by suspected 'insurgents'.
20903,26/7/2013,Pakistan,Parachinar,57,167,224,A barbaric double suicide bombing at a Shiite market by assailants shouting praises to Allah leaves fifty-seven dead.
20904,26/7/2013,Pakistan,Parachinar,2,6,8,A landmine planted by religious radicals leaves two dead and six others with lost limbs.
20905,26/7/2013,Pakistan,Karachi,1,0,1,The Tehreek-e-Taliban shoot a political activist to death.
20906,26/7/2013,Pakistan,Orangi,1,0,1,An elderly faith healer is murdered by suspected fundamentalists.
20907,26/7/2013,Yemen,Aden,1,0,1,al-Qaeda gun down a man outside his home.
20908,26/7/2013,Nigeria,Mainok,1,1,2,A teen dies after being shot in the chest by Boko Haram.
20909,26/7/2013,Afghanistan,Farah,5,0,5,Five truck drivers are reportedly killed by Sunni militants.
20910,26/7/2013,Afghanistan,Qarabagh,7,7,14,Seven people are sent to Allah by a Shahid suicide bomber.
20911,26/7/2013,Philippines,Cagayan de Oro,8,47,55,"Khilafa Islamiyah Mindanao terrorists stage a brutal shrapnel bombing at a medical convention which leaves eight dead, including doctors."
20912,27/7/2013,Pakistan,Okara,1,0,1,A Christian is beaten and executed in front of his children by Islamic gunmen.
20913,27/7/2013,Nigeria,Dawashe,20,12,32,"Boko Haram Islamists open fire on a village, killing twenty fishermen and traders."
20914,27/7/2013,Pakistan,Mattani,1,4,5,"A rocket fired during a Mujahideen attack lands on a house, killing a 15-year-old boy."
20915,27/7/2013,Somalia,Mogadishu,3,9,12,"A Fedayeen suicide car bomber rams into a building housing hospital workers, killing three civilians."
20916,27/7/2013,Iraq,Baghdad,3,4,7,"Religion of Peace bombers target a cafe filled with young people, killing at least three."
20917,27/7/2013,Iraq,Diyala,2,0,2,A farmer and a doctor are murdered in separate Muslim terror attacks.
20918,27/7/2013,Iraq,Baaj,1,0,1,A Muslim extremist stabs a woman to death inside her home.
20919,28/7/2013,Iraq,Tuz Khurmatu,8,9,17,Eight Kurds are taken out by a Sunni suicide bomber.
20920,28/7/2013,Pakistan,Kurram,2,2,4,Two civilians are blown to bits by a Taliban landmine.
20921,28/7/2013,Syria,Homs,3,3,6,Woman and children are among the victims of a Sunni car bomb.
20922,28/7/2013,Iraq,Baghdad,3,9,12,Three commuters are dismantled by a Mujahid minibus bomb.
20923,28/7/2013,India,Sopore,1,0,1,Hizb-ul-Mujahideen gunmen assassinate a local cop.
20924,28/7/2013,Afghanistan,Shahjoy,9,15,24,"Nine locals, mostly women and children, are ripped apart by a Taliban bomb blast."
20925,29/7/2013,Syria,Raqqa,1,0,1,An Italian priest is kidnapped and reportedly shot 14 times by an al-Qaeda linked group.
20926,29/7/2013,Tunisia,Jebel Chaambi,8,0,8,"Eight local soldiers are ambushed, captured and beheaded by al-Qaeda."
20927,29/7/2013,Nigeria,Kano,45,15,60,Forty-five people lose their lives to Islamist bombers targeting Christian districts and churches.
20928,29/7/2013,Iraq,Baghdad,32,129,161,Fifteen al-Qaeda bombs planted in Shia districts leave over thirty dead.
20929,29/7/2013,Pakistan,Dera Ismail Khan,14,30,44,"Fedayeen shouting 'Allah Akbar' attack a prison, killing guards and beheading Shiite prisoners."
20930,29/7/2013,Iraq,Sadr City,9,33,42,Two separate bomb attacks on a Shia neighborhood leave nine dead.
20931,29/7/2013,Afghanistan,Spin Boldak,3,0,3,A mother and her two children are exterminated by a fundamentalist bomb blast.
20932,29/7/2013,Iraq,Samawa,6,19,25,A half-dozen people at a Shia market are laid out by a Sunni shrapnel bomb.
20933,29/7/2013,Iraq,Kut,10,40,50,"Islamists bomb a market and construction site, sending at least ten innocents to their deaths."
20934,29/7/2013,Iraq,Tikrit,7,7,14,A series of Mujahideen attacks produce six dead Iraqis.
20935,29/7/2013,Iraq,Madaen,3,9,12,A Sunni landmine along a road traveled by Shiites leaves three dead.
20936,29/7/2013,Iraq,Khamsa Mile,4,14,18,al-Qaeda bombers take out four people at a commercial district.
20937,29/7/2013,Libya,Benghazi,1,3,4,Suspected Ansar al-Sharia set off a car bomb that leaves one dead.
20938,29/7/2013,Egypt,al-Arish,5,0,5,Five security personnel are killed by Hamas-backed terrorists in a span of 36 hours.
20939,30/7/2013,Iraq,Baghdad,7,20,27,Seven worshippers are sent to Allah in their own mosque by a Fedayeen suicide bomber.
20940,30/7/2013,Syria,Homs,11,26,37,A child is among those killed when Sunni terrorists send rockets into a Shia neighborhood.
20941,30/7/2013,Iraq,Tikrit,3,10,13,A Fedayeen suicide bomber and a separate small arms attack leave three Iraqis dead.
20942,30/7/2013,Iraq,Baghdad,7,19,26,Seven Iraqis are killed in a series of Mujahideen attacks.
20943,30/7/2013,Iraq,Tuz Khormato,4,14,18,Four people near at a mosque are sent to Allah by Religion of Peace rivals.
20944,30/7/2013,Iraq,Baqubah,8,20,28,al-Qaeda bombers murder eight young people at a popular shop.
20945,30/7/2013,Pakistan,Darra Adamkhel,2,4,6,"Taliban attack a local checkpoint, killing two defense personnel."
20946,30/7/2013,Pakistan,Pishin,2,0,2,Islamic fundamentalists murder two people guarding a team of polio workers.
20947,30/7/2013,Syria,Qamishli,1,0,1,The Islamic State of Iraq is blamed for the car bomb assassination of a politician in Syria.
20948,30/7/2013,Pakistan,Karachi,2,0,2,Sipah-e-Sahaba gun down two Shia civilians.
20949,30/7/2013,Pakistan,Punjab,1,0,1,A man shoots his own brother to death for leaving Sunni Islam.
20950,31/7/2013,Syria,Damascus,6,19,25,Six civilians bleed to death following a suspected al-Nusra rocket attack.
20951,31/7/2013,Afghanistan,Almar,3,2,5,Three Afghans are killed by a Shahid suicide bomber.
20952,31/7/2013,Iraq,Mosul,2,25,27,A suicide bombing is one of several Mujahid attacks that leave two others dead.
20953,31/7/2013,Iraq,Tuz Khormato,4,4,8,"Dedicated Sunnis bomb a Shiite mosque, killing four worshippers."
20954,31/7/2013,Iraq,Nahrawan,2,3,5,Two farmers are shot to death in the back of their truck by Muslim 'insurgents'.
20955,31/7/2013,Iraq,Hawija,3,0,3,Three civilians are ambushed and murdered by al-Qaeda.
20956,31/7/2013,Iraq,Mosul,5,4,9,Five Iraqi policemen are shot to death by al-Qaeda.
20957,31/7/2013,Iraq,Ur,5,9,14,Sunni gunmen drive through a Shiite district and spray pedestrians with bullets.
20958,1/8/2013,Afghanistan,Maiwand,7,3,10,Religion of Peace bombers take down seven members of the same family.
20959,1/8/2013,Pakistan,Peshawar,2,0,2,Two people are shot to death by Islamic radicals.
20960,1/8/2013,Iraq,Mosul,21,30,51,Twenty-one Iraqis are killed in a series of Mujahideen shootings and suicide bombings.
20961,1/8/2013,Pakistan,Karachi,3,1,4,Three activists of a secular political party are shot to death by suspected Taliban.
20962,1/8/2013,Pakistan,Benazirabad,1,0,1,Radicals shoot a cleric to death for preaching sectarian peace and tolerance.
20963,1/8/2013,Thailand,Yala,2,5,7,Muslim militants kill two local policemen providing security for teachers.
20964,1/8/2013,Nigeria,Biu,8,0,8,A college lecturer is among eight people slaughtered by pro-Sharia advocates.
20965,1/8/2013,Syria,Homs,40,120,160,A series of rocket attacks by the al-Haq Brigade on residential neighborhoods leave over forty dead.
20966,1/8/2013,Afghanistan,Badghis,1,2,3,"Taliban militants spray a police checkpoint with bullets, killing at least one person."
20967,1/8/2013,Pakistan,Lahore,1,0,1,Deobandi terrorists decapitate a Shiite on video.
20968,2/8/2013,Syria,Tal Abyad,450,0,450,Over one-hundred children are among four-hundred and fifty Kurdish civilians massacred over a four-day stretch by the Jabhat al-Nusra Front.
20969,2/8/2013,Iraq,Shora,4,0,4,An al-Qaeda bomb produces four dead Iraqis.
20970,2/8/2013,Afghanistan,Sherzad,22,12,34,The lives of twenty-two local cops are lost to a Taliban attack.
20971,2/8/2013,Pakistan,Bahawalpur,2,0,2,A cleric and his teen son are murdered by Sunni gunmen simply because they are Shia.
20972,3/8/2013,CAR,Bozoum,15,24,39,A baby is among at least fifteen Christian refugees massacred by the Seleka Islamic militia.
20973,3/8/2013,Dagestan,Makhachkala,1,0,1,Islamists gun down a rival cleric as he is getting out of his car.
20974,3/8/2013,Iraq,Baghdad,3,10,13,Sunni extremists set off a bomb outside a market that kills three shoppers.
20975,3/8/2013,Iraq,Tikrit,2,0,2,An 11-year-old boy and his father are reduced to pulp by an Islamist bomb.
20976,3/8/2013,Iraq,Baqubah,4,5,9,"Mujahideen kill four people in separate attacks, including two brothers."
20977,3/8/2013,Iraq,Baqubah,3,0,3,A woman and her two daughters are brutally murdered in their home by al-Qaeda.
20978,3/8/2013,Afghanistan,Jalalabad,9,24,33,Children are among nine killed by three Fedayeen suicide bombers outside the Indian consulate.
20979,3/8/2013,Pakistan,Karachi,1,0,1,Sipah-e-Sahaba snipers pick off a 30-year-old Shiite.
20980,3/8/2013,India,Kupwara,1,0,1,Islamic militants shoot a local soldier to death.
20981,3/8/2013,Iraq,Muqdadiya,2,0,2,A mosque official is taken out by a car bomb planted by co-religionists.
20982,3/8/2013,Iraq,Baqubah,9,11,20,Sunni bombers take down nine Iraqis.
20983,4/8/2013,Syria,Latakia,8,1,9,"Two babies are shot in the stomach by al-Nusra, who also murder four other children and their parents."
20984,4/8/2013,Syria,Bremseh,15,1,16,Fifteen members of the same Alawite family are machine-gunned by al-Nusra.
20985,4/8/2013,Syria,Aramo,6,1,7,"Dedicated Sunnis slit the throats of six Shia family members, including four children."
20986,4/8/2013,Syria,Abu Makkeh,4,1,5,Four members of a family are massacred by gunmen screaming praises to Allah.
20987,4/8/2013,Syria,Blouta,12,0,12,"A dozen people, mostly members of the same family are shot in their own homes by devout Sunnis."
20988,4/8/2013,Syria,Sleibeh,28,0,28,al-Nusra terrorists slit the throats of twenty-eight people.
20989,4/8/2013,Syria,al-Hamboushieh,18,0,18,Eighteen innocent civilians are shot or stabbed to death for being Alawite.
20990,4/8/2013,Syria,Nbeiteh,25,0,25,"Twenty-five residents, including women and children, are murdered by al-Nusra."
20991,4/8/2013,Syria,Barouda,18,0,18,Eight women and two children are among eighteen family members slaughtered by Islamists.
20992,4/8/2013,Syria,Latakia,56,0,56,Fifty-six villagers are summarily executed by Sunni hardliners for belonging to the Alawite sect.
20993,4/8/2013,Afghanistan,Logar,2,2,4,Religious extremists kill two civilians with a remote-controlled bomb.
20994,4/8/2013,Nigeria,Malumfatori,19,2,21,At least nineteen policemen are killed in two Boko Haram attacks.
20995,4/8/2013,Iraq,Baghdad,19,28,47,Nineteen Iraqis are killed in various Mujahideen attacks.
20996,4/8/2013,Syria,Damascus,5,1,6,"Sunni terrorists enter a home and murder five family member, including three children."
20997,4/8/2013,Afghanistan,Jalalabad,0,16,16,The Haqqani network is suspected of a bomb blast along a city street.
20998,4/8/2013,Germany,Brandenburg,1,2,3,"Islamists beat an unmarried couple, causing the woman to lose her baby."
20999,4/8/2013,Tunisia,Mount Chaambi,1,7,8,Fundamentalists kill a local soldier with a roadside bomb.
21000,5/8/2013,Thailand,Pattani,1,0,1,A pro-peace imam is gunned down at a local market by suspected Barisan Revolusi Nasional.
21001,5/8/2013,Afghanistan,Kandahar,4,10,14,Religious radicals hide a bomb in a donkey cart that takes the lives of four civilians.
21002,5/8/2013,Indonesia,Jakarta,0,3,3,Muslim radicals bomb a Buddhist monastery.
21003,5/8/2013,Egypt,al-Arish,1,2,3,Islamists murder a local cop.
21004,5/8/2013,Philippines,Cotabato,8,27,35,"Bangsamoro Islamic Freedom Fighters detonate a bomb in a busy commercial district, killing at least eight innocents."
21005,5/8/2013,Thailand,Narathiwat,11,0,11,Eleven people are reported killed by Muslim 'separatists'.
21006,5/8/2013,Iraq,Maqdadiyah,2,0,2,Two family members are gunned down by al-Qaeda.
21007,5/8/2013,Iraq,Hawija,2,0,2,al-Qaeda gunmen kill two men.
21008,5/8/2013,Iraq,Mosul,10,8,18,A series of al-Qaeda attacks leaves ten dead.
21009,5/8/2013,Nigeria,Gamboru Ngala,20,0,20,Twenty people are reported killed during a Boko Haram assault on a village.
21010,5/8/2013,Iraq,Baghdad,4,21,25,Four people lining up outside a Shia bakery are blown to bits by Sunni bombers.
21011,5/8/2013,Iraq,Tal Afar,4,19,23,A Mujahideen car bomb takes out four Iraqis.
21012,5/8/2013,Pakistan,Punjab,1,14,15,"A bomb planted by suspected Taliban goes off on a train, killing a toddler."
21013,5/8/2013,Syria,Latakia,32,10,42,A suicide car bombing by Sunni Islamists reportedly kills nearly three dozen local soldiers.
21014,6/8/2013,Syria,Jaramana,18,56,74,Islamists set off a powerful car bomb in a Christian suburb.  At least eighteen people are slain.
21015,6/8/2013,Syria,Tal Abyad,3,0,3,Video emerges of al-Nusra members burning three people alive.
21016,6/8/2013,India,Poonch,5,1,6,Five Indian soldiers are ambushed and shot to death by Pakistani terrorists.
21017,6/8/2013,Algeria,Azeffoun,3,0,3,Islamists shoot three policemen to death outside a hospital.
21018,6/8/2013,Pakistan,Diamer,3,0,3,Junudul Hafsa terrorists murder three people investigating an earlier attack on a group of mountain climbers.
21019,6/8/2013,Pakistan,Kashmore,3,1,4,Two children are among three people tragically cut down by an Islamist bomb.
21020,6/8/2013,Iraq,Anbakiya,10,15,25,Ten villagers are ripped apart by an al-Qaeda shrapnel bomb.
21021,6/8/2013,Iraq,Baghdad,5,16,21,Five people at an ice cream shop are taken out by Holy Warriors.
21022,6/8/2013,Iraq,Baghdad,9,30,39,Two al-Qaeda car bombs snuff out the lives of nine innocents.
21023,6/8/2013,Iraq,Nahrawan,8,21,29,Eight people bleed to death when Islamic terrorists bomb a popular Shiite market.
21024,6/8/2013,Iraq,Baghdad,5,21,26,Jihadis set off a bomb at a public square that leaves five dead.
21025,6/8/2013,Egypt,Souhag,1,3,4,"Muslims attack a store owned by a Coptic family, shooting three members and kidnapping a fourth."
21026,6/8/2013,USA,"Richmond, CA",1,0,1,"A Muslim convert ""on a mission from Allah"" stabs a store clerk to death."
21027,6/8/2013,Egypt,Ain Shams,1,0,1,A 10-year-old Christian girl is shot through the heart in front of her church by pro-Muslim Brotherhood activists.
21028,7/8/2013,Pakistan,Mastung,3,11,14,Muslim terrorists are suspected of a blast in a shopping district that leaves two children and a woman dead.
21029,7/8/2013,Afghanistan,Ghazni,2,1,3,"Religious hardliners attack a female senator, killing her young daughter and bodyguard."
21030,7/8/2013,Egypt,al-Arish,1,0,1,Islamists assassinate a local politician.
21031,7/8/2013,Indonesia,Ciputat,1,0,1,A policeman is shot in the back of the head by an Abu Roban Jihadist.
21032,7/8/2013,Pakistan,Karachi,11,24,35,A pro-Sharia group is thought responsible for a brutal bomb attack at a soccer field that kills mostly children.
21033,7/8/2013,Tanzania,Zanzibar,0,2,2,Two teenage charity workers from Britain have acid thrown on them.
21034,7/8/2013,Iraq,Mosul,5,8,13,A young girl is among five Iraqis murdered by Muslim terrorists.
21035,7/8/2013,Iraq,Ramadi,2,0,2,Two women are exterminated by a Mujahid bomb outside their home.
21036,7/8/2013,Iraq,Tikrit,13,30,43,"'Freedom Fighters' storm a police officer's home and massacre his entire family, including children."
21037,7/8/2013,Dagestan,Makhachkala,0,16,16,Fundamentalists set off bombs and attack stores selling alcohol during Ramadan.
21038,7/8/2013,Iraq,Tikrit,1,0,1,A devout Muslim gathers others to his own brother's house where they murder him.
21039,8/8/2013,Pakistan,Quetta,38,60,98,Forty people at a funeral are sent to Allah by a Fedayeen suicide bomber.
21040,8/8/2013,Afghanistan,Nangarhar,14,4,18,Fourteen women and children are pulled into pieces by Taliban bombers during a visit to a cemetery.
21041,8/8/2013,Dagestan,Khasavyurt,1,0,1,Islamists shoot a police officer to death in his car.
21042,8/8/2013,Iraq,Ramaid,1,1,2,Muslim terrorists plant a bomb that kills a woman and severely injures her husband.
21043,9/8/2013,Iraq,Baji,2,2,4,Two people are cut down by al-Qaeda gunmen.
21044,9/8/2013,Pakistan,Islamabad,1,3,4,A suicide bomber kills a guard outside a rival mosque.
21045,9/8/2013,Afghanistan,Kabul,3,2,5,Three Chinese prostitutes are murdered in a targeted attack by fundamentalists.
21046,10/8/2013,Iraq,Baghdad,4,16,20,Two children are among four innocents shredded by a Mujahid shrapnel bomb.
21047,10/8/2013,Afghanistan,Dawlat Abad,4,0,4,Four local cops are blown to bits in their car by Taliban bombers.
21048,10/8/2013,Iraq,Tuz Khurmato,10,45,55,Ten people are ripped apart by a Fedayeen suicide bomber.
21049,10/8/2013,Pakistan,Jarwar,2,0,2,A conservative family executes a member and her alleged lover on suspicion of adultery.
21050,10/8/2013,Iraq,Fallujah,2,4,6,A Shahid suicide bomber sends two others to Allah.
21051,10/8/2013,Iraq,Madaen,1,3,4,"Fundamentalists detonate a bomb at a video arcade, killing an 8-year-old boy."
21052,10/8/2013,Iraq,Dhi Qar,4,18,22,Four people bleed to death following a Religion of Peace car bombing.
21053,10/8/2013,Iraq,Karbala,5,11,16,Sunni car bombers murder five people at a cafe in a Shiite city.
21054,10/8/2013,Iraq,Nasariya,4,67,71,Three Mujahideen bombings leave four dead.
21055,10/8/2013,Iraq,Baghdad,12,64,76,A series of small bombs around the capital leave at least a dozen dead.
21056,10/8/2013,Iraq,Baghdad,5,14,19,"Sunnis bomb a car market, killing five patrons."
21057,10/8/2013,Iraq,Doura,5,15,20,Militant Islamists kill five Iraqis simply walking down the street.
21058,10/8/2013,Iraq,Baghdad,3,16,19,Three innocents lose their lives to an al-Qaeda bomb at a parking lot.
21059,10/8/2013,Iraq,Baghdad,6,15,21,Religion of Peace bombers murder six Iraqis.
21060,10/8/2013,Iraq,Hussainiya,7,15,22,Seven people are brought down by an al-Qaeda shrapnel bomb at a restaurant in a Shia neighborhood.
21061,10/8/2013,Iraq,Baghdad,7,20,27,al-Qaeda bombers kill seven people at an outdoor market.
21062,11/8/2013,Yemen,Balhaf,5,0,5,Five guards at a gas plant are shot point-blank by al-Qaeda members.
21063,11/8/2013,Nigeria,Ngom,12,0,12,At least a dozen villagers are massacred by Boko Haram Islamists.
21064,11/8/2013,Nigeria,Konduga,44,26,70,Forty-four people praying at a mosque are machine-gunned by Religion of Peace hardliners.
21065,11/8/2013,Pakistan,Karachi,3,1,4,A 12-year-old girl is among three Shiites shot to death on the basis of their sectarian status.
21066,11/8/2013,Afghanistan,Uruzgan,5,2,7,Three women and a child are among five civilians exterminated by Taliban bombers.
21067,12/8/2013,Syria,Qusayr,1,0,1,"A young Christian girl is reportedly raped, torture and murdered by Jihadis."
21068,12/8/2013,Iraq,Balad,24,18,42,Two dozen people at a crowded cafe are torn to shreds apart by a Holy Warrior with a suicide vest.
21069,12/8/2013,Iraq,Baqubah,4,20,24,"Mujahideen bomb a marketplace, killing four patrons."
21070,12/8/2013,Iraq,Muqdadiyah,6,24,30,Children are among the casualties of a Religion of Peace bomb blast at a playground and soccer field.
21071,13/8/2013,Iraq,Madain,5,13,18,Five Shiites are sent straight to Allah outside their mosque by Sunni bombers.
21072,13/8/2013,Pakistan,Karachi,2,28,30,"Religious radicals toss a hand grenade into a group of Ismaili religious minorities, killing a mother and 4-year-old boy."
21073,13/8/2013,Thailand,Narathiwat,1,15,16,A policeman is killed by Muslim bombers.
21074,13/8/2013,Iraq,Mosul,24,27,51,A suicide bombing is among a series of Jihad attacks that produce about two dozen dead Iraqis.
21075,13/8/2013,Israel,Jerusalem,1,0,1,A 17-year-old woman is burned alive by her conservative Muslim father for having 'Facebook' relationships.
21076,13/8/2013,Iraq,Nineveh,2,0,2,Terrorists gun down two Iraqis.
21077,14/8/2013,Egypt,Kerdasa,15,0,15,Fifteen cops are killed and mutilated when Brotherhood supporters storm a police station.
21078,14/8/2013,Syria,Aleppo,2,0,2,Video surfaces of two children being executed to cries of 'Allah Akbar'.
21079,14/8/2013,Pakistan,Jaranwala,2,0,2,A young couple is shot to death by the girl's conservative family for marrying by choice.
21080,14/8/2013,Afghanistan,Ghazni,8,0,8,Eight civilians are pulled off a bus by Sunni fundamentalists and summarily executed.
21081,14/8/2013,Iraq,Baqubah,14,26,40,"al-Qaeda militants detonate two bombs, one at a cafe and the other at an ice cream shop, which leave fourteen dead."
21082,14/8/2013,Syria,Raqqa,1,0,1,An Italian priest is kidnapped and murdered by Islamists.
21083,15/8/2013,Egypt,Minya,2,48,50,Two Copts are killed and dozens more injured when Muslim Brotherhood supporters go on a church-burning rampage.
21084,15/8/2013,Iraq,Baghdad,8,43,51,A series of Mujahideen attacks leave at least eight more dead Iraqis.
21085,15/8/2013,Iraq,Dujail,2,4,6,"A bomb attack on a family vehicle leaves a mother and son dead, and four other members injured."
21086,15/8/2013,Iraq,Baghdad,5,13,18,A Sunni car bomb blast in a Shiite area leaves five dead.
21087,15/8/2013,Iraq,Baghdad,6,13,19,Six day laborers are ripped to pieces by al-Qaeda bombers.
21088,15/8/2013,Iraq,Baladiyat,7,15,22,Terrorists take down seven Iraqis in a sustained attack.
21089,15/8/2013,Iraq,Kadhimiya,8,18,26,"An al-Qaeda car bomb explodes near a bus station in a Shiite area, killing eight."
21090,15/8/2013,Lebanon,Beirut,27,336,363,Twenty-five people in a Shiite neighborhood are incinerated by a Brigades of Aisha suicide bomber.
21091,15/8/2013,Egypt,al-Arish,7,0,7,Seven local police officers are machine-gunned at a checkpoint by Sinai Islamists.
21092,15/8/2013,Nigeria,Damboa,11,0,11,Eleven villagers are slaughtered by Boko Haram Islamists.
21093,16/8/2013,Indonesia,Tangerang,1,0,1,A police officer is fatally shot by members of the Islamic Defenders Front.
21094,16/8/2013,Egypt,Alexandria,1,0,1,Muslim radicals pull a Christian taxi driver out of his cab and decapitate him.
21095,16/8/2013,Pakistan,Shujabad,1,0,1,A 12-year-old girl is chopped into pieces after disobeying her father's order to marry a man of his choice.
21096,16/8/2013,Pakistan,Peshawar,1,0,1,Fundamentalists enter a female politician's home and shoot her in the head.
21097,16/8/2013,Thailand,Narathiwat,4,0,4,A vicious bombing and shooting attack in front of a nursery school leaves four guards dead.
21098,16/8/2013,Pakistan,Swabi,2,4,6,Taliban militants ambush a police van and shoot two officers to death.
21099,16/8/2013,Afghanistan,Sangin,3,0,3,Three women are dismantled by a Taliban roadside bomb.
21100,16/8/2013,Afghanistan,Kandahar,0,16,16,Women are among the casualties of a Shahid suicide bombing.
21101,16/8/2013,Iraq,Buhruz,2,7,9,Mujahideen kill two people with a bomb hidden on a minibus.
21102,16/8/2013,Iraq,Muqdadiyah,1,0,1,al-Qaeda militants enter a home and shoot a father to death in front of his family.
21103,16/8/2013,Iraq,Baghdad,4,14,18,A bomb blast in a Shiite neighborhood leaves four dead.
21104,16/8/2013,Afghanistan,Herat,10,0,10,Ten construction workers are machine-gunned in their tents by Islamic radicals.
21105,16/8/2013,China,Turpan,1,0,1,"A pro-government imam, age 74, is stabbed to death by Muslim extremists."
21106,17/8/2013,Syria,Homs,6,0,6,Six Christians are murdered by Sunni terrorists.
21107,17/8/2013,Syria,Ras al-Ain,2,0,2,Two ambulance drivers are shot to death by al-Nusra.
21108,17/8/2013,Kenya,Garissa,4,0,4,Four policemen are shot dead by al-Shabaab.
21109,17/8/2013,Afghanistan,Farah,2,3,5,"A suicide bomber detonates inside a hospital, taking two civilians with him."
21110,17/8/2013,Afghanistan,Marjah,5,0,5,Three children and a woman are among a family of five pulled into pieces by a Religion of Peace bomb blast.
21111,17/8/2013,Egypt,Sohag,1,0,1,A civilian is killed while trying to defend a church from the Muslim Brotherhood.
21112,17/8/2013,Egypt,Minya,0,1,1,A Copt survives a brutal stabbing by Muslims while trying to put out a fire at a church.
21113,17/8/2013,Pakistan,Karachi,1,0,1,A Shia civilian dies of injuries days after being assaulted by Sipah-e-Sahaba.
21114,17/8/2013,Syria,al-Hasn,15,24,39,Fifteen Christian villagers are reportedly massacred by Sunni terrorists.
21115,17/8/2013,Somalia,Mogadishu,1,0,1,A journalist is assassinated by suspected al-Shabaab.
21116,18/8/2013,Egypt,Minya,2,0,2,Islamists butcher two security guards on a boat owned by Christians.
21117,18/8/2013,Egypt,Sharquiya,1,10,11,"Members of the al-Jihad Islamic group open fire on police officers, killing one."
21118,18/8/2013,Afghanistan,Ghazni,2,3,5,The Taliban murder two local cops with a roadside bomb.
21119,18/8/2013,Iraq,Muqdadiyah,1,0,1,A teacher is laid out by an 'insurgent' bomb.
21120,18/8/2013,Iraq,Kirkuk,1,0,1,"A government employee is kidnapped, tortured and murdered by Islamic extremists."
21121,18/8/2013,Iraq,Baghdad,4,13,17,"Jihadi bombers target a supermarket and bus stop, killing four people."
21122,19/8/2013,Egypt,Rafah,24,3,27,Islamic fundamentalists pull two dozen police officers off a bus and shoot them execution style.
21123,19/8/2013,Iraq,Mosul,6,0,6,Three carpenters are among six Iraqis murdered by Islamic militants.
21124,19/8/2013,Pakistan,Karachi,2,0,2,Sectarian Jihadis shoot a man and his nephew to death.
21125,20/8/2013,Nigeria,Dumba,44,12,56,"Forty-four villagers are mercilessly butchered by Islamists, who slit throats and even gouged out eyes."
21126,20/8/2013,Afghanistan,Logar,3,8,11,Three Afghans are taken apart by Islamist bombers.
21127,20/8/2013,Afghanistan,Gulistan,11,17,28,The Taliban murder eleven local security personnel in two attacks.
21128,20/8/2013,Thailand,Pattani,1,0,1,A young Buddhist teacher is shot to death by Muslim militants.
21129,20/8/2013,Nigeria,Gwoza,2,0,2,"Boko haram militants open fire on a group of police, killing two."
21130,20/8/2013,Iraq,Baghdad,3,9,12,Three people at a livestock market are sent to Allah by Islamist bombers.
21131,20/8/2013,Iraq,Iskanadariyah,3,18,21,Terrorists plant bombs in a parking lot that take the lives of three innocents.
21132,20/8/2013,Iraq,Amara,4,42,46,"Holy Warriors bomb a commercial district, killing four Iraqis."
21133,20/8/2013,Iraq,Hillah,6,15,21,A half-dozen innocents are slain by a brutal double-bombing.
21134,20/8/2013,Iraq,Nasariya,3,21,24,Sunni hardliners set off a bomb at a power plant that leaves three dead.
21135,20/8/2013,Iraq,Baghdad,5,15,20,Five people at a cafe are exterminated in mid-bite by an al-Qaeda bomb.
21136,20/8/2013,Syria,Damascus,1,0,1,A Shiite journalist is gunned down by al-Nusra.
21137,21/8/2013,Yemen,Aden,2,0,2,A father and son are cut down by al-Qaeda gunmen.
21138,21/8/2013,Iraq,Baghdad,16,36,52,Sixteen Iraqis are killed in various Mujahideen attacks.
21139,21/8/2013,Nigeria,Gamboru Ngala,4,0,4,Islamic radicals lure four people out of their homes and then machine-gun them.
21140,21/8/2013,Pakistan,Karachi,1,0,1,Sipah-e-Sahaba terrorists murder a Shia doctor.
21141,21/8/2013,Libya,Tripoli,3,0,3,Sunnis are suspected in a sectarian shooting incident that leaves two Shiites and a passerby dead.
21142,21/8/2013,Thailand,Pattani,1,0,1,An Islamic religion teacher is gunned down by Muslim extremists.
21143,21/8/2013,Pakistan,Multan,1,0,1,"A cleric hacks his wife to death for ""challenging Allah's orders"" by refusing to wear a veil."
21144,21/8/2013,Pakistan,Karachi,2,0,2,A 46-year-old Ahmadi is shot dead outside his home along with a neighbor by Sunni purists.
21145,21/8/2013,Algeria,Tlemcen,3,0,3,A father and son are among a group of hunters decapitated by Islamic fundamentalists.
21146,22/8/2013,Syria,Aleppo,6,19,25,"A suicide bomber targets a group of youth celebrating a graduation at a restaurant, killing six."
21147,22/8/2013,Pakistan,Karachi,2,9,11,Two people are incinerated when Tehreek-e-Taliban terrorists set off a bomb along a city street.
21148,22/8/2013,Iraq,Dujail,9,27,36,"A Sunni wades into a Shia wedding party and detonates a suicide vest, slaughtering at least nine."
21149,22/8/2013,Afghanistan,Farah,1,15,16,A child is disassembled by Religion of Peace hardline bombers.
21150,22/8/2013,Pakistan,Wana,5,0,5,Tehreeke-e-Taliban kill a former member and four others.
21151,22/8/2013,Iraq,Ramadi,14,10,24,Fourteen Iraqis die at the hands of a Fedayeen suicide bomber.
21152,23/8/2013,Lebanon,Tripoli,50,358,408,Fifty worshippers at two mosques are blown to bits in a sectarian bloodbath by rival bombers.
21153,23/8/2013,Iraq,Baghdad,3,18,21,Three worshippers at a mosque are sent directly to Allah by their Muslim brothers.
21154,23/8/2013,Iraq,Dujail,3,0,3,"Jihadis break into a home and murder a man, his wife and elderly mother."
21155,23/8/2013,Yemen,Shibam,2,6,8,Two people are taken out by a Shahid suicide bomber.
21156,23/8/2013,Iraq,Baghdad,28,58,86,"A barbaric suicide bombing at a park leaves over two dozen dead, mostly women and children."
21157,23/8/2013,Iraq,Mosul,2,12,14,A suicide truck bomber takes down two Iraqis.
21158,23/8/2013,Iraq,Adhamiyah,4,0,4,Four people are shot dead by Mujahideen.
21159,23/8/2013,Pakistan,Islamabad,2,1,3,Two people are slain outside a seminary by sectarian rivals on a motorcycle.
21160,23/8/2013,Pakistan,Bhakkar,9,7,16,At least nine are killed when Ahle Sunnat Waljamaat and Shiites open fire on each other.
21161,24/8/2013,Thailand,Yala,3,1,4,Muslim 'insurgents' machine-gun four elderly men sitting outside a tea shop.
21162,25/8/2013,Pakistan,Khairpur,2,0,2,Two people lose their lives in an honor killing over free-will marriage.
21163,25/8/2013,Nigeria,Nasarawa,0,7,7,Thirty Muslims attack a church armed with knives and clubs.
21164,25/8/2013,Pakistan,Karachi,3,0,3,The Sunni Tehreek is suspected of murdering three members of secular-leaning political parties.
21165,25/8/2013,Iraq,Qaiyara,5,0,5,Five local soldiers are murdered and then burned by al-Qaeda.
21166,25/8/2013,Syria,Hama,2,8,10,al-Nusra terrorists murder a local official and a civilian with a car bomb.
21167,25/8/2013,Iraq,Baqubah,4,21,25,Religion of Peace bombers take out a child and three nurses.
21168,25/8/2013,Iraq,Nineveh,2,0,2,Two religious minorities are gunned down by Sunnis.
21169,25/8/2013,Iraq,Ramadi,3,0,3,Video surfaces of three Syrian truck drivers executed after failing a quiz on Sunni prayer by gunmen yelling 'Allah Akbar'.
21170,25/8/2013,Yemen,Sanaa,12,11,23,al-Qaeda plant a bomb on a bus that leaves a dozen air force cadets dead.
21171,25/8/2013,Nigeria,Bama,14,9,23,Twenty-three youth are lured into a deadly ambush by Boko Haram Islamists.
21172,25/8/2013,Iraq,Baghdad,13,69,82,Thirteen Iraqis are killed in a series of Mujahideen bombings.
21173,25/8/2013,Iraq,Baghdad,10,25,35,Religion of Peace bombers take out ten patrons at an outdoor cafe.
21174,25/8/2013,Iraq,Balad,5,21,26,Five Iraqis are exterminated by a terrorist bomb blast.
21175,25/8/2013,Iraq,Baqubah,5,8,13,"A Shiite wedding is bombed by al-Qaeda, leaving five dead guests."
21176,25/8/2013,Iraq,Baqubah,2,11,13,A child is among two members of a Shiite family killed when Sunnis bomb their home.
21177,25/8/2013,Iraq,Baqubah,13,36,49,"al-Qaeda bomb a popular market, sending thirteen shoppers home in body bags."
21178,25/8/2013,Iraq,Madaen,7,30,37,"Jihadis set off a bomb at a soccer field, killing seven people."
21179,26/8/2013,Iraq,Tarmiyah,6,0,6,Sunnis kidnap six Shiites from their homes and execute them.
21180,26/8/2013,Afghanistan,Kapisa,1,10,11,A local soldier is killed during a Fedayeen suicide assault by a group of Taliban.
21181,26/8/2013,Syria,Latakia,1,0,1,Sunnis kidnap and murder a Shia cleric.
21182,26/8/2013,India,Shopian,2,1,3,Two guards are shot to death by Islamic 'separatists'.
21183,26/8/2013,Nigeria,Damasak,6,6,12,"Islamists pump machine-gun fire into a village a night, killing six sleeping residents."
21184,26/8/2013,Pakistan,Sakwar,2,0,2,Terrorists murder two sectarian rivals.
21185,27/8/2013,Afghanistan,Paktia,6,0,6,The Taliban execute six civilians.
21186,27/8/2013,Afghanistan,Herat,6,0,6,Four engineers are among six contractors found shot in the head by Sunni fundamentalists.
21187,27/8/2013,Ingushetia,Nizhnie Achaluki,2,0,2,Two men are shot to death in their car by Islamic militia.
21188,27/8/2013,Pakistan,Karachi,1,0,1,Sipah-e-Sahaba gunmen pick off a 55-year-old Shia civilian.
21189,27/8/2013,Pakistan,Madaripur,0,30,30,Islamic fundamentalists attack a brothel and beat thirty up prostitutes.
21190,27/8/2013,Pakistan,Multan,1,0,1,A devout Muslim kills a woman who refused to marry him over his religious views.
21191,27/8/2013,Iraq,Baghdad,5,11,16,"Muslim terrorists bomb the home of a tribal leader, killing five people."
21192,28/8/2013,Pakistan,Peshawar,1,0,1,The Taliban kidnap and kill a 9-year-old girl.
21193,28/8/2013,Afghanistan,Farah,15,10,25,Fifteen local cops are ambushed and murdered by the Taliban.
21194,28/8/2013,Afghanistan,Ghanzi,7,62,69,"A Taliban attack leaves seven people dead, including police and civilians."
21195,28/8/2013,Afghanistan,Helmand,3,4,7,Three Afghans bleed to death following a Fedayeen suicide bombing.
21196,28/8/2013,Afghanistan,Farah,6,10,16,Six Afghans are burned alive by Taliban militants.
21197,28/8/2013,Iraq,Madaen,4,5,9,Four Iraqi soldiers are slain by al-Qaeda bombers.
21198,28/8/2013,Afghanistan,Laskar Gah,4,15,19,Four civilians are sent to Allah by a Shahid suicide bomber.
21199,28/8/2013,Iraq,Kadhimiya,5,30,35,Five Iraqis are blown to bits by Islamist bombers.
21200,28/8/2013,Iraq,Latifiya,12,0,12,"al-Qaeda militants storm two homes and shoot a dozen family members to death, including four children as young as 4."
21201,28/8/2013,Iraq,Baghdad,12,133,145,A dozen Iraqis are taken out in a series of small-scale bombings and shootings by Islamic State of Iraq and the Levant.
21202,28/8/2013,Iraq,Shaab,9,9,18,Nine Iraqis are killed when Mujahideen bomb a packed commercial area.
21203,28/8/2013,Iraq,Kazimiyah,10,27,37,A Fedayeen suicide bomber slaughters ten onlookers at the scene of an earlier bombing.
21204,28/8/2013,Iraq,Mahmoudiya,5,15,20,"A Holy Warrior detonates a suicide vest inside a restaurant, snuffing out the lives of at least five others."
21205,28/8/2013,Iraq,Sadr City,19,24,43,Two al-Qaeda car bombs send at least nineteen innocents to Allah.
21206,28/8/2013,Iraq,Baghdad,7,23,30,A Sunni bomb blast in a Shiite neighborhood leaves seven dead.
21207,29/8/2013,Iraq,Abu Grhaib,5,8,13,An al-Qaeda car bomb leaves five dead.
21208,29/8/2013,Yemen,Huta,1,0,1,A gay man is shot to death by Islamic fundamentalists at a market.
21209,29/8/2013,Thailand,Narathiwat,1,0,1,Muslim 'separatists' are suspected of shooting a 29-year-old villager in the neck and head.
21210,29/8/2013,Iraq,Samarrah,18,32,50,Eighteen Iraqis are blown to bits by Jihadi car bombers at a vegetable market.
21211,29/8/2013,Somalia,El-Barde,2,7,9,At least two residents are slain during an al-Shabaab attack on a town.
21212,29/8/2013,Pakistan,Punjab,1,1,2,A Shia is gunned down by Sipah-e-Sahaba inside a medical clinic.
21213,29/8/2013,Afghanistan,Wardak,11,0,11,The Taliban murder eleven local guards.
21214,29/8/2013,Nigeria,Jos,5,0,5,Five Christians are ordered off a bus and summarily executed by Religion of Peace activists.
21215,30/8/2013,Nigeria,Monguno,24,0,24,Two dozen village defense volunteers are ambushed and massacred by Boko Haram.
21216,30/8/2013,Iraq,Tuz Khurmatu,13,18,31,Children make up the bulk of a dozen victims pulled into pieces by Islamist bombers.
21217,30/8/2013,Afghanistan,Dashi Archi,8,16,24,A Shahid suicide bomber slips into a funeral and murders eight mourners.
21218,30/8/2013,Nigeria,Barkin Ladi,6,0,6,Five men and a pregnant woman are raked by Boko Haram automatic weapons fire.
21219,31/8/2013,Afghanistan,Sangin,12,0,12,A dozen Afghans are bombed and then machine-gunned to death by Religion of Peace hardliners.
21220,31/8/2013,Afghanistan,Kabul,6,24,30,A Fedayeen suicide bomber murders six innocents outside a bank.
21221,31/8/2013,Nigeria,Borno,14,0,14,Fourteen nomadic herders are slaughtered by Boko Haram.
21222,31/8/2013,Iraq,Dijail,3,3,6,Mujahideen use an IED to kill three little girls.
21223,31/8/2013,Iraq,Ramadi,12,20,32,Women are among a dozen Iraqis torn to shreds by a Fedayeen suicide bomber.
21224,31/8/2013,Iraq,Baghdad,5,4,9,Five worshippers at a mosque are machine-gunned by sectarian rivals.
21225,31/8/2013,Yemen,Lahj,1,0,1,An off-duty officer is gunned down by al-Qaeda assassins.
21226,31/8/2013,Pakistan,Karachi,1,0,1,A Shiite is shot to death by Sipah-e-Sahaba.
21227,31/8/2013,Pakistan,Karachi,4,6,10,Four members of a secular-leaning political party are shot to death at a medical clinic.
21228,1/9/2013,Iraq,Camp Ashraf,52,0,52,"Shia militia enter a refugee camp, sort out fifty-two unarmed dissidents and summarily execute them."
21229,1/9/2013,Somalia,Beledweyne,1,1,2,"A Christian woman is murdered in front of her child, in a targeted attack by Islamic radicals."
21230,1/9/2013,Pakistan,Matta,1,0,1,Islamists gun down a man at a market.
21231,1/9/2013,Pakistan,Miranshah,9,21,30,The Taliban murder nine local soldiers with a roadside bomb.
21232,1/9/2013,Afghanistan,Andar,7,0,7,"The Taliban kidnap seven Afghans from their family homes, chain them together and then brutally execute them."
21233,1/9/2013,Nigeria,Adu,9,3,12,"Nine Christian villagers, including two children, are machine-gunned in their own homes by Muslim terrorists."
21234,2/9/2013,Iraq,Baqubah,4,12,16,"A Shahid suicide bomber rams a checkpoint, killing at least four other people."
21235,2/9/2013,Iraq,Baghdad,8,14,22,Two suicide bombers take out eight Iraqis at a house.
21236,3/9/2013,Syria,Talkalakh,24,0,24,"al-Nusra terrorists reportedly stop a train and behead twenty-four passengers, including a baby."
21237,3/9/2013,Iraq,Jabla,5,6,11,Five patrons are blown apart by Mujahid bombers at a restaurant.
21238,3/9/2013,Afghanistan,Herat,1,0,1,A judge is assassinated by pro-Sharia radicals.
21239,3/9/2013,Pakistan,Karachi,3,0,3,A local mosque official is among three people gunned down by sectarian rivals.
21240,3/9/2013,Pakistan,Karachi,1,0,1,A 30-year-old Shiite is shot to death in his shop by Sipah-e-Sahaba.
21241,3/9/2013,Nigeria,Kaduna,10,0,10,Two children and their parents are among ten family members butchered by Fulani terrorists.
21242,3/9/2013,Iraq,Maamil,3,41,44,"A Mujahideen car bomb rips through an outdoor market, leaving three dead."
21243,3/9/2013,Iraq,Karradah,6,14,20,al-Qaeda bombers murder six people at an ice cream shop.
21244,3/9/2013,Iraq,Sadiyah,6,15,21,Back to back bombings take the lives of six Iraqis.
21245,3/9/2013,Iraq,Sadr City,3,8,11,"Sunni terrorists detonate a bomb in a Shia neighborhood, killing three."
21246,3/9/2013,Iraq,Talibiyah,7,28,35,Seven innocents are cut to pieces by al-Qaeda bombers in a shopping district.
21247,3/9/2013,Iraq,Husseiniyah,9,32,41,"Sunnis bomb a restaurant popular with Shiites, leaving at least nine dead."
21248,3/9/2013,Dagestan,Makhachkala,3,0,3,Three police officers are killed by suspected Islamic militia.
21249,3/9/2013,Afghanistan,Khairabad,4,1,5,The Taliban murder four local security guards.
21250,3/9/2013,Iraq,Baghdad,29,180,209,Twenty-nine Iraqis are killed in a series of al-Qaeda attacks in Shiite areas.
21251,3/9/2013,Iraq,Arab Jubour,5,0,5,Three children and their parents are brutally slain in their own home by Muslim terrorists.
21252,3/9/2013,Iraq,Tarmiya,12,39,51,Two Mujahid bombings leave a dozen dead.
21253,3/9/2013,Nigeria,Jos,3,1,4,A father and his two children are murdered by suspected Muslim extremists.
21254,3/9/2013,Nigeria,Kunte-Kuru,6,0,6,"A brutal assault by Muslim militia on the home of a Christian family leaves six members dead, including a 7-year-old child."
21255,3/9/2013,Nigeria,Gura Dabwam,3,1,4,Muslims gun down a devout Christian villager and his two teenage sons.
21256,4/9/2013,Syria,Maalula,1,0,1,"Islamists slit the throat of a Christian for refusing to deny his faith, then taunt his fiancee."
21257,4/9/2013,Afghanistan,Ghazni,3,0,3,A man and his two sons are shot to death in their own home by Islamic hardliners.
21258,4/9/2013,Iraq,Latifiyah,18,9,27,"Eighteen Shiite family members are shot to death in their homes, including six children."
21259,4/9/2013,Syria,Maaloula,8,27,35,At least eight defenders are killed when Islamists storm a Christian village and shell a church.
21260,4/9/2013,Afghanistan,Paktiya,1,0,1,A tribal leader is shot to death by Islamic terrorists.
21261,4/9/2013,Afghanistan,Shindand,4,0,4,The Taliban murder four local policemen at a checkpoint.
21262,4/9/2013,Iraq,Mosul,5,11,16,A suicide bomber takes out five innocents.
21263,4/9/2013,Iraq,Baji,3,4,7,Three Iraqis are machine-gunned at point-blank range by al-Qaeda.
21264,5/9/2013,Pakistan,Jamrud,0,16,16,A dozen girls are injured when the Taliban set off a bomb near their school.
21265,5/9/2013,Egypt,Nasr City,2,10,12,A suicide bomber praises Allah and then kills two bystanders.
21266,5/9/2013,Afghanistan,Paktika,1,0,1,A female writer is brutally gunned down by Islamic fundamentalists.
21267,5/9/2013,Afghanistan,Kabul,0,3,3,Terrorists spray automatic weapons fire into a Shiite mosque.
21268,5/9/2013,Nigeria,Gajiram,15,12,27,Sharia proponents torch a village and shoot fifteen locals to death.
21269,5/9/2013,Iraq,Haswa,3,2,5,Three Iraqis are machine-gunned by al-Qaeda.
21270,5/9/2013,Iraq,Kirkuk,2,25,27,al-Qaeda car bombs leave two dead.
21271,5/9/2013,Egypt,al-Arish,2,8,10,Two local soldiers are killed in a terror attack by Islamists.
21272,5/9/2013,Syria,Damascus,4,6,10,Sunni terrorists detonate a car bomb in a Shia neighborhood that leaves four dead.
21273,6/9/2013,Pakistan,Gujrat,7,2,9,Two children are among a family of seven Shiites exterminated in their home by Sipah-e-Sahaba gunmen.
21274,6/9/2013,Egypt,Minya,1,3,4,A Muslim Brotherhood attempt to violently breach a police station leaves a 6-year-old child dead.
21275,6/9/2013,Pakistan,Orangi Town,1,0,1,A car dealer is murdered by Tehreek-e-Taliban.
21276,6/9/2013,Pakistan,Peshawar,6,1,7,Six people including a child are shot to death in a drive-by attack by Muslim militants.
21277,7/9/2013,Somalia,Hamarweyne,18,31,49,Eighteen people are pulled into pieces by a suicide bomber outside a restaurant.
21278,7/9/2013,India,Muzaffarnagar,3,0,3,"Three Hindus are waylaid, murdered and dumped in a river by Muslims in an attack that provoked reprisals."
21279,7/9/2013,Dagestan,Derbent,1,0,1,One person is left dead following an Islamist car bombing.
21280,7/9/2013,Iraq,Tikrit,3,5,8,Terrorists kill three local cops with a series of IED's.
21281,7/9/2013,Iraq,Taji,2,5,7,Two Iraqis are taken out by a Fedayeen suicide bomber.
21282,7/9/2013,Syria,Maaloula,3,0,3,At least three Christians are shot to death after declining an offer to embrace Islam.
21283,7/9/2013,Egypt,Sheikh Zuwayed,2,0,2,Two local soldiers die when Islamists detonate a shrapnel bomb.
21284,8/9/2013,Afghanistan,Wardak,4,120,124,Four employees are killed during a sustained Taliban suicide assault on a government building.
21285,8/9/2013,Nigeria,Benisheik,12,18,30,A dozen defenders are killed during a Boko Haram assault on a village.
21286,8/9/2013,Iraq,Jalula,3,10,13,Two suicide bombers murder three Iraqis.
21287,8/9/2013,Pakistan,Khyber,5,2,7,Islamic militants kill five villagers.
21288,8/9/2013,Iraq,Basra,6,0,6,Four women are among six family members slain in their home by Muslim terrorists.
21289,8/9/2013,Iraq,Samarrah,3,0,3,Three Iraqis are shot to death by al-Qaeda.
21290,8/9/2013,Syria,Maaloula,3,6,9,"Three Christians are murdered in their home, and six others taken hostage by Islamists."
21291,9/9/2013,Philippines,Zamboanga,6,24,30,"Moro Islamists invade a coastal village, killing six people and taking hostages."
21292,9/9/2013,Pakistan,Landi Kotal,3,4,7,Religious extremists behead three members of a peace committee.
21293,10/9/2013,Egypt,Dalga,1,0,1,A 60-year-old Copt is killed while defending his home from a Muslim mob.
21294,10/9/2013,Afghanistan,Musa Qala,5,0,5,Five civilians are taken down by fundamentalist bombers.
21295,10/9/2013,Afghanistan,Ghazni,7,17,24,Three children are among seven civilians blown to bits by the Taliban.
21296,10/9/2013,Yemen,Amran,42,0,42,Over three dozen people are killed during an armed clash between Sunni Islah and Shiite Huthi .
21297,10/9/2013,Thailand,Yala,2,2,4,Two people are killed when Muslim 'rebels' set off a bomb at a school.
21298,10/9/2013,Pakistan,Karachi,4,0,4,"Sectarian Jihadis kill four people, including a Shia scholar."
21299,10/9/2013,Iraq,Baghdad,3,14,17,Sunni Mujahideen take down three Shiites at a soccer field.
21300,10/9/2013,Iraq,Baqubah,10,34,44,Ten people at an outdoor market are sent to Allah by al-Qaeda bombers.
21301,10/9/2013,Iraq,Latifiya,4,14,18,Islamists plant a bomb inside a coffee shop that leaves four dead.
21302,10/9/2013,Iraq,Yusufiyah,6,0,6,Terrorists invade a home and murder six family members preparing for a funeral.
21303,10/9/2013,Syria,Maksar al-Hesan,30,0,30,Women and children are among thirty villagers massacred by al-Nusra over their status as religious minorities at the urging of a cleric.
21304,11/9/2013,Syria,Deir al-Zour,35,0,35,An 'Australian' suicide bomber kills three dozen soldiers guarding an airport.
21305,11/9/2013,Pakistan,Nazimabad,1,0,1,A Shia scholar is brought down outside his home by Sunni assassins.
21306,11/9/2013,Nigeria,Adamawa,2,1,3,Two officers are killed during a Boko Haram assault on a police station.
21307,11/9/2013,Iraq,Baghdad,15,8,23,At least one child is among fifteen Iraqis are killed in a series of Mujahideen attacks.
21308,11/9/2013,Thailand,Pattani,5,0,5,"Muslim 'insurgents' spray a police car with machine-gun fire, killing five passengers."
21309,11/9/2013,Iraq,Baghdad,31,57,88,At least thirty Shia worshippers are torn to shreds by a suicide bomber at the entrance of their mosque.
21310,11/9/2013,Egypt,Rafah,11,17,28,A Fedayeen suicide car bombing leaves eleven dead.
21311,12/9/2013,Egypt,Sahel Selim,2,0,2,Two Copts are shot to death for refusing to pay Jizya to Muslims.
21312,12/9/2013,Thailand,Pattani,3,1,4,"Militant Muslims fire on soldiers helping villagers repair houses, killing three."
21313,12/9/2013,Indonesia,Jember,1,0,1,"An Islamic mob, angered by the vandalism of a mosque beat a fisherman to death."
21314,12/9/2013,Iraq,Basra,4,0,4,Four Muslims are taken out in two bomb attacks by Religion of Peace rivals.
21315,12/9/2013,Iraq,Kirkuk,3,31,34,A Shahid suicide bomber sends three Iraqis to the hereafter.
21316,12/9/2013,Philippines,Basilan,1,4,5,Islamists gun down a local man.
21317,13/9/2013,Philippines,Zamboanga,16,28,44,An additional sixteen people are reported killed during a Moro Islamist siege.
21318,13/9/2013,Afghanistan,Herat,3,17,20,Three Afghan guards are killed during a Taliban attack on the U.S. consulate.
21319,13/9/2013,Israel,Yata,1,0,1,A 15-year-old girl is hanged by her mother for getting pregnant.
21320,13/9/2013,Iraq,Samarrah,3,0,3,Three Shiite pilgrims are sent to Allah by Sunni bombers.
21321,13/9/2013,Iraq,Baqubah,32,43,75,Thirty worshippers at a Sunni mosque are massacred by two bombs set by sectarian Jihadis.
21322,13/9/2013,Iraq,Mosul,6,0,6,Four children and their parents are slaughtered in their home by Muslim 'insurgents'.
21323,13/9/2013,Tanzania,Zanzibar,0,1,1,"Muslims throw acid on a priest, badly burning him."
21324,13/9/2013,Syria,Damascus,2,5,7,A child is among two killed in a Sunni attack on a Shia shrine.
21325,14/9/2013,Pakistan,Darra,2,4,6,Two people on an archaeological dig are disassembled by Islamist bombers.
21326,14/9/2013,Iraq,Ramadi,2,3,5,A woman is among two people shot to death in their car by suspected al-Qaeda.
21327,14/9/2013,Iraq,Abu Ghraib,3,5,8,Three Iraqis are taken out by Mujahid bombers.
21328,14/9/2013,Iraq,Mosul,27,36,63,Over two-dozen people at a Shia funeral are exterminated by a Fedayeen suicide bomber.
21329,14/9/2013,Pakistan,Karachi,1,0,1,Sipah-e-Sahaba gunmen pick off a Shiite.
21330,14/9/2013,Afghanistan,Kandahar,3,3,6,Three civilians are disassembled by a Shahid suicide bomber.
21331,14/9/2013,Yemen,al-Qatn,2,8,10,Two local soldiers are killed in an al-Qaeda ambush.
21332,14/9/2013,Thailand,Pattani,2,4,6,Two local soldiers are killed by Muslim roadside bombers.
21333,14/9/2013,Iraq,Dujail,5,0,5,An 11-year-old boy and a married couple are among five Iraqis murdered in separate attacks by Mujahideen.
21334,14/9/2013,Iraq,Mosul,3,1,4,"A Shiite mother, father and child are slain in their home by Sunni gunmen."
21335,14/9/2013,Pakistan,Karachi,1,0,1,A Christian's throat is slit on the street after being branded an 'infidel' and blasphemer.
21336,15/9/2013,Dagestan,Kizlyar,1,0,1,A moderate activist is murdered outside his home by suspected pro-Sharia radicals.
21337,15/9/2013,Pakistan,Karachi,1,0,1,A Shiite is shot to death by Sunni drive-by shooters.
21338,15/9/2013,Iraq,Rashid,4,0,4,Two children and their parents are brutally slain in their home by al-Qaeda.
21339,15/9/2013,Iraq,Baghdad,12,22,34,Three terrorist bombings leave a dozen dead.
21340,15/9/2013,Iraq,Basra,8,26,34,al-Qaeda bombers take down eight Shiites.
21341,15/9/2013,Iraq,Abu Sayda,3,0,3,Terrorists shoot three farmers to death in their own home.
21342,15/9/2013,Iraq,Kut,9,45,54,Nine Iraqis die in a series of Jihad attacks.
21343,15/9/2013,Iraq,Karbalah,5,25,30,Sunni bombers take out five Shiites at an industrial area.
21344,15/9/2013,Iraq,Iskandariyah,4,9,13,An al-Qaeda car bomb at a parking lot kills four people.
21345,15/9/2013,Iraq,Hillah,15,29,44,Two car bombs at an outdoor market leave fifteen patrons dead.
21346,15/9/2013,Pakistan,Upper Dir,3,0,3,Taliban bombers murder three local military officers.
21347,15/9/2013,Pakistan,Jawaki,3,0,3,Three women are 'honor' killed on orders of a jirga because one left her husband and the other two helped.
21348,16/9/2013,Egypt,Arish,1,8,9,A civilian loses their life to an Islamist rocket.
21349,16/9/2013,Afghanistan,Helmand,1,0,1,A prominent policewoman dies days after being shot in the neck in a targeted assassination.
21350,16/9/2013,Chechnya,Sernovodsk,3,6,9,Suicide bombers take out three policemen at their station.
21351,16/9/2013,Iraq,Tarmiya,2,5,7,Two civilians are taken out by Mujahid bombers.
21352,16/9/2013,Iraq,Mosul,1,10,11,A Fedayeen suicide bomber kills one other person.
21353,17/9/2013,Pakistan,Karachi,4,0,4,Four activists of a secular-leaning political party are machine-gunned at a shop by suspected Islamists.
21354,17/9/2013,Iraq,Baghdad,17,85,102,Seventeen people are blown to bits in a series of Mujahideen bombings.
21355,17/9/2013,Iraq,Fallujah,8,12,20,Three suicide bombers kill eight Iraqis.
21356,17/9/2013,Iraq,Husseiniya,8,20,28,Islamists set off a blast in a commercial district that takes the lives of eight innocents.
21357,17/9/2013,Iraq,Madaen,5,0,5,"Three children, ages 2 to 9, are butchered along with their parents during an al-Qaeda home invasion."
21358,17/9/2013,Iraq,Sadr City,6,18,24,Two al-Qaeda car bombs leave six dead.
21359,17/9/2013,Egypt,Cairo,2,0,2,Islamists murder two local soldiers in a street attack.
21360,18/9/2013,Thailand,Pattani,2,0,2,A middle-aged Buddhist couple are murdered by militant Muslims.
21361,18/9/2013,Thailand,Narathiwat,1,0,1,Muslim 'separatists' shoot a 59-year-old construction worker to death.
21362,18/9/2013,Nigeria,Benisheik,161,0,161,Boko Haram Islamists massacre over one-hundred and sixty villagers.
21363,18/9/2013,Bangladesh,Noakhali,1,0,1,A rickshaw driver is stoned to death by Jamaat-e-Islami supporters.
21364,18/9/2013,Pakistan,Quetta,2,0,2,Two Shiites are shot to death by Sunni militants.
21365,18/9/2013,Afghanistan,Kunduz,1,0,1,Sunni hardliners shoot a man to death on his way in to work.
21366,18/9/2013,Afghanistan,Badakhshan,18,13,31,Eighteen local police officers are slaughtered by Sunni radicals.
21367,19/9/2013,Pakistan,Quetta,2,0,2,Two Shiites are shot to death along a city street by Lashkar-e-Jhagvi.
21368,19/9/2013,Syria,Jbourin,19,4,23,Sunni terrorists are suspected of a bus bombing that leaves nineteen dead.
21369,19/9/2013,Afghanistan,Badakhshan,10,16,26,At least ten local cops lose their lives during a massive Taliban ambush.
21370,19/9/2013,Pakistan,Karachi,3,18,21,Religion of Peace rivals storm a mosque and murder at least three worshippers.
21371,19/9/2013,Pakistan,Landhi,1,9,10,"Sectarian Jihadis hurl a hand grenade into a mosque, killing one person."
21372,19/9/2013,Bangladesh,Sirajganj,1,1,2,Jamaat-e-Islami kill an innocent person.
21373,19/9/2013,Pakistan,Peshawar,3,20,23,Islamic militants murder three people near a mosque.
21374,19/9/2013,Iraq,Ishaqi,6,18,24,Terrorists gun down a shop owner and leave a bomb that takes five other lives.
21375,19/9/2013,Iraq,Haswa,9,30,39,Islamic 'insurgents' blow up nine innocent people.
21376,19/9/2013,Iraq,Baghdad,10,0,10,Ten Iraqis are rounded up by al-Qaeda and shot in the head.
21377,20/9/2013,Yemen,Shabwa,65,38,103,Three suicide bombings claim the lives of at least sixty-five local soldiers and guards.
21378,20/9/2013,Iraq,Samarra,18,21,39,"Terrorists detonate two bombs at a rival mosque, which snuff out the lives of eighteen worshippers."
21379,20/9/2013,Philippines,Zamboanga,3,1,4,Muslim 'rebels' set off a bomb on a bus that leaves three dead.
21380,20/9/2013,Pakistan,Bahawalpur,1,0,1,A woman is murdered by her brother on suspicion of sex outside of marriage.
21381,20/9/2013,Israel,Qalqiliya,1,0,1,A Israeli soldier is kidnapped and murdered by Fatah.
21382,21/9/2013,Pal. Auth.,Gaza,1,0,1,A 33-year-old woman is strangled by her family after having being accused of 'violating Allah's law'.
21383,21/9/2013,Afghanistan,Paktia,3,0,3,Three NATO soldiers are shot in the back by a Taliban in police uniform.
21384,21/9/2013,Iraq,Beiji,7,21,28,Seven Iraqis are taken out by an al-Qaeda suicide bomber.
21385,21/9/2013,Iraq,Sadr City,72,120,192,Women and children are amply represented among over seventy people massacred by a Shahid suicide bomber at a funeral.
21386,21/9/2013,Somalia,Bakaro,2,6,8,Two businessmen are killed when Muslim militants toss a grenade into a building.
21387,21/9/2013,Kenya,Nairobi,68,175,243,Nearly seventy shoppers are murdered by Islamic activists in a targeted attack on non-Muslims at a shopping mall.  The victims include children and pregnant women.
21388,21/9/2013,Iraq,Ur,9,14,23,"Jihadi car bombers strike a commercial district, taking out nine Iraqis."
21389,21/9/2013,Iraq,Azamiyah,4,0,4,Fundamentalist gunmen kill four people at a store selling alcohol.
21390,21/9/2013,Syria,Aleppo,40,0,40,"Forty FSA rebels are reportedly beheaded by the al-Qaeda group, Islamic State of Iraq and the Levant."
21391,22/9/2013,Yemen,Maarib,4,2,6,Four tribesmen lose their lives to an al-Qaeda ambush.
21392,22/9/2013,Pakistan,Peshawar,105,150,255,"Two Jundullah suicide bombers obliterate over one-hundred worshippers at a church service, including many women and children."
21393,22/9/2013,Israel,Hebron,1,0,1,An Israeli soldier is killed by a Palestinian sniper.
21394,22/9/2013,Iraq,Baghdad,12,35,47,"A sectarian suicide bomber hits a funeral, killing at least a dozen mourners."
21395,22/9/2013,Iraq,Baghdad,6,0,6,"Six Iraqis are shot to death by Mujahideen, including four young people at a refreshment shop."
21396,22/9/2013,Iraq,Kirkuk,0,51,51,A car bomb targeting educators leaves over fifty injured.
21397,22/9/2013,Afghanistan,Shorabak,11,0,11,Eleven local cops are sprayed with Taliban machine-gun fire.
21398,23/9/2013,DRC,Watalinga,3,30,33,Islamist rebels kill three people and abduct thirty others.
21399,23/9/2013,Syria,al-Thawra,1,0,1,A Christian is killed in a targeted attack by Islamists.
21400,23/9/2013,Iraq,Mosul,2,2,4,Jihadis bomb an ambulance carrying a pregnant woman.
21401,23/9/2013,Philippines,North Cotabato,8,15,23,Eight people lose their lives when Bangsamoro Islamic Freedom Fighters storm a town a take hostages.
21402,23/9/2013,Dagestan,Tabasaransky,2,16,18,Two others are killed by a Fedayeen suicide car bomber at a police station.
21403,23/9/2013,Iraq,Adhamiyah,16,34,50,Sixteen mourners are killed when yet another funeral is targeted by sectarian bombers.
21404,23/9/2013,India,Srinagar,1,1,2,Islamic militants murder a man shopping at a market.
21405,23/9/2013,Egypt,Ismailiya,1,0,1,Islamists gun down a cop.
21406,23/9/2013,Afghanistan,Chardara,1,0,1,A man is shot to death on his way to work by Islamic fundamentalists.
21407,23/9/2013,Pakistan,Gilgit,1,0,1,Sipah-e-Sahaba gunmen pick off a Shiite outside his house.
21408,23/9/2013,Pakistan,Pishin,5,5,10,Two civilians and three police are blown to bits by Tehreek-e-Taliban bombers.
21409,23/9/2013,Iraq,Yusufiya,3,2,5,A Shiite married couple and their child are murdered in their home by Sunni gunmen.
21410,23/9/2013,Iraq,Ramadi,3,4,7,Three Iraqis are taken down by a Fedayeen suicide bomber.
21411,23/9/2013,Iraq,Sadr City,2,10,12,"Terrorists bomb a cafe in a Shiite area, killing two patrons."
21412,24/9/2013,Syria,Damascus,7,15,22,Seven people are killed when Sunni terrorists set off a car bomb in a residential neighborhood.
21413,24/9/2013,Iraq,Haditha,9,0,9,"al-Qaeda launch a suicide attack on local police, killing at least nine."
21414,25/9/2013,Kenya,Wajir,1,3,4,al-Shabaab claims credit for a grenade attack near a Catholic church.
21415,25/9/2013,Dagestan,Makhachkala,2,0,2,A judge and his son are shot to death in their car by suspected Islamists.
21416,25/9/2013,Pakistan,Mohmand,3,7,10,"Muslim militants attack a dam, killing three construction workers."
21417,25/9/2013,Iraq,Balad,5,3,8,Jihadis kill five locals with a car bomb.
21418,25/9/2013,Iraq,Baghdad,6,0,6,Three small children and their parents are among six family members brutally murdered in their home by Islamic terrorists.
21419,25/9/2013,Iraq,Hawijah,10,22,32,Ten Iraqis are taken out by a Fedayeen suicide bomber.
21420,25/9/2013,Yemen,Ataq,1,0,1,A Religion of Peace suicide bomber manages to kill one other person.
21421,25/9/2013,Libya,Derna,2,0,2,"Two Christians are invited to embrace Islam, then tied up and shot when they refuse."
21422,26/9/2013,Yemen,Huta,1,0,1,A homosexual is executed by Islamic fundamentalists.
21423,26/9/2013,Nigeria,Gamboru,27,0,27,Twenty-seven villagers are massacred by terrorists fighting for an Islamic state.
21424,26/9/2013,Pakistan,Rahim Yar Khan,2,0,2,A young couple is shot to death for getting married without the father's permission.
21425,26/9/2013,Iraq,Baghdad,8,14,22,Eight people including women and children are pulled into pieces by Jihadi bombers at a Sunni commercial center.
21426,26/9/2013,Iraq,Baghdad,20,71,91,A Shahid suicide bomber murders twenty other people at a packed Shia marketplace.
21427,26/9/2013,Iraq,Tikrit,4,0,4,An al-Qaeda bomb blast leaves four dead.
21428,26/9/2013,Nigeria,Dorawa,3,0,3,A Pastor and his son are among three people machine-gunned by Religion of Peace enthusiasts.
21429,26/9/2013,Kenya,Mandera,2,3,5,al-Shabaab militants ambush and kill two innocents.
21430,26/9/2013,India,Kashmir,10,4,14,"Muslim terrorists go on a 6-hour rampage, eventually killing ten other people."
21431,26/9/2013,Thailand,Yala,1,0,1,A rescue worker is slain by suspected Muslim 'separatists'.
21432,26/9/2013,Iraq,Baghdad,19,50,69,"Holy Warriors bomb two marketplaces in Shia areas, killing nineteen."
21433,27/9/2013,Nigeria,Saminaka,3,0,3,Three guards are killed when Boko Haram cadres attack a bank.
21434,27/9/2013,Iraq,Baghdad,9,33,42,"Jihadis bomb two rival mosques, killing at least nine worshippers."
21435,27/9/2013,Iraq,Mosul,2,11,13,A Fedayeen suicide bomber kills two Iraqis.
21436,27/9/2013,Thailand,Narathiwat,1,0,1,A civilian is killed during an ambush by Muslim 'separatists'.
21437,27/9/2013,Egypt,al-Arish,1,0,1,Islamists shoot a cop to death outside a hotel.
21438,27/9/2013,Syria,Rankus,37,100,137,Thirty-seven people are reportedly killed by a terrorist car bomb at a mosque.
21439,27/9/2013,Pakistan,Peshawar,19,46,65,Hardliners fighting for an Islamic state blow up nineteen passengers on a bus.
21440,28/9/2013,Nigeria,Zangang,15,12,27,"Muslim militia attack a Christian village, hacking to death fifteen residents and burning down their homes."
21441,28/9/2013,Iraq,Tarmiyah,4,15,19,"al-Qaeda militants blow up four houses, killing people sleeping inside."
21442,28/9/2013,Mali,Timbuktu,2,6,8,Two civilians on a horse-cart are sent to Allah by Shahid suicide bombers.
21443,28/9/2013,Afghanistan,Ghazni,3,8,11,Women and children are among the casualties of a bombing by religious hardliners.
21444,28/9/2013,Afghanistan,Uruzgan,2,0,2,Two civilians are left dead after a fundamentalist bomb attack.
21445,29/9/2013,Afghanistan,Herat,5,0,5,Three farmers are among five people gunned down by the Taliban.
21446,29/9/2013,Iraq,Irbil,6,40,46,An al-Qaeda suicide bombing leaves six others dead.
21447,29/9/2013,Pakistan,Peshawar,42,107,149,Forty innocents at a packed market are torn to shreds by a Religion of Peace bomb blast.
21448,29/9/2013,Nigeria,Gujba,64,16,80,Sixty-four college students are slaughtered in the middle of the night by Boko Haram gunmen at their dorm.
21449,29/9/2013,Iraq,Mussayab,40,50,90,Forty people at a Shiite funeral join their beloved courtesy of a Sunni suicide bomber.
21450,29/9/2013,Iraq,Tarmiyah,1,0,1,A teacher at a secular school is assassinated by suspected Islamists.
21451,29/9/2013,Iraq,Shurqat,4,6,10,Four residents are killed when terrorists blow up a house.
21452,29/9/2013,Iraq,Hussainya,5,14,19,'Insurgent' bombers snuff out five lives at a vegetable market.
21453,29/9/2013,Yemen,Taez,1,0,1,A local is shot to death in his car by al-Qaeda.
21454,30/9/2013,Pakistan,Gilgit,1,0,1,A Shia cab driver is kidnapped and tortured to death by Sipah-e-Sahaba.
21455,30/9/2013,Pakistan,Karachi,1,0,1,Sunni gunmen murder an official at a Shia mosque.
21456,30/9/2013,Yemen,Mukalla,2,0,2,A suicide attack leaves at least two dead.
21457,30/9/2013,Egypt,Ismailia,4,0,4,Two people eating breakfast are among four locals machine-gunned by Islamic hardliners.
21458,30/9/2013,Afghanistan,Takhar,2,0,2,Two people are killed when the Taliban spray a car with bullets.
21459,30/9/2013,Pakistan,Karachi,2,0,2,Two Shiites are gunned down by Sunni terrorists.
21460,30/9/2013,Iraq,Baghdad,24,78,102,Two dozen Iraqis are brought down by al-Qaeda bombers in a series of attacks around the city.
21461,30/9/2013,Iraq,Mosul,3,3,6,Three people are ripped apart by a Sunni bomb blast at a Shia market.
21462,30/9/2013,Iraq,Shaab,5,30,35,al-Qaeda bombers murder five Iraqis with three blasts.
21463,30/9/2013,Iraq,Kadhimiya,9,25,34,"Two Religion of Peace car bombs go off at a town square, leaving at least nine dead."
21464,30/9/2013,Iraq,Sadr City,7,16,23,"Jihadis set off a bomb at a packed Shiite vegetable market, killing at least seven patrons."
21465,1/10/2013,Pakistan,Lahore,1,0,1,Sipah-e-Sahaba gunmen take down a local Shiite.
21466,1/10/2013,Iraq,Tikrit,5,0,5,Five Iraqis are taken out by a Fedayeen suicide bomber.
21467,1/10/2013,Dagestan,Khasavyurt,2,0,2,Two off-duty cops are gunned down by suspected Islamists.
21468,1/10/2013,Pakistan,Rawalpindi,4,0,4,"A Shiite doctor, his wife and two young children are brutally executed in their own home by sectarian killers."
21469,2/10/2013,Iraq,Baghdad,2,6,8,"Sunnis bomb a Shia vegetable market, killing two vendors."
21470,2/10/2013,Iraq,Baghdad,4,17,21,Bombs near an ice cream shop leave four dead.
21471,2/10/2013,Thailand,Yala,4,3,7,Children are among the casualties of a Muslim 'separatist' bomb blast.
21472,2/10/2013,Afghanistan,Chaman,8,16,24,"A Holy Warrior detonates a suicide vest at a border crossing, sending eight innocents to the hereafter."
21473,2/10/2013,Yemen,Hadramout,5,0,5,Five local cops are murdered by suspected al-Qaeda.
21474,2/10/2013,Thailand,Yala,2,5,7,Muslim terrorists attack a group of soldiers guarding teachers and kill two.
21475,2/10/2013,Pakistan,Parachinar,1,2,3,A Shiite father is shot to death in his own home by Sunni gunmen.
21476,3/10/2013,Afghanistan,Nawa,4,2,6,Four local soldiers are sent to Allah by Taliban bombers.
21477,3/10/2013,Iraq,Madain,5,13,18,Five teens at a soccer field are exterminated by Mujahideen bombers.
21478,3/10/2013,Pakistan,Spin Tall,17,22,39,"A Tehrik-i-Taliban suicide bomber murders seventeen people, including a woman and child."
21479,3/10/2013,Iraq,Fallujah,2,3,5,Two civilians are killed in their own home by Sunni bombers.
21480,4/10/2013,Lebanon,Tripoli,27,358,385,"Sectarian bombers target a rival mosque, killing over two dozen worshippers."
21481,4/10/2013,Iraq,Salaheddin,3,7,10,A Fedayeen suicide bomber kills three other people.
21482,4/10/2013,Iraq,Anbar,3,5,8,Three Iraqis are taken down by a Shahid suicide bomber.
21483,4/10/2013,Egypt,Ismailiya,2,1,3,Islamists shoot two local cops to death.
21484,4/10/2013,Pakistan,Karachi,1,1,2,A targeted sectarian attack leaves a Shia cloth trader dead and his son wounded.
21485,4/10/2013,Afghanistan,Qaisar,2,9,11,Taliban bombers kill two locals.
21486,4/10/2013,Kenya,Mombasa,5,0,5,Five people are shot to death on orders of an Islamic terrorist.
21487,4/10/2013,Pakistan,Islamabad,0,3,3,Two Christian teens and their uncle are badly beaten in their own home for refusing to embrace Islam.
21488,5/10/2013,India,Andhra Pradesh,1,0,1,A jeweler is killed during a robbery to 'fund Jihad operations.'
21489,5/10/2013,Israel,Pesagot,0,1,1,A Palestinian sniper hits a 9-year-old Jewish girl in the neck outside her house.
21490,5/10/2013,Pakistan,Charbagh,2,0,2,Two members of a peace committee are gunned down in cold blood by Religion of Peace radicals.
21491,5/10/2013,CAR,Bangassou,9,0,9,Nine Christians protesting violence by Muslim 'rebels' are killed when their demonstration is attacked.
21492,5/10/2013,Nigeria,Damboa,5,0,5,Five people are slain by Boko Haram rivals as they are leaving a mosque.
21493,5/10/2013,Iraq,Balad,16,32,48,Over a dozen innocents at a cafe in a Shiite town are incinerated by a Sunni suicide bomber.
21494,5/10/2013,Iraq,Mosul,2,0,2,Two local journalists are murdered by Mujahid gunmen.
21495,5/10/2013,Iraq,Yusufiya,3,5,8,al-Qaeda bombers take down three Iraqis.
21496,5/10/2013,Iraq,Baghdad,3,15,18,A Mujahideen bomb at a cafe leaves three dead.
21497,5/10/2013,Iraq,Baghdad,51,109,160,Scores of Shiite pilgrims are reduced to a bloody pulp by a Fedayeen suicide bomber along a bridge.
21498,5/10/2013,Pakistan,Karachi,2,0,2,Two Shiite electrical employees are gunned down by Sunnis on their way home from work.
21499,6/10/2013,Pakistan,Bannu,3,8,11,Three people are blown up by Islamic extremists.
21500,6/10/2013,Nigeria,Gwoza,2,0,2,Islamists shout praises to Allah as they shoot a nurse to death and slit a guard's throat.
21501,6/10/2013,Iraq,Baghdad,14,30,44,A Fedayeen suicide bomber exterminates over a dozen Shiite pilgrims on foot.
21502,6/10/2013,Iraq,Tal Afar,15,90,105,Fourteen children (ages 6 - 12) are disassembled along with their principal by a Shahid suicide bomber at a playground.
21503,7/10/2013,Yemen,Sanaa,1,0,1,A German man is gunned down by al-Qaeda at a grocery store.
21504,7/10/2013,Iraq,Baghdad,5,10,15,A half-dozen Iraqis are murdered by al-Qaeda bombers.
21505,7/10/2013,Iraq,Sadiyah,3,10,13,al-Qaeda hit a shopping district with a bomb that takes the lives of three innocents.
21506,7/10/2013,Iraq,Dora,4,8,12,Four shoppers are taken out by Muslim terrorists.
21507,7/10/2013,Iraq,Baghdad,8,22,30,al-Qaeda bombers murder eight Iraqis with two bombs in a commercial district.
21508,7/10/2013,Iraq,Baghdad,3,10,13,Three patrons at a coffee shop are dismantled by Sunni bombers.
21509,7/10/2013,Iraq,Obeidi,5,8,13,Five people lose their lives to al-Qaeda bombers.
21510,7/10/2013,Iraq,Zafaraniyah,6,21,27,Two car bombs in a Shiite neighborhood leave six dead.
21511,7/10/2013,Iraq,Husseiniya,7,21,28,Seven people at a market are taken out by Mujahid car bombers.
21512,7/10/2013,Iraq,Baghdad,4,11,15,al-Qaeda bombers set off a blast in a neighborhood that wipes out four residents.
21513,7/10/2013,Egypt,al-Tour,5,48,53,Salafis set off a car bomb near an apartment complex that leaves at least five dead.
21514,7/10/2013,Egypt,Ismailiya,5,0,5,Five local cops are machine-gunned by drive-by Islamists.
21515,7/10/2013,Pakistan,Peshawar,6,12,18,"Religious radicals target a polio team with a bomb, killing six."
21516,7/10/2013,Pakistan,Karachi,1,0,1,A 54-year-old Shia doctor and father of four is brutally cut down in his clinic by Sunni gunmen.
21517,7/10/2013,Thailand,Narathiwat,2,0,2,Two civilians on a motorcycle are shot in the head by Muslim 'separatists'.
21518,7/10/2013,Pakistan,Mardan,4,0,4,Two children are among a family of four brutally 'honor killed' in their own home.
21519,8/10/2013,CAR,Gaga,40,50,90,Forty civilians are reported killed by Seleka rebels.
21520,8/10/2013,Iraq,Zafaraniyah,9,16,25,Nine people are killed in a series of attacks including a car bomb at a restaurant in a Shiite neighborhood.
21521,9/10/2013,Syria,Aleppo,10,6,16,At least ten Syrians are blown up by a Fedayeen suicide bomber.
21522,9/10/2013,Thailand,Yala,7,22,29,Thirty-one bombs planted next to ATMs leave seven people dead.
21523,9/10/2013,Thailand,Pattani,1,1,2,A 55-year-old female teacher is killed during an ambush by Muslim militants.
21524,9/10/2013,Iraq,Kut,8,7,15,Eight poultry workers on a truck are torn to shreds by Mujahid bombers.
21525,9/10/2013,Iraq,Baiji,4,6,10,al-Qaeda gunmen roll up on a checkpoint and machine-gun four local cops.
21526,9/10/2013,Afghanistan,Helmand,3,4,7,Three Afghans are sent to Allah by a Fedayeen suicide bomber.
21527,10/10/2013,Israel,Mshadmot Mehola,1,1,2,An Israeli couple is attacked in a residential area.  The husband is bludgeoned to death.
21528,10/10/2013,Iraq,Baghdad,3,8,11,Muslim terrorists take out three people with a bomb in a commercial district.
21529,10/10/2013,Syria,al-Qusayr,6,0,6,Video surfaces of Hezbollah militants executing seriously wounded prisoners while praising Allah.
21530,10/10/2013,Yemen,Mukalla,1,0,1,al-Qaeda gunmen assassinate a local official.
21531,10/10/2013,Pakistan,Lahore,1,13,14,"Jihadis bomb a bustling food market, killing at least one."
21532,10/10/2013,Egypt,al-Reesa,4,3,7,Four people are killed by a Shahid suicide bomber.
21533,10/10/2013,Syria,Jaramana,11,23,34,Eleven people are killed when Sunni terrorists fire mortars into a Christian neighborhood.
21534,11/10/2013,Thailand,Pattani,1,0,1,A car mechanic is taken out by Muslim gunmen.
21535,11/10/2013,Pakistan,Machi Goth,1,0,1,A 15-year-old girl is shot to death by her conservative family over a suspected sexual affair.
21536,11/10/2013,Yemen,Lahj,1,4,5,A suicide bomber at a market and a separate shooting leave at least one dead victim.
21537,12/10/2013,Scotland,Stirling,1,0,1,A Muslim burns his 'too Westernized' wife to death after asserting that Islam teaches a man's superiority over women.
21538,12/10/2013,Afghanistan,Jalalabad,4,8,12,Four people are incinerated by a suicide bomber.
21539,12/10/2013,Iraq,Samarrah,24,32,56,Women and several young children are among two dozen shoppers disassembled by Islamic bombers along a crowded sidewalk.
21540,12/10/2013,Pakistan,Wana,2,2,4,A suicide car bomber takes out two Pakistanis.
21541,12/10/2013,Iraq,Tuz Khormato,4,7,11,A brutal IED attack on a market leaves four shoppers dead.
21542,13/10/2013,Syria,Darkush,39,27,66,"Islamists detonate a car bomb near a market, killing nearly forty."
21543,13/10/2013,Iraq,Diwaniya,9,56,65,Bombs at an ice cream shop and a bakery leave nine dead.
21544,13/10/2013,Iraq,Samarrah,4,10,14,Four Iraqis are blown to bits a Shiite shrine by Sunni suicide bombers.
21545,13/10/2013,Iraq,Samarrah,9,22,31,A car bomb at a funeral takes out five mourners.
21546,13/10/2013,Iraq,Baghdad,14,17,31,"Three al-Qaeda bomb blasts, one at a soccer field, leave fourteen dead."
21547,13/10/2013,Pakistan,Karachi,1,1,2,A child is among two members of a religious minority shot by sectarian Jihadis.
21548,13/10/2013,Iraq,Kut,4,31,35,"Muslim terrorists set off a shrapnel bomb in a bus station, killing at least four commuters."
21549,13/10/2013,Iraq,Hillah,8,27,35,Eight shoppers at a market bleed out following a Mujahideen bomb blast.
21550,13/10/2013,Afghanistan,Kunar,2,0,2,"Two children, ages 8 and 10, are executed by the Taliban on charges of ""spying""."
21551,13/10/2013,Afghanistan,Nuristan,7,9,16,"Fundamentalists fire a rocket into a bazaar, killing seven civilians."
21552,14/10/2013,Ethiopia,Addis Ababa,0,0,0,Two suicide bombers kill only themselves outside a stadium hosting a World Cup qualifier.
21553,14/10/2013,Iraq,Yathrib,3,6,9,Three Iraqis bleed out following an attack by Jihadi bombers.
21554,15/10/2013,Yemen,Lahj,2,4,6,Two guards at a checkpoint are cut down by an al-Qaeda drive-by.
21555,15/10/2013,Afghanistan,Logar,2,18,20,Fundamentalists kill an official at a mosque with a bomb hidden in the microphone.
21556,15/10/2013,Iraq,Kirkuk,12,24,36,Radical bombers murder a dozen worshippers at a rival mosque.
21557,15/10/2013,Yemen,Hadramawt,1,0,1,A local cop is gunned down by al-Qaeda.
21558,15/10/2013,Iraq,Mosul,2,0,2,'Insurgents' murder two brothers on their way to a rival mosque.
21559,16/10/2013,Pakistan,Swat,3,10,13,Three people are killed in two attacks by Islamist militants.
21560,16/10/2013,Pakistan,Kulachi,9,30,39,A Fedayeen suicide bomber takes out nine people at a small village.
21561,16/10/2013,Syria,Daraa,21,12,33,Four children and six women are among twenty-one people exterminated by a Sunni car bomb blast on Eid.
21562,16/10/2013,Iraq,Abu Ghraib,5,16,21,A 4-year-old is among five children who bleed to death after terrorists set off a blast in front of a playground.
21563,16/10/2013,Iraq,Abu Saida,2,3,5,Jihadi bombers pick off two members of the same family.
21564,17/10/2013,Iraq,Tuz Khurmatu,4,27,31,Four people are torn to shreds by a Fedayeen suicide bomb blast.
21565,17/10/2013,Iraq,Mosul,1,3,4,A child is murdered in a targeted Sunni terror attack on a minority religious family.
21566,17/10/2013,Iraq,al-Muwaffaqiyah,15,60,75,Fifteen members of a religious minority community are dismantled by a Shahid suicide bomber.
21567,17/10/2013,Tunisia,Beja,2,1,3,Two police officers are killed by religious radicals.
21568,17/10/2013,Iraq,Baghdad,11,54,65,A Shahid suicide blast is one of several bombings that leave eight dead and dozens more in agony.
21569,17/10/2013,Iraq,Baghdad,7,14,21,Seven patrons at a restaurant are taken out in mid-bite by a Religion of Peace bomb blast.
21570,17/10/2013,Iraq,Baghdad,8,15,23,"Islamists set off a bomb in a Christian neighborhood, killing at least eight residents."
21571,17/10/2013,Iraq,Baghdad,11,22,33,Eleven innocents are sent to Allah by Sunni bombers in a Shia suburb.
21572,18/10/2013,Syria,Deir Ezzor,10,0,10,Ten captured soldiers are executed by al-Nusra.
21573,18/10/2013,Iraq,Sinjar,4,0,4,A mother and her three sons are shot to death by Sunni fundamentalists over their status as religious minorities.
21574,18/10/2013,Iraq,Baqubah,4,5,9,Two members of the same family are among four people killed by al-Qaeda.
21575,18/10/2013,Iraq,Mashtal,3,12,15,Three Iraqis are taken down by Islamic terrorists.
21576,18/10/2013,Afghanistan,Kabul,6,0,6,Four children are among a family of six exterminated by pro-Sharia bombers.
21577,18/10/2013,Egypt,al-Arish,1,0,1,Islamic militants shoot a man seventeen times outside his home.
21578,18/10/2013,Yemen,Ahwar,12,6,18,Twelve local soldiers are sent to Allah by an al-Qaeda suicide bomber.
21579,18/10/2013,Dagestan,Khasavyurt,1,0,1,A policeman is shot to death by an Islamic extremist.
21580,18/10/2013,Iraq,Baghdad,12,23,35,Children are heavily represented among the dozen Iraqis blown up outside an ice cream shop.
21581,19/10/2013,Iraq,Baghdad,3,11,14,Sunni bombers hit a Shia mosque with a blast that rips three worshippers into pieces.
21582,19/10/2013,Somalia,Beledweyne,16,40,56,Sixteen people at a restaurant are torn to shreds by a Fedayeen suicide bomber.
21583,19/10/2013,Syria,Jaramana,16,12,28,At least sixteen people are killed by a suicide bomber at a checkpoint.
21584,20/10/2013,Somalia,Mogadishu,1,0,1,Islamists murder a father of five young children for spreading his Christian faith.
21585,20/10/2013,Iraq,Baghdad,54,70,124,Over fifty innocents lose their lives when one suicide bomber detonates at a packed cafe and another catches others rushing to help.
21586,20/10/2013,Iraq,Baaj,8,5,13,Women are among eight Iraqis taken out by Mujahideen bombers.
21587,20/10/2013,Iraq,Rawa,8,28,36,"Eight suicide bombers manage to kill only one other person apiece, including a child."
21588,20/10/2013,Iraq,Abu Disher,1,0,1,An imam is gunned down at his mosque by Religion of Peace rivals.
21589,20/10/2013,Pakistan,Peshawar,4,0,4,Sunni hardliners roll up on a checkpoint and machine-gun four local cops at point-blank range.
21590,20/10/2013,Egypt,Warraq,4,18,22,"Muslim radicals open fire at church, murdering the pastor, one woman and two young girls."
21591,20/10/2013,Iraq,Narathiwat,5,13,18,A series of bombings and shootings by Muslim 'insurgents' leaves five dead villagers.
21592,20/10/2013,Iraq,Samarrah,6,0,6,A Fedayeen suicide bomber takes out a family of six.
21593,20/10/2013,Nigeria,Logumani,19,0,19,"Boko Haram members block traffic along a highway, then shoot and hack nineteen motorists to death."
21594,20/10/2013,Kenya,Mombasa,1,0,1,Islamic radicals shoot a Christian pastor in the head as he is preparing a Bible study.
21595,20/10/2013,Kenya,Kilifi,1,0,1,Muslims pull a Pentecostal church cleric into the bushes and strangle him.
21596,20/10/2013,Syria,Hama,43,36,79,Over forty motorists are obliterated by a Shahid suicide truck bomber at an agricultural exchange.
21597,21/10/2013,Thailand,Narathiwat,1,1,2,Muslim 'separatists' shoot a man to death in front of his house.
21598,21/10/2013,Afghanistan,Lashkar Gah,2,0,2,A young couple is pulled out of their home and beheaded for living in sin.
21599,21/10/2013,Pakistan,Rawalpindi,5,16,21,A Fedayeen suicide bomber sends five souls on a train straight to Allah.
21600,21/10/2013,Russia,Volgograd,6,37,43,"A Muslim woman detonates an explosives-laden suicide vest on a bus, killing six strangers."
21601,21/10/2013,Nigeria,Borno,10,0,10,Pro-Sharia militants burn down houses and shoot dead ten villagers.
21602,21/10/2013,Iraq,Fallujah,7,20,27,Two suicide bombers take out seven Iraqi policemen.
21603,22/10/2013,Egypt,Sinai,2,5,7,Two Egyptians are incinerated by Islamic bombers.
21604,22/10/2013,Iraq,Ramadi,7,43,50,"Mujahideen spray machine-gun fire into vehicles along a highway, killing at least seven."
21605,22/10/2013,Iraq,Rutba,10,6,16,Ten Iraqis are exterminated by a Fedayeen suicide bomber.
21606,22/10/2013,Iraq,Jurf al-Sakhar,7,9,16,"A young girl is among seven murdered in a series of Jihad attack, including a suicide bombing."
21607,22/10/2013,Iraq,Mosul,2,1,3,A Fedayeen suicide bomber kills two Iraqis.
21608,22/10/2013,Iraq,Hit,3,4,7,"al-Qaeda members shoot a mortar into a house, killing three family members including a child."
21609,23/10/2013,Iraq,Mosul,8,0,8,"al-Qaeda gunmen kill six people, then kidnap and kill two others in captivity."
21610,23/10/2013,Iraq,Madain,4,9,13,A Religion of Peace bomb blast at a market leaves four dead.
21611,23/10/2013,Iraq,Ghazaliyah,3,11,14,Roadside bombers take out three Iraqis.
21612,23/10/2013,Syria,Deir al-Zor,1,0,1,Video surfaces of a man being beheaded in front of children to cries of 'Allah Akbar'.
21613,23/10/2013,Mali,Tessalit,3,0,3,Three people are killed during a suicide assault by Jihadists.
21614,23/10/2013,Egypt,Tamada,1,0,1,Islamists shoot a local soldier through the head.
21615,23/10/2013,Iraq,Musayyab,4,2,6,Four local cops are disassembled by a Shahid suicide bomber.
21616,23/10/2013,Iraq,Abu Ghraib,2,8,10,A Mujahid bomb blast at a market sends two shoppers to Allah.
21617,23/10/2013,Iraq,Mosul,7,12,19,al-Qaeda militants set off a bomb at a shopping mall that leaves five women and two children dead.
21618,23/10/2013,Iraq,Ramadi,14,0,14,"Mujahideen kidnap fourteen local cops, then slit their throats."
21619,23/10/2013,Tunisia,Sidi Bouzidi,8,4,12,"Islamic extremists inside a house open up on security forces coming to arrest them, killing eight."
21620,23/10/2013,Pakistan,Karachi,2,1,3,Two policemen are cut down by the Tehreek-e-Taliban.
21621,24/10/2013,Pakistan,Bannu,1,0,1,A civilian is killed when Islamic militants fire rockets into a police station.
21622,24/10/2013,Nigeria,Damaturu,35,0,35,At least thirty-five others are killed when Boko Haram Islamists assault a town.
21623,24/10/2013,Yemen,Sanaa,1,0,1,al-Qaeda gunmen take down a man outside his home.
21624,24/10/2013,Dagestan,Makhachkala,1,0,1,A man dies from injuries suffered in a brutal bombing by those fighting for an Islamic state.
21625,24/10/2013,Afghanistan,Bla Murghab,4,3,7,A Taliban assault on a police post leaves four local officers dead.
21626,24/10/2013,Egypt,al-Arish,1,0,1,The life of a local policeman is cut short by religious radicals.
21627,24/10/2013,Iraq,Anbar,1,1,2,A woman is killed and her child injured by a suspected al-Qaeda bomb planted at her home.
21628,24/10/2013,Afghanistan,Herat,6,0,6,Fundamentalists murder six people with a roadside bomb.
21629,24/10/2013,Iraq,Mosul,3,30,33,A series of suicide bombings take the lives of three other people.
21630,24/10/2013,Iraq,Yusifiyah,4,11,15,A bombing at a market leaves four dead.
21631,24/10/2013,Iraq,Madain,2,7,9,Cafe bombers take out two Iraqis.
21632,24/10/2013,Iraq,Baghdad,4,7,11,"Muslim terrorists open fire on a restaurant, killing four patrons."
21633,24/10/2013,Pakistan,Karachi,1,3,4,Islamic terrorists are suspected in an IED attack that leaves an 8-year-old boy dead and three others injured.
21634,25/10/2013,Iraq,Buhriz,2,0,2,A man and his wife are murdered by Mujahideen.
21635,25/10/2013,Syria,Suq Wadi Barada,40,36,76,"Terrorists set off a massive car bomb outside a rival mosque, killing at least forty worshippers including children."
21636,25/10/2013,Iraq,Yusufiya,5,15,20,Islamic bombers full five people at a market into separate pieces.
21637,25/10/2013,Iraq,Mosul,3,7,10,A woman is among three people cut down by a Shahid suicide bomber.
21638,25/10/2013,Iraq,Baqubah,7,8,15,A series of bomb attacks leave seven Iraqis dead inside their homes.
21639,25/10/2013,Iraq,Baghdad,4,15,19,Four people at a cafe are taken out in mid-bite by Religion of Peace bombers.
21640,25/10/2013,Pakistan,Karachi,1,0,1,Sipah-e-Sahaba gunmen pick off a Shiite near a college.
21641,25/10/2013,Iran,Sistan,14,7,21,"A Sunni group, Jaish-ul Adl, claims an attack that left fourteen dead."
21642,26/10/2013,Pakistan,Malam Jabba,1,0,1,A member of a peace committee is shot in his car by Muslim militants.
21643,26/10/2013,Pakistan,Mastung,2,3,5,A bomb targeting Shia pilgrims leaves two dead.
21644,26/10/2013,Somalia,Mogadishu,1,0,1,A journalist dies from gunshot injuries suffered during an attack blamed on al-Shabaab.
21645,26/10/2013,Lebanon,Tripoli,13,56,69,Clashes between Sunni and Shia leave thirteen dead.
21646,26/10/2013,Iraq,Baghdad,7,0,7,A family of seven is exterminated in their home by al-Qaeda gunmen.
21647,27/10/2013,Pakistan,North Waziristan,3,7,10,Three civilians are killed when religious hardliners open up on a passing security patrol.
21648,27/10/2013,Iraq,Baghdad,4,7,11,Four Iraqis are taken out by an al-Qaeda car bomb.
21649,27/10/2013,Iraq,Sabaa al-Bour,6,18,24,Six patrons at a market are disassembled by Sunni bombers.
21650,27/10/2013,Iraq,Baghdad,5,11,16,Sunni 'insurgents' take out five Iraqi civilians with a roadside bomb.
21651,27/10/2013,Bangladesh,Jhenidah,2,0,2,At least two opposition party officials are stabbed to death by Islamic loyalists.
21652,27/10/2013,Iraq,Baghdad,6,14,20,Sunni bombers take out six innocents at a market frequented by Shia.
21653,27/10/2013,Iraq,Hurriya,5,12,17,Five people at a market are sectionalized by an al-Qaeda bomb blast.
21654,27/10/2013,Iraq,Baghdad,7,15,22,Two Mujahid car bomb blasts send seven souls to Allah.
21655,27/10/2013,Iraq,Tarmiya,4,11,15,Religion of Peace bombers kill four innocents at a market.
21656,27/10/2013,Iraq,Mosul,9,10,19,"Nine people, including a woman and two construction workers are murdered in a series of Mujahideen attacks."
21657,27/10/2013,Iraq,Mosul,14,55,69,"A Holy Warrior detonates a suicide vest amid a crowd of people, snuffing out the lives of fourteen."
21658,27/10/2013,Iraq,Shaab,8,18,26,A Shiite neighborhood is hit with a bomb blast that leaves eight dead.
21659,27/10/2013,Iraq,Dour,3,0,3,"Three family members, including a father and son, are killed in their own home by al-Qaeda."
21660,27/10/2013,Iraq,Muqdadiya,2,0,2,Two Shiites are shot to death by Sunni rivals.
21661,27/10/2013,Afghanistan,Ghazni,18,5,23,Woman and children are among eighteen civilians slaughtered by a roadside bomb.
21662,27/10/2013,Afghanistan,Kabul,1,5,6,A young girl is killed when Muslim fundamentalists set off a bomb in the street.
21663,27/10/2013,Nigeria,Banki,4,0,4,Four local cops are murdered by pro-Sharia militants.
21664,28/10/2013,England,Essex,1,0,1,A prostitute is killed by a devout Muslim for working too close to his mosque.
21665,28/10/2013,Iraq,Baghdad,6,14,20,A half-dozen people at a cafe are murdered by Sunni bombers.
21666,28/10/2013,Iraq,Abu Ghraib,2,5,7,Two people at a medical clinic are taken down by terrorist bombers.
21667,28/10/2013,Turkey,Sanliurfa,1,0,1,An al-Nusra bomb leaves one dead.
21668,28/10/2013,Egypt,Mansura,3,0,3,Three guards at a secular university are gunned down by Islamic extremists.
21669,28/10/2013,Thailand,Narathiwat,3,1,4,A Muslim roadside bomb kills three members of a bomb disposal unit.
21670,28/10/2013,Nigeria,Kaduna,3,0,3,Boko Haram gunmen kill three policemen.
21671,28/10/2013,China,Beijing,2,38,40,A suicide car bombing at Tiananmen Square kills two tourists.
21672,28/10/2013,Syria,Haffar,13,40,53,At least thirteen innocents are slain when Islamists assault two Christian villages.
21673,29/10/2013,Pakistan,Quetta,2,0,2,Sipah-e-Sahaba shoot two innocent people to death because one is Shiite.
21674,29/10/2013,Iraq,Baghdad,24,15,39,A suicide bomber walks into a house and slaughters two dozen people around the dinner table.
21675,29/10/2013,Iraq,Mosul,2,0,2,A man and his wife are gunned down by Mujahideen.
21676,29/10/2013,Iraq,Mosul,1,0,1,A Christian woman is shot to death in her own home by Muslim extremists.
21677,30/10/2013,Pakistan,Jamrud,1,0,1,Islamists are suspected in the murder of a private school teacher.
21678,30/10/2013,Iraq,Abu Ghraib,3,7,10,"Terrorists bomb a market, killing three patrons."
21679,30/10/2013,Iraq,Mosul,8,25,33,Eight Iraqis are pulled into pieces by a Shahid suicide bomber.
21680,30/10/2013,Dagestan,Makhachkala,2,15,17,Two people are killed and fifteen more hospitalized when fundamentalists bomb a liquor store.
21681,30/10/2013,Thailand,Pattani,1,0,1,Islamic 'separatists' shoot a 41-year-old city official in the head.
21682,30/10/2013,Thailand,Pattani,1,1,2,An older farmer is slain by Muslim 'insurgents'.
21683,30/10/2013,Pakistan,Waziristan,10,18,28,Terrorists kill ten locals with two bombs.
21684,30/10/2013,Yemen,Saada,10,3,13,"Shiites fire a rocket into a Sunni mosque, killing ten worshippers."
21685,31/10/2013,Nigeria,Bama,27,12,39,Islamists roll into a village and massacre over two dozen residents.
21686,31/10/2013,Iraq,Baiji,2,1,3,al-Qaeda gunmen brutally murder two Iraqis.
21687,31/10/2013,Iraq,Tuz Khurmatu,4,0,4,At least four people are murdered by a suicide bomber as they gather at the scene of an earlier blast.
21688,31/10/2013,Iraq,Mosul,12,15,27,Three bombs leave a dozen dead.
21689,31/10/2013,Iraq,Muqdadiya,4,6,10,Mujahideen bombers take down four Iraqis.
21690,31/10/2013,Iraq,Baqubah,5,11,16,Five people at a car dealership are blown to bits by sectarian bombers.
21691,31/10/2013,Iraq,Tuz Khurmatu,6,42,48,Three family members are among six residents obliterated by a Mujahid car bomb in their neighborhood.
21692,31/10/2013,Yemen,Abyan,3,0,3,al-Qaeda gunmen murder three people at a police checkpoint.
21693,1/11/2013,Pakistan,Mach,6,1,7,Lashkar-e-Jhangvi members murder six mine workers who belonged to the minority Hazara community.
21694,1/11/2013,Iraq,Mosul,4,0,4,Four local cops are machine-gunned at point-blank range by activists fighting for an Islamic state.
21695,1/11/2013,Pakistan,Karachi,1,4,5,An Ahmadi is shot to death in a sectarian attack as he is returning from prayers.
21696,1/11/2013,Yemen,Saada,18,50,68,Eighteen people are killed when Shiite extremists attack Sunnis.
21697,2/11/2013,Nigeria,T-Junction,13,0,13,Thirteen villagers are cut down by Boko Haram.
21698,2/11/2013,Yemen,Damaj,27,147,174,Another forty-five people are reported killed in clashes between Sunni and Shia radicals.
21699,2/11/2013,Mali,Kidal,2,0,2,Two French journalists are abducted and slain by al-Qaeda.
21700,2/11/2013,Thailand,Yala,1,0,1,A 51-year-old man is slain by Muslim gunmen outside his rubber plantation.
21701,2/11/2013,Iraq,Samarrah,2,4,6,Two Iraqis are machine-gunned point-blank by al-Qaeda.
21702,2/11/2013,Iraq,Tikrit,7,36,43,Two women are among seven people dismembered by a Mujahid car bomb.
21703,2/11/2013,Nigeria,Borno,30,0,30,"Islamists ambush a wedding party and execute thirty members, including the groom."
21704,2/11/2013,Pakistan,Charsadda,2,0,2,Two young lovers are 'honor killed' by the girl's conservative Muslim family.
21705,3/11/2013,Iraq,Tal Afar,6,9,15,A suicide bombing is among two terror attacks that leave six dead.
21706,3/11/2013,Thailand,Pattani,1,0,1,A 35-year-old Buddhist is shot in the head by Muslim 'insurgents' while having tea.
21707,3/11/2013,Egypt,Ismaila,2,1,3,"Islamists fire automatic weapons into a police checkpoint, killing two officers."
21708,3/11/2013,Yemen,Saada,3,12,15,Three more people are killed when Sunnis and Shia clash.
21709,4/11/2013,Pakistan,Peshawar,1,6,7,A child is pulled into pieces by a militant bomb.
21710,4/11/2013,Iraq,Kirkuk,4,7,11,A pair of Shahid suicide bombers manage to murder four other people.
21711,4/11/2013,Iraq,Baqubah,12,20,32,A dozen Iraqis are taken out by Mujahideen.
21712,4/11/2013,Syria,Sabtiyeh,6,40,46,Three children and a woman are among six villagers exterminated by a Fedayeen suicide bomber.
21713,4/11/2013,Iraq,Mosul,11,4,15,Eleven Iraqis are shot dead by Muslim terrorists in three attacks.
21714,4/11/2013,Yemen,Damaj,4,0,4,Four people are killed when Shia extremists send rockets into a Sunni town.
21715,4/11/2013,Pakistan,Karachi,2,3,5,Two Shiites are shot to death by Sunnis at a tailor shop.
21716,4/11/2013,Dagestan,Makhachkala,1,0,1,The assassination of a judge is thought to be the work of Islamic militants.
21717,4/11/2013,Iraq,Tikrit,12,23,35,A dozen people at a market are torn to shreds by Muslim terrorists.
21718,4/11/2013,Syria,Thabitiyeh,6,37,43,Three children are among six Shiites disassembled by a Sunni car bomb blast.
21719,4/11/2013,Thailand,Pattani,1,0,1,A 52-year-old woman is shot to death by Muslim 'separatists'.
21720,4/11/2013,Pakistan,Karachi,2,0,2,Two Shia doctors are gunned down in separate targeted sectarian attacks.
21721,5/11/2013,Nigeria,Rantis,4,2,6,"Two young boys, ages 2 and 4, are among a family of Christians massacred in their home by militant Muslims."
21722,5/11/2013,Pakistan,Karachi,6,0,6,Six religious Sunnis are gunned down in three targeted attacks by Shiites.
21723,5/11/2013,Pakistan,Karachi,1,0,1,A young seminary student is murdered by Religion of Peace rivals.
21724,5/11/2013,Afghanistan,Kamparack,1,0,1,A British soldier is killed by a suicide bomber.
21725,5/11/2013,Syria,Sadad,30,0,30,The bodies of thirty Christian civilians are found in a mass grave from a 10-21-2013 massacre by Islamists.
21726,5/11/2013,Iraq,Baghdad,2,0,2,A man and his son are shot to death by al-Qaeda.
21727,5/11/2013,Ethiopia,Benishangul,4,10,14,Four passengers are killed by a bomb blast on a bus following threats from al-Shabaab.
21728,5/11/2013,Iraq,Baiji,2,0,2,A man and his wife are murdered by Mujahideen.
21729,5/11/2013,Iraq,Fallujah,2,3,5,Two people are taken out by a Shahid suicide bomber.
21730,5/11/2013,Iraq,Tikrit,4,0,4,Four Iraqis are shot to death by al-Qaeda.
21731,5/11/2013,Tanzania,Gilgal,1,2,3,Religion of Peace proponents hack a young man to death at a church service.
21732,6/11/2013,Syria,Sweida,8,41,49,Eight locals are shredded by a Fedayeen suicide bomber.
21733,6/11/2013,Iraq,al-Salam,7,14,21,A suicide bomber murders seven local cops.
21734,6/11/2013,Syria,Damascus,8,50,58,"Sunni terrorists set off a car bomb at a city square, killing eight innocents."
21735,6/11/2013,Egypt,Sheikh Zuwayed,1,0,1,A Jihadi shoots a local soldier in the head at a training camp.
21736,6/11/2013,Pakistan,Karachi,1,0,1,Sipah-e-Sahaba gunmen pick off a Shiite.
21737,6/11/2013,Thailand,Narathiwat,1,7,8,A bomb planted by Muslim terrorists leaves one dead.
21738,6/11/2013,Iran,Zabol,1,0,1,Jaish al Adl extremists assassinate a local official.
21739,7/11/2013,Afghanistan,Khost,3,6,9,A child is among the casualties of a Taliban bomb blast.
21740,7/11/2013,Iraq,Tikrit,6,0,6,Six family members are slain in their sleep by Islamic terrorists.
21741,7/11/2013,Syria,Sadad,6,0,6,The bodies of six more Christians are found.  The victims were of the same family and included teens and two elderly members.
21742,7/11/2013,Thailand,Narathiwat,1,0,1,Islamic 'insurgents' gun down a 48-year-old outside a furniture store.
21743,7/11/2013,Iraq,Anbar,3,10,13,A Fedayeen suicide bomber ends the lives of three other people.
21744,7/11/2013,Iraq,Baghdad,5,12,17,Five Shia pilgrims are sent straight to Allah by Sunni bombers.
21745,7/11/2013,Iraq,Tarmiya,22,45,67,Suicide bombers slaughter two dozen Iraqis in a coordinated attack.
21746,8/11/2013,Afghanistan,Qalat,8,3,11,"Five women, two children and an elderly man are disassembled by Religion of Peace bombers."
21747,8/11/2013,Israel,Tekoa,0,2,2,A Jewish mother and daughter are burned by a Palestinian firebomb attack.
21748,8/11/2013,Somalia,Mogadishu,11,15,26,A Shahid car bomber exterminates eleven people at a hotel.
21749,8/11/2013,Iraq,Mosul,12,58,70,Mujahid bombers cause a horrific scene with a shrapnel bomb along a shopping district.
21750,8/11/2013,Iraq,Baghdad,5,15,20,Four worshippers bleed to death when rivals set off a bomb outside their mosque.
21751,9/11/2013,Thailand,Narathiwat,1,0,1,Muslim 'separatists' murder a man on a motorcycle.
21752,9/11/2013,Pakistan,Mominpur,2,0,2,"Terrorists fire into a rival mosque, killing two worshippers."
21753,9/11/2013,Pakistan,Gujranwala,1,0,1,An imam is cut down by rivals in the middle of a recitation.
21754,9/11/2013,Thailand,Narathiwat,1,2,3,Three teens are fired on by Muslim 'insurgents' outside a farm.
21755,9/11/2013,Syria,Ashrafieh,6,6,12,Six children are killed when Islamic 'rebels' fire a rocket into a Christian neighborhood.
21756,9/11/2013,Yemen,Damaj,2,12,14,A sectarian clash between Sunni and Shia leaves two dead.
21757,10/11/2013,Syria,Damascus,1,0,1,A 50-year-old MP kidnapped by al-Nusra Islamists is executed in captivity.
21758,10/11/2013,Iraq,Baghdad,7,50,57,A Fedayeen suicide bombing is among a string of terror attacks that leave seven dead.
21759,10/11/2013,Thailand,Pattani,1,0,1,A 63-year-old Buddhist is taken out in a Muslim drive-by.
21760,11/11/2013,Nigeria,Lokoja,4,0,4,Four innocent people lose their lives to a suspected Boko Haram attack.
21761,11/11/2013,Syria,Damascus,9,27,36,Nine children are reportedly crushed to death when an Islamist mortar round hits a Christian school.
21762,11/11/2013,Pakistan,Nazimabad,1,1,2,Sipah-e-Sahaba members gun down a Shiite inside a shop.
21763,12/11/2013,Lebanon,Tripoli,1,0,1,A Sunni cleric is assassinated by suspected Shiites.
21764,12/11/2013,Iraq,Tikrit,1,0,1,A local cop is murdered in his home by suspected al-Qaeda.
21765,13/11/2013,Cameroon,Ashigashia,1,0,1,Islamic extremists murder a Protestant missionary and set several churches ablaze.
21766,13/11/2013,Afghanistan,Chaman,2,0,2,Two local cops are ambushed and murdered by the Taliban.
21767,13/11/2013,Iraq,Garma,4,24,28,"Islamic militants bomb several homes, killing four people."
21768,13/11/2013,Iraq,Salahudin,10,2,12,A suicide truck bomber turns ten Iraqis into bloody pulp.
21769,13/11/2013,Iraq,Baqubah,8,35,43,Eight Shiite pilgrims - including two children - are sent straight to Allah by Sunni co-religionists in three separate bombings.
21770,13/11/2013,Afghanistan,Uruzgan,1,0,1,The Taliban detonate a teenage boy returning home on a bicycle.
21771,13/11/2013,Afghanistan,Farah,2,3,5,Two schoolboys are dismantled by a fundamentalist bomb.
21772,13/11/2013,Syria,Damascus,2,7,9,"Terrorists send a shell into a Christian neighborhood, killing two residents."
21773,13/11/2013,Thailand,Narathiwat,1,0,1,A 26-year-old Buddhist on a motorcycle is machine-gunned by Muslim terrorists.
21774,13/11/2013,Israel,Afula,1,0,1,A 19-year-old soldier sleeping in a bus is brutally stabbed to death by a 16-year-old Muslim.
21775,13/11/2013,Syria,Aleppo,1,0,1,An al-Qaeda video is released showing members beheading a rival.
21776,14/11/2013,Iraq,Baqubah,48,107,155,Two barbaric suicide bombings take the lives of fifty Shia worshippers in separate attacks.
21777,14/11/2013,Iraq,Kut,9,28,37,Three bombs at a Shiite procession leave eight dead.
21778,14/11/2013,Nigeria,Yazza,26,41,67,"Islamists spray automatic weapons fire into a village, taking out two dozen innocents."
21779,14/11/2013,Iraq,Baqubah,1,0,1,The imam at a mosque is shot to death by sectarian rivals.
21780,14/11/2013,Bangladesh,Gaibandha,1,0,1,Jamaat-e-Islami members hack a man to death inside a saloon.
21781,15/11/2013,Chechnya,Grozny,1,0,1,A conservative Muslim punishes his daughter for 'amoral' behavior by killing her.
21782,15/11/2013,Pakistan,Rawalpindi,3,15,18,Three Sunni seminary students are beaten to death by Shia pilgrims.
21783,15/11/2013,Afghanistan,Kandahar,1,0,1,A Muslim cleric is gunned down by Religion of Peace rivals.
21784,15/11/2013,Malaysia,Borneo,1,1,2,al-Qaeda members kill a middle-aged Taiwanese tourist and kill his wife.
21785,15/11/2013,Libya,Tripoli,14,62,76,Fourteen people are killed when an 'Islamist Brigade' opens fire on civilians.
21786,15/11/2013,Thailand,Narathiwat,3,0,3,Three local cops are blown to bits by Muslim 'separatists'.
21787,15/11/2013,Pakistan,Rawalpindi,8,65,73,"Sunnis open fire on a Shia religious procession, killing eight pilgrims."
21788,16/11/2013,Afghanistan,Kabul,12,22,34,At least a dozen people are torn shredded by a Fedayeen suicide bomber.
21789,16/11/2013,Pakistan,Bannu,1,11,12,One person is killed in a roadside bombing by Islamic militants.
21790,16/11/2013,Iraq,Baghdad,7,15,22,Terrorists kill seven Iraqis in a series of attacks.
21791,16/11/2013,China,Serik Buya,2,2,4,A group of Muslims armed with axes and knives attack a local police station and hack two people to death.
21792,17/11/2013,Syria,Damascus,31,0,31,At least 31 people are killed in a blast by Direh al-Aasmeh shouting praises to Allah.
21793,17/11/2013,Egypt,Cairo,1,0,1,Muslim terrorists shoot a man to death outside his home.
21794,17/11/2013,Myanmar,Paut Taw,1,0,1,A 6-year-old girl is raped an murdered in what appears to be a targeted attack on Buddhists.
21795,17/11/2013,Afghanistan,Balkh,1,4,5,A civilian is taken out be a Shahid suicide bomber.
21796,17/11/2013,Afghanistan,Kandahar,6,0,6,Six Afghan contractors are kidnapped and beheaded by Sharia advocates.
21797,17/11/2013,Pakistan,Swabi,2,0,2,Islamic militants slay two policemen at a checkpoint.
21798,17/11/2013,Iraq,Baghdad,3,12,15,al-Qaeda bombers take down three patrons at a vegetable market.
21799,17/11/2013,Iraq,Tuz Khormato,21,40,61,Twenty-one innocent people are sent to Allah by suicide bombers at a popular market.
21800,17/11/2013,Iraq,Baghdad,3,10,13,Three Iraqis at a liquor store a commercial area are pulled into pieces by fundamentalist bombers.
21801,17/11/2013,Iraq,Baghdad,4,11,15,A bomb set in a car showroom leaves four dead.
21802,18/11/2013,Afghanistan,Paktika,7,3,10,Holy Warriors take out seven children playing in the road.
21803,18/11/2013,Afghanistan,Zabul,2,2,4,Two children are pulled into pieces by fundamentalist bombers.
21804,18/11/2013,Pakistan,Naseerabad,1,0,1,A truck driver is murdered by the Taliban.
21805,18/11/2013,Yemen,Belhaf,8,0,8,Eight local cops are ambushed and riddled with bullets by al-Qaeda members.
21806,18/11/2013,Pakistan,Rawalpindi,69,45,114,An additional sixty-seven people are reported killed in sectarian strife between Sunni and Shia.
21807,18/11/2013,Pakistan,Nazimabad,2,0,2,Tehreek-i-Taliban members gun down two local cops.
21808,18/11/2013,Pakistan,Kohat,2,0,2,Two people are killed in a Sunni-Shia sectarian clash.
21809,18/11/2013,Iraq,Baqubah,2,0,2,A man and his son are murdered by al-Qaeda gunmen.
21810,18/11/2013,Iraq,Abu Ghraib,1,3,4,An old woman bleeds to death following a Mujahid bomb attack on her home.
21811,19/11/2013,Lebanon,Beirut,26,150,176,An Abdullah Azzam Brigades suicide blast at the Iranian embassy leaves two dozen people dead.
21812,19/11/2013,Thailand,Pattani,1,2,3,Muslim 'separatists' are suspected of shooting a man and his two sisters in front of their house.
21813,19/11/2013,Pakistan,Quetta,1,0,1,A Shiite dies from gunshot injuries suffered from Sipah-e-Sahabah terrorists.
21814,19/11/2013,Nigeria,Gombe,1,0,1,A local cop is gunned down by Boko Haram.
21815,19/11/2013,Somalia,Beledweyne,20,12,32,Twenty people are disassembled by Religion of Peace suicide bombers.
21816,19/11/2013,Pakistan,Gujrat,2,0,2,A Shiite university professor and his driver are assassinated by sectarian Jihadis.
21817,20/11/2013,Syria,Qalamoun,7,5,12,Two suicide bombers take out seven Syrians.
21818,20/11/2013,Afghanistan,Helmand,1,1,2,An early morning Taliban attack leaves one dead.
21819,20/11/2013,Iraq,Najaf,2,9,11,Two commuters are killed when al-Qaeda bombers target their bus.
21820,20/11/2013,Yemen,Hadramawt,3,0,3,"al-Qaeda members open fire on a group of police officer, killing three."
21821,20/11/2013,Pakistan,Miranshah,7,1,8,Seven people are killed when a Fedayeen suicide bomber rams their car.
21822,20/11/2013,Pakistan,North Waziristan,3,8,11,Shahid suicide bombers take the lives of three other people.
21823,20/11/2013,Egypt,al-Arish,11,35,46,Islamic militants detonate a car bomb that leaves eleven Egyptians dead.
21824,20/11/2013,Afghanistan,Kandahar,3,22,25,Three people bleed to death following a Fedayeen suicide attack.
21825,20/11/2013,Pakistan,Karachi,1,2,3,"Sunnis fire on a group of Shia civilians outside their home, killing one."
21826,20/11/2013,Iraq,Shaab,4,11,15,Four people are blown to bits by Mujahid bombers.
21827,20/11/2013,Iraq,Hurriya,4,9,13,'Insurgents' set off a bomb near a school which leaves four dead.
21828,20/11/2013,Iraq,Bayaa,15,22,37,"A Shahid suicide bomber wades into an Internet cafe and detonates, sending fifteen souls to Allah."
21829,20/11/2013,Iraq,Baghdad,5,10,15,"Fundamentalists bomb a bar, killing five patrons."
21830,20/11/2013,Iraq,Baghdad,5,13,18,"Terrorists bomb a bakery, killing five people in line for bread."
21831,20/11/2013,Iraq,Baghdad,7,19,26,Sunni bombers murder seven people preparing food for a Shia observance.
21832,21/11/2013,Nigeria,Adamawa,6,3,9,"Boko Haram Islamists move from house to house, shooting six residents to death."
21833,21/11/2013,Nigeria,Sandiya,12,12,24,"Gunmen shoot up a small village while shouting praises to Allah, killing a dozen."
21834,21/11/2013,Iraq,Saadiyah,48,50,98,"Mujahideen blow up an outdoor vegetable market with a truck bomb, taking out nearly fifty patrons, including children."
21835,21/11/2013,Egypt,Qulubiya,1,0,1,Ansar Beit al-Maqdis gunmen murder a local cop.
21836,21/11/2013,Pakistan,Khanewal,0,1,1,An 18-year-old girl is tied to a tree and set on fire by her brothers on suspicion of sex.
21837,21/11/2013,Pakistan,Torkham,0,26,26,Dozens are injured when a suicide bomber detonates at a customs office.
21838,21/11/2013,Iraq,Salahuddin,1,2,3,al-Qaeda gunmen shoot a child to death in his own home.
21839,21/11/2013,Iraq,Taji,6,12,18,A half-dozen Iraqis are ripped to shreds by a Fedayeen suicide bomber.
21840,21/11/2013,Iraq,Baghdad,11,22,33,Islamic terrorists murder eleven Iraqis in a series of attacks.
21841,22/11/2013,Yemen,Sanaa,1,0,1,A man is gunned down by sectarian rivals outside a mosque.
21842,22/11/2013,Pakistan,Karachi,7,48,55,A child is among seven killed in a bomb blast by Tehreek-e-Taliban suicide bombers at a shopping area.
21843,22/11/2013,Pakistan,Mohmand,3,4,7,Religion of Peace bombers murder three people riding in a car.
21844,22/11/2013,Pakistan,Rawalpindi,1,0,1,A Shiite is gunned down at a grocery store in a suspected sectarian attack.
21845,22/11/2013,Iraq,Khalis,2,0,2,An imam and his relative are shot to death in front of their mosque by Religion of Peace rivals.
21846,22/11/2013,Iraq,Baghdad,4,15,19,Bombs at two Sunni mosques send four worshippers to Allah in mid-prayer.
21847,22/11/2013,Iraq,Baghdad,8,17,25,Eight patrons at a soda shop are sent to the great beyond by Muslim bombers.
21848,22/11/2013,Pakistan,Malakand,2,0,2,Two young lovers are shot to death by conservative family members.
21849,22/11/2013,Thailand,Pattani,1,0,1,A 37-year-old Buddhist villager is machine-gunned by suspected Muslim militants.
21850,23/11/2013,Pakistan,Baghlan,2,0,2,Conservative locals shoot a young couple to death for eloping without permission.
21851,23/11/2013,Pakistan,Karachi,1,2,3,"Sectarian rivals shoot at three seminary students, killing one."
21852,23/11/2013,Iraq,Tuz Khurmatu,10,45,55,A suicide attack on a Shia mosque leaves ten worshippers dead.
21853,24/11/2013,Afghanistan,Takhar,1,3,4,A local official is murdered by Sunni fundamentalists.
21854,24/11/2013,Pakistan,Karimkot,2,5,7,A shrapnel bomb ends the lives of two security personnel.
21855,24/11/2013,Nigeria,Borno,8,0,8,A Boko Haram spree leaves at least eight farmers dead.
21856,24/11/2013,Iraq,Mosul,1,0,1,A Christian journalist is gunned down in a targeted attack.
21857,24/11/2013,Yemen,Seyoun,3,2,5,Religious extremists ambush and murder three local cops.
21858,24/11/2013,Nigeria,Kuka,5,30,35,Five residents of a Christian village are shot dead by Muslim terrorists.
21859,24/11/2013,Pakistan,Quetta,1,0,1,'Sectarian hatred' is blamed for a Sunni on Shia murder.
21860,25/11/2013,Libya,Benghazi,5,23,28,An Ansar-al-Sharia attack leaves five dead.
21861,25/11/2013,Iraq,Baghdad,3,4,7,Three Iraqis are dispatched by a Fedayeen suicide car bomber.
21862,25/11/2013,Iraq,Baghdad,23,32,55,A vicious double-bombing at a cafe snuffs out the lives of twenty-three patrons and first responders.
21863,25/11/2013,Pakistan,Parachinar,3,1,4,Three young Shia are disassembled by two bombs planted by religious radicals.
21864,25/11/2013,Dagestan,Khasavyurt,1,1,2,Islamists are suspected of spraying machine-gun fire into a vehicle.
21865,25/11/2013,Pakistan,Karachi,2,0,2,A man and his wife are murdered merely for being Shia.
21866,25/11/2013,Iraq,Mosul,2,4,6,A Shahid suicide bomber takes out two locals.
21867,25/11/2013,Iraq,Mosul,4,30,34,Terrorists wipe out four locals with a bomb placed in a busy street.
21868,26/11/2013,Pakistan,Hyderabad,1,0,1,A Shiite is picked off by Sipah-e-Sahaba gunmen.
21869,26/11/2013,Syria,Damascus,11,0,11,Terrorists reportedly ambush two ambulances and massacre eleven medical personnel.
21870,26/11/2013,Syria,Somariyeh,15,30,45,"A Shahid suicide bomber detonates a bus stop, taking fifteen souls with him."
21871,26/11/2013,Iraq,Tarmiyah,7,22,29,An al-Qaeda suicide bomber kills seven people at a local army base.
21872,26/11/2013,Nigeria,Barkin Ladi,37,12,49,Thirty-seven Christians in four villages are slaughtered by Muslim raiders.  The dead included children and pregnant women shot at close range.
21873,26/11/2013,Yemen,Sanaa,1,1,2,A non-Muslim is shot to death by al-Qaeda.
21874,26/11/2013,Afghanistan,Oruzgan,3,0,3,Three aid workers are pulled into pieces by a Religion of Peace shrapnel blast.
21875,26/11/2013,Pakistan,Hyderabad,5,3,8,Five people are shot to death by suspected Islamists.
21876,26/11/2013,Bangladesh,Satkhira,2,0,2,Jamaat-e-Islami beat and hack two men to death.
21877,26/11/2013,Iraq,Taji,4,9,13,A suicide bomber murders four policemen.
21878,27/11/2013,Iraq,Abu Ghraib,12,32,44,"A Fedayeen suicide bomber detonates at a funeral, putting a dozen mourners out of their misery."
21879,27/11/2013,Afghanistan,Pashtun Kot,6,1,7,Six members of a humanitarian team are dragged from their car and executed by Islamic extremists.
21880,27/11/2013,Iraq,Baghdad,5,0,5,Five members of a family are slaughtered in their home by Muslim militants.
21881,27/11/2013,Iraq,Ramadi,4,11,15,Two suicide bombings leave four dead Iraqis.
21882,27/11/2013,Iraq,Baghdad,14,0,14,Fourteen victims of sectarian militia are found bound and shot.
21883,27/11/2013,Syria,Idlib,7,0,7,ISIL Islamists execute seven members of a more moderate Islamist group on video.
21884,27/11/2013,Iraq,Hadhar,3,0,3,A cab driver and two teachers are murdered by suspected Mujahideen.
21885,27/11/2013,Iraq,Jbara,1,9,10,A security guard is taken out by a Shahid suicide bomber.
21886,27/11/2013,Iraq,Doura,2,3,5,"Terrorists bomb a vegetable market, killing two patrons."
21887,27/11/2013,Iraq,Khanaqin,2,0,2,al-Qaeda gunmen shoot a man and wife to death in their home.
21888,28/11/2013,Pakistan,Karachi,1,0,1,"A convert to Shiism is beheaded by Sunni radicals, who then hang his head from a bridge."
21889,28/11/2013,Nigeria,Damboa,17,6,23,Seventeen villagers are slaughtered by machete-wielders shouting praises to Allah.
21890,28/11/2013,Israel,Jerusalem,0,1,1,Arabs crush an Israeli baby's skull with rocks.
21891,28/11/2013,Iraq,Tikrit,1,3,4,A suicide bomber manages to take out one other person.
21892,28/11/2013,Afghanistan,Nangarhar,6,10,16,"Two Taliban bombs kill six civilians, including five rushing to help the first victim."
21893,28/11/2013,Pakistan,Karachi,1,0,1,A man posing as a religious advisor is beheaded by angry fundamentalists.
21894,28/11/2013,Iraq,Tikrit,7,7,14,Seven people are aerated by a Religion of Peace shrapnel bomb.
21895,28/11/2013,Iraq,Samarrah,3,9,12,Three people are laid out by a Fedayeen suicide bomber.
21896,28/11/2013,Iraq,Suwayrah,5,14,19,Five civilians in a commercial area are reduced to pulp by Mujahid bombers.
21897,28/11/2013,Iraq,Najaf,7,12,19,Sunni bombers take out seven Iraqis.
21898,28/11/2013,Iraq,Hillah,9,31,40,Car bombs targeting Shia shoppers leaves nine dead.
21899,28/11/2013,Libya,Benghazi,4,0,4,"Four soldiers are killed by Ansar al-Sharia for 'imposing something that is not part of the religion."""
21900,29/11/2013,Iraq,Tarmiyah,18,0,18,Eighteen civilians are rounded up and brutally shot in the head by suspected al-Qaeda.
21901,29/11/2013,Afghanistan,Helmand,1,4,5,A suicide bomber kills one other person.
21902,29/11/2013,Iraq,Baghdad,5,9,14,Jihadis kill five spectators by detonating a bomb at a soccer field.
21903,29/11/2013,Iraq,Baghdad,7,0,7,Fundamentalists storm a brothel and murder six women and one man.
21904,29/11/2013,Iraq,Salaheddin,7,0,7,Islamists kidnap seven laborers and maintenance staff from a soccer stadium and cut their throats.
21905,29/11/2013,Libya,Benghazi,2,0,2,Two more security personnel are murdered by suspected Ansar al-Sharia.
21906,29/11/2013,Syria,Damascus,4,26,30,"Terrorists reportedly fire a rocket at a mosque, killing four worshippers."
21907,29/11/2013,Afghanistan,Kandahar,1,2,3,A child is blown to bits by a Holy Warrior with a suicide belt.
21908,30/11/2013,Pakistan,Mohmand,3,2,5,Tehreek-e-Taliban kill three local police officers.
21909,30/11/2013,Iraq,Mahmoudiya,4,7,11,Mujahideen blow up a bus stop along with four commuters.
21910,30/11/2013,Pakistan,Peshawar,1,0,1,"Fundamentalists fire on an polio team, killing a guard."
21911,30/11/2013,Nigeria,Baga,7,15,22,Seven fisherman are ambushed and slain by Boko Haram.
21912,30/11/2013,Iraq,Baghdad,20,28,48,Twenty Iraqis are taken out by a series of Mujahideen attacks.
21913,30/11/2013,Egypt,Minya,0,14,14,"Muslims rampage through a Christian village, burning homes and throwing children from roofs."
21914,30/11/2013,Thailand,Pattani,1,2,3,Muslim 'insurgents' are suspected of the cold blooded murder of a father in front of two young children.
21915,1/12/2013,Pakistan,Karachi,2,0,2,Two Shiite brothers are gunned down by Sipah-e-Sahaba terrorists.
21916,1/12/2013,Iraq,Sadiya,6,5,11,Mujahid bombers end the lives of a half-dozen people at a cafe.
21917,1/12/2013,Iraq,Baghdad,5,0,5,Two women and two children are among a family of five murdered in their own home by sectarian Jihadis.
21918,1/12/2013,Iraq,Muqdadya,12,25,37,A Shahid suicide bomber sends twelve mourners at a funeral straight to Allah.
21919,1/12/2013,Lebanon,Sidon,2,1,3,Two people are murdered by Jund al-Sham militants.
21920,1/12/2013,Libya,Benghazi,1,1,2,A father is shot to death in front of his own son by suspected Sharia advocates.
21921,1/12/2013,Lebanon,Tripoli,3,1,4,A sniper picks off three men in a truck for having the wrong religion.
21922,1/12/2013,Kenya,Mombasa,1,0,1,A man is kidnapped from his home and beheaded by Islamic extremists.
21923,2/12/2013,Nigeria,Maiduguri,2,0,2,Terrorists chanting 'Allah Akbar' hack two brothers to death in their home.
21924,2/12/2013,Iraq,Mosul,2,6,8,A bomb targeting oil workers leaves two dead.
21925,2/12/2013,Afghanistan,Kabul,4,17,21,A suicide truck bomber incinerates at least four other people.
21926,2/12/2013,Tunisia,Mount Chaambi,1,0,1,An engineer is taken out by al-Qaeda bombers.
21927,2/12/2013,Iraq,al-Nibaie,6,0,6,Children are among a family of six massacred in their home by Islamists.
21928,2/12/2013,Pakistan,Mansehra,1,0,1,A 15-year-old girl is 'honor killed' by her brother on suspicion of an affair.
21929,3/12/2013,Iraq,Tikrit,22,30,52,Twenty-two people are a welfare office are ripped into pieces by four Holy Warriors with suicide belts.
21930,3/12/2013,Iraq,Abu Ghraib,2,8,10,Jihads murder two patrons at a vegetable market.
21931,3/12/2013,Iraq,Baghada,6,13,19,"A Sunni car bomb rips through a Shia district, leaving six dead."
21932,3/12/2013,Lebanon,Hadath,1,0,1,The Free Sunnis of Baalbek Battalion assassinate a Shia leader outside his house.
21933,3/12/2013,Thailand,Pattani,1,0,1,A 49-year-old villager is killed by suspected Muslim 'insurgents'.
21934,3/12/2013,Pakistan,Karachi,3,2,5,"Shia militia are suspected of firing into a group of Sunnis, killing three."
21935,3/12/2013,Pakistan,Matta,1,0,1,A peace committee member is gunned down by Islamic extremists.
21936,3/12/2013,Pakistan,Karachi,2,0,2,A prayer leader is among two Shiites assassinated by Sunni gunmen.
21937,3/12/2013,Afghanistan,Marjah,2,10,12,"Religious radicals bomb a market, wiping out two patrons."
21938,3/12/2013,Afghanistan,Gareshk,4,2,6,Four civilians lose their lives to fundamentalist bombers.
21939,3/12/2013,Afghanistan,Zabul,3,4,7,Three local cops are take out by a Taliban bomb.
21940,3/12/2013,Pal. Auth.,Gaza,1,0,1,"Hamas is accused of beating a man in front of his wife, kidnapping him and then torturing him to death."
21941,3/12/2013,Syria,Damascus,4,17,21,Four locals are blown to bits by a Shahid suicide bomber.
21942,3/12/2013,Iraq,Tarmiyah,9,17,26,Two Fedayeen suicide bombers slaughter nine people who gathered at the scene of an earlier bombing.
21943,4/12/2013,Syria,Idlib,1,0,1,A cameraman is kidnapped and executed by an al-Qaeda linked group.
21944,4/12/2013,Afghanistan,Panjwayi,4,0,4,"A man, his wife and two children are exterminated by a Taliban bomb."
21945,4/12/2013,India,Ambedkar Nagar,1,0,1,Muslim activists gun down a Hindu.
21946,5/12/2013,CAR,Bangui,3,0,3,"Three pastors, including a father of eleven, are murdered in a Muslim rampage."
21947,5/12/2013,Libya,Benghazi,1,0,1,An American teacher is murdered by gunmen while jogging.
21948,5/12/2013,Somalia,Bosasso,7,37,44,Pro-Sharia activists detonate a car bomb that leaves seven dead.
21949,5/12/2013,Iran,Khuzestan,4,0,4,Four Arab political activists are executed for 'being enemies of Allah'.
21950,5/12/2013,Libya,Benghazi,2,0,2,Two young soldiers are shot in the head by suspected Ansar al-Sharia.
21951,5/12/2013,Iraq,Kirkuk,6,79,85,"Fedayeen suicide bombers attack a shopping mall, exterminating six innocents."
21952,5/12/2013,Iraq,Mosul,7,0,7,al-Qaeda shootings and bombings leave seven dead.
21953,5/12/2013,Yemen,Sanaa,52,167,219,Six doctors are among fifty innocents slaughtered in a massive suicide attack on a hospital.
21954,5/12/2013,Bangladesh,Satkhira,1,2,3,Islami Chhatra Shibir gunmen shoot secular activist to death outside his home.
21955,6/12/2013,Pakistan,Karachi,3,0,3,Three Sunnis are picked off at an eatery by Shia gunmen.
21956,6/12/2013,Somalia,Mogadishu,1,0,1,A lawmaker is taken out by a suspected al-Shabaab bomb.
21957,6/12/2013,Syria,Qamishli,6,10,16,A Shahid suicide car bombing rocks a neighborhood and snuffs out the lives of six residents.
21958,6/12/2013,Iraq,Baghdad,5,14,19,Two Mujahideen blasts leave five dead.
21959,6/12/2013,Iraq,Dor,5,11,16,A Fedayeen suicide bomber sends five other souls to Allah.
21960,6/12/2013,Iraq,Tikrit,3,8,11,Three Iraqis are taken out by a Shahid suicide bomber.
21961,6/12/2013,Philippines,Marawi,1,1,2,Moro Islamists murder a civilian.
21962,6/12/2013,Pakistan,Peshawar,2,0,2,Two Sunni brothers are gunned down by Sipah-e-Sahaba for being too friendly with Shiites.
21963,7/12/2013,Syria,Aleppo,1,0,1,A man is beheaded with a heavy machine-gun to shouts of 'Allah Akbar'.
21964,7/12/2013,Iraq,Mosul,3,14,17,Three people at a market are sectionalized by a Religion of Peace blast.
21965,7/12/2013,Iraq,Baghdad,9,6,15,Islamic fundamentalists murder nine patrons at alcohol shops.
21966,7/12/2013,Syria,Homs,7,0,7,The bodies of seven Christians are found brutally tortured and beheaded by Islamist 'rebels'.
21967,8/12/2013,Pakistan,Haider Shah,1,0,1,An 18-year-old girl is stabbed to death by her conservative brother for having an affair.
21968,8/12/2013,Yemen,Sanaa,2,0,2,al-Qaeda is suspected in the assassination of two army officers.
21969,8/12/2013,Pakistan,Karachi,1,0,1,A 42-year-old Shiite is gunned down by angry Sunnis.
21970,8/12/2013,Iraq,Baghdad,13,112,125,A series of smaller terror attacks leave thirteen dead.
21971,8/12/2013,Iraq,Jamila,3,16,19,Mujahideen wipe out three shoppers at a market.
21972,8/12/2013,Iraq,Husseiniyah,3,13,16,A bombing near a restaurant kills three innocents.
21973,8/12/2013,Iraq,Baghdad,6,22,28,Six Iraqis are dismantled by Islamic bombers at a tax office.
21974,8/12/2013,Iraq,Baghdad,6,19,25,Six shoppers at a Shia market are disintegrated by al-Qaeda bombers.
21975,8/12/2013,Iraq,Baghdad,7,20,27,"Jihadis detonate a car bomb along a commercial district, killing seven."
21976,8/12/2013,Somalia,Elbur,1,0,1,A tribal elder is kidnapped and murdered by al-Shabaab militants.
21977,9/12/2013,Syria,Idlib,1,0,1,An oil vendor is executed by Islamists for 'blasphemy'.
21978,9/12/2013,Afghanistan,Saripul,3,1,4,A Taliban bomb produces three dead children.
21979,9/12/2013,Dagestan,Khasavyurt,1,0,1,A security official is picked off by suspected Hizb Ut-Tahrir.
21980,9/12/2013,Bangladesh,Bogra,1,0,1,A college professor is stabbed to death by Jamaat-e-Islami students.
21981,9/12/2013,Bangladesh,Dhaka,1,0,1,Jamaat-e-Islami gun down a 55-year-old man.
21982,9/12/2013,Iraq,Baghdad,3,7,10,Three patrons at a Shia market are laid out by Sunni bombers.
21983,9/12/2013,Iraq,Baghdad,2,3,5,Two Iraqis are taken out by al-Qaeda bombers.
21984,9/12/2013,Iraq,Buhriz,12,24,36,A brutal bomb blast at a cafe kills a dozen patrons.
21985,9/12/2013,Afghanistan,Badghis,6,3,9,A half dozen family members are crushed to death in their home by a Taliban rocket.
21986,10/12/2013,Bangladesh,Gazipur,2,0,2,A young woman and her 7-year-old daughter are burned to a crisp when Islami Chhatra Shibir radicals set fire to their lorry.
21987,10/12/2013,Iraq,Baqubah,7,0,7,Seven Shia shepherds are murdered in cold blood by Sunni extremists.
21988,10/12/2013,Iraq,Baqubah,11,19,30,Eleven worshippers at a Shiite mosque are exterminated by a Shahid suicide bomber.
21989,10/12/2013,Kenya,Garissa,8,0,8,Eight Kenyans are killed when al-Shabaab militants spray a car with automatic weapons.
21990,10/12/2013,Iraq,Abara,7,0,7,Seven Sunni construction workers are shot to death by Mujahideen.
21991,10/12/2013,Iraq,Diyala,6,0,6,Six family members are torn to pieces by Mujahid bombers while preparing for a funeral.
21992,11/12/2013,India,Srinagar,1,1,2,Two local soldiers guarding a highway are machine-gunned by Muslim militants.
21993,11/12/2013,Pakistan,Quetta,1,0,1,A mob murders a man for wrapping fruit in pages from the Quran.
21994,11/12/2013,Thailand,Pattai,4,17,21,Four local cops are taken out by a roadside bomb.
21995,11/12/2013,Thailand,Yala,1,0,1,Suspected Muslim 'insurgents' murder a man on his way to work.
21996,11/12/2013,Nigeria,Borno,9,3,12,"Pro-Sharia activists attack random cars on the highway, slitting the throats of nine travelers."
21997,11/12/2013,Iraq,Madaen,17,11,28,A father and son murdered by al-Qaeda are among seventeen Iraqis taken out in various attacks.
21998,11/12/2013,Pakistan,Karachi,1,0,1,A Quran teacher is shot to death by sectarian rivals.
21999,12/12/2013,Somalia,Baidoa,10,9,19,Gunmen 'chanting religious slogans' shoot up a small town.
22000,12/12/2013,Thailand,Pattani,1,8,9,Muslim 'separatists' shoot a villager and set off a bomb at a school.
22001,12/12/2013,Egypt,Ismailiya,1,35,36,A bomb planted by religious radicals leaves one dead.
22002,12/12/2013,Pakistan,Miranshah,2,7,9,Islamic militants murder two security personnel.
22003,12/12/2013,Syria,Gevere,4,0,4,"Islamists butcher four villagers who came to negotiate with them, cutting off ears and noses."
22004,12/12/2013,Pakistan,Spinwam,4,0,4,Ansar-ul-Mujahideen murder four locals with a roadside bomb.
22005,12/12/2013,Bangladesh,Satkhira,2,0,2,Islami Chhatra Shibi radicals stab two men to death.
22006,12/12/2013,Iraq,Tarmiya,5,13,18,Five Iraqis are sectionalized by a Fedayeen suicide bomber.
22007,13/12/2013,Iraq,Imam Wais,18,6,24,Eighteen oil workers are massacred by Islamic militants at a pipeline.
22008,13/12/2013,Pakistan,Jamrud,1,0,1,A medical worker is shot to death by religious fundamentalists.
22009,13/12/2013,Pakistan,Swabi,2,0,2,Four gunmen murder two guards providing security for polio workers.
22010,13/12/2013,Syria,Adra,80,0,80,At least eighty ordinary Shiites are executed by Sunni radicals over a two-day spree.
22011,13/12/2013,Bangladesh,Satkhira,2,0,2,Jamaat-e-Islami militants hack a man to death and gun down a kindergarten student.
22012,13/12/2013,Iraq,Ramadi,5,7,12,A suicide bomber sends five other souls to Allah.
22013,13/12/2013,Iraq,Madaen,6,18,24,A half-dozen people lose their lives to a Mujahid car bomb.
22014,13/12/2013,Iraq,Bahgdad,5,14,19,Jihadi car bombers aerate five Iraqis.
22015,13/12/2013,Pakistan,Faisalabad,1,0,1,A 35-year-old single woman is beaten to death on suspicion of having sexual relations.
22016,14/12/2013,Syria,Atmeh,3,0,3,Three secular Sunnis are kidnapped and executed by the Islamic Front.
22017,14/12/2013,DRC,North Kivu,21,3,24,"ADF-Nalu terrorists massacre twenty-one villagers, including children."
22018,14/12/2013,Iraq,Baghdad,7,16,23,Seven Shiite pilgrims are sent straight to Allah by their Sunni brothers.
22019,14/12/2013,Iraq,Husseiniyah,2,7,9,Two patrons at a restaurant are disassembled in mid-bite by a Sunni bomb blast.
22020,14/12/2013,Iraq,Baghdad,5,14,19,Five shoppers at a market are sectionalized by Jihadi car bombers.
22021,14/12/2013,Mali,Kidal,2,5,7,Two UN troops guarding a bank are wiped out by a suicide bomber.
22022,14/12/2013,Kenya,Nairobi,6,24,30,"Islamic militants toss a grenade at a mini-bus, killing six passengers."
22023,14/12/2013,CAR,Bangui,1,0,1,A Bible translator is shot and killed by Christian-seeking Muslims.
22024,14/12/2013,Nigeria,Arboko,4,0,4,"Islamists attack a Christian village, slaughtering four inhabitants and burning on-hundred homes."
22025,15/12/2013,Pakistan,Lahore,1,0,1,A prominent Shia cleric is assassinated by Sunni rivals.
22026,15/12/2013,Libya,Sidon,1,3,4,A suicide bomber steps out of a car and kills a Lebanese soldier at a checkpoint.
22027,15/12/2013,Iraq,Baghdad,9,27,36,Sunnis take out nine Shiites with two bombs.
22028,15/12/2013,Iraq,Khanaqin,5,0,5,Three Shia children and their parents are exterminated by Sunni bombers.
22029,15/12/2013,Afghanistan,Nangarhar,4,7,11,Taliban bombers take down four Afghans.
22030,15/12/2013,Iraq,Mosul,1,0,1,Fundamentalists shoot a female TV host to death.
22031,15/12/2013,Somalia,Elbur,1,0,1,Pro-Sharia activists kidnap and murder a tribal elder.
22032,15/12/2013,Afghanistan,Kunar,4,1,5,Four civilians are pulled into pieces by a Shahid suicide bomber.
22033,15/12/2013,Thailand,Narathiwat,2,0,2,A Buddhist couple in their 60's are shot to death by Muslim 'separatists'.
22034,15/12/2013,Libya,Benghazi,1,0,1,A man dies an agonizing death in the aftermath of an Ansar al-Sharia car bombing.
22035,15/12/2013,Israel,Rosh Hanikra,1,0,1,A Hezbollah sniper shoots an IDF soldier across the border.
22036,15/12/2013,Bangladesh,Nilphamari,5,50,55,Islami Chhatra Shibir kill five rivals.
22037,16/12/2013,Iraq,Baghdad,4,14,18,A bloody bomb attack on a bus station by Islamists leaves four dead.
22038,16/12/2013,Iraq,Tikrit,2,7,9,Two civilians are blown to bits by three Shahid suicide bombers.
22039,16/12/2013,Egypt,Cairo,1,0,1,Muslim Brotherhood supporters slit the throat of a cab driver.
22040,16/12/2013,Iraq,Baghdad,5,14,19,Five people in a residential neighborhood are reduced to pulp by Islamic bombers.
22041,16/12/2013,Iraq,Baghdad,6,12,18,An al-Qaeda car bomb at a parking lot produces six dead Iraqis.
22042,16/12/2013,Iraq,Beiji,8,5,13,Four Fedayeen suicide bombers kill eight local policemen.
22043,16/12/2013,Pakistan,Peshawar,1,0,1,Another healthcare professional is murdered by suspected Islamists.
22044,16/12/2013,Iraq,Rashid,23,55,78,Two dozen pilgrims are sent straight to Allah by a brutal Sunni double car-bombing.
22045,16/12/2013,Iraq,Mosul,12,8,20,al-Qaeda gunmen board a bus and summarily execute a dozen Shiite pilgrims.
22046,16/12/2013,China,Kashgar,2,0,2,Two policemen are reportedly beaten to death by a Muslim mob.
22047,16/12/2013,Pakistan,Peshawar,4,1,5,Terrorists remotely detonate a bomb while it is being examined.  Four disposal experts are killed in the blast.
22048,16/12/2013,Thailand,Pattani,1,0,1,A Buddhist bread vendor is murdered by suspected 'insurgents'.
22049,16/12/2013,Iraq,Baghdad,4,11,15,Terrorists take out four shoppers at an outdoor market.
22050,17/12/2013,Kenya,Malindi,1,0,1,A man is kidnapped and beheaded by religious radicals.
22051,17/12/2013,Pakistan,Miranshah,0,29,29,A series of Religion of Peace blasts leave twenty-nine in agony.
22052,17/12/2013,Iraq,Baghdad,3,14,17,"A Sunni hurls a grenade at a group of Shia pilgrims, killing three."
22053,17/12/2013,Iraq,Baghdad,4,11,15,Four Shiite pilgrims are laid out by Sunni car bombers.
22054,17/12/2013,Iraq,Mahmoudiya,6,16,22,A half-dozen Shia pilgrims are exterminated by a Sunni suicide bomber.
22055,17/12/2013,Nigeria,Gwol,6,4,10,Four very young children are among a family of Christians massacred in their own home by Fulani militants.
22056,17/12/2013,Pakistan,Rawalpindi,4,13,17,"A suicide bomber detonates at a rival mosque, sending four 'apostates' to Allah."
22057,17/12/2013,Dagestan,Makhachkala,1,3,4,"A group of Islamists open fire on police, killing one."
22058,17/12/2013,Pakistan,Kurram,3,2,5,Sectarian Jihadis take the lives of three civilians with a roadside bomb.
22059,18/12/2013,Afghanistan,Torkahm,1,5,6,One Afghani is killed during a Taliban attack.
22060,18/12/2013,Somalia,Afgoye,6,1,7,Six fully-trained doctors are pulled out of their vehicle and summarily executed.
22061,18/12/2013,Pakistan,Karachi,0,2,2,A female suicide bomber detonates too early while trying to enter a rival mosque.
22062,18/12/2013,Afghanistan,Landikotal,6,8,14,Six local soldiers are machine-gunned at a terminal by Islamic extremists.
22063,18/12/2013,Iraq,Samarrah,3,12,15,Three Shia pilgrims are sent to the great beyond by their Sunni co-religionists.
22064,18/12/2013,Iran,Saravan,3,0,3,Jaish al-Adl take out three Shiites with a roadside bomb.
22065,18/12/2013,Pakistan,Miranshah,5,34,39,At least five are killed by a Fedayeen suicide car-bomber.
22066,18/12/2013,Iraq,Samarrah,1,1,2,A Shia child is machine-gunned by Sunni terrorists.
22067,18/12/2013,Iraq,Hamdiya,2,5,7,Two Iraqis are taken out by a Shahid suicide bomber.
22068,18/12/2013,Iraq,Khalis,6,15,21,"A suicide bomber attacks a Shia procession, killing six pilgrims."
22069,18/12/2013,Kenya,Diani,1,0,1,Islamists gun down a rival cleric.
22070,19/12/2013,Yemen,Kitaf,9,6,15,Nine people are killed when religious Sunni and Shia clash.
22071,19/12/2013,Libya,Benghazi,2,0,2,Ansar al-Sharia is suspected in the beheading of one local and the shooting of another.
22072,19/12/2013,Iraq,Latifiya,9,23,32,Nine Shiite pilgrims on foot are sent straight to Allah by the Sunni brothers.
22073,19/12/2013,Iraq,Yusifiyah,8,32,40,"A Fedayeen suicide bomber strikes a tent holding Shia pilgrims, taking out at least eight."
22074,19/12/2013,Thailand,Pattani,1,0,1,A 52-year-old Buddhist woman is cut down outside her home by Muslim gunmen.
22075,19/12/2013,Iraq,Baghdad,17,35,52,Seventeen Shia pilgrims on foot are blown to bits by a Sunni suicide bomber.
22076,19/12/2013,Nigeria,Mubi,22,24,46,Nearly two dozen people are killed when Boko Haram militants storm a market.
22077,19/12/2013,Thailand,Pattani,1,0,1,A 61-year-old man is murdered by Muslim 'separatists' yards away from his family.
22078,19/12/2013,Iraq,Abu Ghraib,5,0,5,"A family of five, including three children are exterminated in their home by al-Qaeda."
22079,19/12/2013,Pakistan,Bahawalpur,1,1,2,A Shia leader is gunned down by sectarian Jihadis.
22080,20/12/2013,Pakistan,Karachi,2,25,27,Two people lose their lives to a Shahid suicide bomber.
22081,20/12/2013,Iraq,Tuz Khurmato,12,31,43,A vicious double-bombing at a livestock market shreds a dozen patrons.
22082,20/12/2013,Iraq,Tuz Khurmato,4,5,9,A sectarian bombing at a cemetery leaves four dead.
22083,20/12/2013,Iraq,Hawija,6,0,6,Six young men are pulled out of their homes and executed by suspected al-Qaeda.
22084,20/12/2013,Pakistan,Mauripur,2,24,26,The Taliban is thought responsible for a bombing that leaves two dead.
22085,20/12/2013,Nigeria,Bama,20,12,32,"Twenty people, including women and children, are killed during a raid by a pro-Caliphate group."
22086,21/12/2013,Iraq,Latifiya,3,6,9,Three Shiite pilgrims are sent straight to Allah by terrorists.
22087,21/12/2013,Iraq,Hawija,5,6,11,"Five people, including an old woman, are dismantled by a Sunni bomb blast at their home."
22088,21/12/2013,Iraq,Shirqat,6,5,11,Mujahideen kill six Iraqis with two bombs.
22089,21/12/2013,Syria,Daraa,12,10,22,Twelve people are reported killed when Islamists shell a church distributing aid to the needy.
22090,21/12/2013,Syria,Aleppo,5,8,13,Women and children are killed by an Islamist mortar attack on a residential neighborhood.
22091,21/12/2013,Iraq,Rutba,18,32,50,Eighteen Iraqis soldiers are killed during an al-Qaeda ambush.
22092,21/12/2013,Pakistan,Jamrud,1,0,1,A polio worker is machine-gunned in his clinic by Muslim radicals.
22093,21/12/2013,Thailand,Pattani,1,0,1,Muslim assassins shoot a man in the back of the head as he is eating lunch.
22094,22/12/2013,Syria,Homs,7,0,7,Terrorists snag five schoolchildren and two others with a car bomb.
22095,22/12/2013,Libya,Aguiria,13,3,16,Thirteen people are pulled into pieces by a Fedayeen suicide bomber.
22096,22/12/2013,Nigeria,Chanchu,2,4,6,A 4-year-old is among two villagers shot to death by Muslim terrorists.
22097,22/12/2013,Thailand,Songkhla,0,27,27,Muslim 'insurgents' detonate a car bomb outside a hotel.
22098,22/12/2013,Iraq,Baghdad,13,34,47,A university student is among thirteen people shot to death by Mujahideen.
22099,23/12/2013,Thailand,Yala,1,3,4,A 12-year-old is among the casualties of a terrorist shooting.
22100,23/12/2013,Egypt,Cairo,16,134,150,"A suicide bomber detonates at a police station, ending over a dozen lives in horrible fashion."
22101,23/12/2013,Dagestan,Tsuntinsky,4,0,4,"Four people, including a border guard, are taken out by pro-Caliphate gunmen."
22102,23/12/2013,Pakistan,Karachi,3,0,3,Islamists are suspected in the torture and murder of three kidnapped members of a secular-leaning party.
22103,23/12/2013,Iraq,Baghdad,2,9,11,"Islamic militants open fire on a bus, killing three passengers."
22104,23/12/2013,Iraq,Baghdad,3,9,12,Three Shiites are blown to bits by Sunni bombers at a market.
22105,23/12/2013,Iraq,Baqubah,3,6,9,Three commuters are shot to death by al-Qaeda.
22106,23/12/2013,Iraq,Tikrit,4,0,4,Four college students are murdered by Mujahid gunmen.
22107,23/12/2013,Iraq,Tikrit,5,5,10,Five journalists are killed during an al-Qaeda suicide assault on their office.
22108,24/12/2013,Israel,Nachal Oz,1,0,1,A civilian is picked off across the border by a Palestinian sniper.
22109,24/12/2013,Iraq,Tikrit,5,18,23,A suicide bombing is one of several that leave five dead Iraqis.
22110,24/12/2013,Iraq,Bartala,2,17,19,Two Shia pilgrims are sent to Allah by Sunni bombers.
22111,24/12/2013,Iraq,Mosul,2,0,2,Two brothers are gunned down by Mujahid.
22112,25/12/2013,Pakistan,Karachi,4,23,27,Two teens are among four persons killed in separate bomb blasts.
22113,25/12/2013,Thailand,Yala,1,3,4,A 58-year-old civilian is shot to death outside a mosque by Islamic 'insurgents'.
22114,25/12/2013,Afghanistan,Logar,6,13,19,Six people are killed when Islamic extremists detonate a bicycle bomb outside a humanitarian aid office.
22115,25/12/2013,Iraq,Baghdad,26,38,64,Over two dozen innocents outside a Catholic church are massacred by Religion of Peace bombers.
22116,25/12/2013,Iraq,Baghdad,11,21,32,"Holy Warriors target a market in a Christian area, killing at least eleven patrons in two blasts."
22117,25/12/2013,Iraq,Tal Afar,1,17,18,Bombs targeting Shia pilgrims leave at least one dead.
22118,25/12/2013,Iraq,Balad,8,13,21,A bomb near a playground leaves eight dead.
22119,25/12/2013,Iraq,Baghdad,4,11,15,Jihadi bombers murder four people at a soccer field.
22120,25/12/2013,Dagestan,Mutsalaul,1,2,3,A family is attacked for selling alcohol.  Fundamentalists manage to kill an 11-year-old girl.
22121,26/12/2013,Iraq,Baghdad,3,50,53,Three Iranian dissidents were killed during a targeted Shia attack.
22122,26/12/2013,Egypt,Cairo,1,3,4,Suspected Islamists kill one person with a bomb attack on a bus.
22123,26/12/2013,Iraq,Mosul,2,1,3,'Insurgents' invade a home and riddle a family with bullets.
22124,26/12/2013,Iraq,Diyala,4,0,4,Four Iraqis are kidnapped from their homes and murdered by terrorists.
22125,26/12/2013,Yemen,Hadramawt,3,0,3,Three local soldiers are machine-gunned point-blank by al-Qaeda.
22126,27/12/2013,Somalia,Mogadishu,11,7,18,Islamists plant a bomb in a restaurant that kills seven patrons.
22127,27/12/2013,Lebanon,Beirut,7,70,77,Hezbollah assassinates a former minister and six others with a car bomb.
22128,27/12/2013,Afghanistan,Kabul,3,7,10,"A suicide bomber attacks a NATO convoy, killing three."
22129,27/12/2013,Russia,Pyatigorsk,3,0,3,Islamic militants detonate a car bomb that takes three lives.
22130,28/12/2013,Nigeria,Tashan Alede,8,3,11,Pro-Sharia advocates storm a bachelor party and randomly shoot guests.
22131,28/12/2013,Pakistan,Nowshera,2,0,2,An 18-year-old girl and 22-year-old man are shot to death by her conservative family for an 'illicit' relationship.
22132,28/12/2013,Thailand,Pattani,1,0,1,Muslim 'separatists' shoot a 5-year-old girl in the head.
22133,28/12/2013,Pakistan,Karachi,2,0,2,"Sunni radicals fire on a rival religious scholar, killing two of his guards."
22134,28/12/2013,Pakistan,Peshawar,1,1,2,Fundamentalists shoot a polio worker to death at a clinic where children are being immunized.
22135,28/12/2013,Afghanistan,Nawagai,1,1,2,"The Taliban fire a rocket into a village, killing a local."
22136,29/12/2013,Iraq,Abu Ghraib,6,6,12,al-Qaeda shooting and bombing attacks leave six dead.
22137,29/12/2013,Iraq,Mosul,5,3,8,A child is among five people who bleed to death following two Mujahideen bombings.
22138,29/12/2013,Iraq,Mosul,8,13,21,A suicide bomber takes out eight Iraqis.
22139,29/12/2013,Russia,Volgograd,18,51,69,"Children are among the casualties when a female suicide bomber detonates at a train station, killing at least eighteen."
22140,29/12/2013,Pakistan,Karachi,5,2,7,Five Shia are shot to death in two separate attacks by dedicated Sunnis.
22141,29/12/2013,Iraq,Garma,4,10,14,Islamic militants kill four Iraqis in a shooting attack.
22142,29/12/2013,Nigeria,Kwajffa,4,0,4,Boko Haram shoot four people to death at a Christian village.
22143,30/12/2013,Pakistan,Rawalpindi,2,1,3,Two guards outside a Shia mosque are taken down by Sunni rivals.
22144,30/12/2013,Russia,Volgograd,16,35,51,"A bus is blown up by a suicide bomber, leaving at least sixteen dead commuters."
22145,30/12/2013,Pakistan,Charsadda,3,1,4,Suspected Islamists plant a bomb inside a home which kills a woman and her two children.
22146,30/12/2013,Pakistan,Pashtunabad,0,2,2,A woman and child are hurt when terrorists throw a hand grenade at a polio team.
22147,30/12/2013,Iraq,Mosul,4,3,7,A Fedayeen suicide bomber takes out four bystanders.
22148,30/12/2013,Iraq,Baiji,2,9,11,A man and his son are murdered by a Shahid suicide bomber.
22149,30/12/2013,Dagestan,Khasavyurt,2,5,7,An Islamist IED takes the lives of two passersby.
22150,31/12/2013,Pakistan,Peshawar,3,4,7,Children are among the casualties of a bomb blast in a residential area.
22151,31/12/2013,Yemen,Aden,4,3,7,"Fedayeen suicide car bombers strike a police station, killing at least four."
22152,31/12/2013,Egypt,Ain Shams,1,0,1,Muslim Brotherhood members shoot a young Christian in the head outside a church.
22153,31/12/2013,Nigeria,Maikatako,3,16,19,"Fulani gunmen fire into a church during a New Years Eve service, killing three worshippers, including a 14-year-old girl."
22154,31/12/2013,Iraq,Mosul,2,0,2,Islamic terrorists storm a home and shoot a married couple to death.
22155,31/12/2013,Philippines,Basilan,6,6,12,An Abu Sayyaf group is thought responsible for a vicious attack on a New Year's Eve party that leaves a half-dozen dead.
22156,31/12/2013,Iraq,Baghdad,2,0,2,Sunnis turn two Shiites into pulp with a bomb mounted on a truck.
22157,31/12/2013,Iraq,Baghdad,4,0,4,"'Insurgents' fire mortars into a housing project, killing four innocents."
22158,31/12/2013,Iraq,Baghdad,7,7,14,Seven residents of a Shiite neighborhood are dismantled by al-Qaeda bombs.
22159,1/1/2014,Iraq,Tarmiya,4,12,16,Sunni radicals storm a police station and kill four officers.
22160,1/1/2014,Iraq,Rutba,2,7,9,A suicide bomber murders two Iraqis.
22161,1/1/2014,Pakistan,Quetta,3,31,34,"A bus carrying Shia pilgrims is hit by Sunni suicide bomber, leaving three dead."
22162,1/1/2014,Somalia,Mogadishu,20,30,50,A suicide blast outside a hotel leaves twenty dead.
22163,2/1/2014,DRC,North Kivu,3,0,3,Foreign Islamists kill three local soldiers.
22164,2/1/2014,Afghanistan,Herat,1,0,1,A high-ranking female official is cut down by religious extremists.
22165,2/1/2014,Lebanon,Beirut,5,77,82,An al-Qaeda suicide bomber takes out five people outside a restaurant.
22166,2/1/2014,Kenya,Mombasa,0,10,10,Fundamentalists are suspected of throwing a grenade into a pool hall.
22167,2/1/2014,Yemen,Aden,1,0,1,A man is gunned down by al-Qaeda.
22168,2/1/2014,Syria,al-Rabieh,3,6,9,A woman and two children are killed by Islamist 'rebels'.
22169,2/1/2014,Iraq,Balad Ruz,19,37,56,Nineteen people at a car dealership are pulled into pieces by a Fedayeen suicide bomber.
22170,2/1/2014,Iraq,Latifiya,5,9,14,Muslim militants wipe out five shoppers at a market with a well-planted bomb.
22171,2/1/2014,Thailand,Yala,1,0,1,Muslim 'separatists' shoot a civilian to death.
22172,3/1/2014,Egypt,Cairo,1,0,1,Muslim Brotherhood activists shoot dead a man who 'yelled insults' from the window of his house.
22173,3/1/2014,Yemen,Amran,23,34,57,Twenty-three people are killed during a clash between Sunni and Shia radicals.
22174,3/1/2014,Pakistan,Islamabad,2,0,2,Sectarian Jihadis are suspected of a shooting attack that leaves two Sunni leaders dead.
22175,3/1/2014,Thailand,Pattani,1,0,1,A Buddhist is brought down by a Muslim drive-by.
22176,3/1/2014,Pakistan,Orakzai,1,3,4,A bomb planted in a seminary by Religion of Peace rivals takes the live of a cleric in training.
22177,3/1/2014,Pakistan,Bahawalpur,2,0,2,"In separate attacks, conservative Muslims strangles their sisters on suspicion of sexual misconduct."
22178,4/1/2014,Ghana,Nima,1,0,1,A gay man is reportedly lynched by a Muslim mob.
22179,4/1/2014,Pakistan,Sibi,2,3,5,A bomb planted on a motorcycle takes the lives of two people.
22180,4/1/2014,Egypt,al-Arish,1,2,3,A local soldier is ambushed and killed by Islamic militants.
22181,4/1/2014,Pakistan,Karachi,2,0,2,Two Sunni brothers are shot to death by sectarian rivals.
22182,4/1/2014,Pakistan,Karachi,3,4,7,Three Shiites are gunned down in a targeted attack by Sunnis.
22183,4/1/2014,Pakistan,Tehsil Chowk,0,15,15,Fifteen Shia protesters are clubbed with axes and stones by their Sunni brothers.
22184,4/1/2014,Afghanistan,Nangarhar,1,0,1,At least one other person is killed during a suicide attack.
22185,4/1/2014,Thailand,Pattani,1,1,2,A man drinking tea at a shop is shot three times in the head by Muslim terrorists.
22186,4/1/2014,Afghanistan,Ghazni,4,3,7,Four local cops are killed by Taliban bombers.
22187,5/1/2014,Egypt,Cairo,1,3,4,A civilian is killed when Islamic extremists fire at a police checkpoint.
22188,5/1/2014,Pakistan,Multan,1,0,1,Sunnis shoot a 59-year-old Shiite doctor eight times.
22189,5/1/2014,Pakistan,Karachi,1,0,1,A prayer leader is shot to death by Religion of Peace rivals.
22190,5/1/2014,Pakistan,Baldia,2,0,2,Two people are killed when Tehreek-e-Taliban lob a hand grenade into a shop.
22191,5/1/2014,Bangladesh,Dinajpur,1,0,1,A man is beaten to death by Jamaat-e-Islami.
22192,5/1/2014,Iraq,Sadr City,5,10,15,Sunnis set off a car bomb near a restaurant that leaves five dead.
22193,5/1/2014,Iraq,Adhaim,6,0,6,al-Qaeda gunmen summarily execute six civilians.
22194,5/1/2014,Iraq,Baghdad,20,61,81,"'Insurgents' kill twenty Iraqis with a series of bombings, mostly in Shia neighborhoods."
22195,5/1/2014,Bangladesh,Jamalpur,0,8,8,Eight Catholics are injured during a targeted attack by Islamic extremists.
22196,6/1/2014,Bangladesh,Jessore,5,20,25,Five Hindus are reportedly hacked to death by a mob of Jamaat-e-Islami.
22197,6/1/2014,Yemen,Lahj,1,0,1,A man suspected of being gay is shot to death by Muslim moralists.
22198,6/1/2014,Syria,Aleppo,50,0,50,al-Qaeda-linked militants reportedly execute fifty prisoners at a children's hospital.
22199,6/1/2014,Afghanistan,Jawzjan,1,2,3,An oil worker is brought down by Taliban terrorists.
22200,6/1/2014,Pakistan,Tirah,9,9,18,Three children are among nine disassembled by a Lashkar-e-Islam bomb.
22201,6/1/2014,Lebanon,Akkar,1,0,1,A Shiite man is picked off by a Sunni sniper.
22202,6/1/2014,Pakistan,Hangu,1,2,3,A 14-year-old boy bleeds to death following a suicide bombing at his school.
22203,6/1/2014,Iraq,Tuz Khormatu,4,12,16,Mujahid bombers take out four people at a parking garage.
22204,6/1/2014,Pakistan,Matani,2,1,3,A woman is among two killed when Muslim militants open fire at a market.
22205,6/1/2014,Nigeria,Riyom,33,25,58,Thirty villagers are massacred by Fulani raiders.
22206,7/1/2014,Pakistan,Karachi,6,0,6,Sunni fundamentalists cut the throats of six Sufis for visiting a shrine.
22207,7/1/2014,Syria,Darkoush,20,24,44,A Fedayeen suicide bomber takes out twenty other souls.
22208,7/1/2014,Iraq,Baghdad,12,0,12,Muslim fundamentalists shoot a dozen sinners to death at a brothel.
22209,7/1/2014,Iraq,Samarrah,7,2,9,Seven local police officers are machine-gunned at their checkpoint by al-Qaeda.
22210,7/1/2014,Pakistan,Peshawar,1,0,1,A Shia bank manager is picked off by Sunni snipers while walking to his car.
22211,7/1/2014,Syria,Aleppo,9,0,9,Nine captured men are shot to death by an al-Qaeda group on video to shouts of 'Allah Akbar'.
22212,7/1/2014,India,Sopore,1,3,4,Islamic militants murder a local cop.
22213,7/1/2014,Iraq,Jurf al-Sakhar,4,0,4,A child is among four people killed when al-Qaeda set off a bomb at a house.
22214,7/1/2014,Iraq,Kirkuk,5,55,60,Five people at a police station are wasted by a Shahid suicide bomber.
22215,8/1/2014,Syria,Marmarita,1,1,2,A young Christian is beheaded after Islamists discover him wearing a cross necklace.
22216,8/1/2014,Nigeria,Kayamula,9,3,12,Islamists walk into a village and shoot nine residents to death.
22217,8/1/2014,Nigeria,Kano,3,12,15,"Boko Haram is suspected of spraying a rival mosque with bullets, killing three worshippers."
22218,8/1/2014,Iraq,Baqubah,12,4,16,Twelve Iraqi security personnel are brought down by an al-Qaeda assault.
22219,8/1/2014,Pakistan,Peshawar,1,3,4,A police officer is shot in the back by suspected Taliban.
22220,8/1/2014,Iraq,Tikrit,5,5,10,al-Qaeda militants murder five Iraqis.
22221,9/1/2014,Syria,Aleppo,1,0,1,A Christian is executed for refusing to convert to Islam.
22222,9/1/2014,Pakistan,Karachi,3,11,14,The Taliban exterminate a critic using a suicide bomber.
22223,9/1/2014,Russia,Stavropol Krai,6,0,6,Six victims of suspected Islamists are discovered shot in the head.
22224,9/1/2014,Iraq,Baghdad,23,33,56,A suicide bomber murders over twenty young police recruits waiting to register.
22225,9/1/2014,Pakistan,Mardan,2,0,2,Two caretakers at a Sufi shrine are gunned down by sectarian rivals.
22226,9/1/2014,Iraq,Ramadi,4,6,10,"A Sunni suicide bomber self-detonates, taking four other souls with him."
22227,9/1/2014,Iraq,Shirqat,2,3,5,Two students are shot to death by 'insurgents'.
22228,10/1/2014,Iraq,Kut,1,0,1,A 30-year-old teacher bleeds out following a Mujahid bomb blast.
22229,10/1/2014,Syria,Deir Hassan,2,0,2,Two Christians are kidnapped and beheaded by Religion of Peace extremists.
22230,10/1/2014,Syria,Hama,18,32,50,"Sunni terrorists detonate a car bomb outside a school, wiping out eighteen innocents."
22231,10/1/2014,Pakistan,Karachi,1,0,1,A young Shiite is kidnapped and brutally tortured to death by Sunni extremists.
22232,11/1/2014,Syria,Saraqub,5,0,5,Five people are killed in an ISIL suicide bombing.
22233,11/1/2014,Israel,Jerusalem,0,1,1,A 30-year-old Orthodox Jewish man is stabbed in the neck.
22234,11/1/2014,Pakistan,Malir,0,3,3,Two teenagers are among the casualties when a bomb is thrown onto the roof of a mosque by Religion of Peace rivals.
22235,11/1/2014,Bangladesh,Gaibandha,1,0,1,Islamists murder a young Catholic man for organizing a demonstration against anti-Christian violence.
22236,12/1/2014,Nigeria,Sabon Gari,8,3,11,"Muslim terrorists attack Christians on a Sunday morning, killing at least eight and maiming others."
22237,12/1/2014,Pakistan,Peshawar,3,0,3,Three 'apostates' are shot to death by the Taliban.
22238,12/1/2014,Bangladesh,Natore,1,4,5,A Hindu farmer is stabbed to death in front of his wife by militant Muslims.
22239,12/1/2014,Yemen,al-Shahr,4,0,4,"al-Qaeda militants shell a local coast guard camp, killing four occupants."
22240,12/1/2014,Iraq,Baghdad,5,14,19,Five people traveling through a city square are disintegrated by Mujahid bombers.
22241,12/1/2014,Iraq,Baghdad,9,16,25,Jihad car bombers murder eight Iraqis at a bus station.
22242,12/1/2014,Afghanistan,Kabul,2,20,22,"A Fedayeen suicide bomber on a bicycle pedals to paradise, taking two bus passengers with him."
22243,12/1/2014,Libya,Sirte,1,0,1,A cabinet minister is assassinated by suspected Islamists.
22244,12/1/2014,Pakistan,Shangla,6,4,10,Six people are disassembled by Taliban bombers.
22245,12/1/2014,Iraq,Tuz Khormato,10,35,45,A pair of car bombs set by suspected al-Qaeda leaves ten dead.
22246,13/1/2014,Syria,Homs,14,0,14,Fourteen captives are executed by ISIL.
22247,13/1/2014,Nigeria,Kayamula,5,10,15,Pro-Sharia militants storm a village and murder five people.
22248,13/1/2014,Iraq,Baghdad,8,34,42,A series of small-scale terror attacks kills eight Iraqis.
22249,13/1/2014,Iraq,Baghdad,5,14,19,Five people in a Shia neighborhood are ripped to shreds by a Sunni car bomb.
22250,13/1/2014,Iraq,Baghdad,11,28,39,A single al-Qaeda car bomb blast at a commercial district leaves eleven dead.
22251,14/1/2014,Nigeria,Maiduguri,19,51,70,A Boko Haram blast at a busy market sends twenty shoppers to Allah.
22252,14/1/2014,Syria,Ram Hamdan,8,18,26,Eight people are killed by an ISIL car bombing.
22253,14/1/2014,Syria,Kantari,46,0,46,Forty-six 'prisoners' are executed by ISIL.
22254,14/1/2014,Pakistan,Peshawar,2,13,15,A bombing and shooting by Islamic extremists takes the lives of two people.
22255,14/1/2014,Iraq,Tarmiya,3,13,16,Mujahideen execute three Iraqis and injure thirteen more in a separate bombing.
22256,14/1/2014,Iraq,Qamma,3,10,13,Two children are among three people who bleed to death following a shrapnel attack by 'insurgents'.
22257,14/1/2014,Iraq,Khalis,5,2,7,al-Qaeda gunmen attack the homes of two families and kill five.
22258,14/1/2014,Iraq,Baghdad,7,17,24,A series of attacks by Islamic terrorists leave seven dead.
22259,14/1/2014,Iraq,Sadr City,4,10,14,Four motorists and bystanders are sent to the great beyond by Religion of Peace bombers.
22260,14/1/2014,Iraq,Baghdad,6,13,19,"Jihadi bombers strike a popular market, killing a half dozen."
22261,15/1/2014,Nigeria,Banki,1,4,5,One person is killed when a pro-Caliphate group attacks a police station.
22262,15/1/2014,Syria,Aleppo,26,24,50,An al-Qaeda car bomb leaves over two dozen dead.
22263,15/1/2014,Pakistan,Landikotal,2,0,2,Two village guards are cut down by suspected Lashkar-e-Islam.
22264,15/1/2014,Iraq,Ain al-Jahsh,6,10,16,Six Iraqis are disassembled by a Mujahid bomb blast.
22265,15/1/2014,Thailand,Yala,2,1,3,Islamic 'separatists' murder two guards providing security for teachers.
22266,15/1/2014,Cameroon,Limani,1,4,5,A woman is killed during a border attack by Boko Haram.
22267,15/1/2014,Iraq,Buhriz,16,24,40,Sixteen mourners at a funeral are obliterated by shrapnel from a Fedayeen suicide bomber.
22268,15/1/2014,Iraq,Dujail,5,7,12,Five people are dismantled by a Shahid suicide bomber.
22269,15/1/2014,Iraq,Baghdad,12,32,44,A series of Mujahideen attacks produces a dozen dead Iraqis.
22270,15/1/2014,Iraq,Karrada,6,24,30,A half-dozen people in a residential area are pulled into pieces by two car bombs.
22271,15/1/2014,Iraq,Baghdad,5,12,17,"Jihadis bomb a market, sending five shoppers to Allah."
22272,15/1/2014,Iraq,Muqdadiya,7,0,7,Seven employees at a brick factory are brutally executed by Islamic 'insurgents'.
22273,16/1/2014,Pakistan,Lahore,1,0,1,Sunni gunmen take out a prominent businessman simply because he is a Shiite.
22274,16/1/2014,Pakistan,Peshawar,11,65,76,At least eleven people at a worship center are blown to bits by Religion of Peace rivals.
22275,16/1/2014,Iraq,Mishada,14,0,14,Fourteen are kidnapped and killed by militants fighting for an Islamic state.  Nine were from the same family.
22276,16/1/2014,Lebanon,Beqaa,3,43,46,Three people are disintegrated when an al-Nusra suicide bomber detonates in a Shia area.
22277,16/1/2014,Yemen,Bayda,10,16,26,Three al-Qaeda suicide attacks leave ten security personnel dead.
22278,16/1/2014,Iraq,Tikrit,2,0,2,Two brothers are murdered by al-Qaeda gunmen.
22279,16/1/2014,Pakistan,Multan,2,0,2,A Shiite leader is assassinated along with his bodyguard by Sunni radicals.
22280,16/1/2014,Iraq,Baqubah,3,6,9,Women and children are among the casualties of an Islamic extremist bomb attack on a house.
22281,16/1/2014,Iraq,Ramadi,3,5,8,An al-Qaeda suicide bomber takes out three Iraqis.
22282,16/1/2014,Pakistan,Punjab,1,0,1,Muslim rape and kill a 9-year-old Hindu girl.
22283,17/1/2014,Syria,Jarabulus,12,0,12,A 2-year-old is among twelve women and children slaughtered in their home by pro-Sharia militants.
22284,17/1/2014,Syria,Jarabulus,10,0,10,"The ISIL behead ten men to the tune of ""Allah akbar"" and plant their heads on stakes."
22285,17/1/2014,Afghanistan,Kabul,21,30,51,Over twenty people at a restaurant die horrifically when a suicide bombing is followed by an automatic weapons assault.
22286,17/1/2014,Pakistan,Nazimabad,3,3,6,Tehreek-e-Taliban on motorbikes machine-gun three journalists.
22287,17/1/2014,Lebanon,Arsal,7,15,22,Five young children are among seven who bleed to death as rockets are fired from a Hezbollah stronghold into a Sunni neighborhood.
22288,17/1/2014,Iraq,Ramadi,5,4,9,A suicide bomber tears the life out of five other people.
22289,17/1/2014,Pakistan,Karachi,1,0,1,Sunni extremists pump a Shia doctor full of bullets outside his clinic.
22290,18/1/2014,Yemen,Sanaa,1,0,1,An Iranian diplomat dies after being shot in the stomach and chest by Sunni terrorists.
22291,18/1/2014,Afghanistan,Kandahar,3,4,7,"The Taliban fire a rocket at a group of youth playing soccer, killing three."
22292,18/1/2014,Dagestan,Makhachkala,0,9,9,Jihadists detonate a car bomb at a restaurant.
22293,18/1/2014,Pakistan,Sargodha,2,5,7,Two prominent Sunni activists are gunned down by sectarian Jihadis.
22294,18/1/2014,Iraq,Kirkuk,3,13,16,Three people at a market are torn to shreds by a Sunni bomb blast.
22295,18/1/2014,Iraq,Baghdad,19,53,72,A series of Mujahideen bomb blasts produce nineteen dead Iraqis.
22296,18/1/2014,Iraq,Baghdad,6,12,18,Religion of Peace bombers take out six patrons at a shopping mall.
22297,19/1/2014,Iraq,Baqubah,5,0,5,Five Iraqis are machine-gunned point-blank at a checkpoint by al-Qaeda.
22298,19/1/2014,Iraq,Baiji,7,17,24,Three al-Qaeda attacks produce seven dead Iraqis.
22299,19/1/2014,Iraq,Tuz Khormato,7,20,27,Seven citizens outside a sewage treatment office are wasted by Religion of Peace bombers.
22300,19/1/2014,Pakistan,Bannu,22,38,60,Twenty-two local soldiers are ambushed and killed by Sunni fundamentalists.
22301,19/1/2014,Nigeria,Agatu,7,9,16,"Muslims fire into a Christian village, killing seven residents."
22302,20/1/2014,Nigeria,Alau Ngawo,19,12,31,"Pro-Sharia gunmen invade a village, firing indiscriminately and killing at least nineteen residents."
22303,20/1/2014,Nigeria,Gwoza,3,4,7,Boko Haram attack a village and murder three residents.
22304,20/1/2014,Iraq,Baghdad,14,26,40,A series of Mujahideen attacks in Sunni neighborhoods leave fourteen dead Iraqis.
22305,20/1/2014,Iraq,Baghdad,3,8,11,"Jihadis bomb a market, killing three patrons."
22306,20/1/2014,Iraq,Baghdad,4,15,19,"'Insurgents' set off a bomb near a group of day laborers, killing four."
22307,20/1/2014,Nigeria,Wulgo,1,1,2,Islamists take out a teacher in his own home with an AK-47.
22308,20/1/2014,Pakistan,Rawalpindi,13,15,28,Thirteen people are ripped to shreds by a Shahid suicide bomber.
22309,20/1/2014,Afghanistan,Zhari,3,0,3,A 13-year-old girl is among three killed in a Fedayeen suicide assault.
22310,20/1/2014,Thailand,Pattani,2,0,2,Muslim militants spray a man and woman with bullets as they are heading to the market.
22311,20/1/2014,Iraq,Baghdad,7,18,25,"Jihadis bomb a crowded market, sending seven civilians to Allah."
22312,20/1/2014,Pakistan,Peshawar,1,0,1,A Shia religious scholar is assassinated by Sunni rivals.
22313,20/1/2014,Syria,Bab al-Hawa,16,20,36,"A Fedayeen suicide bomber detonates at a border crossing with Turkey, killing at least sixteen."
22314,20/1/2014,Algeria,Ghardaia,1,3,4,Muslims stab a Berber minority to death in his own home.
22315,20/1/2014,Pakistan,Karachi,1,0,1,A prominent Shia cleric bleeds to death following a Sunni drive-by shooting.
22316,20/1/2014,Pakistan,Karachi,3,0,3,Three innocents are kidnapped and brutally tortured to death after ignoring warnings not to worship at a Shia shrine.
22317,21/1/2014,Yemen,Sanaa,1,0,1,Sunnis assassinate a Shia law professor.
22318,21/1/2014,Pakistan,Landhi,1,0,1,A Sunni leader is murdered by sectarian rivals.
22319,21/1/2014,Lebanon,Beirut,4,20,24,Four people are killed when an al-Nusra suicide bomber detonates in a Shia neighborhood.
22320,21/1/2014,Pakistan,Mastung,28,31,59,Over two dozen Shia pilgrims on a bus are massacred by a Lashkar-e-Jhangvi suicide bomber.
22321,21/1/2014,Pakistan,Karachi,1,2,3,A secular politician is assassinated by suspected Islamists.
22322,21/1/2014,India,Madurai,1,0,1,A man is hacked to death by four members of al-Umma.
22323,21/1/2014,Pakistan,Karachi,3,2,5,Fundamentalists murder three members of a polio vaccination team.
22324,21/1/2014,Thailand,Narathiwat,1,5,6,A 21-year-old man guarding a group of teachers is pulled into pieces by a Muslim blast.
22325,21/1/2014,Somalia,Mahaday,15,3,18,Fifteen people are reported dead following an al-Shabaab assault on a village.
22326,21/1/2014,Iraq,Wajihiya,1,0,1,A Sunni cleric is shot to death by sectarian rivals.
22327,21/1/2014,Lebanon,Tripoli,7,58,65,Seven are killed when Sunnis and Shia start shooting at each other.
22328,22/1/2014,Thailand,Yala,1,0,1,Militant Muslims are thought responsible for the drive-by shooting of a teenager.
22329,22/1/2014,Pakistan,Balochistan,6,0,6,'Foreign militants' shoot six guards to death in an attempt to kidnap Western cyclists.
22330,22/1/2014,Iraq,Baghdad,2,4,6,Terrorists murder two children in an attack on their home.
22331,22/1/2014,Pakistan,Charsadda,6,6,12,A child is among six dismantled by a Taliban bombing attack on a team guarding polio workers.
22332,22/1/2014,Pakistan,Karachi,1,0,1,A prayer leader is gunned down by Religion of Peace rivals.
22333,22/1/2014,Pakistan,Tank,1,0,1,Sectarian Jihadis take out a rival cleric.
22334,22/1/2014,Pakistan,Charsadda,1,0,1,A Sikh minority is shot to death by suspected Islamic extremists.
22335,23/1/2014,Egypt,Bani Suief,5,2,7,Five policemen are machine-gunned at a checkpoint by radical Muslims on motorbikes.
22336,23/1/2014,Afghanistan,Qaisar,6,4,10,Six Afghan cops are machine-gunned by Taliban terrorists.
22337,23/1/2014,Pakistan,Peshawar,6,8,14,Children are among the casualties when a bomb planted on an impounded car explodes at a garage.
22338,23/1/2014,Kyrgyzstan,Issyk-Kul,1,0,1,A armed group shouting 'Allah Akbar' murder a border guard.
22339,23/1/2014,Afghanistan,Laghman,5,0,5,Five youth playing volleyball are gunned down in cold blood by Taliban fundamentalists.
22340,23/1/2014,Iraq,Mosul,3,0,3,Suspected al-Qaeda shoot three people to death inside their home.
22341,23/1/2014,Iraq,Jurf al-Sakhar,3,4,7,"Jihadis bomb a bus, killing three passengers."
22342,23/1/2014,Pakistan,Peshawar,1,0,1,A Shia factory owner is cornered and picked off by Sunni extremists.
22343,24/1/2014,Thailand,Yala,2,3,5,Islamic 'separatists' kill two locals with a roadside bomb.
22344,24/1/2014,Afghanistan,Balkh,1,0,1,"An 18-year-old is kidnapped, executed and set on fire by Sunni hardliners."
22345,24/1/2014,Iraq,Tikrit,3,0,3,A child is among three females taken out in their own home by Mujahid bombers.
22346,24/1/2014,Thailand,Pattani,2,2,4,An elderly Buddhist monk is among two people shot to death by Muslim 'separatists.'
22347,24/1/2014,Egypt,Cairo,1,8,9,One person is killed by an Ansar Beit al-Maqdis bombing near a metro station.
22348,24/1/2014,Egypt,Cairo,5,73,78,Five people bleed out following an Ansar Beit al-Maqdis shrapnel bomb blast outside a police station.
22349,25/1/2014,Iraq,Baqubah,6,2,8,A woman and child are among six members of a family wiped out by 'insurgents'
22350,25/1/2014,Iraq,Jaizan,6,2,8,"Radical Sunnis fire rockets into a Shia village, killing six residents."
22351,25/1/2014,Pakistan,Karachi,6,6,12,Six guards at the residence of a secular-leaning political leader are machine-gunned by suspected Taliban.
22352,25/1/2014,Iraq,Tuz Khormato,7,19,26,Seven people at a restaurant are taken out in mid-bite by Mujahideen bombers.
22353,25/1/2014,Iraq,Baghdad,2,6,8,Two patrons at a shopping district are taken apart by al-Qaeda bombers.
22354,25/1/2014,Iraq,Baghdad,4,12,16,A Sunni bomb blast in a Shia commercial district leaves four dead.
22355,26/1/2014,Afghanistan,Nangarhar,2,8,10,"Taliban bombers decimate a wedding party, leaving at least two dead."
22356,26/1/2014,Pakistan,Swat,1,0,1,Mujahid snipers pick off a member of a peace committee.
22357,26/1/2014,Nigeria,Waga Chakawa,53,25,78,Fifty-three people at a church service are slaughtered by pro-Sharia gunmen.
22358,26/1/2014,Iraq,Mishahda,3,12,15,A car bomb outside a Sunni mosque leaves three dead.
22359,26/1/2014,Iraq,Husseiniya,2,0,2,A man and wife are machine-gunned in their own home by 'insurgents'
22360,26/1/2014,Iraq,Abu Ghraib,8,0,8,Eight Iraqis are cut down in two shooting and bombing attacks.
22361,26/1/2014,Nigeria,Kawuri,85,40,125,Over eighty villagers a massacred in a brutal assault by Boko Haram Islamists.  Many were cut down or burned alive in their own homes.
22362,26/1/2014,Iraq,Kirkuk,5,14,19,Five Iraqis are reduced to pulp by Islamist car bombers.
22363,26/1/2014,Iraq,Fallujah,4,0,4,A woman and her three children are exterminated in their own home by Jihadi bombers.
22364,26/1/2014,Afghanistan,Helmand,6,13,19,A half dozen civilians in a taxi are torn to shreds by Religion of Peace bombers.
22365,26/1/2014,Egypt,Sinai,4,9,13,Radical Islamists kill four local soldiers riding a bus.
22366,26/1/2014,Pakistan,Peshawar,1,0,1,Islamic gunmen murder a guard at a Hindu temple.
22367,26/1/2014,Pakistan,Quetta,1,0,1,A Sikh is reportedly killed for refusing to pay the jizya.
22368,26/1/2014,Egypt,Sheikh Zuwayed,5,0,5,Ansar Beit al-Madqis claim responsibility for downing a helicopter with five aboard.
22369,26/1/2014,Yemen,Hadramawt,1,0,1,A police officer is gunned down by al-Qaeda on motorbikes.
22370,26/1/2014,Nigeria,Riyom,1,2,3,A Chinese contractor is killed by suspected Boko Haram gunmen.
22371,26/1/2014,Afghanistan,Kabul,4,22,26,A woman is among four people sent to Allah by a Fedayeen suicide bomber.
22372,27/1/2014,Iran,Tehran,1,0,1,A poet is executed for 'waging war on Allah'.
22373,27/1/2014,Pakistan,Khanpur,1,0,1,A Shia leader is picked off by Sunni gunmen outside his home.
22374,27/1/2014,Iraq,Samarrah,3,0,3,Three Iraqis are decapitated by al-Qaeda.
22375,27/1/2014,Syria,Rahjan,13,5,18,An al-Nusra suicide bomber murders thirteen people at a checkpoint.
22376,27/1/2014,Pakistan,Mashokehl,3,0,3,Islamic militants take three family members from their home and execute them in a nearby field.
22377,27/1/2014,Thailand,Narathiwat,3,0,3,A 7-year-old girl is among three civilians machine-gunned by suspected 'separatists'.
22378,28/1/2014,Syria,Aleppo,4,0,4,An ISIL suicide bomber murders four Religion of Peace rivals.
22379,28/1/2014,Iraq,Balad,2,3,5,Two citizens are aerated by Religion of Peace ball bearings.
22380,28/1/2014,Iraq,Muqdadiya,6,4,10,Six Iraqis are riddled with bullets by al-Qaeda gunmen.
22381,28/1/2014,Egypt,Giza,1,0,1,Ansar Beit al-Maqdis assassinate a government official.
22382,28/1/2014,Egypt,Cairo,1,2,3,Islamic extremists gun down a guard at a church.
22383,28/1/2014,Philippines,Datu Piang,0,2,2,An 8-year-old girl and a pregnant woman are hurt by a Bangsamoro Islamist bomb.
22384,28/1/2014,Pakistan,Karachi,2,0,2,Two religious minorities are shot dead in targeted attacks.
22385,29/1/2014,Pakistan,Nazimabad,3,5,8,A bearded Shahid suicide bomber snuffs out the lives of three people.
22386,29/1/2014,Pakistan,Nazimabad,1,7,8,Tehreek-e-Taliban bombers kill policeman inspecting a bridge.
22387,29/1/2014,Iraq,New Baghdad,5,12,17,"Shrapnel tears through a popular market, leaving five dead."
22388,29/1/2014,Iraq,Baghdad,3,10,13,Three patrons at a market are sectionalized by a Jihad bomb blast.
22389,29/1/2014,Iraq,Baghdad,8,20,28,Eight people lose their lives to a pair of Mujahid car bombs.
22390,29/1/2014,Iraq,Hawija,3,2,5,al-Qaeda gunmen take down three Iraqis.
22391,29/1/2014,Thailand,Narathiwat,2,3,5,A shooting and separate bombing attack on a group of teachers leaves two civilians dead.
22392,29/1/2014,Pakistan,Mastung,1,0,1,A young child dies from injuries suffered in a blast targeting Shia minorities.
22393,29/1/2014,Iraq,Camp Sarah,3,0,3,Three Christians are shot to death by Muslim terrorists.
22394,30/1/2014,Thailand,Pattani,2,0,2,Muslim radicals kill two people guarding a group of teachers with a homemade bomb.
22395,30/1/2014,Iraq,Baghdad,4,11,15,Sunni car bombers destroy four lives at an outdoor market.
22396,30/1/2014,Iraq,Baghdad,5,11,16,Eleven people are torn to shreds by a Religion of Peace bomb at a bus stop.
22397,30/1/2014,Iraq,Baghdad,18,50,68,Six al-Qaeda suicide bombers storm a government office building and murder eighteen people.
22398,30/1/2014,Egypt,Giza,1,0,1,A policeman is murdered by Ansar Beit Al Maqdis as he leaves his house.
22399,30/1/2014,Pakistan,Landikotal,2,0,2,Two children are disassembled by a Taliban bomb.
22400,30/1/2014,Afghanistan,Pachir Wagam,2,3,5,A suicide car bomber sends two local cops to Allah.
22401,31/1/2014,Nigeria,Unguwar Kajit,7,0,7,Seven members of a Christian family are murdered in their own home by Muslim gunmen.
22402,31/1/2014,Nigeria,Kutura,7,3,10,Boko Haram militants kill seven car passengers with an IED.
22403,31/1/2014,Nigeria,Garin Yamdula,11,0,11,A pastor is among eleven people slain by pro-Sharia activists.
22404,31/1/2014,Yemen,Shibam,15,4,19,Fifteen local soldiers are ambushed and killed by al-Qaeda.
22405,31/1/2014,Iraq,Hit,5,3,8,A suicide bomber extinguishes five Iraqis.
22406,1/2/2014,Lebanon,Hermel,3,23,26,An al-Nusra suicide bomber sends three Shiites to Allah.
22407,1/2/2014,Afghanistan,Herat,2,0,2,Two campaign workers are shot to death by suspected Taliban.
22408,1/2/2014,Philippines,Saudi Ampatuan,0,12,12,Two journalists are among the casualties of a Bangsamoro Islamic bombing.
22409,1/2/2014,Afghanistan,Farah,4,4,8,Four local soldiers are ambushed and killed by religious extremists.
22410,1/2/2014,Pakistan,Garhi Mali Khel,4,0,4,Four members of one family are taken out by Islamic militants.
22411,1/2/2014,Syria,Homs,1,0,1,Radical Sunnis behead a Shiite in front of children.
22412,1/2/2014,Iraq,Baghdad,8,22,30,Four Mujahid bombs produce eight dead Iraqis.
22413,1/2/2014,Afghanistan,Spin Boldak,4,1,5,A Taliban bomb ends the lives of four local policemen.
22414,1/2/2014,Syria,Aleppo,26,18,44,Over two dozen people are killed by two al-Qaeda suicide bombers.
22415,2/2/2014,Kenya,Mombasa,1,0,1,A 59-year-old pastor is murdered for sharing his faith near a mosque.
22416,2/2/2014,Syria,al-Raei,16,20,36,An ISIL 'peace envoy' blows himself up during negotiations.  Sixteen others are killed.
22417,2/2/2014,Thailand,Pattani,4,5,9,'Insurgents' murder four people with a bomb and shooting attack.
22418,2/2/2014,Pakistan,Peshawar,5,31,36,"Suspected fundamentalists toss grenades into a cinema, killing five people."
22419,2/2/2014,Iraq,Kirkuk,4,1,5,al-Qaeda militants take out four local soldiers.
22420,2/2/2014,Iraq,Diyala,5,3,8,A woman is among five people riddled with bullets by Muslim terrorists.
22421,2/2/2014,Iraq,Baiji,8,18,26,A Fedayeen suicide car bomber dismantles eight Iraqis.
22422,2/2/2014,Kenya,Mombasa,1,0,1,A police officer is stabbed in the head at a mosque by youth yelling 'Allah Akbar' .
22423,2/2/2014,Somalia,Beled Hawa,3,5,8,Pro-Sharia activists bomb a coffee shop at a peak time.
22424,3/2/2014,Pakistan,Karachi,2,0,2,Sipah-e-Sahaba murder two people merely because they are Shia.
22425,3/2/2014,Nigeria,Yobe,18,0,18,Eighteen traders at a market are machine-gunned by Boko Haram Islamists.
22426,3/2/2014,Tunisia,Raoued,1,0,1,"Islamic militants open fire on a group of police officers, killing one."
22427,3/2/2014,Pakistan,Karachi,4,0,4,Four cops are gunned down by suspected Islamists.
22428,3/2/2014,Iraq,Baghdad,2,6,8,Two people are taken down by a Holy Warrior with a suicide vest.
22429,3/2/2014,Iraq,Mahmoudiya,9,28,37,Nine Iraqis are reduced to pulp by al-Qaeda car bombers.
22430,3/2/2014,Iraq,Abdu Dashir,6,14,20,Six shoppers at an outdoor market are ripped to pieces by Sunni car bombers.
22431,3/2/2014,Iraq,Hurriyah,4,11,15,Car bombers kill four people in a commercial district.
22432,3/2/2014,Lebanon,Choueifat,1,0,1,A Shahid suicide bomber takes out one other person.
22433,4/2/2014,Nigeria,Riyom,34,20,54,Thirty-four villagers are massacred by Muslim gunmen.
22434,4/2/2014,Pakistan,Peshawar,7,42,49,Women and children at a Shiite mosque are among seven people aerated by ball bearings packed into a suicide bomb vest.
22435,4/2/2014,Yemen,Sanaa,2,12,14,"al-Qaeda members bomb a bus, killing two passengers."
22436,4/2/2014,Iraq,Baghdad,18,40,58,Eighteen people are killed in a series of Mujahid suicide bombings and shooting.
22437,4/2/2014,Iraq,Tarmiya,2,0,2,Two people are kidnapped and murdered by al-Qaeda.
22438,4/2/2014,Iraq,Mosul,2,6,8,Two Iraqis are sent to Allah by a Fedayeen suicide bomber.
22439,4/2/2014,Pakistan,Karachi,1,0,1,A 60-year-old Shia leader is shot to death by Sunni extremists.
22440,5/2/2014,Iraq,Hit,3,0,3,Three civlians are burned alive by the Islamic State while other residents were forced to watch.
22441,5/2/2014,Iraq,Baghdad,9,24,33,A triple-bombing at an outdoor market leaves nine dead Shiites.
22442,5/2/2014,Iraq,Baghdad,5,12,17,"A Shahid suicide bomber detonates at a restaurant, brutally ending the lives of five patrons."
22443,5/2/2014,Iraq,Baghdad,12,22,34,Two car bombs at an office park leave a dozen dead.
22444,5/2/2014,Iraq,Fallujah,3,11,14,Three Iraqis are sent to Allah by a Shahid suicide bomber.
22445,5/2/2014,Iraq,Nuaimiya,5,7,12,A suicide bomber kills five people at a checkpoint.
22446,5/2/2014,Iraq,Baghdad,5,11,16,Five people at a busy commercial area are exterminated by Islamic bombers.
22447,5/2/2014,Iraq,Mosul,1,7,8,Three suicide bombers manage to take out one Iraqi.
22448,5/2/2014,Pakistan,Norak,4,0,4,Four tribesmen are riddled with Taliban bullets while sitting outside their house.
22449,5/2/2014,Egypt,Sharqiya,1,1,2,Islamists shoot two policemen in the head.
22450,5/2/2014,Yemen,Aden,1,0,1,al-Qaeda gunmen kill a man outside a sports arena.
22451,6/2/2014,Algeria,Ghardia,1,0,1,A Berber dies after being assaulted by Muslims angered over a minority religious shrine.
22452,6/2/2014,Thailand,Narathiwat,1,0,1,Muslim terrorists shoot a rubber tapper to death.
22453,6/2/2014,Iraq,Sadiyah,1,3,4,A Fedayeen suicide bomber kills one other person.
22454,6/2/2014,Iraq,Mosul,2,0,2,A man and his son are murdered by Mujahid gunmen at a market.
22455,6/2/2014,Syria,Aleppo,46,20,66,A British suicide bomber kills scores of people during an attack on a prison.
22456,7/2/2014,Pakistan,Khanewal,2,3,5,A Shahid suicide bomber wipes out two Pakistanis.
22457,7/2/2014,Thailand,Yala,1,2,3,A 45-year-old man is blown away in front of his home by Muslim 'separatists'.
22458,7/2/2014,Pakistan,Upper Kurram,1,0,1,A Shiite school teacher is picked off by Sunni gunmen.
22459,7/2/2014,Iraq,Tuz Khormatu,5,22,27,"Sunni bombers strike a residential neighborhood, killing five residents."
22460,7/2/2014,Pakistan,Turbat,1,5,6,"Sunni hardliners fire a rocket into a police checkpoint, killing one officer."
22461,8/2/2014,Iraq,Kanous,5,0,5,Five people are kidnapped and beheaded by Religion of Peace fanatics.
22462,8/2/2014,Iraq,Tuz Khormatu,4,7,11,Four civilians are obliterated by Islamist bombers.
22463,8/2/2014,Thailand,Pattani,2,3,5,"Islamic gunmen target a group of police officers, killing two."
22464,9/2/2014,Thailand,Pattani,1,0,1,Muslim militants use a nail bomb to kill a man working at a rubber plantation.
22465,9/2/2014,Iraq,Tuz Khormatu,6,0,6,Six guards at a construction site are rounded up and executed after it is determined that they are Shiite.
22466,9/2/2014,Iraq,Baiji,3,0,3,Three family members are kidnapped and beheaded by al-Qaeda.
22467,9/2/2014,Syria,Maan,40,0,40,"Islamists seize control of a small village and massacre forty people, mostly women and children who belong to the Alawite faith."
22468,9/2/2014,Iraq,Mosul,2,0,2,Two members of the Shabak religious minority are gunned down in a targeted attack.
22469,9/2/2014,Iraq,Tuz Khormato,4,28,32,A Mujahid car bomb attack on a commercial center leaves four dead.
22470,9/2/2014,Iraq,Baghdad,1,0,1,A prominent Shia politician is assassinated by suspected al-Qaeda.
22471,9/2/2014,Pakistan,Karachi,9,10,19,"Fundamentalists fire into a group at a Sufi shrine, killing nine including a baby."
22472,9/2/2014,Yemen,Sanaa,2,3,5,Two bystanders are taken out by an al-Qaeda suicide bomb attack.
22473,9/2/2014,Israel,Jerusalem,0,1,1,An ultra-Orthodox Jewish man is brutally stabbed on the street.
22474,9/2/2014,Afghanistan,Dilaram,7,0,7,A Taliban roadside bomb kills seven local soldiers.
22475,9/2/2014,Iraq,Sadr City,2,9,11,"Sunnis bomb a market in a Shia area, killing two."
22476,9/2/2014,Iraq,Gatoun,3,5,8,Mujahid bombers successfully kill a child and two others.
22477,9/2/2014,Thailand,Pattani,1,0,1,A Buddhist woman is shot at a market and then set on fire by militant Muslims.
22478,10/2/2014,Sudan,Damardago,1,2,3,"A Christian is killed, and two others badly burned, in a targeted bombing on their village by the Islamic Republic of Sudan."
22479,10/2/2014,Afghanistan,Kabul,2,3,5,A Fedayeen suicide bomber takes out two civilians.
22480,10/2/2014,Pakistan,Peshawar,4,6,10,A Lashkar-e-Islam suicide blast takes the lives of four women.
22481,10/2/2014,Iraq,Ramadi,4,7,11,A Shahid suicide bomber murders four Iraqis.
22482,10/2/2014,Pakistan,Mauza Kot Olakh,2,0,2,A conservative family kills their 18-year-old daughter and her boyfriend over suspicion of sex.
22483,10/2/2014,Pakistan,Hangu,3,0,3,Three teachers are shot to death by Islamic extremists.
22484,10/2/2014,Pakistan,Dera Ismail Khan,1,1,2,Two guards for an anti-polio team are gunned down by religious hardliners.
22485,11/2/2014,Pakistan,Peshawar,13,24,37,"Islamists throw three grenades into a cinema showing a pornographic movie, killing over a dozen patrons."
22486,11/2/2014,Pakistan,Islamabad,1,0,1,Muslim cops arrest an innocent Christian father of two and torture him to death.
22487,11/2/2014,CAR,Bangui,1,0,1,"Muslim target a Christian man carrying wood, slitting his throat"
22488,11/2/2014,Nigeria,Konduga,62,50,112,Islamists roll up on a local village and slaughter over sixty residents.
22489,11/2/2014,Iraq,Mosul,2,1,3,A woman and child are taken apart by an al-Qaeda roadside bomb.
22490,11/2/2014,Iraq,Nineveh,16,0,16,Hardline fundamentalists shoot and slit the throats of sixteen Iraqi soldiers.
22491,11/2/2014,Egypt,Ismailia,5,0,5,Five policemen are murdered by religious radicals in three shooting attacks.
22492,12/2/2014,Syria,al-Reqqa,1,0,1,A girl is stoned to death after a religious court convicts her for having a Facebook account.
22493,12/2/2014,Thailand,Pattani,1,0,1,A female banker is killed and set on fire by Muslims because she was Buddhist.
22494,12/2/2014,Pakistan,Peshawar,9,0,9,"Two children, ages 8 and 10, are among a family of nine taken from their home and executed by activists fighting for Islamic law."
22495,12/2/2014,Pakistan,Nazimabad,2,0,2,Two Shiite activists are ambushed and murdered by Ahl-e-Sunnat Wal-Jamaat.
22496,12/2/2014,Afghanistan,Kapisa,2,0,2,"Taliban in uniform turn the weapons on US troops, killing two."
22497,12/2/2014,Iraq,Tuz Khormato,4,9,13,Four Iraqis are blown to bits by Mujahid bombers.
22498,12/2/2014,Pakistan,Swabi,1,1,2,"Islamic militants fire on two brothers, killing one."
22499,13/2/2014,Nigeria,Izhe,9,0,9,Nine local soldiers are ambushed and killed by Boko Haram.
22500,13/2/2014,Yemen,Sanaa,7,3,10,Seven people are killed during an attack on a prison by suspected al-Qaeda.
22501,13/2/2014,Somalia,Mogadishu,7,15,22,An al-Shabaab car bomb takes the lives of fifteen people at an airport.
22502,13/2/2014,Thailand,Pattani,4,6,10,A Buddhist monk and a child of 9 are among five people brought down by a Muslim drive-by shooting.
22503,13/2/2014,Pakistan,Karachi,13,57,70,A brutal Tehreek-e-Taliban suicide blast sends over a dozen bus passengers to Allah.
22504,13/2/2014,Iraq,Baghdad,7,21,28,Sunni extremists set off two bombs at a historic market which leave seven dead.
22505,13/2/2014,Iraq,Baqubah,3,12,15,Three people are dismantled by Sunni bombers.
22506,14/2/2014,Iraq,Hillah,11,3,14,Eleven local soldiers are machine-gunned at a checkpoint by suspected al-Qaeda.
22507,14/2/2014,Iraq,Saqlawiya,7,4,11,A Shahid suicide bomber murders seven Iraqis.
22508,14/2/2014,Syria,Yadouda,48,150,198,Dozens are reported dead following a car bomb attack on a rival mosque.
22509,15/2/2014,Thailand,Yala,2,0,2,A husband and wife die of gunshot wounds following a Muslim drive-by.
22510,15/2/2014,Nigeria,Izghe,121,0,121,Over one-hundred mostly Christian villagers are rounded up and summarily hacked to death by militants shouting praises to Allah.
22511,15/2/2014,Thailand,Narathiwat,2,0,2,Muslim 'separatists' chase down and murder two construction workers.
22512,15/2/2014,Iraq,Mosul,3,0,3,Sunni radicals kidnap and behead three local policemen.
22513,15/2/2014,Iraq,Baghdad,17,12,29,A series of Mujahideen attacks leave seventeen dead across the country.
22514,15/2/2014,Afghanistan,Kunduz,2,6,8,Two civilians are shredded by a Fedayeen suicide bomber.
22515,16/2/2014,Pakistan,Loralai,2,0,2,A man and woman are formally executed over consensual sex at the order of a cleric.
22516,16/2/2014,Tunisia,Jendouba,4,4,8,Ansar al-Sharia fundamentalists kill four locals in two attacks.
22517,16/2/2014,Iraq,Muqdadiya,2,0,2,al-Qaeda gunmen pick off two Iraqis.
22518,16/2/2014,Iraq,Shirqat,2,0,2,A father and son are murdered in the own home by Islamic terrorists.
22519,16/2/2014,Iraq,Baghdad,4,15,19,Sunni car bombers take out four people in a Shia commercial district.
22520,16/2/2014,Pakistan,Jacobabad,7,35,42,"Militants fighting for an Islamic state are suspected of bombing a train and killing seven passengers, including four children."
22521,16/2/2014,Pakistan,Budhni,1,1,2,An attack on a polio vaccination team leaves one guard dead.
22522,16/2/2014,Egypt,Taba,4,13,17,Three Christian tourists and their driver are killed as Shahid suicide bomber detonates on board their bus.
22523,16/2/2014,Iraq,Kirkuk,5,0,5,Five policemen at a checkpoint are massacred by Mujahid gunmen.
22524,16/2/2014,Iraq,Ramadi,3,4,7,Three people lose their lives to a Fedayeen suicide bomber.
22525,17/2/2014,Pakistan,Shongari,23,0,23,Twenty-three captured soldiers are beheaded after being held hostage for nearly four years.
22526,17/2/2014,Iraq,Anbar,1,8,9,A Shahid suicide bomber manages to kill one other person.
22527,17/2/2014,Iraq,Mosul,1,1,2,A baby is torn to shreds by a Religion of Peace bomb blast.
22528,17/2/2014,Afghanistan,Kapisa,6,0,6,A half-dozen Afghans are blown to bits by religious radicals.
22529,17/2/2014,Iraq,Baghdad,2,9,11,"Sunnis bomb a Shia mosque, killing two worshippers."
22530,17/2/2014,Iraq,Baghdad,4,15,19,Four patrons are pulled into pieces by al-Qaeda bombers.
22531,17/2/2014,Somalia,Kismayo,3,0,3,Three men are murdered by a pro-Sharia gunmen.
22532,17/2/2014,Iraq,Baghdad,10,26,36,"Sunni car bombers strike a heavily populated Shiite area, taking out ten civilians."
22533,17/2/2014,Iraq,Karrada,9,30,39,Nine civilians at a market are sectionalized by Jihadi car bombers.
22534,17/2/2014,Iraq,Ramadi,3,6,9,A suicide car bomber sends three Iraqis to Allah.
22535,17/2/2014,Egypt,Alexandria,4,0,4,A 6-year-old girl is among a Christian family of four found murdered.
22536,18/2/2014,Thailand,Pattani,3,0,3,"Suspected Muslim 'insurgents' sweep the inside of a pickup truck with gunfire, killing three riders."
22537,18/2/2014,Syria,Aleppo,14,0,14,A video shows a hardline fundamentalist group executing fourteen people in cold blood.
22538,18/2/2014,Iraq,Hillah,35,90,125,Thirty-five people are torn to shreds by seven al-Qaeda car bombs.
22539,18/2/2014,Nigeria,Borno,1,0,1,A guard is killed during a Boko Haram attack on a house.
22540,18/2/2014,Iraq,Baghdad,7,18,25,A brutal al-Qaeda car bomb at a bus station claims the lives of seven innocents.
22541,18/2/2014,Iraq,Baghdad,10,31,41,A series of Religion of Peace car bombs in mostly Shia areas leave ten dead.
22542,18/2/2014,Philippines,Jolo,1,0,1,A farmer is beheaded by Bangsamoro Islamists.
22543,18/2/2014,Nigeria,Adamawa,11,0,11,Eleven villagers are slaughtered by Boko Haram.
22544,19/2/2014,Nigeria,Bama,115,48,163,Fifty people at a school are among over 100 'infidels' shot up or burned to death by militants fighting for an Islamic state.
22545,19/2/2014,Lebanon,Beirut,12,103,115,Two Abdullah Azzam Brigades suicide bombers murder a dozen people outside an orphanage.
22546,19/2/2014,Iraq,Dujail,3,20,23,A powerful car bomb sends ball bearings through shoppers at a market.
22547,19/2/2014,Iraq,Mahmoudiya,6,18,24,Six people bleed to death when Jihadis set off a bomb at a vegetable market.
22548,19/2/2014,Nigeria,Rapyem,13,0,13,Nine children are among thirteen villagers slain in their sleep by Muslim terrorists.
22549,20/2/2014,Iraq,Musayyib,22,50,72,"Sunnis send mortar rounds into a Shiite neighborhood, killing over twenty residents."
22550,20/2/2014,Afghanistan,Kabul,1,4,5,A suicide bomber takes out a security guard.
22551,20/2/2014,Thailand,Yala,1,1,2,"Muslim terrorists fire on a man and wife, killing the husband."
22552,20/2/2014,Syria,Esselame,24,25,49,Two dozen people are reduced to pulp by ISIL bombers.
22553,20/2/2014,Iraq,Dujail,10,8,18,Three al-Qaeda bombs produce ten dead Iraqis.
22554,21/2/2014,Somalia,Mogadishu,5,6,11,Five Somalis are laid out by a number of Fedayeen suicide bombers.
22555,21/2/2014,Pakistan,Sibi,1,0,1,The Taliban strap explosives to a 13-year-old boy.
22556,21/2/2014,Afghanistan,Sarobi,1,3,4,Three suicide bombers manage to kill only one other person.
22557,21/2/2014,India,Sopore,1,0,1,Islamists murder a civilian.
22558,22/2/2014,Pakistan,Barawal,2,0,2,A man and woman are shot to death for having 'illicit' sex.
22559,22/2/2014,Afghanistan,Laghman,3,5,8,A child is among three people killed when fundamentalists fire on a women's clinic.
22560,22/2/2014,Thailand,Yala,3,0,3,Three Buddhists are gunned down at a shop by militant Muslims.
22561,22/2/2014,Pakistan,Buner,3,2,5,Three people lose their lives to a Taliban bomb.
22562,22/2/2014,Iraq,Ramadi,6,4,10,A Fedayeen suicide bomber sends a half-dozen Iraqis to Allah.
22563,22/2/2014,Lebanon,Hermel,3,10,13,Three people are blown to bits by an al-Nusra suicide bomber.
22564,22/2/2014,Iraq,Baqubah,6,4,10,A half dozen Iraqis are machine-gunned by militants fighting for an Islamic state.
22565,22/2/2014,Iraq,Kirkuk,5,18,23,"'Insurgents' set off three car bombs in a neighborhood, killing five people."
22566,23/2/2014,Iraq,Sadr City,6,21,27,A bomb planted at a bicycle market claims the lives of six people.
22567,23/2/2014,Pakistan,Karachi,1,3,4,A 10-year-old boy is among the victims of a Taliban shooting inside a rival mosque.
22568,23/2/2014,Iraq,Baghdad,4,17,21,"Mujahideen detonate a bomb along a busy street, which takes the lives of four innocents."
22569,23/2/2014,Syria,Aleppo,7,0,7,Seven Jihadis are killed by a rival suicide bomber.
22570,23/2/2014,Iraq,Baiji,7,0,7,Muslim militants kill seven Iraqis with automatic weapons fire.
22571,23/2/2014,Egypt,Zagazig,1,0,1,Religious extremists murder a man on his way home.
22572,23/2/2014,Syria,Atmeh,14,50,64,Sectarian bombers take out over a dozen people outside a hospital.
22573,23/2/2014,Pakistan,Kohat,13,14,27,A woman and child are among thirteen who bleed to death following a Religion of Peace shrapnel bombing.
22574,23/2/2014,Afghanistan,Kunar,21,3,24,"Armed fundamentalists assault an Afghan checkpoint, killing twenty-one defenders."
22575,23/2/2014,Thailand,Yala,2,0,2,An older couple in their 60's are machine-gunned in their own home by a group of fifteen Muslims.
22576,24/2/2014,Iraq,Khalidiya,2,3,5,Two Iraqis are taken down by al-Qaeda.
22577,24/2/2014,Thailand,Yala,1,0,1,A 42-year-old man is ambushed and killed by Muslim terrorists.
22578,24/2/2014,Libya,Benghazi,7,0,7,Seven Christians are shot execution-style by Muslims who first confirmed their identity.
22579,24/2/2014,Bangladesh,Mymensingh,1,0,1,Jama'atul Mujahideen gun down a cop.
22580,24/2/2014,Pakistan,Peshawar,2,13,15,"A Sunni suicide bomber attacks an Iranian consulate office, killing two guards."
22581,24/2/2014,Nigeria,Izge,3,0,3,Two women and a man are murdered by Islamic extremists.
22582,24/2/2014,Pakistan,Karachi,1,0,1,An elderly Shiite is picked off by Sipah-e-Sahaba gunmen.
22583,24/2/2014,Thailand,Yala,2,2,4,Two attacks by Muslim terrorists leave two dead.
22584,25/2/2014,Afghanistan,Tirinkot,9,40,49,Nine people are wiped out when a Shahid suicide bomber detonates at a hotel.
22585,25/2/2014,Nigeria,Damaturu,59,29,88,Islamic extremists burn alive or slit the throats of dozens of students at a school.
22586,25/2/2014,Iraq,Meshahda,4,0,4,Four Iraqis are kidnapped and executed by al-Qaeda.
22587,25/2/2014,Iraq,Baghdad,15,36,51,Fifteen innocents at a crowded commercial district are blown to bits by a Mujahideen car bomb.
22588,25/2/2014,Iraq,Ramadi,3,18,21,A Fedayeen suicide bomber obliterates three souls.
22589,26/2/2014,Nigeria,Ayekale,1,3,4,A 19-year-old woman is hacked to death inside a church for leaving her Islamic faith.  The pastor and his family are seriously wounded as well.
22590,26/2/2014,Turkmenistan,Moqor,3,0,3,Three border guards are gunned down by Taliban.
22591,26/2/2014,Nigeria,Michika,3,0,3,Three catholic nuns are feared dead after their church is torched by Islamists.
22592,26/2/2014,Nigeria,Riyom,2,0,2,Two family members are shot to death their own home by Boko Haram.
22593,26/2/2014,Thailand,Narathiwat,1,1,2,Muslim gunmen murder a man and critically injure his wife.
22594,26/2/2014,Iraq,Diyala,4,5,9,Roadside bombers kill four passengers on a bus.
22595,26/2/2014,Iraq,Mosul,4,5,9,Four Iraqis are blow to bits by a Fedayeen suicide bomber.
22596,27/2/2014,Pakistan,Karachi,2,1,3,Sunni gunmen take down a Shiite imam and his son outside their madrassah.
22597,27/2/2014,Pakistan,Karachi,1,0,1,A prominent Shia scholar is gunned down by Sunni rivals.
22598,27/2/2014,Pakistan,Samanabad,1,1,2,A seminary teacher is assassinated by rival co-religionists.
22599,27/2/2014,Iraq,Sadr City,32,56,88,Thirty-two patrons at a used motorbike market in a Shia area are brutally dismantled by Sunni bombers.
22600,27/2/2014,Somalia,Mogadishu,10,12,22,Ten people are taken out in mid-bite by an al-Shabaab bombing at a restaurant.
22601,27/2/2014,Syria,Homs,5,13,18,Five people are killed when Sunni militants fire a rocket into a hospital.
22602,27/2/2014,Nigeria,Adamawa,37,20,57,"Boko Haram Islamists burn churches and massacre nearly forty people, including students at a Christian seminary."
22603,27/2/2014,Iraq,Baghdad,3,3,6,A Shahid suicide bomber sends three Iraqis to Allah.
22604,27/2/2014,Iraq,Baghdad,4,13,17,A bomb blast in a neighborhood leaves four dead.
22605,27/2/2014,Iraq,Sadr City,4,14,18,Sunnis plant a bomb on a minibus that kills five Shia.
22606,27/2/2014,Iraq,Haditha,7,5,12,A Religion of Peace suicide bomber blows up seven people at a house.
22607,27/2/2014,Iraq,Tuz Khurmato,2,18,20,"Jihadis blow up a fish market, killing two patrons."
22608,28/2/2014,Pakistan,Miranshah,5,5,10,Five people are killed by Muslim terrorists in two bombing and shooting attacks.
22609,28/2/2014,Egypt,Mansoura,1,0,1,A local cop is murdered by Islamic extremists.
22610,28/2/2014,Pakistan,Nazimabad,2,1,3,"Muslim militant open fire on a group of worshippers at a rival mosque, killing two."
22611,28/2/2014,Pakistan,Karachi,1,1,2,Sectarian Jihadis pick off a salesman working at a shop.
22612,28/2/2014,Iraq,Baqubah,3,1,4,Four family members are riddled with machine-gun fire by Mujahideen.
22613,28/2/2014,Tanzania,Bondeni,0,2,2,A cleric and his son are doused with acid after declining to promote Jihad.
22614,1/3/2014,Pakistan,Hotani,1,0,1,A woman is murdered by her conservative brother-in-law on suspicion of an affair.
22615,1/3/2014,China,Yunnan,33,143,176,A group of Muslim terrorists go on a sudden stabbing spree at a train station that leaves over thirty dead.
22616,1/3/2014,Iraq,Tuz Khormato,3,10,13,"Suspected al-Qaeda bombers target a shop, killing three patrons."
22617,1/3/2014,Iraq,Balad Ruz,1,6,7,A woman is taken out by Jihadi bombers.
22618,1/3/2014,Pakistan,Jamrud,12,12,24,A young boy is among a dozen killed in two bombing attacks on polio vaccination teams.
22619,1/3/2014,Nigeria,Maiduguri,52,60,112,Children are 'most affected' by a double suicide bombing at a crowded marketplace that leaves over fifty dead.
22620,1/3/2014,Nigeria,Bullumkuttu,7,19,26,A Boko Haram car bomb claims seven lives.
22621,1/3/2014,Nigeria,Mainok,47,25,72,Islamic extremists pour into a village and massacre over forty innocents.
22622,2/3/2014,Afghanistan,Nangarhar,2,1,3,Two students bleed to death following a bomb attack by fundamentalists.
22623,2/3/2014,Syria,Aleppo,10,0,10,Ten victims of the ISIL are discovered in a mass grave.
22624,2/3/2014,Afghanistan,Logar,4,0,4,Two children and two women are killed by a Taliban bomb.
22625,2/3/2014,Iraq,Tikrit,2,2,4,Two Iraqis are blown up by al-Qaeda.
22626,2/3/2014,Nigeria,Mafa,32,48,80,Thirty-two villagers are slaughtered by militants fighting for Sharia.
22627,2/3/2014,Libya,Benghazi,1,0,1,Islamists are suspected of shooting a French engineer to death.
22628,2/3/2014,Thailand,Yala,1,1,2,A couple of married gardeners are ambushed and killed by Muslim terrorists.
22629,2/3/2014,Cameroon,Border,7,0,7,Seven people are killed when Nigerian Islamists sneak across the border and open fire.
22630,2/3/2014,Iran,Rasht,2,0,2,Two homosexuals are executed for the crime of 'perversion'.
22631,3/3/2014,Thailand,Yala,1,0,1,Muslim terrorists murder a 40-year-old laborer outside a tea shop.
22632,3/3/2014,India,Pulwama,2,0,2,Muslim terrorists murder two people transporting food.
22633,3/3/2014,Iraq,Fallujah,2,2,4,Two women are crushed to death by a mortar attack that also injures two children.
22634,3/3/2014,Iraq,Hawija,2,6,8,al-Qaeda bombers take out two mourners at a funeral.
22635,3/3/2014,Nigeria,Jakana,48,14,62,"Gunmen shouting praises to Allah invade a small village and kill nearly fifty innocents, some by burning."
22636,3/3/2014,Pakistan,Islamabad,12,28,40,A dozen people are pulled into pieces by a suicide bomber inside a court house.
22637,3/3/2014,Pakistan,Landikotal,2,6,8,Islamic radicals kill two local soldiers with a roadside bomb and subsequent shooting.
22638,3/3/2014,Nigeria,Borno,2,14,16,Two local cops are taken down by a Boko Haram bomb.
22639,3/3/2014,Yemen,Shabwa,6,14,20,An al-Qaeda ambush leaves six local soldiers dead.
22640,4/3/2014,Pakistan,Jamrud,2,2,4,Two truck drivers lose their lives to Taliban snipers.
22641,4/3/2014,Somalia,Barawa,2,0,2,A woman and her cousin are beheaded in front of her young children for being Christians.
22642,4/3/2014,Afghanistan,Qaisar,7,0,7,Sunni hardliners roll up on a checkpoint and machine-gun seven local cops at point-blank range.
22643,4/3/2014,Iraq,Samarrah,7,35,42,Seven Iraqis are laid out by al-Qaeda gunmen at a city council.
22644,4/3/2014,Thailand,Yala,1,1,2,A 22-year-old woman is shot to death in front of her husband by 'insurgents'.
22645,4/3/2014,Bahrain,Manama,3,0,3,Three police are pulverized by a bomb thought to have been planted by Shiite radicals.
22646,4/3/2014,Pakistan,Karachi,1,0,1,A Shia man is gunned down by Sipah-e-Sahaba.
22647,5/3/2014,Syria,Homs,15,12,27,Fifteen people are reduced to pulp by a Sunni car bombing.
22648,5/3/2014,Pakistan,Hangu,6,8,14,Six local soldiers are slain by Ansar-ul-Mujahideen.
22649,5/3/2014,Iraq,Ramadi,3,3,6,Three Iraqis are dismantled by a Fedayeen suicide bomber.
22650,5/3/2014,Iraq,Baghdad,3,10,13,"Fundamentalists bomb a university, killing three bystanders."
22651,5/3/2014,Iraq,Baghdad,8,31,39,"Sunni bombers strike a Shiite neighborhood, taking out at least eight innocents."
22652,6/3/2014,USA,"Port Bolivar, TX",2,0,2,A Muslim man shoots his lesbian daughter and her lover to death and leaves a copy of the Quran open to a page condemning homosexuality.
22653,6/3/2014,Pakistan,Kurram,3,3,6,Two women are among three people killed in a Religion of Peace bomb blast.
22654,6/3/2014,Syria,Hama,5,20,25,Two suicide bombings leave at least five dead.
22655,6/3/2014,Nigeria,Riyom,16,10,26,"Armed Muslims raid a series of Christian villages, burning churches and killing sixteen, including women and four children."
22656,6/3/2014,Iraq,Baghdad,4,7,11,Jihadis murder four people at a cafe.
22657,6/3/2014,Syria,Homs,15,12,27,A brutal sectarian car bombing in an Armenian neighborhood leaves fifteen dead.
22658,6/3/2014,Iraq,Baghdad,7,17,24,Sunni bomber take down seven patrons at an outdoor market frequented by Shias.
22659,6/3/2014,Iraq,Kanaan,5,12,17,Five people at a billiards hall lose their lives to a Mujahideen bomb blast.
22660,6/3/2014,Iraq,Hillah,9,28,37,Two al-Qaeda car bombs produce nine dead Iraqis.
22661,6/3/2014,Iraq,Iskandariyah,4,10,14,Fundamentalist bombers blow up four people at a casino.
22662,6/3/2014,Iraq,Meshada,5,14,19,Five civilians are blown apart by a terrorist bomb blast.
22663,6/3/2014,Iraq,Baghdad,2,11,13,A bomb at a restaurant leaves two dead.
22664,7/3/2014,Afghanistan,Marjah,5,8,13,"Sunni hardliners detonate a bomb in a crowded marketplace, killing five shoppers."
22665,7/3/2014,Iraq,Tuz Khormatu,4,18,22,Jihadis plant a bomb at a market that takes the lives of four innocents.
22666,7/3/2014,Iraq,Ramadi,3,4,7,Three Iraqis are taken out by a Shahid suicide bomber.
22667,7/3/2014,Syria,Aleppo,10,0,10,Ten 'enemies of Islam' are lined up and shot on video to the cry of 'Allah Akbar'.
22668,8/3/2014,Afghanistan,Taywara,3,0,3,Three teachers are kidnapped and murdered by Islamic extremists.
22669,8/3/2014,Afghanistan,Nazian,1,6,7,The Taliban assassinate a district chief by attaching a bomb to his car.
22670,8/3/2014,Yemen,Lawder,2,0,2,Two local soldiers are killed when al-Qaeda militants fire an RPG into their base.
22671,8/3/2014,Iraq,Baghdad,6,14,20,A street packed with shoppers is the target of a suspected al-Qaeda blast that kills at least a half-dozen Iraqis.
22672,8/3/2014,Iraq,Ramadi,13,29,42,A suicide bombing is among a series of Mujahid attacks that leave nine dead.
22673,8/3/2014,Afghanistan,Kajaki,2,0,2,Two civilians are disintegrated by a Taliban bomb.
22674,9/3/2014,Afghanistan,Musa Qala,7,8,15,Three women and two children are among a family of seven reduced to a bloody mess by Taliban bombers.
22675,9/3/2014,Thailand,Narathiwat,1,0,1,'Insurgents' fire two shots into the head of a man laying eel traps.
22676,9/3/2014,Thailand,Pattani,1,0,1,A Buddhist fisherman is shot to death by suspected militants.
22677,9/3/2014,Iraq,Tuz Khurmatu,3,7,10,"'Insurgents' fire on oil company workers, killing three."
22678,9/3/2014,Iraq,Abu Ghraib,4,0,4,Suspected al-Qaeda roll up on a check point and machine-gun four policemen.
22679,9/3/2014,Iraq,Hillah,45,157,202,Over forty people are aerated by a suicide bomber with a shrapnel-packed minibus.
22680,9/3/2014,Thailand,Pattani,4,3,7,"Runda Kumpulan Kecil gunmen open fire on a Buddhist village, killing four residents."
22681,10/3/2014,Pakistan,Islamabad,1,2,3,Sectarian Jihadi gunmen pick off a rival cleric.
22682,10/3/2014,Afghanistan,Herat,2,7,9,Hardline fundamentalists detonate a motorcycle shrapnel bomb that sends two local to Allah.
22683,10/3/2014,Pakistan,Peshawar,1,0,1,Sunni snipers pick off a Shiite outside his house.
22684,10/3/2014,Iraq,Muqdadiya,1,0,1,A mosque preacher is picked off on his way home by rivals.
22685,10/3/2014,Iraq,Baqubah,2,4,6,A child and an old man are exterminated by Mujahideen bombers.
22686,11/3/2014,Turkey,Istanbul,2,0,2,A woman is honor killed in court by her own son for seeking a divorce (a bystander is also killed).
22687,11/3/2014,Pakistan,Dera Ismail Khan,2,0,2,Two people are killed when Islamists fire on a team trying to vaccinate children against polio.
22688,11/3/2014,Iraq,Qamishli,7,15,22,Four women are among seven Kurds killed by three suicide bombers.
22689,11/3/2014,Afghanistan,Kabul,1,0,1,A European journalist is assassinated by religious radicals from Fidai Mahaz.
22690,11/3/2014,Syria,Jarabulus,22,0,22,Islamists with knives execute twenty-two people in cold blood while shouting praises to Allah.
22691,11/3/2014,Iraq,Baqubah,2,8,10,Two people at a mosque are blown to bits by Religion of Peace rivals.
22692,11/3/2014,Iraq,Samarrah,2,0,2,A woman and her child are disassembled by Mujahid bombers.
22693,12/3/2014,Afghanistan,Faryab,3,0,3,Three election workers are murdered by Taliban fundamentalists.
22694,12/3/2014,Iraq,Aziria,4,5,9,A Shahid suicide car bomber takes out four Iraqis.
22695,13/3/2014,Kenya,Mandera,2,0,2,A young woman closing her shop is among two people shot to death by al-Shabaab.
22696,13/3/2014,Egypt,Cairo,1,3,4,"Islamists open fire at a bus stop, killing a guard."
22697,13/3/2014,Thailand,Narathiwat,1,0,1,A 45-year-old rubber tapper is gunned down by Muslim terrorists.
22698,13/3/2014,Iraq,Mosul,1,3,4,One other person loses their lives to a suicide car bomber.
22699,13/3/2014,Iraq,Rawa,18,18,36,Mujahid bombers sectionalize eighteen members of a wedding party.
22700,13/3/2014,Pakistan,Shabqadar,2,0,2,A Sikh man and his employee are murdered in a targeted attack on him.
22701,13/3/2014,Iraq,Rawa,4,3,7,Four people on a bridge are sent to the great beyond by a Fedayeen suicide bomber.
22702,14/3/2014,Nigeria,Maiduguri,8,12,20,At least eight civilians die during a sustained assault by Boko Haram.
22703,14/3/2014,Somalia,Hiraan,10,23,33,An al-Shabaab assault on a small town leaves ten dead.
22704,14/3/2014,Nigeria,Kayamla,20,0,20,Islamists stop commercial vehicles at random on a highway and murder the passengers.
22705,14/3/2014,Pakistan,Quetta,11,42,53,Ahrarul Hind terrorists blown eleven people to bits to 'bring about Islamic Sharia'.
22706,14/3/2014,Pakistan,Peshawar,10,45,55,"A Fedayeen suicide bomber detonates at gas station, incinerating ten souls, including two women."
22707,14/3/2014,Afghanistan,Helmand,6,0,6,Two children and two women are among a family of six obliterated by Religion of Peace bombers.
22708,14/3/2014,Iraq,Baghdad,5,16,21,Five patrons at a market are aerated by a shrapnel bomb blast.
22709,14/3/2014,Iraq,Anbar,3,6,9,Three Iraqis are taken out by a Fedayeen suicide bomber.
22710,14/3/2014,Thailand,Pattani,1,0,1,Muslim shoot a Buddhist teacher and then set her body on fire.
22711,15/3/2014,Libya,Benghazi,1,0,1,A Christian dies two weeks after being shot in the head by Ansar al-Sharia.
22712,15/3/2014,Iraq,Baqubah,2,0,2,An elderly woman is among two people take out by Jihadi snipers.
22713,15/3/2014,Iraq,Baghdad,15,50,65,Sunnis murder fifteen Shiites with three car bomb blasts.
22714,15/3/2014,Iraq,Baghdad,3,6,9,A bomb placed at a restaurant kills three patrons.
22715,15/3/2014,Nigeria,Chenshyi,150,48,198,"A pastor and his family are among over 150 people 'shot, burned and hacked' by Muslim herdsmen in attacks on three Christian villages."
22716,15/3/2014,Egypt,Cairo,6,0,6,Islamists machine-gun six off-duty soldiers.
22717,15/3/2014,Egypt,Minya,1,0,1,Muslim extremists shoot a Christian in the head.
22718,15/3/2014,Somalia,Mogadishu,0,2,2,A suicide bomber suffers premature detonation outside a hotel.
22719,16/3/2014,Nigeria,Pela Birni,2,0,2,"Boko Haram attack a Christian village, torch a church and murder two people."
22720,16/3/2014,Nigeria,Taraba,35,0,35,Thirty-five people are reported dead following a Fulani attack on a Catholic church and village.
22721,16/3/2014,Iraq,Mosul,3,5,8,A Shahid suicide bomber takes out three bombers.
22722,16/3/2014,Iraq,Sammarah,4,6,10,al-Qaeda gunmen attack a family home and murder four occupants.
22723,16/3/2014,Lebanon,Nabi Othman,4,12,16,A married couple are among four people pulled apart by an al-Nusra suicide car bombing.
22724,17/3/2014,China,Xinjiang,1,0,1,A local cop is stabbed by a Uighur militant.
22725,17/3/2014,Somalia,Yalho,1,3,4,A man bleeds to death following an al-Shabaab bombing.
22726,17/3/2014,Syria,Homs,6,20,26,Women and children are among six people cut down by sectarian car bombers.
22727,17/3/2014,Libya,Benghazi,10,23,33,Ten people are injured in a car bomb blast staged by Islamic extremists.
22728,17/3/2014,Afghanistan,Herat,2,0,2,A judge and his bodyguard are gunned down by Taliban.
22729,17/3/2014,Pakistan,Karachi,1,0,1,A doctor belonging to a minority religious community is brought down at his clinic by sectarian gunmen.
22730,17/3/2014,Iraq,Saladin,4,2,6,At least one child is among four women blown up in their own home by al-Qaeda.
22731,17/3/2014,Pakistan,Gara Mehraban,2,0,2,A father and son are shot to death by Islamist 'insurgents'.
22732,17/3/2014,Somalia,Alamada,7,0,7,al-Shabaab claims credit for a suicide car bombing that leaves seven dead.
22733,17/3/2014,Thailand,Yala,1,0,1,The 65-year-old Buddhist owner of a gas station is shot and set on fire by militant Muslims.
22734,17/3/2014,Iraq,Ramadi,1,4,5,"A suicide bomber detonates on a city street, taking one other soul with him."
22735,17/3/2014,Somalia,Bulobarde,21,20,41,Two dozen people are killed when a suicide bomber plows an explosives-laden car into a hotel in the middle of the night.
22736,18/3/2014,Thailand,Pattani,1,1,2,A bomb targeting teachers kills one of their guards.
22737,18/3/2014,Iraq,Hillah,3,13,16,Two car bombings at a restaurant and bus stop claim the lives of three Iraqis.
22738,18/3/2014,Thailand,Pattani,2,0,2,A construction worker and his 3-year-old son are shot to death by suspected 'insurgents'.
22739,18/3/2014,Iraq,Karbala,3,16,19,"Sunnis set off a bomb blast among a group of shops in a Shia city, sending at least three innocents to Allah."
22740,18/3/2014,Iraq,Ramadi,4,0,4,Four local soldiers are ambushed and killed by suspected al-Qaeda.
22741,18/3/2014,Afghanistan,Maimana,16,20,36,Sixteen people at a market are disassembled by a Shahid suicide bomber with a rickshaw.
22742,18/3/2014,Iraq,Baghdad,10,47,57,Mujahid murder at least ten Iraqis with seven car bombs.
22743,18/3/2014,Lebanon,Fanar,1,0,1,A man is stabbed to death in a brutal sectarian attack.
22744,18/3/2014,Yemen,Aden,1,12,13,A suicide bomber kills one other person.
22745,19/3/2014,Pakistan,Talib Jan,4,2,6,A Taliban bomb explodes early killing four women and a child belonging to the family of the militant.
22746,19/3/2014,Iraq,Samarra,11,11,22,Women and children are among eleven people aerated by a shrapnel blast.
22747,19/3/2014,Iraq,Samarra,3,0,3,al-Qaeda members behead a woman and her sons.
22748,19/3/2014,Iraq,Mosul,2,0,2,Two Shabek religious minorities lose their lives to Religion of Peace gunmen.
22749,19/3/2014,Iraq,Mosul,1,0,1,A cleric who preached peace is quickly shot to death by terrorists.
22750,19/3/2014,Iraq,Jurf al-Sakhar,3,13,16,Three Iraqis are slain by Mujahideen.
22751,19/3/2014,Iraq,Baghdad,13,40,53,Thirteen people at a cafe are torn to shreds by a Shahid suicide bomber.
22752,20/3/2014,Afghanistan,Jalalabad,11,22,33,A Fedayeen suicide assault on a police station leaves eleven dead.
22753,20/3/2014,Pakistan,Shikarpur,2,0,2,A religious council orders the death of two girls for the crime of marrying by choice.
22754,20/3/2014,Nigeria,Ngurosoye,32,60,92,At least thirty people are murdered when Islamists toss grenades into a fish market.
22755,20/3/2014,Afghanistan,Kabul,9,6,15,Two young girls are among nine people shot to death when teenage Taliban storm a hotel.
22756,20/3/2014,Iraq,Hawija,2,0,2,Militants fighting for an Islamic state pull a man and his son from their home and murder them.
22757,20/3/2014,Iraq,Ramadi,14,18,32,"Terrorists blow up a house with twenty Iraqi policemen inside, killing fourteen."
22758,20/3/2014,Turkey,Ulukisla,3,0,3,Jihadists attack and kill three security personnel.
22759,21/3/2014,Iraq,Ramadi,13,37,50,"An al-Qaeda suicide bomber detonates in the middle of a packed funeral, ripping the lives out of thirteen more people."
22760,21/3/2014,Afghanistan,Kandahar,3,7,10,"Fundamentalists bomb a Persian New Years ceremony, killing three participants."
22761,21/3/2014,Iraq,Injan,9,15,24,A suicide car bomber disintegrates nine Iraqis.
22762,21/3/2014,Pakistan,Quetta,2,0,2,Two men are gunned down by sectarian rivals.
22763,21/3/2014,Iraq,Samarrah,8,13,21,"Sunni terrorists throw grenades into a police station, killing eight offers."
22764,22/3/2014,Pakistan,Pind Dadan Khan,2,0,2,A man acquitted of a blasphemy accusation is shot to death along with a companion.
22765,22/3/2014,Iraq,Tikrit,7,18,25,Seven people are torn to shreds by a Mujahid double bombing.
22766,22/3/2014,Iraq,Baqubah,3,12,15,A suicide bomber takes out three souls.
22767,22/3/2014,Thailand,Pattani,1,1,2,Muslim terrorists shoot two villagers.
22768,23/3/2014,Syria,Kessab,80,0,80,"al-Nusra and Ansar al-Sham overrun a Christian village and massacre eighty residents, mostly elderly.  Thirteen were beheaded."
22769,23/3/2014,Kenya,Mombasa,6,17,23,Six people are shot to death when gunmen burst into a church and begin firing - after shouting 'Allah Akbar'.
22770,23/3/2014,Iraq,Abu Ghraib,1,0,1,al-Qaeda militants gun down a man outside his house.
22771,23/3/2014,Iraq,Tikrit,3,10,13,Three civilians are laid out by a Religion of Peace shrapnel blast.
22772,23/3/2014,Nigeria,Gbajimba,36,10,46,Muslim raiders massacre three-dozen villagers and burn churches.
22773,23/3/2014,Iraq,Buhriz,33,0,33,"Thirty-three people, including women, are executed by Shiite militia."
22774,24/3/2014,Pakistan,Balochistan,1,0,1,Jeish al-Adl kill at least one abducted Iranian border guard.
22775,24/3/2014,Nigeria,Zaragajiri,5,0,5,"Islamists attack a village, kill five resident and burn many homes."
22776,24/3/2014,Yemen,Hadramout,24,1,25,A vicious al-Qaeda attack on a local military barracks leaves two dozen dead.
22777,24/3/2014,Pakistan,Daudzai,1,0,1,"A female polio worker is kidnapped, tortured and murdered."
22778,24/3/2014,Iraq,Mosul,11,9,20,A series of Mujahideen attacks leaves eleven dead.
22779,24/3/2014,Iraq,Hawija,3,2,5,Three Iraqis are machine-gunned by al-Qaeda.
22780,25/3/2014,Afghanistan,Kabul,5,8,13,At least five innocents are cut down by a Shahid suicide assault on an election office.
22781,25/3/2014,Afghanistan,Helmand,1,0,1,A female police officer is shot to death by fundamentalists.
22782,25/3/2014,Afghanistan,Kunar,6,2,8,Six people at a bank are laid out by a Fedayeen suicide attack.
22783,25/3/2014,Afghanistan,Kunduz,5,20,25,"A suicide bomber attacks a group of spectators at a sporting event, killing five."
22784,25/3/2014,Iraq,Baghdad,4,14,18,Four civilians are pulled into pieces by Religion of Peace car bombers.
22785,25/3/2014,Iraq,Tarmiyah,8,14,22,A sustained al-Qaeda assault leaves eight local soldiers dead.
22786,25/3/2014,Iraq,Taji,5,14,19,Five people are reduced to body parts by a Fedayeen suicide bomber.
22787,25/3/2014,Iraq,al-Nibaee,22,15,37,Nearly two-dozen local soldiers are murdered in a brutal shooting attack by terrorists fighting for an Islamic state.
22788,25/3/2014,Nigeria,Dalori,8,6,14,Two suicide bombings result in eight dead Nigerians.
22789,25/3/2014,Iraq,Baghdad,9,10,19,Nine people crossing a bridge are blown apart by a well-placed Sunni bomb.
22790,26/3/2014,Lebanon,Tripoli,2,2,4,A woman is among two people gunned down in a targeted sectarian attack on Shiites.
22791,27/3/2014,Lebanon,Beirut,1,0,1,"Drive-by terrorists open fire on a Lebanese soldier, killing him instantly."
22792,27/3/2014,Iraq,Adhamiyah,7,22,29,A bomb set off near a mosque leaves seven dead.
22793,27/3/2014,Syria,Kassab,1,0,1,"Islamists invade a town, destroy churches and behead a resident for standing up to them."
22794,27/3/2014,Somalia,Bakool,8,0,8,al-Shabaab stop a vehicle carrying eight local chieftains and summarily execute them.
22795,27/3/2014,Syria,Homs,1,11,12,One civilian is killed by an Islamist car bomb.
22796,27/3/2014,Pakistan,Loralai,1,0,1,A guard for a team vaccinating children against polio is shot to death by fundamentalists.
22797,27/3/2014,Syria,Aleppo,2,0,2,Video surfaces of two men forced to kneel and then shot in the head to a chorus of 'Allah Akbar'.
22798,27/3/2014,Thailand,Yala,1,0,1,Suspected Muslim militants enter a man's home and kill him in his sleep.
22799,27/3/2014,Iraq,Balad,4,11,15,Four women are machine-gunned by Muslim terrorists.
22800,27/3/2014,Iraq,Baghdad,4,14,18,Four people at a commercial area are sectionalized by an Islamist blast.
22801,27/3/2014,Iraq,Baghdad,3,15,18,Three shoppers are taken out by a Mujahid car bomb at a mall.
22802,27/3/2014,Iraq,Baghdad,19,55,74,Two neighborhood car bombs within minutes of each other snuff out the lives of nineteen innocents.
22803,28/3/2014,Egypt,Ain Shams,4,0,4,Four people are reportedly killed when an Islamic mob lays siege to a church.
22804,28/3/2014,Somalia,Barawe,3,0,3,Three men are forced to kneel and then executed by gunmen fighting for an Islamic state.
22805,28/3/2014,Lebanon,Tripoli,4,0,4,An 11-year-old boy is among four people shot to death by sectarian Jihadis.
22806,28/3/2014,India,Janglot,2,0,2,Lashkar-e-Toiba execute a captured civilian and stage a raid on a nearby base that leaves a defender dead.
22807,28/3/2014,Iraq,Baghdad,4,16,20,A triple bombing at a market produce four dead shoppers.
22808,28/3/2014,Pakistan,Lahore,1,0,1,"Muslim 'extremists' attempt to assassinate a news anchor, killing his driver."
22809,28/3/2014,Afghanistan,Kabul,3,4,7,A woman and child are cut down when Sunni fundamentalists attack an aid office with a suicide bombing and assault rifles.
22810,28/3/2014,India,Kathua,1,4,5,"Muslim militants stop a car near a college and fire into it, killing an occupant."
22811,28/3/2014,Egypt,Cairo,1,0,1,A Coptic woman is stabbed to death by Islamic radicals.
22812,28/3/2014,Egypt,Cairo,1,0,1,The government says that the Muslim Brotherhood is behind the killing of a female journalist.
22813,29/3/2014,Libya,Banghazi,1,0,1,A young Christian is executed by Islamists at his workplace.
22814,29/3/2014,Syria,Arsal,3,4,7,A Shahid suicide bomber kills three Lebanese security personnel.
22815,29/3/2014,Nigeria,Azir,4,7,11,Boko Haram gunmen skim through a village on motorcycles and take out four civilians.
22816,29/3/2014,Iraq,Albu Delma,6,0,6,Six Iraqis are shot point-blank by al-Qaeda activists.
22817,30/3/2014,Pakistan,Nawabshah,1,0,1,A man honor kills his own daughter for unIslamic behavior.
22818,30/3/2014,Iraq,Baghdad,8,0,8,A mother and three children are among eight Iraqis taken down by Mujahideen bombers.
22819,30/3/2014,Iraq,Baghdad,4,9,13,Sunni bombers pick off four Shiites at a market.
22820,30/3/2014,Iraq,Ramadi,13,11,24,A Fedayeen suicide bomber slaughters thirteen people crossing a bridge.
22821,30/3/2014,Iraq,Fallujah,9,14,23,Nine people are killed during a brutal al-Qaeda assault.
22822,30/3/2014,Egypt,al-Arish,1,3,4,"Islamic radicals attack a bus, killing the driver."
22823,30/3/2014,Yemen,Zinjibar,2,0,2,Two Yemenis are riddled with bullets by al-Qaeda.
22824,30/3/2014,Thailand,Narathiwat,2,3,5,Two cops are blown to bits by Muslim terrorists.
22825,31/3/2014,Iraq,Mosul,2,10,12,Two people are blown up by Mujahid bombers.
22826,31/3/2014,Iraq,Haditha,2,3,5,Suspected al-Qaeda gun down two men.
22827,31/3/2014,Afghanistan,Kabul,6,0,6,Six campaign workers are killed by terrorists.
22828,31/3/2014,Afghanistan,Kunduz,8,0,8,A family of eight is exterminated by fundamentalist bombers.
22829,31/3/2014,Kenya,Nairobi,6,11,17,Six people are killed when suspected Islamists throw grenades into a food kiosk and bus stop.
22830,31/3/2014,Afghanistan,Logar,2,5,7,Two people are sent to Allah by a Shahid suicide bomber.
22831,31/3/2014,Pakistan,Cantt,1,0,1,Fundamentalists gun down a female polio worker.
22832,1/4/2014,Yemen,Hudaydah,2,2,4,"al-Qaeda militants stage a suicide attack on a police checkpoint, killing two officers."
22833,1/4/2014,Pakistan,Karachi,1,1,2,"Islamists fire on students leaving a rival seminary, killing one."
22834,1/4/2014,Nigeria,Maiduguri,15,20,35,Fifteen civilians are disassembled by a series of suicide bombers.
22835,2/4/2014,Afghanistan,Sar-e-pul,9,1,10,Nine locals are kidnapped and brutally executed by the Taliban.
22836,2/4/2014,Afghanistan,Kabul,6,0,6,Six Afghans are sent to Allah by a Shahid suicide bomber.
22837,2/4/2014,Iraq,Riyadh,8,23,31,A Shahid suicide bomber takes eight Iraqis with him.
22838,2/4/2014,Thailand,Pattani,1,0,1,A 51-year-old woman is shot to death by Muslim militants.
22839,2/4/2014,Egypt,Cairo,2,5,7,Two people bleed to death following two bombings by religious radicals at a university campus.
22840,2/4/2014,Yemen,Aden,6,14,20,Children are among the casualties of an al-Qaeda suicide attack.
22841,2/4/2014,Lebanon,Labweh,1,1,2,A laborer is killed by a rocket fired by Liwaa Ahrar al-Sunna-Baalbek.
22842,2/4/2014,Jordan,Amman,1,0,1,A 16-year-old girl is honor killed with a rock by her brother for speaking with a man over the phone.
22843,2/4/2014,Egypt,Minya,1,0,1,Muslim students shoot a Copt teacher in the head.
22844,3/4/2014,Pakistan,Islamabad,1,0,1,A young girl is murdered by the Taliban for helping her cousin convert to Christianity.
22845,3/4/2014,Nigeria,Birnin-Tsab,8,6,14,Eight civilians are shot to death by Religion of Peace enthusiasts.
22846,3/4/2014,Nigeria,Maitsaba,14,12,26,Boko Haram invade a village on motorcycles and gun down over a dozen locals.
22847,3/4/2014,Chechnya,Yandi,4,7,11,Four Russians are killed by an Islamist bomb.
22848,4/4/2014,Iraq,Tikrit,2,0,2,Two Iraqis are shot to death by al-Qaeda.
22849,4/4/2014,Iraq,Baiji,2,0,2,A suicide bomber takes out a man and his son outside their home.
22850,4/4/2014,Afghanistan,Khost,1,1,2,"A terrorist yells 'Allah Akbar' and turns his machine-gun on a car full of reporters, killing one."
22851,4/4/2014,Yemen,Hadramawt,8,11,19,"al-Qaeda terrorists stage a Fedayeen assault on a group of local soldiers, killing eight."
22852,4/4/2014,Iraq,Baghdad,9,30,39,A series of Mujahideen attacks leave nine dead.
22853,5/4/2014,Nigeria,Gwoza,25,0,25,Over two dozen travelers are stopped and slaughtered by Boko Haram.
22854,5/4/2014,Nigeria,Buni Gari,20,22,42,At least twenty people at a rival mosque are machine-gunned by Islamists shouting praises to Allah.
22855,6/4/2014,Uganda,Kawaga,1,1,2,A teen girl is quickly killed by her father for leaving Islam and embracing Christianity.
22856,6/4/2014,Iraq,Baghdad,6,16,22,Two bombs lay out six civilians.
22857,6/4/2014,Iraq,Tikrit,3,13,16,Three Iraqis are incinerated by a suicide bomber in a fuel tanker.
22858,6/4/2014,Iraq,Latifiyah,6,0,6,Six men are kidnapped from their homes and summarily executed by activists promoting an Islamic state.
22859,6/4/2014,Thailand,Yala,1,28,29,Muslim terrorists place a car bomb outside of a furniture store that leaves one dead.
22860,6/4/2014,Iraq,Rashad,3,0,3,Terrorists kill three farmers who confronted them after a bomb went off.
22861,6/4/2014,Nigeria,Yar Galadina,105,50,155,Fulani militants attack a Christian village and massacre over one hundred residents.
22862,7/4/2014,Pakistan,Hassan,1,0,1,A Shia bakery owner is murdered in his own shop by Sipay-e-Sahaba gunmen.
22863,7/4/2014,Afghanistan,Herat,4,3,7,Taliban bombers take out four local police officers.
22864,7/4/2014,Afghanistan,Kandahar,15,4,19,Fifteen civilians are disassembled by a Religion of Peace roadside bomb.
22865,7/4/2014,Somalia,Galkayo,2,0,2,Two UN workers are murdered by Islamists as they exit a plane.
22866,7/4/2014,Lebanon,Sidon,8,10,18,Members of Ansar Allah storm a rival group's office and kill eight.
22867,7/4/2014,Syria,Homs,1,0,1,Suspected Islamists assassinate an elderly priest.
22868,7/4/2014,India,Kralpora,3,7,10,"Lashkar-e-Toiba open fire on a group of policemen, killing three."
22869,7/4/2014,Iraq,Tikrit,1,0,1,A mosque imam is assassinated by sectarian rivals.
22870,7/4/2014,Iraq,Mosul,4,3,7,Four civilians are pulled into pieces by a Religion of Peace suicide bomber.
22871,7/4/2014,Iraq,Samarrah,5,11,16,Five innocents are demolished by a Shahid suicide bomber.
22872,7/4/2014,Iraq,Ramadi,3,4,7,A Fedayeen suicide bomber cuts short the lives of three people.
22873,8/4/2014,Nigeria,Sambisa,5,0,5,Five local soldiers are ambushed and killed by pro-Sharia militants.
22874,8/4/2014,Iraq,Tuz Khormato,4,13,17,A Shahid suicide bomber takes four Iraqis with him.
22875,8/4/2014,Pakistan,Karachi,2,0,2,Sunni extremists target and kill and Shia doctor and his driver outside his clinic.
22876,8/4/2014,Yemen,Mukalla,4,2,6,"al-Qaeda militants open fire point-blank on a checkpoint, killing four policemen."
22877,8/4/2014,Yemen,Sanaa,3,1,4,"Terrorists target a university professor, killing three of his companions."
22878,9/4/2014,Pakistan,Islamabad,23,96,119,Ahrar-ul-Hind claims a brutal blast at a fruit market that pulverizes two dozen shoppers and vendors.
22879,9/4/2014,Pakistan,Karachi,1,0,1,A second physician in as many days is assassinated because of his Shia faith.
22880,9/4/2014,Nigeria,Gwaram,8,4,12,"Boko Haram bomb a bank, killing eight."
22881,9/4/2014,Pakistan,Tank,5,1,6,A targeted killing at a hotel by Islamists leaves five dead.
22882,9/4/2014,Iraq,Kut,5,18,23,Five people walking by a school are murdered by Mujahid bombers.
22883,9/4/2014,Iraq,Sadr City,5,11,16,Sunni car bombers take out five Shiites.
22884,9/4/2014,Iraq,Baghdad,17,93,110,Eight separate bombings in Shia neighborhoods claim seventeen lives.
22885,9/4/2014,Iraq,Hafriyah,4,8,12,A Sunni car bomb sectionalizes four innocents.
22886,9/4/2014,Pakistan,Karachi,3,2,5,Three seminary students are assassinated by Religion of Peace rivals.
22887,9/4/2014,Libya,Banghazi,1,2,3,"Jihadists blow up a family vehicle, killing one and seriously injuring two others."
22888,10/4/2014,Yemen,Amran,3,0,3,Radical Shiites attack an army post and kill three occupants.
22889,10/4/2014,Iraq,Baghdad,5,13,18,Sectarian Jihadis exterminate five Iraqis in a commercial district.
22890,10/4/2014,Iraq,Sadr City,11,21,32,"Sunnis detonate a car bomb in a Shia neighborhood, killing eleven."
22891,10/4/2014,Pakistan,Jamrud,1,1,2,Islamic snipers pick off a truck driver.
22892,10/4/2014,Nigeria,Potiskum,2,6,8,Islamists roll up on a group watching a soccer game on TV and machine-gun several fans.
22893,10/4/2014,Syria,Homs,25,107,132,A Sunni terrorist group massacres over two dozen innocents with a car bomb in a Shia neighborhood.
22894,10/4/2014,Pakistan,Karachi,2,0,2,Two Shiites are shot to death by Sunni radicals.
22895,10/4/2014,Nigeria,Kala Balge,60,0,60,Sixty villagers are massacred by Boko Haram.
22896,10/4/2014,Nigeria,Dikwa,8,0,8,Militants fighting for an Islamic state invade a teachers collage and slaughter eight educators.
22897,10/4/2014,Nigeria,Kala-Balge,3,0,3,Three villagers are shot to death by Boko Haram.
22898,10/4/2014,Iraq,Buhruz,8,12,20,al-Qaeda gunmen storm a small town and massacre at least eight residents.
22899,10/4/2014,Iraq,Mosul,1,0,1,A female teacher is shot to death by Muslim terrorists.
22900,11/4/2014,Pakistan,Shawal,10,0,10,An Islamist bombing produces ten dead Pakistanis.
22901,11/4/2014,Pakistan,Datta Khel,3,2,5,Militant Muslims kill three people with a bomb.
22902,11/4/2014,Pakistan,Karachi,2,0,2,A shopkeeper is among two people murdered in targeted sectarian attacks.
22903,11/4/2014,Iraq,Baqubah,2,3,5,Roadside bombers successfully disassemble a young man and child.
22904,11/4/2014,Nigeria,Sambisa,8,0,8,Eight highway travelers are 'butchered like animals' by pro-Sharia militants.
22905,11/4/2014,Syria,Hama,2,100,102,al-Nusra is blamed for a chemical attack that leaves two dead.
22906,11/4/2014,Dagestan,Nechayevka,1,0,1,A rival religious teacher is murdered in his home by extremist gunmen.
22907,11/4/2014,Iraq,Sanjar,6,0,6,Terrorists strafe a family of six on a picnic.
22908,11/4/2014,Nigeria,Gambulga,150,0,150,One-hundred and fifty students and residents are reportedly slaughtered when militants fighting for an Islamic state attack three villages.
22909,12/4/2014,Pakistan,Quetta,2,0,2,A teen is among two family members shot to death during a Sunni drive-by on Shiites.
22910,12/4/2014,Iraq,Baqubah,3,19,22,Two children are among three people dismantled by al-Qaeda bombers.
22911,12/4/2014,Iraq,Tikrit,5,0,5,Five Iraqis are exterminated by Mujahid gunmen.
22912,12/4/2014,Algeria,Ghardaia,2,0,2,Two Berbers are murdered by Arabs over their ethnicity.
22913,13/4/2014,Nigeria,Anchaka,60,0,60,Another sixty villagers are massacred in the middle of the night by Boko Haram.
22914,13/4/2014,Iraq,Dibs,11,18,29,"A Fedayeen suicide bomber plows his car into a crowd of people, killing eleven."
22915,13/4/2014,India,Khrew,2,0,2,Two guards at a politicians home are slain by Muslim terrorists.
22916,13/4/2014,Iraq,Sulaiman Bek,3,2,5,A father and son are among three people murdered by al-Qaeda.
22917,13/4/2014,Iraq,Mosul,10,12,22,"Holy Warriors detonate a car bomb along a city street, slaying ten Iraqis."
22918,14/4/2014,Israel,Hevron,1,4,5,Terrorists kill a Jewish man in front of his family on their way to Passover Seder.
22919,14/4/2014,Afghanistan,Andar,3,0,3,Religious hardliners ambush and kill three civilians.
22920,14/4/2014,Pakistan,Peshawar,1,2,3,"Taliban gunmen attack a group of trucks, killing one driver."
22921,14/4/2014,Afghanistan,Khost,2,8,10,Two civilians are pulled apart by a Religion of Peace roadside blast.
22922,14/4/2014,Nigeria,Abuja,86,257,343,Activists for an Islamic state slaughter over eighty innocents at a bus stop with a massive bomb blast.
22923,14/4/2014,Nigeria,Chibok,2,0,2,Boko Haram militants kill two guards and set fire to a town.
22924,14/4/2014,Syria,Maaloula,3,0,3,Three Shia journalists are picked off by Sunni gunmen.
22925,15/4/2014,Pakistan,Quetta,2,1,3,A child is among the victims of a brutal sectarian attack.
22926,15/4/2014,Iraq,Baiji,2,0,2,Two brothers bleed to death following a Mujahideen bombing.
22927,15/4/2014,Nigeria,Hawul,2,0,2,Two people are assassinated in their home by Boko Haram.
22928,15/4/2014,Iraq,Ramadi,2,7,9,A Shahid suicide bomber sends two Iraqis to Allah.
22929,15/4/2014,Pakistan,Karachi,2,1,3,Two people are murdered by Sipah-e-Sahaba gunmen.
22930,15/4/2014,Nigeria,Nwokyo,9,0,9,Women and children are among at least nine who die when Muslim militants torch a Christian worship center and hospital.
22931,15/4/2014,Nigeria,Obagaji,12,0,12,Muslim militants ambush and kill a dozen unarmed youth.
22932,15/4/2014,Syria,Homs,6,24,30,Six die when terrorists fire rockets into civilian areas.
22933,15/4/2014,Syria,Damascus,1,61,62,"Sunni extremists fire a missile at a Catholic school, killing a child."
22934,16/4/2014,Syria,Raqa,1,0,1,Islamists crucify a man for theft.
22935,16/4/2014,Iraq,Sadr City,4,11,15,"Sunni car bombers hit a Shia area, taking out four souls."
22936,16/4/2014,Iraq,Baghdad,6,18,24,Mujahid marketplace bombers kill six in two separate blasts.
22937,16/4/2014,Iraq,Ramadi,8,14,22,Eight people are ripped apart when two Shahid suicide bombers plow into a crowd.
22938,16/4/2014,Pakistan,Lahore,1,0,1,A 22-year-old Christian is shot to death for refusing to embrace Islam.
22939,16/4/2014,Nigeria,Wala,18,7,25,Eighteen people are slaughtered by militants fighting for Islamic law.
22940,17/4/2014,Iraq,Diyala,3,10,13,A Fedayeen suicide bomber murders three others.
22941,17/4/2014,Iraq,Baghdad,9,22,31,Jihadi car bombers take down nine innocents at a commercial district.
22942,17/4/2014,Iraq,Mahallabiya,12,15,27,A dozen people are blown into small chunks by a Shahid suicide bomber.
22943,17/4/2014,India,Gulzarpora,1,0,1,A 45-year-old man is shot to death by Muslim terrorists outside his home.
22944,17/4/2014,Syria,Aleppo,7,30,37,Two children are among seven civilians killed by militant Sunnis.
22945,17/4/2014,Pakistan,Karachi,1,1,2,A 55-year-old Shia shopkeeper is gunned down at his business by Sunni assassins.
22946,17/4/2014,Dagestan,Makhachkala,2,0,2,Islamic gunmen murder an official and his driver.
22947,18/4/2014,Tunisia,Mount Chaambi,1,1,2,A bomb planted by Islamic militants claims the life of one security personnel.
22948,18/4/2014,Afghanistan,Faryab,2,0,2,Two guards are killed when Taliban attack a prison.
22949,18/4/2014,Egypt,Cairo,1,3,4,Ajnad Misr claims a planted bomb attack along a city street that leaves one dead.
22950,18/4/2014,Pakistan,Karachi,2,1,3,A seminary teacher and his student are assassinated by Religion of Peace rivals.
22951,18/4/2014,Syria,Homs,14,50,64,A Sunni car bomb blast takes the life of fourteen people leaving a rival mosque.
22952,19/4/2014,Syria,Hama,4,9,13,"Islamic car bombers target trucks carrying humanitarian aid, killing four."
22953,19/4/2014,Bahrain,al-Mughsha,2,1,3,Sectarian bombers incinerate two people at a Shia village.
22954,19/4/2014,Iraq,Meshahda,5,8,13,Five Iraqis are sent to Allah by a Fedayeen suicide bomber.
22955,19/4/2014,Iraq,Qalat Suker,5,2,7,Three children and two adults are shot to death by Islamic terrorists along a highway.
22956,19/4/2014,Iraq,Baghdad,9,21,30,Nine civilians are torn to shreds by a series of Mujahid bombings.
22957,19/4/2014,CAR,Paoua,1,0,1,Muslim radicals kill a priest and mutilate his body.
22958,19/4/2014,Libya,sirte,1,8,9,An Ansar al-Sharia attack claims one life.
22959,19/4/2014,Afghanistan,Ghazni,0,0,0,Five faithful Muslims are killed while making a bomb inside their mosque.
22960,20/4/2014,Iraq,Mussayab,4,5,9,Terrorists detonate a car bomb at a market that takes down four shoppers.
22961,20/4/2014,Syria,Homs,1,10,11,"Suspected al-Nusra fire a rocket at a hospital, killing one civilian."
22962,20/4/2014,Iraq,Iskandariyah,3,12,15,Jihadis kill three civilians with a car bomb along a city street.
22963,20/4/2014,Iraq,Samawah,7,17,24,Seven civilians are dismantled by Religion of Peace car bombers.
22964,20/4/2014,Nigeria,Yana,1,0,1,A five-year-old girl is killed when pro-Sharia activists set fire to a school.
22965,20/4/2014,Iraq,Baghdad,5,18,23,A suicide bomber murders five people at a university.
22966,20/4/2014,Algeria,Kabylie,11,14,25,Eleven local soldiers are ambushed and killed by armed fundamentalists.
22967,20/4/2014,Thailand,Yala,3,1,4,A 2-year-old girl is among three people shot to death by Muslim 'insurgents'.
22968,20/4/2014,Egypt,Suez,2,0,2,Religious hardliners machine-gun two policemen on a desert road.
22969,20/4/2014,Syria,Deir Ezzor,16,0,16,Sixteen people are killed in a double suicide bombing by al-Nusra.
22970,21/4/2014,Nigeria,Borno,2,0,2,Two politicians are assassinated by pro-Caliph radicals.
22971,21/4/2014,Thailand,Yala,1,0,1,A 65-year-old man is shot off of his motorcycle by suspected Muslim terrorists.
22972,21/4/2014,Pakistan,Karachi,2,1,3,"Sipah-e-Sahaba gunmen pick off two Shiites, including a professor."
22973,21/4/2014,India,Tral,1,0,1,Muslim separatists shoot a man to death.
22974,21/4/2014,India,Batgund,2,0,2,A man and his son are killed in their own home by Muslim terrorists.
22975,21/4/2014,Pakistan,Peshawar,5,2,7,Five members of a rescue party are riddled with bullets by Islamic radicals.
22976,21/4/2014,Iraq,Baghdad,14,40,54,Fourteen people are blown to bits by Mujahid bombers.
22977,21/4/2014,Iraq,Madain,5,12,17,A holy warrior with a suicide vest pulverizes five innocents.
22978,21/4/2014,Iraq,Suwayrah,12,19,31,A dozen Iraqis are ripped to shreds by a Fedayeen suicide bomber.
22979,21/4/2014,Somalia,Marka,1,4,5,A local politician is assassinated by al-Shabaab.
22980,22/4/2014,Somalia,Mogadishu,1,0,1,A girl is pulled out of her home and murdered in front of her parents by al-Shabaab for proclaiming her faith in Christianity.
22981,22/4/2014,Somalia,Mogadishu,1,0,1,A lawmaker is shot and killed outside his home for 'allowing' non-Muslims into the country.
22982,22/4/2014,Afghanistan,Maiwand,4,0,4,Taliban bombers take out four civilians.
22983,22/4/2014,Afghanistan,Ghorak,4,1,5,Four local cops manning a checkpoint are riddled with bullets by Islamic hardliners.
22984,22/4/2014,Iraq,Mahmoudiya,4,9,13,Four people are killed when Mujahideen bombers target a street full of shoppers.
22985,22/4/2014,Iraq,Kirkuk,10,6,16,Muslim extremists roll up on an election center and gently machine-gun ten poll workers.
22986,22/4/2014,Pakistan,Charsadda,3,33,36,A shopkeeper is among three people laid out by a Religion of Peace bomb blast.
22987,22/4/2014,Mali,Bamako,1,0,1,"The Movement for Oneness and Jihad announces that it has killed a 62-year-old French hostage ""in the name of Allah""."
22988,23/4/2014,Iraq,Dujail,1,4,5,A child is shredded by a Sunni shrapnel.
22989,23/4/2014,Kenya,Nairobi,2,0,2,At least two people are killed when terrorists detonate a car bomb.
22990,23/4/2014,Iraq,Mosul,8,45,53,Eight members of the Shabak religious minority are disassembled by al-Qaeda truck bombers.
22991,23/4/2014,Pakistan,Gokhowal,1,0,1,Sunni radicals gun down a 45-year-old Shiite at his shop.
22992,23/4/2014,Nigeria,Kauyen-Yaku,17,4,21,Muslims attack a peaceful Christian village and massacre seventeen.
22993,23/4/2014,Egypt,Cairo,1,2,3,Islamists kill a police general with a bomb planted under his car.
22994,23/4/2014,Pakistan,Karachi,1,0,1,A 36-year-old Shia bank manager is shot to death by Sunni radicals.
22995,24/4/2014,Pakistan,Karachi,4,2,6,Four relatives at a tailor shop are cut to pieces by a Shahid suicide bomber.
22996,24/4/2014,Iraq,Hillah,11,27,38,"A Fedayeen suicide car bomber detonates in a crowded street, laying out eleven Iraqis."
22997,24/4/2014,Afghanistan,Kabul,3,2,5,"An Afghan cop opens fire at a Christian hospital, killing three American doctors."
22998,24/4/2014,Iraq,Saniya,5,5,10,Five guards are killed when Islamists bomb a polling station.
22999,24/4/2014,Iraq,Tikrit,1,5,6,"al-Qaeda bombers target a family home, killing a bystander."
23000,25/4/2014,Thailand,Pattani,3,13,16,Muslim bombers kill three people at a fishing contest.
23001,25/4/2014,Pakistan,Karachi,6,28,34,A woman and her teenage son are among six people slain when a bomb packed with nuts and bolts rips through a city street.
23002,25/4/2014,Iraq,Baghdad,33,90,123,"ISIL suicide bombers detonate at a packed political rally, slaughtering over thirty."
23003,26/4/2014,Afghanistan,Ghazni,4,7,11,Four people are dismantled by a Shahid suicide bomber.
23004,26/4/2014,Iraq,Baghdad,4,11,15,A bombing leaves four residents of a neighborhood dead and eleven more in agony.
23005,27/4/2014,USA,"Skyway, WA",1,0,1,A 30-year-old man is murdered by a Muslim fanatic.
23006,27/4/2014,China,Kashgar,3,0,3,Three fishermen are nearly decapitated by throat-cutting Muslim 'rebels'.
23007,27/4/2014,Thailand,Pattani,2,0,2,A Buddhist man and wife are shot in the head at a market.
23008,27/4/2014,CAR,Nanga Boguila,22,0,22,Three MSF medical workers are among twenty-two butchered by Seleka 'rebels'.
23009,27/4/2014,Pakistan,Waziristan,3,3,6,Three security personnel are murdered by Taliban bombers.
23010,27/4/2014,Iraq,Fallujah,4,8,12,Four civilians are sectionalized by a Mujahid bomb blast.
23011,27/4/2014,Iraq,Baghdad,10,36,46,"Jihadis bomb an outdoor market, killing ten patrons."
23012,28/4/2014,Pakistan,Suru,2,2,4,Two women are killed when fundamentalists throw a grenade into the house of an anti-polio worker.
23013,28/4/2014,Pakistan,Lahore,3,0,3,"A devout Muslim confesses to serial killing three homosexuals in order to ""stop evil."""
23014,28/4/2014,Pakistan,Karachi,4,30,34,Four young boys are killed when a Religion of Peace rival tosses a grenade into a Quran class at a mosque.
23015,28/4/2014,Iraq,Kirkuk,3,7,10,Three Iraqis are blown to bits by a Fedayeen suicide bomber.
23016,28/4/2014,Iraq,Tuz Khormato,3,9,12,A Shahid suicide bomber kills three people at a polling station.
23017,28/4/2014,Iraq,Hawija,4,9,13,A Shahid suicide bomber kills four people at a polling station.
23018,28/4/2014,Iraq,Khanaqin,30,50,80,A Shahid suicide bomber kills thirty people at a polling station.
23019,28/4/2014,Iraq,Baghdad,7,21,28,A Shahid suicide bomber kills seven people at a polling station.
23020,28/4/2014,Iraq,Baghdad,6,19,25,A Shahid suicide bomber kills six people at a polling station.
23021,28/4/2014,Iraq,Kirkuk,9,11,20,A Shahid suicide bomber kills nine people at a polling station.
23022,29/4/2014,Libya,Benghazi,2,2,4,Two local soldiers die at the hands of a Fedayeen suicide car bomber.
23023,29/4/2014,Pakistan,Rahimabad Pul,1,3,4,A cleaner is machine-gunned by Sunni hardliners.
23024,29/4/2014,Thailand,Narathiwat,2,0,2,Two Buddhist women are murdered by Muslim gunmen.  One was pregnant.
23025,29/4/2014,Iraq,Saidiya,18,42,60,Eleven are laid out when Muslim terrorists set off two bombs at a market.
23026,29/4/2014,Afghanistan,Alingar,3,1,4,Three Afghans are machine-gunned by Taliban.
23027,29/4/2014,Syria,Homs,79,84,163,A double car-bombing by al-Nusra produces eighty dead civilians.
23028,29/4/2014,Syria,Damascus,14,86,100,"Sunnis send mortars into a Shia neighborhood, killing at over a dozen residents."
23029,29/4/2014,Iraq,Haditha,2,4,6,A suicide car bomber manages to kill two other people.
23030,29/4/2014,Iraq,Rutba,2,3,5,Two people lose their lives to a suicide bomber.
23031,29/4/2014,Iraq,Abu Ghraib,2,8,10,Jihadi bombers take down two Iraqis.
23032,30/4/2014,India,Bangalore,1,0,1,The sole bread-winner for a family is stabbed 34 times for publicly opposing construction for a mosque.
23033,30/4/2014,Iraq,Dibs,2,0,2,Two women voters are pulled into pieces by a Mujahid bomb at a polling center.
23034,30/4/2014,Syria,Raqa,7,0,7,"The ISIL capture and execute seven people, two by crucifying them."
23035,30/4/2014,Nigeria,Kubla,8,11,19,At least eight people are killed when Islamists attack a village and burn down a church.
23036,30/4/2014,Pakistan,South Waziristan,5,3,8,Five people die from shrapnel injuries suffered during a Taliban bomb blast.
23037,30/4/2014,China,Xinjiang,3,79,82,At least three people die when Muslim terrorists wade into a train station stabbing and bombing.
23038,30/4/2014,Pakistan,Khyber Pukhtoonkhwa,1,0,1,A 38-year-old man is shot to death merely because he is Shia.
23039,30/4/2014,Iraq,Baiji,6,3,9,Two suicide bombings kill six voters at polling stations.
23040,1/5/2014,Pakistan,Nishtar,1,0,1,A conservative man slits the throat of his 22-year-old daughter for dating men without his permission.
23041,1/5/2014,Pakistan,Chashma Pul,3,0,3,Sunni fundamentalists shoot three people to death in a car.
23042,1/5/2014,Israel,Migdal Haemek,1,0,1,A 20-year-old Jewish woman is stabbed to death in her car by a Palestinian.
23043,1/5/2014,Yemen,Ataq,3,0,3,"al-Qaeda members kidnap, torture and kill three local soldiers."
23044,1/5/2014,Nigeria,Abuja,19,60,79,At least nineteen people are torn to pieces at a bus stop by a Boko Haram shrapnel bomb.
23045,1/5/2014,Afghanistan,Panjsher,13,30,43,A Fedayeen suicide bomber sends over a dozen bystanders to Allah.
23046,1/5/2014,Afghanistan,Khost,4,0,4,Four security personnel are murdered during a Taliban ambush.
23047,1/5/2014,Nigeria,Sambisa,10,0,10,Pro-Sharia militants stop cars along the highway and butcher the occupants with knives.
23048,2/5/2014,Syria,Hama,18,50,68,Eleven children are among eighteen innocents disassembled by two suicide car bombers.
23049,2/5/2014,Egypt,El-Tor,1,3,4,One passenger is killed when a suicide bomber detonates next to a bus.
23050,2/5/2014,Egypt,Sinai,2,5,7,An Ansar Bayt Al-Maqdis suicide bomber kills two people.
23051,2/5/2014,Egypt,Cairo,2,1,3,Islamic militants kill two court guards with a planted bomb.
23052,2/5/2014,Iraq,Dujail,5,6,11,Five Iraqis are pulled into pieces by a Shahid suicide bomber.
23053,2/5/2014,Libya,Benghazi,9,24,33,Islamists storm a police station and murder nine people.
23054,3/5/2014,Iraq,Tarmiya,9,7,16,Nine Iraqis are murdered by al-Qaeda in two attacks.
23055,3/5/2014,Iraq,Balad,11,21,32,"Sunni bombers take out a bus full of Shia pilgrims, killing at least eleven."
23056,3/5/2014,Somalia,Mogadishu,7,25,32,Seven people are laid out by an al-Shabaab bomb blast at a busy intersection.
23057,3/5/2014,Kenya,Mombasa,4,20,24,"A suspected member of Kenya's Muslim minority throws a grenade into a bus, aerating four passengers."
23058,3/5/2014,Iraq,Tikrit,4,5,9,Four Shia pilgrims are sent straight to Allah by Sunni car bombers.
23059,3/5/2014,Syria,Homs,1,0,1,Video surfaces showing the 'Banner of God' group executing a hostage in cold blood.
23060,3/5/2014,Iraq,Baghdad,8,0,8,Sectarian Jihadis are suspected when eight family members are found murdered in their home.
23061,3/5/2014,Pakistan,Kandar,1,0,1,"After leading prayers, a mosque official kills his 17-year-old daughter over sex."
23062,4/5/2014,Yemen,Shabwa,6,20,26,Six local soldiers are ripped to pieces by a suicide bomber at their checkpoint.
23063,4/5/2014,Kenya,Nairobi,2,62,64,Two people are killed when Islamists set off two bombs on buses.
23064,5/5/2014,Iraq,Jurf al-Sakhar,4,3,7,Four people are torn to shreds by a Shahid suicide bomber.
23065,5/5/2014,Iraq,Tuz Khormato,3,17,20,Three patron are killed in mid-bite when Muslim terrorists bomb a restaurant.
23066,5/5/2014,Pakistan,Miranshah,2,1,3,Two tribesman bleed to death following an Islamist bomb blast.
23067,5/5/2014,Yemen,Sanaa,1,1,2,A French security agent is shot to death in his car.
23068,5/5/2014,Pakistan,Jamrud,2,2,4,Two truck drivers are murdered by Taliban gunmen.
23069,5/5/2014,Afghanistan,Nimroz,1,2,3,Only one other person is killed when five suicide car bombers detonate outside a government building.
23070,5/5/2014,Afghanistan,Gorzaiwan,7,1,8,At least seven innocents lose their lives to armed religious extremists.
23071,5/5/2014,Cameroon,Far North,2,2,4,Two people are killed during a Boko Haram assault on a small town.
23072,6/5/2014,Pakistan,Kohat,1,0,1,Sipah-e-Sahaba gunmen storm a medical center and murder a Shiite.
23073,6/5/2014,Pakistan,Karachi,2,0,2,Two Shia businessmen are murdered in separate Sipah-e-Sahaba shootings.
23074,6/5/2014,Thailand,Hat Yai,0,10,10,Muslim 'separatists' set off bombs in several tourist areas.
23075,6/5/2014,Afghanistan,Obe,3,2,5,Three Afghans are disassembled by a Taliban bomb.
23076,6/5/2014,Iraq,Ramadi,1,4,5,A suicide bomber kills one other person.
23077,6/5/2014,China,Xinjiang,0,6,6,Religious extremists wade into a crowd waiting at a train station and stab at least six.
23078,7/5/2014,Nigeria,Gamboru Ngala,336,0,336,Over three hundred villagers are slaughtered during a vicious attack by Allah-praising Islamists that lasted for twelve hours.
23079,7/5/2014,Iraq,Hit,3,4,7,Three Iraqis are reduced to pulp by a Fedayeen suicide bomber.
23080,7/5/2014,Pakistan,Multan,1,0,1,A human rights lawyer representing an accused blasphemer is shot fit five times at his office.
23081,8/5/2014,Iraq,Shirqat,3,1,4,Terrorists abduct and murder a police officer and then kill his family members be rigging his body with explosives.
23082,8/5/2014,Libya,Benghazi,1,0,1,Islamic militia shoot a man outside a hospital.
23083,8/5/2014,Iraq,Baghdad,2,5,7,Two Iraqis are cut down by Jihad bombers in a commercial area.
23084,8/5/2014,Iraq,Youssifiyah,3,9,12,Three patrons at an outdoor market are blown to bits by a Mujahideen bomb.
23085,8/5/2014,Iraq,Husseiniyah,4,8,12,Religion of Peace bombers set off a blast at a cafe that leaves four dead.
23086,8/5/2014,Pakistan,Ghulam Khan,9,12,21,Nine locals are sectionalized by Taliban bombers.
23087,9/5/2014,Iraq,Mosul,3,2,5,Three Iraqis lose their lives to al-Qaeda bombers.
23088,9/5/2014,Iraq,Mosul,4,0,4,Four farmers are shot to death by al-Qaeda gunmen.
23089,9/5/2014,Afghanistan,Farah,1,11,12,Religious extremists murder a local policeman.
23090,9/5/2014,Yemen,Sanaa,5,11,16,At least five are left dead after an al-Qaeda bombing and shooting attack.
23091,10/5/2014,Iraq,Dawr,3,2,5,al-Qaeda bombers send shrapnel through three Iraqis.
23092,10/5/2014,Iraq,Tarmiyah,4,17,21,Four people at a market bleed to death following a Religion of Peace bomb blast.
23093,10/5/2014,Iraq,Baghdad,5,14,19,Sunni bombers take out five patrons at a Shia kebab restaurant.
23094,10/5/2014,Iraq,Dujail,12,16,28,A Fedayeen suicide bomber sends a dozen more souls to Allah.
23095,10/5/2014,Iraq,Mosul,20,0,20,Twenty Iraqi soldiers are kidnapped and then brutally executed by suspected al-Qaeda.
23096,10/5/2014,Pakistan,Karachi,1,1,2,A 45-year-old Shiite is shot to death by Sipay-e-Sahaba terrorists.
23097,11/5/2014,Pakistan,Peshawar,4,11,15,"A suicide bomber targets a displaced persons camp, killing four."
23098,11/5/2014,CAR,Kaga Bandoro,13,0,13,At least thirteen Christians burn to death after being rounded up and forced into a burning house by Muslim 'rebels'.
23099,11/5/2014,Iraq,Baaj,6,3,9,Six local cops are ambushed and killed by Islamists.
23100,11/5/2014,Afghanistan,Kandahar,5,22,27,A woman and child are among five murdered by a suicide car bomber outside a hospital.
23101,11/5/2014,Iraq,al-Udhiem,7,0,7,Seven people are shot to death by al-Qaeda militants.
23102,11/5/2014,Iraq,Mosul,2,9,11,Two Iraqis are laid out by a Shahid suicide bomber.
23103,11/5/2014,Pal. Auth.,Bethlehem,0,7,7,"A group of Muslims attack a church, injuring seven worshippers, one of whom was stabbed."
23104,11/5/2014,Yemen,Mukalla,11,15,26,"An al-Qaeda suicide bomber detonates along a city street, blowing away eleven innocents."
23105,11/5/2014,Libya,Benghazi,4,1,5,Four local soldiers are murdered by Islamic militia.
23106,11/5/2014,Yemen,Sanaa,1,0,1,A civilian is killed during an al-Qaeda shooting.
23107,12/5/2014,Pakistan,Dera Ismail Khan,1,0,1,A Shiite is murdered by determined Sunnis outside a medical college.
23108,12/5/2014,Pakistan,Karachi,2,0,2,Two men are shot to death by Sipah-e-Sahaba while playing cricket.
23109,12/5/2014,Afghanistan,Ghazni,3,8,11,"Armed Islamists on motorcycles gun down three people, including two women."
23110,12/5/2014,Somalia,Baidoa,12,20,32,A dozen innocents are ripped to shreds by a Holy Warrior suicide car bomber.
23111,12/5/2014,Thailand,Takbai,2,9,11,A series of explosions set by Muslim 'insurgents' leave two dead.
23112,12/5/2014,Afghanistan,Parwan,2,4,6,The Taliban claim a rocket attack on a market that kills two civilians.
23113,12/5/2014,Afghanistan,Sangin,9,0,9,Fundamentalists roll up on a police checkpoint and shoot nine officers point-blank.
23114,12/5/2014,Afghanistan,Jalalabad,7,10,17,"After killing two guards, religious extremists breach an office building and execute five civilians."
23115,12/5/2014,Pakistan,Karachi,1,0,1,Terrorists gun down an off-duty navy officer.
23116,12/5/2014,Pakistan,Faisal,1,0,1,A cook is gunned down at a market merely for being a Shiite.
23117,12/5/2014,Iraq,Baiji,9,3,12,Nine Iraqis are reduced to pulp by a Fedayeen suicide bomber.
23118,12/5/2014,Iraq,Baghdad,4,17,21,Holy Warriors set off a bomb in a business district that takes out four civilians.
23119,12/5/2014,Pakistan,Karachi,2,0,2,A prominent Shiite and his driver are shot to death by Sipah-e-Sahaba at a traffic light.
23120,12/5/2014,Syria,Damascus,1,0,1,A civilian is killed by explosives planted by Sunni terrorists.
23121,12/5/2014,Pakistan,Rajanpur,1,0,1,A woman is shot to death by her conservative in-laws after being seen talking to an unrelated man.
23122,13/5/2014,Ingushetia,Gazi-Yurt,1,0,1,A police officer is shot execution-style by Islamic terrorists.
23123,13/5/2014,Iraq,Balad,6,17,23,Sunni fundamentalists murder six residents of a Shiite neighborhood.
23124,13/5/2014,Iraq,Baghdad,15,45,60,A series of blasts targeting Shiites leaves at least fifteen dead.
23125,13/5/2014,Iraq,Baghdad,4,7,11,Four people are exterminated by an al-Qaeda shrapnel bomb at a bus stop.
23126,13/5/2014,Iraq,Jamila,3,10,13,Three people are killed when al-Qaeda bombers target a commercial district.
23127,13/5/2014,Iraq,Sadr City,6,13,19,"Two bombs hit a Shia neighborhood, killing six residents."
23128,13/5/2014,Nigeria,Kungana,5,2,7,Muslim raiders attack a village and burn five people 'beyond recognition'.
23129,13/5/2014,Pakistan,Safi,1,1,2,A member of a peace committee succumbs to wounds from a Taliban bomb.
23130,13/5/2014,Pakistan,Hangu,2,0,2,"Sectarian Jihadis open fire on two teachers at a school, killing them both."
23131,14/5/2014,Afghanistan,Ghazni,1,1,2,A woman is killed and a child wounded when pro-Sharia militants fire a rocket into a home.
23132,14/5/2014,Afghanistan,Spin Boldak,3,5,8,Five Holy Warriors in suicide vests take out three local cops.
23133,14/5/2014,Iraq,Basra,1,0,1,Gunmen pick off a guard outside a rival mosque.
23134,14/5/2014,Iraq,Adhaim,8,0,8,Eight local cops are machine-gunned by Religion of Peace advocates.
23135,14/5/2014,Iraq,Hit,1,4,5,A suicide bomber takes one other person with him.
23136,15/5/2014,Somalia,Bardhere,1,0,1,A young man is shot to death by al-Shabaab in front of hundreds of people.
23137,15/5/2014,Iraq,Karrada,7,21,28,A suicide bombing and Fedayeen assault on a courthouse leaves seven dead.
23138,15/5/2014,Iraq,Youssifiyah,5,0,5,Two women and a child are among five family members butchered in their own home by al-Qaeda.
23139,15/5/2014,Iraq,Sadr City,8,17,25,Militants fighting for a Sunni Islamic state set off a bomb in a market that kills eight patrons.
23140,15/5/2014,Iraq,Baghdad,4,12,16,Four people are pulled into pieces by a Shahid suicide bomb blast.
23141,15/5/2014,Iraq,Baghdad,5,0,5,Five off-duty soldiers are pulled out of their car and brutally executed by al-Qaeda gunmen.
23142,15/5/2014,Turkey,Border,43,94,137,Dozens of people lose their lives when an al-Qaeda group sets off a car bomb in a garage.
23143,15/5/2014,Pakistan,Mingora,1,0,1,Radical Muslims gun down a member of a reconciliation committee.
23144,15/5/2014,Dagestan,Gunib,3,7,10,"Islamic 'rebels' open fire on a group of police officers, killing three."
23145,15/5/2014,Libya,Benghazi,3,0,3,A moderate cleric is among three people gunned down by religious extremists.
23146,16/5/2014,Pakistan,Peshawar,1,0,1,Religious radicals gun down a volunteer at a rival mosque.
23147,16/5/2014,Iraq,Baqubah,2,1,3,Terrorists murder a man and his wife inside their home.
23148,16/5/2014,Iraq,Mosul,4,8,12,A Fedayeen suicide bomber takes out four other humans.
23149,16/5/2014,Cameroon,Waza,1,9,10,Boko Haram invade a road construction camp and murder a Chinese engineer.
23150,16/5/2014,Pakistan,Islamabad,1,0,1,A 65-year-old member of a minority community is shot to death by a teenager accusing him of blasphemy.
23151,16/5/2014,Pakistan,Rajanpur,3,0,3,Three women are murdered by their conservative family for bringing 'dishonor'.
23152,16/5/2014,Kenya,Nairobi,13,76,89,"Two bombs, one of which was at a market, snuff out the lives of thirteen innocent people, including a pregnant woman."
23153,16/5/2014,Iraq,Balad,5,8,13,"An al-Qaeda shooting, followed by a bombing elsewhere produces five dead Iraqis."
23154,16/5/2014,Syria,Binnish,13,34,47,"ISIS bomb a Shia mosque as worshippers are leaving, killing at least a dozen, including three children."
23155,17/5/2014,Nigeria,Damaturu,9,0,9,Nine motorists are stopped and shot point-blank by militants fighting for an Islamic state.
23156,17/5/2014,Nigeria,Dalwa-Masuba,40,12,52,At least forty residents of a quiet agrarian village are massacred by Boko Haram.
23157,17/5/2014,Nigeria,Ngurosoye,29,24,53,Twenty-nine people at a market are slaughtered by Islamist rockets and bullets.
23158,17/5/2014,Bangladesh,Ghoraghat,1,0,1,A man is stabbed to death by Jamaat-e-Islami members.
23159,17/5/2014,Iraq,Tarmiya,5,14,19,Five shoppers at a market are blown to bits by Religion of Peace bombers.
23160,17/5/2014,Pakistan,Jamrud,1,1,2,Muslim terrorists kill a man inside his home and kidnap his teenage son.
23161,17/5/2014,England,Accrington,0,1,1,A political candidate is stabbed in the face by a Muslim calling him an 'infidel'.
23162,18/5/2014,Afghanistan,Nad Ali,3,0,3,Three sleeping children are flattened when Talibanis send a rocket into their home.
23163,18/5/2014,India,Akhnoor,1,2,3,An Indian soldier is shot to death by Muslim terrorists.
23164,18/5/2014,Iraq,Baghdad,5,14,19,Two Jihad bombings at commercial districts leave five dead.
23165,18/5/2014,Iraq,Mahmoudiya,4,12,16,Four people at an outdoor market are disassembled by Mujahid bombers.
23166,18/5/2014,Pakistan,Khar,1,6,7,Taliban bombers take down a woman with a remote-controlled blast.
23167,18/5/2014,Nigeria,Kano,4,5,9,Two young girls are among four killed when a suicide bomber detonates in a Christian district.
23168,19/5/2014,Pakistan,Mohmand,4,1,5,Four members of a peace committee are brutally executed by Sunni hardliners.
23169,19/5/2014,Syria,Hama,1,0,1,Video emerges showing al-Nusra beheading a captured 'infidel'.
23170,19/5/2014,Pakistan,Karachi,3,0,3,The caretaker at a mosque is among three Shiites gunned down by Sipah-e-Sahaba in two attacks.
23171,19/5/2014,Iraq,Dujail,4,7,11,Sectarian bombers take out four people in a residential district.
23172,19/5/2014,Kenya,Mandera,12,4,16,Twelve security personnel are machine-gunned by Islamists.
23173,19/5/2014,Somalia,Mogadishu,1,4,5,al-Shabaab is thought responsible for deadly mortar fire into a residential neighborhood.
23174,20/5/2014,Somalia,Gelgel,1,0,1,Pro-Caliphate activists behead a woman in front of her two girls.
23175,20/5/2014,Egypt,Cairo,3,9,12,An al-Qaeda linked group is suspected in a drive-by shooting at a political rally that leaves three dead.
23176,20/5/2014,Nigeria,Jos,162,120,282,"Pro-Islamic state activists set off two massive bus bombs at a packed market in a Christian district, taking out over one-hundred fifty."
23177,20/5/2014,Libya,Benghazi,1,2,3,An engineer is among three Chinese shot by Muslim terrorists.
23178,20/5/2014,Pakistan,Orangi,2,0,2,Two Sunnis are sprayed with bullets by Shia radicals.
23179,20/5/2014,Pakistan,Karachi,2,0,2,Two Shiites are sprayed with bullets by Sunni radicals.
23180,20/5/2014,Pakistan,Awami,1,0,1,A Shiite banker is murdered on his way home by Sipah-e-Sahaba gunmen.
23181,21/5/2014,Egypt,al-Arish,1,6,7,One person is killed when hardliners throw a bomb into a street.
23182,21/5/2014,Nigeria,Shawa,30,0,30,Thirty people are killed when Muslims shout 'Allah Akbar' and fire sporadically into a village.
23183,21/5/2014,Nigeria,Alagarno,19,0,19,"Pro-Sharia militants attack a village and murder nineteen men, women and children."
23184,21/5/2014,Afghanistan,Laghman,4,0,4,"Gunmen in full-length burqas open fire on a police checkpoint, killing four officers."
23185,21/5/2014,Afghanistan,Badakhshan,8,7,15,Eight local cops are shot to death by Taliban terrorists.
23186,21/5/2014,Iraq,Baghdad,2,0,2,Fundamentalists storm a residence and exterminate two suspected prostitutes.
23187,21/5/2014,Iraq,Qadisiya,3,2,5,Three civilians are killed by Mujahid bombers outside a gas station.
23188,21/5/2014,Thailand,Yala,1,0,1,A 62-year-old former economic director is murdered by suspected 'insurgents'.
23189,21/5/2014,Thailand,Pattani,1,0,1,Muslim radicals shoot a Buddhist off his motorcycle and then set him on fire.
23190,21/5/2014,Pakistan,Dera Ismail Khan,2,0,2,Sipah-e-Sahaba gunmen reportedly murder two security guards.
23191,21/5/2014,Afghanistan,Hesarak,2,9,11,A Shahid suicide bomber takes two people with him.
23192,22/5/2014,Syria,Damascus,1,0,1,A prominent Shiite is decapitated by Sunnis.
23193,22/5/2014,Iraq,Tikrit,4,3,7,A woman and her child are among four civilians disassembled by Mujahid bombers at a market.
23194,22/5/2014,Iraq,Mishahda,5,0,5,Five Iraqis are pulled into pieces by a Shahid suicide bomber.
23195,22/5/2014,Nigeria,Kimbi,8,0,8,Eight villagers are cut down by Boko Haram gunmen.
23196,22/5/2014,China,Urumqi,31,94,125,Thirty-one people at a market are brutally blown to bits by two suicide car bombers.
23197,22/5/2014,Iraq,Mosul,3,0,3,Three family members are murdered in their own home by al-Qaeda.
23198,22/5/2014,Iraq,Baghdad,14,17,31,"A suicide bomber plows into a group of Shiite pilgrims, sending over a dozen straight to Allah."
23199,22/5/2014,Iraq,Baghdad,6,38,44,A suicide bomber dressed in a burqa takes out six Iraqis
23200,22/5/2014,Iraq,Baghdad,12,30,42,A dozen Shiite pilgrims are blown to bits by Jihadi car bombers.
23201,22/5/2014,Nigeria,Chukku Nguddoa,29,10,39,Boko Haram shoot twenty-nine farm workers to death as they are tilling their fields.
23202,22/5/2014,Pakistan,Nazimabad,2,0,2,Two brothers are shot to death by Sipah-e-Sahaba for being Shia.
23203,23/5/2014,Yemen,al-Jawf,3,0,3,Three Shiites are exterminated by an al-Qaeda suicide bomber.
23204,23/5/2014,Pakistan,Rawalpindi,1,0,1,Sectarian gunmen take out a rival prayer leader.
23205,23/5/2014,Libya,Benghazi,1,0,1,An imam is assassinated by rivals.
23206,23/5/2014,Nigeria,Moforo,25,0,25,Twenty-five young men are gathered together and executed by pro-Sharia militants.
23207,23/5/2014,Iraq,Nineveh,17,25,42,"Sunnis stage a series of rocket and bomb attacks on Shia pilgrims, killing at least seventeen."
23208,23/5/2014,Syria,Deraa,39,205,244,"Citing loud music as an excuse, Sunnis send rockets into a political rally packed with Shias, slaughtering nearly forty."
23209,23/5/2014,Tunisia,Kasserine,2,4,6,Two local soldiers are left dead after a bombing by fundamentalists.
23210,24/5/2014,Iraq,Riyadh,3,0,3,Three farmers are beheaded by al-Qaeda.
23211,24/5/2014,Iraq,Tuz Khormato,5,4,9,A double-bombing takes out five Iraqis.
23212,24/5/2014,Iraq,Haditha,4,3,7,Four civilians are reduced to pulp by Jihadi bombers.
23213,24/5/2014,Djibouti,Djibouti City,1,15,16,"Two suicide bombers detonate in a restaurant, but manage to kill only one patron."
23214,24/5/2014,Pakistan,Mansehra,1,0,1,A woman is strangled by her conservative father over 'character suspicions'.
23215,24/5/2014,Pakistan,Mohmand,6,3,9,A Taliban roadside blast takes the lives of six security personnel.
23216,24/5/2014,Somalia,Mogadishu,10,11,21,Ten people are killed when Islamic extremists bomb parliament headquarters.
23217,24/5/2014,Yemen,Seyoun,10,6,16,A brutal al-Qaeda assault on a town leaves ten defenders dead.
23218,24/5/2014,Thailand,Yala,3,50,53,Muslims launch a series of attacks on Buddhist businesses that leave at least three dead.
23219,24/5/2014,Pakistan,Islamabad,1,1,2,"A guard at a market loses his life to extremist bombers, while another loses his legs."
23220,24/5/2014,Belgium,Brussels,4,0,4,An Islamic extremist shoots four people to death outside a Jewish museum.
23221,25/5/2014,Nigeria,Gwoza,21,0,21,Twenty-one worshippers at a Church of Christ are machine-gunned in their seats by Islamic extremists.
23222,25/5/2014,Iraq,Kirkuk,12,29,41,"Fundamentalists bomb a shop selling alcohol, killing a dozen patrons and bystanders."
23223,25/5/2014,Syria,Homs,12,40,52,'God generously makes possible' an al-Nusra suicide bomb attack in a Christian residential district that leaves twelve dead.
23224,25/5/2014,Nigeria,Kamuyya,24,0,24,Twenty-four villagers are executed by Islamists for failing to fund 'God's work'.
23225,25/5/2014,Afghanistan,Kandahar,1,0,1,A Fedayeen suicide bomber kills a local policeman.
23226,25/5/2014,Nigeria,Jos,8,3,11,Eight people watching a televised soccer game are pulled apart by a Fedayeen suicide car bomber.
23227,25/5/2014,Iraq,Mosul,3,18,21,Three Iraqis lose their lives to a Fedayeen suicide bomber.
23228,25/5/2014,Syria,Ariha,24,24,48,Dozens are killed in four suicide attacks.
23229,25/5/2014,Pakistan,Kuzdhar,8,0,8,The Taliban is thought responsible for the ambush and murder of eight policemen.
23230,26/5/2014,Nigeria,Chikide,8,6,14,Six churches are burned and eight civilians killed by pro-Sharia extremists.
23231,26/5/2014,Nigeria,Amuda,1,3,4,A Christian is hacked to death by Boko Haram.
23232,26/5/2014,Thailand,Pattani,1,0,1,Muslim terrorists shoot a Buddhist cop to death at his wedding.
23233,26/5/2014,Libya,Benghazi,1,0,1,A journalist is murdered for criticizing those fighting for an Islamic state.
23234,26/5/2014,Nigeria,Adamawa,21,18,39,Boko Haram gunmen shoot twenty-one villagers to death.
23235,26/5/2014,Kenya,Lamu,2,3,5,Two border guards are ambushed an killed by al-Shabaab terrorists.
23236,26/5/2014,Afghanistan,Kabul,2,2,4,Two people are torn to shreds by a Shahid suicide bombing.
23237,26/5/2014,Pakistan,Chanab Nagar,1,0,1,An American doctor is shot to death in front of his wife and kids for being Ahmadi.
23238,26/5/2014,Iraq,Mosul,3,12,15,Three Iraqis bleed to death following a Religion of Peace bomb attack.
23239,26/5/2014,Nigeria,Ashigashiya,9,0,9,Boko Haram shoot nine villagers and burn their homes.
23240,27/5/2014,Nigeria,Buni Yadi,45,0,45,Forty-five people are killed in a barbaric attack by pro-Sharia militants.
23241,27/5/2014,Yemen,Amran,5,0,5,Five defenders are killed when Shiite radicals attack guard stations at a city entrance.
23242,27/5/2014,Pakistan,Lahore,1,0,1,A woman is stoned outside a courthouse by her family for marrying by choice.
23243,27/5/2014,Iraq,Baghdad,19,34,53,"A dedicated Sunni straps explosives to his body and then detonates in a Shia mosque, exterminating seventeen rivals."
23244,27/5/2014,Libya,Derna,1,0,1,A student is beheaded by Islamic militia after challenging them.
23245,27/5/2014,Pakistan,Torghar,2,0,2,A teenager is shot to death by her brother along with her lover over suspicion of sex.
23246,27/5/2014,Pakistan,Karachi,1,2,3,A 23-year-old Shiite is shot point blank by Sipah-e-Sahaba while riding a rickshaw.
23247,28/5/2014,Nigeria,Kuru,4,0,4,Boko Haram walk into a house and blow away four family members.
23248,28/5/2014,Pakistan,Khabal,1,0,1,A 19-year-old is shot to death by her conservative brother on suspicion of sex.
23249,28/5/2014,Pakistan,Karachi,2,0,2,A pair of Shiites are neatly dispatched by Sipah-e-Sahaba gunmen.
23250,28/5/2014,Iraq,Qayara,4,0,4,A child is among four people sectionalized by a Mujahid bomb blast.
23251,28/5/2014,Iraq,Tuz Khormato,4,11,15,Four family members perish together thanks to Holy Warriors.
23252,28/5/2014,Iraq,Sadr City,4,14,18,"Jihadis set off a car bomb amid a row of taxis, killing four people."
23253,28/5/2014,Iraq,Baghdad,16,52,68,"A Fedayeen suicide car bomber detonates in a Shia neighborhood, sending shrapnel through dozens."
23254,28/5/2014,CAR,Bangui,30,10,40,Muslims storm a church service and shoot thirty worshippers to death.
23255,28/5/2014,Iraq,Mosul,23,3,26,A double suicide bombing is among a series of attacks that take the lives of two dozen innocents.
23256,28/5/2014,Thailand,Pattani,0,10,10,Muslim 'insurgents' bomb a hospital.
23257,28/5/2014,Tunisia,Tunis,4,3,7,Four guards are killed during a coordinated Ansar al-Sharia attack on a top official's home.
23258,28/5/2014,Tunisia,Khaldoun,1,0,1,A 13-year-old girl is burned to death by her father for walking home with a boy.
23259,28/5/2014,Syria,Tel Hurmiz,2,0,2,Two Christian teens are picked off their motorcycle by Muslim snipers.
23260,28/5/2014,Kenya,Mandera,2,3,5,al-Shabaab murder two bus drivers.
23261,28/5/2014,Nigeria,Amuda,9,13,22,Nine people in a peaceful farming community are killed during an early morning Boko Haram raid.
23262,29/5/2014,Syria,Deir-ez-Zor,1,0,1,Video surfaces of a child executed by Islamists.
23263,29/5/2014,Pakistan,Lal Pura,4,0,4,Four Shia tribesmen are ambushed and killed by Sunni radicals.
23264,29/5/2014,Iraq,Arab Jabour,2,1,3,al-Qaeda militants take out two Iraqis.
23265,29/5/2014,Yemen,Mukalla,2,0,2,A father and son are shot to death in cold blood by al-Qaeda.
23266,29/5/2014,Iraq,Tuz,6,5,11,Six family members are reportedly killed in two bomb attacks.
23267,29/5/2014,Syria,Ras al-Ain,15,0,15,Seven children and three women are among fifteen civilians massacred by ISIS after being mistaken for religious minority Yazidis.
23268,29/5/2014,Nigeria,Gumushi,32,0,32,Thirty-two villagers are roused from their sleep and slaughtered by pro-Sharia militants who also burn down their homes.
23269,30/5/2014,Syria,Homs,10,12,22,At least ten people are killed when Sunnis set off a truck bomb in a residential neighborhood.
23270,30/5/2014,Pakistan,Nazimabad,1,0,1,Sectarian Jihadis shoot a school principal to death.
23271,30/5/2014,Iraq,Baqubah,1,2,3,A woman and child are among the victims of an 'insurgent' bombing.
23272,30/5/2014,Iraq,Muqdadiya,6,3,9,An al-Qaeda attack is among three that leave six dead including three women.
23273,30/5/2014,Nigeria,Tashan Alade,3,0,3,"Boko Haram open fire on a vehicle traveling to a funeral, killing three people."
23274,30/5/2014,Pakistan,Bir,1,0,1,An 18-year-old girl is shot to death by her brother for talking on her cell phone to a suspected love interest.
23275,31/5/2014,Iraq,Baiji,8,0,8,Eight captives are executed by ISIS fundamentalists.
23276,31/5/2014,Iraq,Jurf al-Sakhar,10,15,25,Ten Iraqis are killed by suspected al-Qaeda in two attacks.
23277,31/5/2014,Pakistan,Karachi,1,0,1,The custodian for a Shiite mosque is hacked to death by axe-wielding Sipah-e-Sahaba.
23278,31/5/2014,Yemen,Lahej,1,0,1,A local man is machine-gunned by al-Qaeda.
23279,31/5/2014,Pakistan,Karachi,1,0,1,Sipah-e-Sahaba gunmen take out a TV station employee simply for being Shia.
23280,31/5/2014,Pakistan,Hussainabad,1,0,1,A Shiite doctor is murdered by Ahl-e-Sunnat-Wal-Jamaat.
23281,31/5/2014,Afghanistan,Giro,14,2,16,Seven women are among fourteen civilians taken out by Taliban bombers as they are returning from a wedding.
23282,31/5/2014,Thailand,Yala,1,0,1,A meatball vendor is taken out by Muslim 'insurgents' with an AK-47.
23283,1/6/2014,Nigeria,Attagara,1,1,2,A 6-year-old boy is hacked and then beheaded by Boko Haram for being Christian.
23284,1/6/2014,USA,"Seattle, WA",2,0,2,Two homosexuals are murdered by an Islamic extremist.
23285,1/6/2014,Pakistan,Karachi,2,1,3,Two Shia civilians are picked off by Sunni snipers.
23286,1/6/2014,Iraq,Ramadi,1,6,7,A sniper picks off a female university student and injures six others.
23287,1/6/2014,Syria,Zanuba,5,3,8,Five members of the same Shia family are butchered and burned to death by Sunni Islamists.  One victim was 102.
23288,1/6/2014,Pakistan,Baldia,4,0,4,"An entire family, including two children, is killed in their home for reasons of 'honor'."
23289,1/6/2014,Yemen,Shabwa,4,0,4,Four tribesmen are captured and executed by al-Qaeda.
23290,1/6/2014,Iraq,Salaheddin,5,0,5,Five off-duty soldiers riding in a car are stopped and machine-gunned by Holy Warriors.
23291,1/6/2014,Thailand,Yala,1,0,1,A man looking for a place to fish is gunned down by Muslim terrorists.
23292,1/6/2014,Thailand,Narathiwat,2,0,2,Two men are shot in the head by Muslim militants at a soccer match.
23293,1/6/2014,Nigeria,Adamawa,40,19,59,Forty people are killed when fundamentalists toss bombs into a soccer match and a brothel.
23294,1/6/2014,Nigeria,Kala Balge,23,0,23,Twenty-three villagers are massacred by pro-Sharia advocates.
23295,1/6/2014,Nigeria,Borno,20,0,20,At least twenty are killed when Boko Haram attack three villages and a wedding party.
23296,1/6/2014,Iraq,Baghdad,2,0,2,Mujahideen shoot two teachers to death.
23297,1/6/2014,Lebanon,Arsal,0,3,3,Three teen boys are kidnapped and brutally tortured by al-Nusra.
23298,2/6/2014,Libya,Benghazi,20,67,87,Twenty are left dead following an attack by Ansar al-Sharia.
23299,2/6/2014,Nigeria,Attangara,20,0,20,"Islamists fire through the windows of a church, killing twenty worshippers."
23300,2/6/2014,Afghanistan,Nangharhar,3,1,4,"A Fedayeen suicide bomber targets a construction crew, killing three members."
23301,2/6/2014,Afghanistan,Helmand,4,3,7,Four local Afghans are reduced to pulp by  two Shahid suicide bombers.
23302,2/6/2014,Iraq,Mshahdh,3,2,5,A Fedayeen suicide bomber kills three local soldiers.
23303,2/6/2014,Iraq,Najaf,6,13,19,Mujahid car bombers take out six Iraqis.
23304,2/6/2014,Syria,Haraqi,18,6,24,Women and children are among the casualties of an ISIS truck bomb blast.
23305,2/6/2014,Iraq,Iskandariyah,3,28,31,Two bombings produce three dead Iraqis.
23306,3/6/2014,Nigeria,Baladigavuraza,3,0,3,Boko Haram gunmen murder three villagers.
23307,3/6/2014,Nigeria,Angurva,12,0,12,Boko Haram gunmen murder a dozen villagers.
23308,3/6/2014,Nigeria,Kaghum,20,0,20,Boko Haram gunmen murder twenty villagers.
23309,3/6/2014,Nigeria,Pege,5,0,5,Boko Haram gunmen murder five villagers.
23310,3/6/2014,Nigeria,Barawa,20,0,20,Boko Haram gunmen murder twenty villagers.
23311,3/6/2014,Nigeria,Chikde,2,0,2,Boko Haram gunmen murder two villagers.
23312,3/6/2014,Nigeria,Arboko,10,0,10,Boko Haram gunmen murder ten villagers.
23313,3/6/2014,Nigeria,Chinene,14,0,14,Boko Haram gunmen murder fourteen villagers.
23314,3/6/2014,Nigeria,Pulka,30,0,30,Boko Haram gunmen murder thirty villagers.
23315,3/6/2014,Nigeria,Kwadale,12,0,12,Boko Haram gunmen murder a dozen villagers.
23316,3/6/2014,Nigeria,Ashigashita,10,0,10,Boko Haram gunmen murder ten villagers.
23317,3/6/2014,Nigeria,Zamgba,13,0,13,Boko Haram gunmen murder thirteen villagers.
23318,3/6/2014,Nigeria,Jabril,12,0,12,Boko Haram gunmen murder a dozen villagers and burn churches.
23319,3/6/2014,Nigeria,Ganjara,46,0,46,Boko Haram gunmen murder forty-six villagers.
23320,3/6/2014,Nigeria,Agapalawa,15,0,15,Boko Haram gunmen murder fifteen villagers.
23321,3/6/2014,Nigeria,Halaghwa,12,0,12,Boko Haram gunmen murder a dozen villagers.
23322,3/6/2014,Nigeria,Amuda,17,0,17,Boko Haram gunmen murder seventeen villagers.
23323,3/6/2014,Nigeria,Gava,26,0,26,Boko Haram gunmen murder twenty-six villagers.
23324,3/6/2014,Nigeria,Ngoshe,46,0,46,Boko Haram gunmen murder forty-six villagers.
23325,3/6/2014,Nigeria,Bokko Wizhe,4,0,4,Boko Haram gunmen murder four villagers.
23326,3/6/2014,Thailand,Pattani,2,0,2,Two security personnel die from injuries suffered during an attack by Muslim terrorists.
23327,3/6/2014,Pakistan,Parachinar,7,3,10,"Sunnis bomb a van full of Shia, killing seven."
23328,3/6/2014,Iraq,Iskandariya,4,0,4,"A man, his wife and their two young children are brutally murdered in their home by al-Qaeda."
23329,3/6/2014,Iraq,Baiji,4,0,4,Four vacationing soldiers are summarily shot to death by Mujahideen.
23330,3/6/2014,Iraq,Ramadi,8,14,22,An al-Qaeda suicide bomber murders eight civilian volunteers trying to protect their families.
23331,4/6/2014,Libya,Benghazi,3,4,7,Three local security personnel are sent to Allah by a suicide car bomber.
23332,4/6/2014,Pakistan,Rawalpindi,5,4,9,Five people bleed to death following a Shahid suicide bombing.
23333,4/6/2014,Pakistan,Bajaur,4,4,8,Four security personnel are killed by a Shahid suicide bomber.
23334,4/6/2014,Iraq,Kirkuk,7,9,16,Seven people lose their lives when Muslim terrorists set off a bomb in a parking lot.
23335,4/6/2014,Iraq,Hillah,8,35,43,"Jihadis bomb a hospital, killing mostly medical students."
23336,4/6/2014,Iraq,Baghdad,6,19,25,Two Mujahid bombings in a shopping area leave six dead.
23337,4/6/2014,Nigeria,Barderi,45,0,45,Forty-five people are mowed down by automatic weapons fire by Boko Haram preachers.
23338,4/6/2014,Libya,Surt,1,0,1,Islamists are suspected of fatally shooting a Swiss worker for the Red Cross.
23339,4/6/2014,Iraq,Suleiman Bek,2,0,2,At least two others are killed by a suicide truck bomb.
23340,4/6/2014,Syria,Damascus,10,102,112,Militant Sunnis send mortars into residential areas to try and punish those trying to vote in elections.
23341,5/6/2014,Pakistan,Yousawala,1,0,1,Two brothers honor kill their sister for marrying without their permission.
23342,5/6/2014,Yemen,Bayhan,17,3,20,Seventeen are slain by al-Qaeda.
23343,5/6/2014,Iraq,Samarrah,7,45,52,Bearded Sunni fundamentalists stage an assault that leaves at least seven others dead.
23344,5/6/2014,Pakistan,Peshawar,2,0,2,Two men riding in a car are shot to death by suspected Taliban.
23345,5/6/2014,Iraq,Mosul,2,0,2,An elderly man and a woman are murdered in their homes by Muslim terrorists.
23346,5/6/2014,Iraq,Baiji,1,4,5,A suicide bomber manages to kill only one other person.
23347,6/6/2014,Iraq,Muwaffaqiyah,6,45,51,Two suicide bombers take out six religious minorities in a Shabak village.
23348,6/6/2014,Iraq,Samarrah,41,42,83,Mostly Shiites are among an additional forty-one reported dead after ISIL terrorists sweep through the city.
23349,6/6/2014,Pakistan,Karachi,2,4,6,Two people lose their lives to a suicide bombing outside a mosque.
23350,6/6/2014,Afghanistan,Kabul,6,22,28,Six people at a political rally are turned into paste by a Fedayeen suicide bomber.
23351,6/6/2014,Syria,Raqqa,1,0,1,ISIS crucify a man in the town square.
23352,6/6/2014,Iraq,Mosul,11,0,11,Five suicide bombers storm a depot and make sure no one inside survives.
23353,6/6/2014,Iraq,Samarrah,30,0,30,Thirty Sunnis are abducted and executed by Shiite militia.
23354,7/6/2014,Nigeria,Kunde,7,0,7,Boko Haram gunmen murder seven villagers and burn churches.
23355,7/6/2014,Pakistan,Bajaur,2,1,3,A Taliban roadside blast kills two local soldiers.
23356,7/6/2014,Iraq,Baghdad,36,37,73,Three dozen innocents are consumed by a series of Mujahideen bombings in mostly Shia areas.
23357,7/6/2014,Iraq,Baghdad,23,8,31,Two dozen people at a billiards hall are dismantled by an Islamist car bomb.
23358,7/6/2014,Iraq,Baghdad,3,14,17,"Fundamentalists bombs a cinema, killing three patrons."
23359,7/6/2014,Iraq,Baghdad,4,15,19,Four people are killed by a Sunni blast at a hotel.
23360,7/6/2014,Iraq,Mosul,21,0,21,Twenty-one local cops are kidnapped and executed by ISIL fundamentalists.
23361,7/6/2014,Iraq,Ramadi,2,5,7,Two Iraqis are sent to Allah by a Shahid suicide bomber.
23362,8/6/2014,Nigeria,Gombe,3,0,3,At least three people are killed by a Boko Haram female suicide bomber.
23363,8/6/2014,Afghanistan,Behsud,1,0,1,A suicide bomber kills a parking lot guard.
23364,8/6/2014,Iraq,Tikrit,3,9,12,Mujahid kill three people at a school.
23365,8/6/2014,Iraq,Jalawla,39,67,106,Suicide car bombers slaughter forty people at a Kurdish political office.
23366,8/6/2014,Pakistan,Taftan,30,14,44,Nine women and a child are among thirty Shia pilgrims brutally murdered during a suicide attack by Jaish al-Islam on their hotel.
23367,8/6/2014,Pakistan,Karachi,18,24,42,A suicide assault at an airport by ten pro-Sharia Fedayeen leaves eighteen others dead.
23368,9/6/2014,Pakistan,Kurram,2,1,3,Talibanis roll up on a checkpoint and machine-gun two cops.
23369,9/6/2014,Pakistan,Datta Khel,4,12,16,Women are among the victims of a Shahid suicide bomber.  A child is killed as well.
23370,9/6/2014,Iraq,Tuz Khormato,28,148,176,A suicide bomber massacres twenty-eight innocents.
23371,9/6/2014,Pakistan,Nazimabad,2,0,2,Two brothers are shot to death by Sipah-e-Sahaba because they were Shia.
23372,9/6/2014,Iraq,Garma,10,2,12,Militants kill women and children with a rocket barrage on their neighborhood.
23373,9/6/2014,Iraq,Ramadi,5,5,10,An al-Qaeda bomb produces five dead Iraqis.
23374,9/6/2014,Dagestan,Ghunib,2,0,2,Two people are killed by an Islamist bomb.
23375,9/6/2014,Yemen,Sanaa,1,0,1,A woman is burned to death by her brother for converting to Christianity.
23376,10/6/2014,Iraq,Mosul,670,14,684,Six-hundred and seventy Shia inmates at a prison are summarily executed by a group of Islamic State terrorists.  Only seventeen survived.
23377,10/6/2014,Iraq,Mosul,4,0,4,Four Christian women are reportedly shot for not wearing veils.
23378,10/6/2014,Iraq,Baqubah,20,28,48,Twenty mourners at a funeral are blasted into chunks by two sectarian bombers.
23379,10/6/2014,Iraq,Fallujah,1,4,5,One person is killed by a Fedayeen suicide bomber.
23380,10/6/2014,Pakistan,Karachi,7,0,7,Seven airport cargo workers are found crushed by rubble from a suicide blast.
23381,10/6/2014,Kenya,Mombasa,1,0,1,A cleric is shot to death after refusing to preach Jihad from his mosque.
23382,11/6/2014,Iraq,Karbala,4,13,17,Four Iraqis are sent to Allah by Holy Warriors.
23383,11/6/2014,Iraq,Baghdad,15,27,42,"Sunni bomb strike two Shia areas, killing fifteen."
23384,11/6/2014,Nigeria,Tanjol,9,0,9,At least nine people are killed when Muslim radicals storm two villages and burn churches.
23385,11/6/2014,Iraq,Sadr City,38,34,72,A Sunni suicide bomber takes the lives of nearly forty Shiites at a tent meeting.
23386,11/6/2014,Pakistan,Swat,5,0,5,Five policemen are killed in two attacks by Mujahideen.
23387,11/6/2014,Thailand,Pattani,1,0,1,Muslim terrorists pump ten bullets into a villager.
23388,11/6/2014,Egypt,al-Arish,1,2,3,A terror attack by fundamentalists leaves one dead.
23389,11/6/2014,Iraq,Safwan,5,5,10,A Sunni car bomb at a crowded market turns five shoppers into paste.
23390,11/6/2014,Iraq,Mosul,17,0,17,Seventeen civilians are found executed by ISIS.
23391,11/6/2014,Pakistan,Kitkoot,2,2,4,A man and his son are shot to death by Islamists.
23392,11/6/2014,Lebanon,Hermel,1,0,1,al-Nusra members murder a 14-year-old and toss his body in a ditch.
23393,12/6/2014,Iraq,Camp Speicher,1700,0,1700,Over seventeen-hundred unarmed cadets are captured and massacred by the Islamic State.
23394,12/6/2014,Israel,Tuba Zangaria,1,0,1,A 14-year-old girl is shot eight times by her family for leaving the house without a male escort.
23395,12/6/2014,Iraq,Baghdad,2,0,2,Asai'b al-Haq kidnap and murder a rival imam and prayer caller.
23396,12/6/2014,Israel,Hebron,3,0,3,Three Israeli teenagers are kidnapped and murdered by Palestinian terrorists.
23397,12/6/2014,India,Poonch,1,3,4,Pakistani terrorists kill an Indian soldier with an IED.
23398,12/6/2014,Mali,Aguelhoc,4,10,14,Four UN peacekeepers are blown to bits by a suicide car bomber.
23399,12/6/2014,Iraq,Salah al-Din,1,0,1,A 10-year-old boy is killed by suspected Mujahid gunmen.
23400,12/6/2014,Syria,Damascus,8,25,33,Eight civilians are cut down by a Sunni car bomb blast.
23401,12/6/2014,Iraq,Tikrit,12,0,12,Twelve ISIS execution victims are discovered.
23402,12/6/2014,Lebanon,Koura,1,0,1,A 24-year-old woman is strangled - honor killed - by her two younger brothers for leaving the house at night.
23403,12/6/2014,Iraq,Dawasa,12,0,12,A dozen more victims of ISIS executions are found.
23404,12/6/2014,Pakistan,Jamrud,3,0,3,"Taliban militants fire point blank into a police checkpoint, killing three officers."
23405,13/6/2014,Iraq,Mosul,3,0,3,A man and his two sons have their throats slit by ISIL after being forced to dig their own graves.
23406,13/6/2014,Iraq,Mosul,1,0,1,A family man is beheaded on video after being kidnapped.
23407,13/6/2014,Yemen,Abyan,4,6,10,An al-Qaeda suicide bomber sends four Yemenis to Allah.
23408,13/6/2014,Pakistan,Khyber,1,0,1,A peace committee member is taken apart by a Taliban bomb.
23409,13/6/2014,Tanzania,Darjani,1,7,8,Muslim bombers murder an imam at a rival mosque.
23410,14/6/2014,Iraq,Camp Speicher,120,0,120,Over one-hundred more Shia prisoners are executed by the Islamic State.
23411,14/6/2014,Iraq,Tikrit,190,0,190,Photos show that militants fighting for an Islamic state rounded up and massacred about two hundred men and boys in three days.
23412,14/6/2014,Tanzania,Zanzibar,1,7,8,A cleric is blown up by suspected Religion of Peace rivals.
23413,14/6/2014,Iraq,Ishaqi,12,0,12,The burned bodies of twelve ISIS victims are discovered.
23414,14/6/2014,Pakistan,Multan,2,0,2,Two young women are honor killed by their families for sexual 'crime'.
23415,14/6/2014,Pakistan,Khanewal,2,0,2,A man and woman are killed by family members for adultery.
23416,14/6/2014,Iraq,Mosul,12,0,12,Twelve clerics are executed in front of a mosque for refusing to take an oath to an Islamic state.
23417,14/6/2014,Syria,Deir Ezzur,15,24,39,An ISIL bomb at a bazaar takes the lives of fifteen civilians .
23418,14/6/2014,Iraq,Ishaqi,9,21,30,Nine Iraqis are left dead after Mujahid gunmen attack a  group of vehicles carrying a rival religious figure.
23419,14/6/2014,Iraq,Mosul,1,0,1,Islamists pull a taxi driver from his car and execute him.
23420,14/6/2014,Afghanistan,Samangan,11,0,11,"Eleven locals, including six women and a child, are disassembled by Taliban bombers."
23421,14/6/2014,Afghanistan,Kabul,38,115,153,A series of Taliban attacks on civilians leaves over three dozen dead.
23422,15/6/2014,Iraq,Mosul,39,0,39,Thirty-nine Indian workers are kidnapped and executed by Quran-waving ISIS members after being singled out as non-Muslims.
23423,15/6/2014,Kenya,Mpeketoni,1,0,1,A father is gunned down in front of his family after Islamists identify him as a Christian.
23424,15/6/2014,Somalia,Baidoa,1,0,1,al-Shabaab pull a man out of his vehicle and behead him.
23425,15/6/2014,Pakistan,Latifabad,1,1,2,A 22-year-old woman is tortured by her family for marrying without their permission.  Her husband is killed.
23426,15/6/2014,Afghanistan,Herat,0,11,11,Fundamentalists cut off the fingers of eleven men for disobeying them by voting in an election.
23427,15/6/2014,Iraq,Mosul,3,0,3,Three men are executed on video after failing a 'Quranic quiz'.
23428,15/6/2014,Iraq,Tal Afar,10,40,50,Ten people are killed when Sunni militants mortar a Shia city.
23429,15/6/2014,Iraq,Mosul,24,0,24,An ISIL video shows the round-up and execution of two dozen Iraqis.
23430,15/6/2014,Iraq,Khales,6,0,6,At least six innocents are killed when ISIL send mortar rounds into a neighborhood.
23431,15/6/2014,Yemen,Aden,9,10,19,"Suspected al-Qaeda fire point-blank into a bus, killing at least nine riders."
23432,15/6/2014,Iraq,Sadr City,3,7,10,"Sunnis detonate a bomb inside a Shiite owned food shop, killing three patrons."
23433,15/6/2014,Iraq,Baghdad,12,30,42,A Religion of Peace car bomb at a bus station produces a dozen corpses.
23434,15/6/2014,Iraq,Baghdad,15,8,23,Fifteen shoppers are pulled into pieces by a Fedayeen suicide bomber.
23435,15/6/2014,Nigeria,Daku,25,15,40,"Boko Haram militants storm a Christian village and open fire on a market, killing at least two dozen."
23436,16/6/2014,Uganda,Mbale,1,0,1,The 12-year-old daughter of a high-profile convert to Christianity is strangled as punishment.
23437,16/6/2014,Thailand,Pattani,1,2,3,"Muslim terrorists rake a vehicle with gunfire, killing a 44-year-old Buddhist woman."
23438,16/6/2014,Thailand,Narathiwat,1,0,1,A civilian is blown off his motorbike by a Muslim bomb.
23439,16/6/2014,Thailand,Songkhla,1,1,2,A grocer is murdered in his store by suspected 'separatists'.
23440,16/6/2014,Iraq,Baqubah,44,0,44,Forty-four Sunnis are executed by Shia militia.
23441,16/6/2014,Egypt,Cairo,1,0,1,A police officer is picked off by Muslim Brotherhood snipers.
23442,16/6/2014,Afghanistan,Kandahar,5,0,5,Taliban roadside bombers take out five members of the same family.
23443,16/6/2014,Kenya,Mpeketoni,65,25,90,Over sixty people watching a World Cup match are cut down by al-Shabaab after they are singled out as non-Muslims for failing a quiz on Islam.
23444,16/6/2014,Iraq,Tal Afar,5,0,5,"Five 'enemies of Allah' are captured, taunted and then shot on video by proponents of an Islamic state."
23445,16/6/2014,Iraq,Sadr City,10,25,35,Ten shoppers at a largely Shiite market are torn to shreds by a Sunni bomb blast.
23446,17/6/2014,India,Bijbehara,1,0,1,A manager at a shoe shop is murdered by Muslim terrorists.
23447,17/6/2014,Iraq,Baghdad,3,9,12,"Jihadis detonate a bomb in the central part of the city, killing three bystanders."
23448,17/6/2014,Iraq,Baghdad,7,0,7,"Seven Sunnis, including a cleric are taken and murdered by Shia rivals."
23449,17/6/2014,Iraq,Sadr City,12,30,42,A dozen innocents at a packed market are disassembled by Sunni bombers.
23450,17/6/2014,Nigeria,Damaturu,24,21,45,"A suicide bomber praises Allah before self-detonating at a World Cup viewing venue, killing two dozen fans."
23451,17/6/2014,Pakistan,Peshawar,1,0,1,A man is shot to death in his car by suspected Taliban.
23452,17/6/2014,Syria,Deir al-Zor,5,0,5,A suspected ISIL car bomb leaves five dead.
23453,17/6/2014,Iraq,Samarrah,18,0,18,Eighteen police officers kidnapped by Islamists are found executed with gunshots to the head and chest.
23454,17/6/2014,Kenya,Poromoko,15,12,27,"Islamists burn down a neighborhood, kill fifteen residents and abduct a dozen women."
23455,17/6/2014,Norway,Oslo,0,1,1,A moderate imam is stabbed by a member of his mosque after denouncing radicals.
23456,18/6/2014,Iraq,Mosul,1,0,1,A judge is kidnapped and executed by religious radicals.
23457,18/6/2014,Pakistan,Hangu,7,1,8,Three women are among a family of eight slaughtered in their home by sectarian Jihadis.
23458,18/6/2014,Iraq,Tal Afar,1,2,3,"ISIS send a rocket into a home, killing a 10-year-old girl and severely maiming her mother and sister."
23459,18/6/2014,Somalia,Mogadishu,2,0,2,"Islamists plant a bomb in a doctor's car, killing him and a nurse."
23460,19/6/2014,Pakistan,Peshawar,3,6,9,Three people bleed to death following a Shahid suicide bombing at a family home.
23461,19/6/2014,Syria,Homs,6,9,15,Women and children are among those carved into pieces by a Sunni car bomb in a Shia area.
23462,19/6/2014,Philippines,Jolo,7,13,20,Abu Sayyaf fundamentalists ambush and slaughter seven local soldiers.
23463,20/6/2014,Iraq,Gogjali,2,0,2,Islamic State radicals abduct and slit the throats of an 18-year-old and his uncle.
23464,20/6/2014,India,Sellu,1,0,1,A civilian is gunned down by Islamic radicals.
23465,20/6/2014,Iraq,Samarrah,45,0,45,Forty-five victims of ISIS execution are discovered on the bank of a river.
23466,20/6/2014,Iraq,Qaim,34,0,34,Thirty-four Iraqis are killed during an assault by Sunni extremists.
23467,20/6/2014,Syria,Hama,43,50,93,"The Islamic Front claims credit for a truck bomb that rips the life out of forty-three dozen bystanders, including eleven children."
23468,20/6/2014,Pakistan,Torghar,2,1,3,Terrorists kill two policemen with a homemade bomb.
23469,20/6/2014,Lebanon,Dahr al-Baidar,1,32,33,A suicide bomber kills one other person and injures thirty-two.
23470,20/6/2014,China,Xinjiang,5,0,5,"Two policemen are butchered by Islamic radicals, who then burn three others to death."
23471,20/6/2014,Nigeria,Adamawa,10,0,10,Ten villagers are murdered by Boko Haram.
23472,20/6/2014,Syria,Deir al-Zor,3,0,3,Three moderate Sunnis are kidnapped and executed by ISIS.
23473,21/6/2014,Pakistan,Jamrud,2,2,4,A woman and her daughter are shot to death in their own home by suspected Taliban.
23474,21/6/2014,Yemen,Sanaa,1,0,1,al-Qaeda gunmen kill a man in front of his home.
23475,21/6/2014,Nigeria,Koronginim,40,20,60,At least forty villagers are massacred by Boko Haram gunmen.
23476,21/6/2014,Somalia,Mogadishu,1,0,1,A journalist is assassinated by suspected al-Shabaab bombers.
23477,21/6/2014,Yemen,Shehr,2,0,2,al-Qaeda gunmen murder two men suspected of witchcraft.
23478,21/6/2014,Pakistan,Cantt,1,0,1,An 18-year-old girl is stabbed to death by her brother for being seen with a man.
23479,21/6/2014,Iraq,Tikrit,84,0,84,"The bodies of eighty-four Iraqi civil servants are found executed by ISIS, including seven who were beheaded."
23480,21/6/2014,Afghanistan,Kabul,1,3,4,One civilian is taken out by a Shahid suicide bomber.
23481,21/6/2014,China,Xinjiang,0,3,3,An attempted suicide bombing results in the deaths of thirteen Fedayeen.
23482,21/6/2014,Thailand,Pattani,1,0,1,A 36-year-old villager is shot to death by militant Muslims.
23483,21/6/2014,Afghanistan,Jalalabad,4,3,7,A Taliban bomb produces four dead civilians.
23484,21/6/2014,Iraq,Baghdad,7,32,39,A series of Mujahid bomb attacks leaves seven dead.
23485,22/6/2014,Israel,Golan Heights,1,3,4,Syrian terrorists kill an Israeli teen with a rocket fired over the border.
23486,22/6/2014,Nigeria,Gwoza,3,3,6,A Shahid suicide car bomber rams a checkpoint and kills three policemen.
23487,22/6/2014,Iraq,Ramadi,8,13,21,A half-dozen mourners at a funeral are laid out by a Shahid suicide bomber.
23488,22/6/2014,Thailand,Si Sakhon,2,5,7,Muslim terrorists ambush and kill two local security personnel.
23489,22/6/2014,Iraq,Rawa,21,0,21,Twenty-one local leaders are executed by terrorists fighting for an Islamic state.
23490,22/6/2014,Pakistan,Quetta,3,0,3,An entire family is honor-killed by the woman's conservative brothers for marrying without their permission.
23491,23/6/2014,Iraq,Kirkuk,40,0,40,"At least forty men, women and children are murdered when ISIS militants attack four Shia villages while shouting praises to Allah."
23492,23/6/2014,Pakistan,Mamon Kanjan,1,0,1,A 22-year-old woman is honor killed by her uncle for having 'loose morals'.
23493,23/6/2014,Iraq,Kirkuk,15,0,15,Fifteen Shia are kidnapped and executed by Islamic State.
23494,23/6/2014,Iraq,Babil,76,0,76,Activists fighting for an Islamic state ambush a convoy carrying prisoners and massacre over seventy.
23495,23/6/2014,Iraq,Bashir,15,0,15,A woman is among fifteen Shiites captured and lynched by ISIL.
23496,23/6/2014,Lebanon,Beirut,1,25,26,A female suicide car bomber injures six people and kills one other at a World Cup viewing gathering.
23497,23/6/2014,Nigeria,Kano,8,20,28,A Fedayeen suicide bomber murders eight students at a medical college.
23498,23/6/2014,Iraq,Tarmiyah,6,0,6,Two women and three children are among a family of six exterminated in their home by sectarian Jihadis.
23499,24/6/2014,Nigeria,Damboa,56,0,56,Over fifty security personnel and five civilians are machine-gunned point-blank at a checkpoint by Boko Haram.
23500,24/6/2014,Pakistan,Manghopir,3,2,5,The Tehreek-e-Taliban murder three people.
23501,24/6/2014,Iraq,Rutba,12,0,12,Twelve victims of ISIL executions are discovered.
23502,24/6/2014,Iran,Kermanshah,3,0,3,Three border guards are killed by suspected Sunni terrorists.
23503,24/6/2014,Nigeria,Ngohi,3,12,15,"Boko Haram enter a village, kill three people and burn houses."
23504,24/6/2014,Pakistan,Peshawar,1,2,3,"The Taliban are accused of firing on a civilian plane at an airport, killing a female passenger."
23505,24/6/2014,Pakistan,Darora,2,0,2,A man and woman are honor killed by her brother-in-law for being seen in an 'objectionable' position.
23506,24/6/2014,Kenya,Witu,11,0,11,Eleven people are hacked and shot to death at close range in a suspected al-Shabaab attack.
23507,24/6/2014,Afghanistan,Herat,4,7,11,Taliban attackers in burqas produce four dead locals.
23508,24/6/2014,Pakistan,Spinwam,3,0,3,Three others are murdered by a Ansarul Mujahideen suicide bomber.
23509,24/6/2014,Nigeria,Ankpong,17,0,17,Boko Haram attack a village and massacre seventeen.
23510,24/6/2014,Nigeria,Kabamu,21,0,21,Twenty-one people are reported dead after an attack by Muslim terrorists.
23511,24/6/2014,Syria,Homs,1,14,15,"Jihadis set off a car bomb outside a candy shop, killing at least one person."
23512,24/6/2014,Pakistan,Rawalpindi,1,0,1,A cleric is gunned down by Religion of Peace rivals.
23513,24/6/2014,Thailand,Pattani,1,0,1,A Buddhist man is shot and set on fire by Muslim terrorists.
23514,24/6/2014,Pal. Auth.,Gaza,1,3,4,A 3-year-old Palestinian girl is killed by a Hamas rocket.
23515,25/6/2014,USA,"West Orange, NJ",1,0,1,A 19-year-old college student is shot to death 'in revenge' for Muslim deaths overseas.
23516,25/6/2014,Nigeria,Abuja,24,52,76,"Islamists detonate a bomb in the middle of a shopping district, slaughtering nearly two dozen shoppers."
23517,25/6/2014,Iraq,Mahmudiyah,12,23,35,A suicide bombing is among a series of Mujahid attacks that leave a dozen dead.
23518,25/6/2014,Libya,Benghazi,3,7,10,Rafallah al-Sahati Islamists ambush and kill three local soldiers in a supply convoy.
23519,25/6/2014,Iraq,Kirkuk,5,20,25,Sunni set off a car bomb in a Kurdish area that claims five lives.
23520,25/6/2014,Nigeria,Gani,9,0,9,Muslim terrorists murder nine villagers.
23521,25/6/2014,Nigeria,Kabani,4,0,4,Muslim terrorists murder four villagers.
23522,25/6/2014,Nigeria,Hayin Kwanta,5,0,5,Muslim terrorists murder five villagers.
23523,25/6/2014,Nigeria,Kabamu,30,0,30,Muslim terrorists murder thirty villagers.
23524,25/6/2014,Nigeria,Naidu,16,0,16,Muslim terrorists murder sixteen villagers.
23525,25/6/2014,Nigeria,Dogon- Daji,21,0,21,Muslim terrorists murder twenty-one villagers.
23526,25/6/2014,Nigeria,Kobin,38,0,38,Muslim terrorists murder thirty-eight villagers.
23527,25/6/2014,Libya,Benghazi,1,2,3,A women's rights activist is murdered in her home by suspected elements of the Muslim Brotherhood.
23528,25/6/2014,Iraq,Hawija,4,0,4,Four civilians are kidnapped and murdered by al-Qaeda.
23529,25/6/2014,Iraq,Kirkuk,4,18,22,"A suicide bomber detonates at a market entrance, killing four innocents."
23530,25/6/2014,Iraq,Baghdad,3,2,5,"Fundamentalists fire into a shop selling alcohol, taking down three people."
23531,26/6/2014,Yemen,Hadramawt,5,40,45,At least five others are killed when al-Qaeda militants attack an airport.
23532,26/6/2014,Iraq,Baghdad,22,49,71,"A Sunni suicide bomber blows himself up at a Shiite market, slaughtering two dozen men, women and children."
23533,26/6/2014,Somalia,Buulobarde,2,4,6,An al-Shabaab grenade attack on a hotel leaves two dead.
23534,26/6/2014,Pakistan,Mandi Bahauddin,1,0,1,A girl who marries without the permission of her conservative Muslim family is burned alive.
23535,26/6/2014,Lebanon,Beirut,0,3,3,A Saudi suicide bomber detonates at a hotel.
23536,27/6/2014,Iraq,Mosul,3,0,3,Sunnis capture and summarily execute three Shiites.
23537,27/6/2014,Uganda,Kyegegwa,2,0,2,An 18-year-old girl and an old man are murdered by machete-wielding Muslim radicals in an attack on their church service.
23538,27/6/2014,Nigeria,Goniri,7,0,7,Seven security personnel lose their lives to a Boko Haram attack.
23539,27/6/2014,Nigeria,Sanga,32,0,32,Muslim terrorists shoot thirty-two people to death.
23540,27/6/2014,Nigeria,Bauchi,13,34,47,Islamists set off a bomb at a brothel and then machine-gun survivors.
23541,27/6/2014,Pakistan,Satrah,2,0,2,A young man and woman who married without permission are kidnapped and beheaded by the girl's family.
23542,27/6/2014,Syria,Bab,1,0,1,An 'apostate' is shot by ISIL and then hung from a cross.
23543,28/6/2014,Yemen,Hadramawt,2,3,5,An al-Qaeda attack on a hospital leaves two defenders dead.
23544,28/6/2014,Syria,Deir Hafer,8,0,8,Eight ISIL opponents are captured and publicly crucified.
23545,28/6/2014,Syria,Damascus,2,24,26,Two shoppers are pulled into pieces by an Islamist blast at a market.
23546,28/6/2014,Thailand,Narathiwat,2,0,2,Two policemen are ambushed and killed by Muslim 'insurgents'.
23547,28/6/2014,Egypt,al-Arish,2,0,2,A shooting attack by militant fundamentalists leaves two dead.
23548,28/6/2014,Iraq,Jurf al-Sakhar,7,29,36,Seven Iraqis are killed during an attack by ISIS.
23549,28/6/2014,Egypt,Giza,2,0,2,A 15-year-old girl and her mother bleed to death following a bomb blast blamed on the Muslim Brotherhood.
23550,28/6/2014,Egypt,Sinai,4,0,4,Religious radicals murder four local cops.
23551,28/6/2014,Iraq,Ramadi,9,22,31,"ISIS sends mortar shells into the center of a city, killing nine civilians."
23552,28/6/2014,Iraq,Anbar,9,0,9,Nine local cops are taken out by Mujahid bombers.
23553,28/6/2014,Nigeria,Paa,10,0,10,Ten villagers are reported dead following a raid by Muslim terrorists.
23554,29/6/2014,Pakistan,Kohat,4,5,9,Four members of the same family lose their lives to a shooting attack on their vehicle by Islamic militants.
23555,29/6/2014,Nigeria,Chibok,54,91,145,At least fifty-four people are massacred by Boko Haram in attacks targeting churches with grenades and guns.
23556,29/6/2014,Nigeria,Kwadakau,10,0,10,"Devout Muslims open fire on church-goers gathered for a service, killing at least ten."
23557,29/6/2014,Somalia,Mogadishu,3,0,3,Islamists gun down three people to mark the beginning of Ramadan.
23558,29/6/2014,Iraq,Ramadi,4,0,4,Four Iraqis are shot to death by Mujahideen.
23559,30/6/2014,Somalia,Mogadishu,1,0,1,A government worker is killed by an al-Shabaab roadside blast.
23560,30/6/2014,Egypt,Cairo,2,8,10,A series of bombings by Ajnad Misr leave two dead.
23561,30/6/2014,Thailand,Pattani,1,1,2,"Muslim terrorists open fire at a rival mosque, killing one person."
23562,30/6/2014,Somalia,Mogadishu,2,7,9,Two shoppers are sectionalized by an al-Shabaab bomb blast at a market.
23563,30/6/2014,Somalia,Karan,2,5,7,At least two people are killed by an al-Qaeda-linked bombing.
23564,30/6/2014,Syria,Idlib,14,50,64,"Sunni terrorists send mortars into a city center, killing fourteen civilians."
23565,30/6/2014,Somalia,Mogadishu,1,0,1,Fundamentalists shoot an 'apostate' to death at a market.
23566,30/6/2014,Somalia,Mogadishu,1,0,1,One person is killed when Islamists hurl a grenade at a checkpoint.
23567,30/6/2014,Pakistan,Karachi,1,0,1,A Shiite man is shot to death outside a restaurant by Sipah-e-Sahaba.
23568,1/7/2014,Somalia,Mogadishu,3,0,3,Three people talking in the street are shot in the head by activists promoting an Islamic state.
23569,1/7/2014,Nigeria,Maiduguri,56,52,108,At least fifty innocents are slaughtered when pro-Sharia militants set off a bomb at a market.
23570,1/7/2014,Iraq,Samarrah,6,23,29,"Sunnis target a Shia mosque with mortars, killing a half-dozen gathered for worship."
23571,1/7/2014,Pakistan,Khuzdar,1,0,1,A Hindu trader is shot to death in his shop by suspected Islamic extremists.
23572,1/7/2014,Pakistan,Mir Ali,2,1,3,Two security officers are murdered by Tehreek-e-Taliban.
23573,1/7/2014,Libya,Benghazi,1,0,1,An imam is quickly gunned down after denouncing Islamic terror.
23574,2/7/2014,Tunisia,Kef,4,6,10,Two roadside attacks by Jihadis leave four dead.
23575,2/7/2014,Afghanistan,Kabul,16,26,42,Sixteen Afghans are pulled into pieces by a Fedayeen suicide bomber.
23576,2/7/2014,Iraq,Baghdad,5,13,18,Five civilians are blown to bits by a Shahid suicide bomber.
23577,2/7/2014,Iraq,Karbalah,5,14,19,"Shiite radicals open fire on local police officers, killing at least five."
23578,3/7/2014,Somalia,Mogadishu,2,2,4,A lawmaker and his bodyguard are gunned down by pro-Sharia militants for 'collaborating with non-Muslims'.
23579,3/7/2014,Lebanon,Tripoli,0,4,4,Four people are injured when fundamentalists bomb a cafe for staying open during Ramadan.
23580,3/7/2014,Egypt,Kerdasa,2,0,2,Two people are killed when an Islamist bomb explodes early.
23581,3/7/2014,Egypt,Alexandria,0,5,5,Jihadists detonate a bomb on a passenger train.
23582,3/7/2014,Yemen,al-Bayda,2,0,2,An al-Qaeda attack leaves two others dead.
23583,3/7/2014,Pakistan,Faisalabad,1,0,1,A 13-year-old girl is beaten to death with hammers by her Muslim uncles for 'having bad character'.
23584,3/7/2014,Iraq,Tikrit,12,0,12,Women and children are among a dozen victims of a suspected Mujahideen firing.
23585,3/7/2014,Iraq,Mosul,9,0,9,Nine people are kidnapped and tortured to death by ISIL.
23586,4/7/2014,Nigeria,Damboa,20,0,20,Nearly two dozen others are killed when Boko Haram overrun a small town.
23587,4/7/2014,Saudi Arabia,Wadia,1,0,1,"al-Qaeda gunmen open fire on a border patrol, killing one member."
23588,4/7/2014,Pakistan,Karachi,2,2,4,Two people lose their lives when a bomb that is packed with ball-bearings goes off outside a mosque.
23589,4/7/2014,Egypt,Abu Kasah,4,0,4,Four people are killed when a Muslim Brotherhood bomb detonates early.
23590,4/7/2014,Yemen,Border,1,1,2,An al-Qaeda suicide bomber kills one other person.
23591,4/7/2014,Pakistan,Shah Latif,0,2,2,Fundamentalists beat two members of a polio vaccination team with sticks.
23592,4/7/2014,Iraq,Mosul,2,0,2,Two more victims of ISIL torture are discovered.
23593,4/7/2014,Iraq,Samarrah,15,25,40,A Fedayeen suicide bomber takes out fifteen Iraqis.
23594,4/7/2014,Nigeria,Konduga,5,24,29,Five people at a mosque are slain by a suicide  bomb blast.
23595,4/7/2014,Yemen,Ghazyl Bawazir,1,0,1,al-Qaeda militants pick off an 'enemy of Allah' in a drive-by shooting.
23596,5/7/2014,Kenya,Gamba,1,0,1,A 12-year-old Christian carrying a Bible is murdered by Islamic supremacists.
23597,5/7/2014,Thailand,Yala,1,0,1,The owner of a Buddhist grocery is shot in the head at her store by militant Muslims.
23598,5/7/2014,Bahrain,Ekar-East,1,0,1,A sectarian bombing by Shiite radicals claims one life.
23599,5/7/2014,Somalia,Mogadishu,6,12,18,Two children are among a half dozen disassembled by a Shahid suicide car bombing.
23600,5/7/2014,Pakistan,Bahawalpur,2,0,2,Terrorists gun down two people outside a rival mosque.
23601,5/7/2014,Iraq,Ramadi,3,4,7,al-Qaeda gunmen murder four Iraqis.
23602,5/7/2014,Iraq,Basra,3,8,11,Three Iraqis are cut down by Jihad bombers.
23603,5/7/2014,Iraq,Fallujah,6,7,13,Women and children are among a half-dozen people pulled apart by a vicious Mujahid bombing.
23604,5/7/2014,Iraq,Salah il-Din,4,0,4,ISIL bombers kill four children.
23605,6/7/2014,Kenya,Tana River,20,0,20,al-Shabaab gunmen invade a village and murder at least twenty residents.
23606,6/7/2014,Kenya,Lamu,9,3,12,Nine people are killed when Islamic militants attack a trading center.
23607,6/7/2014,Kenya,Mombasa,1,0,1,A Russian woman is gunned down while touring a historic site.
23608,6/7/2014,Yemen,Mahfad,6,0,6,Six people are forced out of their vehicle and machine-gunned by al-Qaeda members.
23609,6/7/2014,Iraq,Baghad,4,12,16,A Shahid suicide bomber takes out four cafe patrons in mid-bite.
23610,6/7/2014,Pakistan,Paira,2,0,2,Two adulterers are executed by conservative family members.
23611,6/7/2014,Iraq,Tikrit,1,0,1,A Hindu man is discovered by ISIS and quickly shot to death.
23612,6/7/2014,Iraq,Tikrit,19,0,19,Seven women and nine children are among two families crushed to death in their homes by Mujahideen rockets.
23613,6/7/2014,Somalia,Beled Hawo,4,0,4,Islamists murder four people at a hotel restaurant for eating during mid-day Ramadan.
23614,7/7/2014,Kenya,Lamu,2,0,2,Two worshippers are burned alive when Muslim radicals set fire to a church.
23615,7/7/2014,Sudan,South Kordofan,10,0,10,"Ten Christians are targeted and murdered by the Islamic government, including four children and an elderly woman.  Their church was also destroyed."
23616,7/7/2014,Yemen,Abyan,2,5,7,An al-Qaeda attack leaves two dead and five injured.
23617,7/7/2014,Kenya,Wajir,1,6,7,One person bleeds to death after suspected al-Shabaab throw a grenade into a restaurant.
23618,7/7/2014,Afghanistan,Kunduz,5,4,9,Five children are disassembled when the Taliban send an RPG into their home.
23619,7/7/2014,Iraq,Baghdad,7,17,24,A Fedayeen suicide bomber in a packed Shiite district sends seven souls to Allah.
23620,7/7/2014,Afghanistan,Herat,5,1,6,Five police officers are murdered by the Taliban.
23621,7/7/2014,Thailand,Yala,1,1,2,"Muslim militants ambush a security patrol, killing one member."
23622,7/7/2014,Iraq,Tikrit,1,0,1,A civilian is kidnapped and executed by ISIL.
23623,7/7/2014,Iraq,Adhaim,4,0,4,Four Iraqis are murdered by Jihadis.
23624,7/7/2014,Iraq,al-Meshag,3,10,13,Islamic State militants shoot three villagers to death.
23625,8/7/2014,Afghanistan,Parwan,16,14,30,"A Taliban suicide bombing at a medical clinic leaves sixteen dead, including eleven students."
23626,8/7/2014,CAR,Bambari,27,20,47,At least twenty-seven people are killed when Muslims attack a Catholic church sheltering civilians.
23627,8/7/2014,Iraq,Samarrah,8,9,17,Two Mujahid bombs produce eight dead Iraqis.
23628,8/7/2014,Pakistan,Achini,3,1,4,"Lashkar-e-Islam gunmen open fire on a group of villagers outside their residences, killing three."
23629,8/7/2014,Somalia,Mogadishu,14,4,18,"al-Shabaab militants attack the presidential compound, killing over a dozen guards."
23630,9/7/2014,China,Xinjiang,6,1,7,Six ethnic Han farmers are stabbed to death by Muslim terrorists.
23631,9/7/2014,Pakistan,Khyber Pakhtunkhwa,3,4,7,Three people lose their lives to suspected Taliban.
23632,9/7/2014,Iraq,Khamissiya,53,0,53,Fifty-three victims of a mass sectarian execution are found dumped in a Shiite town.
23633,9/7/2014,Iraq,Babil,2,13,15,Two Jihadi car bombs kill two Iraqis.
23634,9/7/2014,Egypt,al-Arish,1,4,5,Fundamentalists set off a roadside bomb that leaves one dead.
23635,9/7/2014,Iraq,Mansuriyah,9,38,47,Nine soldiers are killed in an ambush by Islamic State militants.
23636,9/7/2014,Thailand,Yala,2,0,2,Two Buddhist nursing students are gunned down at a market by suspected Muslim terrorists.
23637,9/7/2014,Afghanistan,Kandahar,9,9,18,A woman is among nine killed during a massive Fedayeen suicide assault.
23638,9/7/2014,Syria,Khatab,14,0,14,Seven women and are among fourteen villagers massacred by Sunni 'rebels'.
23639,9/7/2014,Pakistan,Shakardara,1,0,1,A member of a peace committee is shot to death by activists fighting for an Islamic state.
23640,9/7/2014,Dagestan,Khasavyurt,1,0,1,A police officer is gunned down by Islamists.
23641,9/7/2014,Dagestan,Kizilyurt,1,0,1,Suspected religious extremists tie a man up and stab him to death.
23642,10/7/2014,Afghanistan,Kohsan,6,3,9,The Taliban murder six employees of a de-mining company.
23643,10/7/2014,Pakistan,Karachi,1,0,1,A shopkeeper is murdered by Sunnis for being Shia.
23644,10/7/2014,Iraq,Samarrah,4,2,6,Four Iraqis are taken apart by a Mujahid roadside bomb.
23645,10/7/2014,Thailand,Yala,3,0,3,Militant Muslims ambush and kill off-duty three police officers.
23646,10/7/2014,Afghanistan,Ghor,7,0,7,Seven Afghans bleed to death following a Taliban roadside bomb.
23647,11/7/2014,Cameroon,Bonderie,2,1,3,Two locals are slain by Boko Haram gunmen.
23648,11/7/2014,Kenya,Mombasa,1,0,1,A financier is killed in a war between rival mosques.
23649,11/7/2014,Israel,Ashdod,0,3,3,Three people are seriously injured when Hamas sends a rocket into a gas station.
23650,11/7/2014,Iraq,Anbar,11,24,35,Eleven Iraqis are killed by Islamic State militants.
23651,11/7/2014,Iraq,Shurqat,3,0,3,Islamic State members murder three civilians and put their bodies on display.
23652,11/7/2014,Pakistan,Abbottabad,2,0,2,A Shia father and son are shot to death by dedicated Sunnis.
23653,11/7/2014,Iraq,Kirkuk,28,25,53,"A Shahid suicide car bombing ends the lives of twenty-eight innocents, including women and children."
23654,11/7/2014,Syria,Rahjan,18,0,18,At least eighteen people are killed during an al-Nusra attack that begins with a suicide bombing.
23655,11/7/2014,Yemen,Hardramawt,1,0,1,al-Qaeda fundamentalists shoot a man to death in his home for 'practicing black magic'.
23656,12/7/2014,Pakistan,Karachi,1,0,1,Religion of Peace rivals assassinate a seminary teacher.
23657,12/7/2014,Afghanistan,Pajwai,8,2,10,Five women are among eight civilians sent to Allah by Taliban bombers.
23658,12/7/2014,Pakistan,Mamond,3,2,5,Three border guards are gunned down by Sunni extremists.
23659,12/7/2014,Iraq,Zayouna,33,18,51,"Fundamentalists enter a brothel and massacre over thirty people, including twenty-eight women."
23660,12/7/2014,Afghanistan,Jalalabad,2,4,6,Two people are taken out by a suspected suicide car bomber.
23661,12/7/2014,Malaysia,Mabul Island,1,1,2,Abu Sayyaf members kill a guard by firing randomly into a resort.
23662,12/7/2014,Algeria,Sidi Bel Abbes,7,0,7,Religion of Peace activists blow up seven security personnel on patrol.
23663,12/7/2014,Pakistan,Karachi,1,0,1,Sectarian Jihadis shoot a man to death at his pump shot.
23664,13/7/2014,Syria,al-Qaim,4,0,4,Four locals are publicly executed by pro-Sharia militants.
23665,13/7/2014,Libya,Benghzi,26,11,37,Over two dozen people are killed in an attack claimed by Islamic militia.
23666,13/7/2014,Afghanistan,Herat,11,4,15,A suicide attack is among several that leave eleven Afghans dead.
23667,13/7/2014,Egypt,al-Arish,8,25,33,Two children are among eight innocents taken out by an Islamist rocket.
23668,13/7/2014,Iraq,Baghdad,6,7,13,"Two bombs, one near a crowded market, leave six dead."
23669,13/7/2014,Iraq,Ishaqi,4,0,4,Four members of a family are disassembled by Mujahid bombers.
23670,13/7/2014,Iraq,Mosul,2,1,3,IS bombers take out two women.
23671,13/7/2014,Iraq,Mosul,10,0,10,Ten Shabak religious minorities are reported kidnapped and executed.
23672,13/7/2014,Iraq,Duluiya,12,0,12,A dozen Iraqis lose their lives to an ISIS assault.
23673,13/7/2014,Thailand,Narathiwat,1,0,1,A 62-year-old Buddhist woman is picked off by Muslim gunmen.
23674,14/7/2014,Nigeria,Borno,27,0,27,"Over two dozen Christians are massacred by Islamists, in an attack on three churches."
23675,14/7/2014,Nigeria,Dille,1,4,5,A pastor is murdered by Boko Haram.  His wife and three young children are kidnapped.
23676,14/7/2014,India,Lalmonirhat,0,4,4,Jamaat-e-Islami attack a Hindu family in their home.
23677,14/7/2014,Iraq,Muqdadiya,8,0,8,Eight young men are executed by Islamic State members.
23678,14/7/2014,Iraq,Baghdad,3,8,11,A Jihad bomb blast near a car dealership ends the lives of three innocents.
23679,14/7/2014,Iraq,Baghdad,4,12,16,"Sunnis set off a bomb in a Shiite district, killing four."
23680,14/7/2014,Iraq,Baqubah,7,0,7,"Seven people are kidnapped, tied up and executed by sectarian rivals."
23681,14/7/2014,Libya,Benghazi,1,6,7,"Islamic militia fire a rocket into an airport, killing a guard."
23682,14/7/2014,Israel,Be'er Sheva,0,3,3,Two children are among three seriously injured by a Hamas rocket.
23683,14/7/2014,Iraq,Saadiya,12,0,12,Twelve tribesmen are detained and summarily executed by Islamic State.
23684,14/7/2014,Nigeria,Zamadede,11,0,11,A mother and her two children are among eleven hacked to death by Fulani terrorists.
23685,14/7/2014,Mali,Moustarat,1,7,8,A suicide bomber kills a French peacekeeper.
23686,15/7/2014,Nigeria,Sabon Gari,20,0,20,Boko Haram massacre twenty villagers.
23687,15/7/2014,Pakistan,Mir Ali,5,8,13,Five local soldiers are cut down by armed religious radicals.
23688,15/7/2014,Iraq,Madain,9,0,9,Nine people are reported dead following a Mujahideen bomb blast.
23689,15/7/2014,Iraq,Tikrit,12,28,40,Two suicide car bombers murder a dozen Iraqis.
23690,15/7/2014,Iraq,Sadr City,14,54,68,Fourteen people are killed when Sunnis bomb a Shiite market.
23691,15/7/2014,Nigeria,Dille,38,20,58,Pro-caliphate militants slaughter over three dozen residents and burn churches in a raid on a Christian farming village.
23692,15/7/2014,Israel,Erez,1,1,2,A 37-year-old distributing food dies from a Hamas rocket.
23693,15/7/2014,Afghanistan,Urgun,89,42,131,A Shahid suicide bomber at a market sends eighty-nine souls to Allah.
23694,15/7/2014,Afghanistan,Kabul,2,5,7,A Taliban bomb takes out two minivan passengers.
23695,15/7/2014,Nigeria,Huyim,9,0,9,Nine Christians are slain by Boko Haram.
23696,15/7/2014,Pakistan,Hangu,1,0,1,A 40-year-old Shia teacher is shot to death by Religion of Peace rivals.
23697,16/7/2014,Iraq,Ramadi,5,10,15,Five Iraqis lose their lives to a Fedayeen suicide bomber.
23698,16/7/2014,Iraq,Mosul,1,0,1,A video surfaces of a handcuffed woman strangled to death by an Islamic State member.
23699,16/7/2014,Nigeria,Sabon Gari,7,0,7,Seven family members are murdered by Boko Haram while trying to bury victims of a previous attack.
23700,16/7/2014,Tunisia,Chaambi,15,23,38,Ansar al-Sharia militants slaughter fifteen local soldiers as they are sitting down to eat.
23701,16/7/2014,Pakistan,Sharifabad,1,2,3,A shopkeeper is murdered by Sunnis for being Shia.
23702,16/7/2014,Syria,Damascus,4,20,24,"Sunnis send mortar rounds into a marketplace, killing four patrons."
23703,16/7/2014,Yemen,Baida,2,1,3,al-Qaeda militants machine-gun two off-duty cops.
23704,17/7/2014,Iraq,Nineveh,13,0,13,Thirteen Yazidi religious minorities are kidnapped and executed by Islamic State.
23705,17/7/2014,Syria,Homs,270,0,270,Islamic State militants attack an oil field and execute nearly three hundred civilians and guards.
23706,17/7/2014,Iraq,Sinjar,10,0,10,Ten Shabak religious minorities are kidnapped and executed by Islamic State.
23707,17/7/2014,Iraq,Taji,6,18,24,A half-dozen Iraqis are pulled into pieces by a Shahid suicide bomber along a crowded street.
23708,17/7/2014,Iraq,Baghdad,4,12,16,An Islamic State suicide bomber takes out four people near a Shia mosque.
23709,17/7/2014,Pakistan,Hangu,6,3,9,Suspected Sunni terrorists set off a roadside blast that claims the lives of six innocents.
23710,17/7/2014,Thailand,Narathiwat,1,0,1,A 49-year-old Buddhist is cut down by Muslim gunmen.
23711,17/7/2014,Iraq,Tikrit,3,4,7,At least three others are killed during a massive Fedayeen suicide assault on an Iraqi camp.
23712,17/7/2014,Pakistan,Ghundi,8,3,11,Eight security personnel lose their lives to a Taliban attack.
23713,17/7/2014,Iraq,Muqdadiya,10,0,10,Ten Iraqis are kidnapped and killed by Islamic State.
23714,17/7/2014,Pakistan,Ganj Chowk,1,0,1,A Shia businessman is murdered by sectarian Jihadis.
23715,18/7/2014,Kenya,Witu,7,5,12,Seven people on a bus are machine-gunned by al-Shabaab Islamists.
23716,18/7/2014,Pakistan,Peshawar,4,0,4,Four people are killed when the Taliban open fire on a car.
23717,18/7/2014,Pakistan,Jamrud,8,0,8,Eight security personnel die when pro-Sharia gunmen open fire on their traffic checkpoint.
23718,18/7/2014,Afghanistan,Laghman,1,14,15,A civilian is sectionalized by a Taliban bomb blast.
23719,18/7/2014,Pakistan,Peshawar,1,3,4,Muslim terrorists kill a police officer with a bomb.
23720,18/7/2014,Syria,Tabaqa,1,0,1,A young woman is stoned to death in the public square for adultery.
23721,18/7/2014,Nigeria,Damboa,21,0,21,Religion of Peace proponents massacre over twenty villagers with automatic weapons and explosives.
23722,18/7/2014,Iraq,Balad,6,0,6,A half-dozen Iraqis are picked apart with ISIS mortars.
23723,18/7/2014,Pakistan,Mansehra,2,6,8,A prayer leader is among two murdered by Religion of Peace rivals.
23724,19/7/2014,Israel,Ein Hashlosha,2,2,4,Palestinian terrorists tunnel into Israel and shoot two soldiers to death.
23725,19/7/2014,Iraq,Khazimiyah,3,15,18,Terrorists set off a car bomb near a bus stop that leaves three dead.
23726,19/7/2014,Israel,Dimona,1,3,4,An Israeli civilian is killed by a Hamas rocket that also severely injures children.
23727,19/7/2014,Nigeria,Saha,6,0,6,"Six Christians are killed by Muslim radicals, who also burn a church."
23728,19/7/2014,China,Memetjan Jumaq,1,1,2,Islamic extremists enter a home and stab a woman to death.
23729,19/7/2014,Nigeria,Gwoza,6,0,6,Radicals tie the hands of six villagers and then slit their throats while shouting praises to Allah.
23730,19/7/2014,Egypt,al-Farafrah,22,4,26,Twenty-two local soldiers are incinerated by an RPG attack blamed on fundamentalists.
23731,19/7/2014,Iraq,Baghdad,15,42,57,Three Islamic State car bombs produced fifteen dead Iraqis.
23732,19/7/2014,Nigeria,Damboa,100,0,100,Boko Haram return to the site of an earlier massacre and machine-gun over one-hundred more villagers before raising their black flag of Islam.
23733,19/7/2014,Syria,Raqqa,1,0,1,"A second woman is stoned to death by IS, this time after her new husband discovers that she is not a virgin."
23734,19/7/2014,Iraq,Abu Dashir,9,21,30,Nine people lose their lives to a vicious Shahid suicide bombing in a Shia neighborhood.
23735,20/7/2014,Afghanistan,Peshawar,2,0,2,Two guards at a market are gunned down point-blank by Taliban.
23736,20/7/2014,Libya,Benghazi,47,120,167,A week-long assault by Islamic militia on an airport leaves forty-seven dead.
23737,20/7/2014,Pakistan,Hayatabad,2,0,2,Two security guards at an industrial complex are murdered by Muslim radicals.
23738,20/7/2014,Iraq,Abu Ghraib,5,0,5,Five Shiites are taken out by a Sunni roadside blast.
23739,20/7/2014,Iraq,Mahmoudiya,11,31,42,Eleven are killed when Sunnis rain down mortar shells on a Shiite religious procession.
23740,20/7/2014,Libya,Benghazi,1,0,1,A foreign worker is singled out and beheaded for not being Muslim.
23741,20/7/2014,Iraq,Mosul,1,0,1,A university professor is murdered by Islamists for speaking out on behalf of abused Christians.
23742,21/7/2014,Iraq,Baqubah,3,4,7,"Islamic State send mortar shells into a family home, killing three members."
23743,21/7/2014,Afghanistan,Lashkar Gah,2,9,11,A Shahid suicide bomber takes out two locals.
23744,21/7/2014,Libya,Benghazi,16,81,97,Sixteen people are killed during an attack by Ansar al-Sharia.
23745,22/7/2014,Iraq,Baqubah,1,0,1,An imam is quickly executed after denouncing the caliphate.
23746,22/7/2014,Afghanistan,Kabul,4,11,15,A Taliban suicide bomber murders four people outside an airport.
23747,22/7/2014,Philippines,North Cotabato,1,0,1,One other person is killed when Bangsamoro Islamic gunmen attack a convoy.
23748,22/7/2014,Iraq,Baghdad,33,50,83,"A Holy Warrior detonates a suicide shrapnel bomb at a packed entrance to a Shiite neighborhood, taking the lives of three dozen innocents."
23749,22/7/2014,Iraq,Kirkuk,6,0,6,ISIL kidnap and murder six taxi drivers.
23750,22/7/2014,Libya,Benghazi,5,4,9,A twin suicide bombing leaves five others dead.
23751,22/7/2014,Iraq,Nahrawan,5,13,18,Sunni bombers take down five patrons at a Shiite market.
23752,22/7/2014,Iraq,Diyala,5,0,5,Five civilians are captured and publicly executed by the Islamic State.
23753,23/7/2014,Pakistan,Badaber,1,2,3,"Tehreek-e-Taliban members attack the home of a judge, killing a guard."
23754,23/7/2014,Iraq,Samarra,8,0,8,Eight Iraqi soldiers are kidnapped and executed by Islamic radicals.
23755,23/7/2014,Iraq,Jalawla,6,0,6,Islamic State gunmen execute six people for being related to a policeman.
23756,23/7/2014,Somalia,Mogadishu,1,0,1,Fundamentalists gun down a female singer turned lawmaker.
23757,23/7/2014,Nigeria,Kawo,50,37,87,"At least fifty people at a market are incinerated by a suicide bus bombing, including woman and children."
23758,23/7/2014,Nigeria,Kaduna,35,14,49,Three dozen people bleed to death following a suicide bomb attack on a rival cleric and his followers.
23759,23/7/2014,Pakistan,Karachi,1,2,3,"Gunmen attack a vehicle carrying a Shia family, killing the mother."
23760,23/7/2014,Pakistan,Karachi,1,0,1,A 60-year-old Shiite man is gunned down by Sunnis while buying fruit.
23761,23/7/2014,Iraq,Sharqat,1,0,1,A female politician is murdered by IS fundamentalists.
23762,23/7/2014,Israel,Eshkol,1,0,1,A civilian is killed by a Hamas mortar round.
23763,24/7/2014,Cameroon,Bargaram,1,0,1,A pastor's body is found after he is abducted by Boko Haram.
23764,24/7/2014,Iraq,Baghdad,21,33,54,"A double car-bombing rips through a commercial district, snuffing out the lives of over twenty innocents."
23765,24/7/2014,Nigeria,Kano,1,8,9,Boko Haram is suspected of a bombing that leaves one dead in a bus park.
23766,24/7/2014,Afghanistan,Herat,2,0,2,Two female aid workers for a Christian charity are shot to death by Muslim radicals.
23767,24/7/2014,Afghanistan,Nangarhar,2,1,3,A Shahid suicide bomber takes the lives of two local cops.
23768,24/7/2014,Iraq,Taji,61,19,80,A massive suicide attack on a convoy transporting prisoners leaves sixty dead.
23769,24/7/2014,Yemen,Lahj,1,0,1,al-Qaeda gunmen pick off a man outside his home.
23770,24/7/2014,Syria,Raqqa,19,0,19,Nineteen people are reported dead following a double suicide attack.
23771,24/7/2014,Nigeria,Garubulu,15,0,15,Islamists enter a village and calmly machine-gun fifteen residents.
23772,24/7/2014,Afghanistan,Takhar,6,26,32,A Fedayeen suicide bomber on a motorcycle slaughters six people at a packed market.
23773,25/7/2014,Cameroon,Bargaram,4,0,4,Four Cameroon soldiers are killed during a cross-border raid by Boko Haram.
23774,25/7/2014,Pakistan,Dera Ismail Khan,2,0,2,Religious radicals kill two meat shop employees with a bomb.
23775,25/7/2014,Iraq,Tikrit,18,0,18,Eighteen suspected victims of the Islamic State are found bound and executed.
23776,25/7/2014,Iraq,Kirkuk,4,15,19,Four Shiites are liquidated by a targeted bomb attack.
23777,25/7/2014,Afghanistan,Ghor,15,0,15,"Three women and a child are among fifteen Shiites singled out and pulled off a bus by dedicated Sunnis, who bound their hands and then execute them."
23778,25/7/2014,Egypt,Sheikh Zuwaid,2,0,2,Two army officers are shot to death by suspected Ansar Bayt al-Maqdis.
23779,25/7/2014,Yemen,Baida,5,2,7,"al-Qaeda members fire heavy machine-guns into a police checkpoint, exterminating five officers."
23780,25/7/2014,Syria,Raqqa,50,0,50,"At least fifty Syrian soldiers are captured and beheaded by Islamic State militants, who then post the heads on a long row of fence posts."
23781,25/7/2014,India,Sopore,1,0,1,A local cop is gunned down by Lashkar-e-Toiba militants.
23782,26/7/2014,Pakistan,Zubaida,1,1,2,A teenage girl is murdered by her conservative brother on suspicion that she is having sex.
23783,26/7/2014,Afghanistan,Marjah,4,4,8,Four civilians are disassembled by a Taliban bomb.
23784,26/7/2014,Egypt,Rafah,4,5,9,Four children are wiped out by a rocket fired by Islamic militia.
23785,26/7/2014,Tunisia,Kef,2,6,8,Armed fundamentalists ambush and kill two local soldiers.
23786,26/7/2014,Iraq,Taji,6,0,6,"Six security personnel are captured, handcuffed and shot in the head by Sunni extremists."
23787,26/7/2014,Syria,Azaz,4,4,8,"Islamists set off a bomb in a vegetable market, killing children and the elderly."
23788,26/7/2014,Pakistan,Karachi,5,0,5,Five Shiites are shot to death by Sunni radicals in three separate attacks.
23789,26/7/2014,India,Sopore,1,4,5,One person dies when a Muslim extremist tosses a grenade into the street.
23790,26/7/2014,India,Saharanpur,2,19,21,Two Sikhs are murdered in a violent Muslim attack.
23791,26/7/2014,Thailand,Betong,2,52,54,Muslim terrorists set off a car bomb in front of a hotel that claims the lives of two young people.
23792,26/7/2014,Libya,Benghazi,34,87,121,Three dozen people soldiers are killed during a sustained assault by Ansar al-Sharia.
23793,26/7/2014,Libya,Tripoli,23,0,23,A rocket fired by suspected Islamic militia hits a house and kills twenty-three laborers.
23794,26/7/2014,Pakistan,Gulshan-e-Iqbal,1,3,4,A prayer leader is murdered outside his mosque by Religion of Peace rivals.
23795,26/7/2014,Nigeria,Hawul,2,0,2,Two Christians are beheaded by Boko Haram.
23796,27/7/2014,Nigeria,Kano,0,5,5,A female suicide bomber detonates along a city street.
23797,27/7/2014,Cameroon,Kolofata,18,22,40,Boko Haram kill eighteen civilians.
23798,27/7/2014,Pakistan,Karachi,2,1,3,A 6-year-old girl is among the casualties of an Islamist shooting attack.
23799,27/7/2014,Nigeria,Shafa,2,0,2,Two men are shot to death by Boko Haram.
23800,27/7/2014,Nigeria,Hong,30,0,30,Thirty villagers are slaughtered randomly by Boko Haram gunmen.
23801,27/7/2014,Nigeria,Kano,5,8,13,"Muslim extremists throw a bomb into a Catholic church, killing five worshippers."
23802,27/7/2014,Israel,Border,1,0,1,A soldier is killed by a Hamas rocket fired into Israel.
23803,27/7/2014,Yemen,Abyan,2,11,13,Two others are killed by suicide bombers.
23804,27/7/2014,Afghanistan,Spinboldak,2,0,2,A child is among two people taken out by Shahid suicide bombers at their home.
23805,27/7/2014,Iraq,Taji,6,0,6,An entire Shiite family of six is found beheaded in their home by Religion of Peace rivals.
23806,27/7/2014,Thailand,Pattani,1,7,8,A young girl is reduced to pulp by an Muslim 'insurgent' bomb.
23807,27/7/2014,Pakistan,Jamrud,1,0,1,Members of a religious group behead a former member.
23808,27/7/2014,Pakistan,Mirokas,1,0,1,Militants fighting for Sharia kill a bus driver with a roadside bomb.
23809,27/7/2014,Iraq,Jurf al-Sakhar,3,4,7,Islamic State terrorists attack a police station and kill three officers.
23810,27/7/2014,Iraq,Tuz Khurmato,2,4,6,Two women are pulled into pieces by a Jihad car bomb at an outdoor market.
23811,28/7/2014,Nigeria,Garkida,40,0,40,Forty civilians are reported killed during a Boko Haram attack.
23812,28/7/2014,Philippines,Talipao,23,11,34,Women and six children are among twenty-three machine-gunned point-blank by Abu Sayyaf.
23813,28/7/2014,Nigeria,Kano,0,6,6,A Fedayeen suicide bomber blows herself up at a shopping mall.
23814,28/7/2014,Nigeria,Kano,3,8,11,A female suicide bomber detonates at a gas station killing three other women lining up to buy kerosene.
23815,28/7/2014,Pakistan,Gujranwala,4,8,12,Two young girls are among four members of an Ahmadi religious minority family burned alive after an angry mob sets fire to their home over alleged 'blasphemy'.
23816,28/7/2014,Thailand,Narathiwat,1,0,1,A villager on foot loses his life to suspected Muslim gunmen.
23817,28/7/2014,Nigeria,Katarko,8,12,20,Pro-Sharia militants throw explosives into homes and shoot those trying to flee.
23818,28/7/2014,Egypt,Sheikh Zuwaid,1,10,11,A 9-year-old girl dies from shrapnel produced by an Islamist rocket.
23819,28/7/2014,Pakistan,Jamrud,1,0,1,A local soldier is kidnapped and beheaded by religious radicals.
23820,28/7/2014,Iraq,Baghdad,6,21,27,Mujahideen bombs claim the lives of six Iraqis.
23821,28/7/2014,Iraq,Baghdad,14,0,14,The bodies of fourteen male victims of sectarian killings are found bound and tortured.
23822,28/7/2014,Israel,Nahal Oz,5,0,5,Hamas terrorists tunnel into Israel and murder five soldiers.
23823,28/7/2014,Iraq,Baghdad,3,0,3,Three women are handcuffed and shot in the head by Mujahideen.
23824,28/7/2014,Israel,Eshkol,4,9,13,Four civilians die from a Hamas rocket.
23825,28/7/2014,Pal. Auth.,Gaza,10,46,56,Nine children are among ten killed when a Hamas rocket falls short.
23826,28/7/2014,Pal. Auth.,Shejaiya,20,0,20,Twenty Palestinian protesters are executed by Hamas for protesting Hamas.
23827,28/7/2014,China,Xinjiang,37,13,50,Thirty-seven (mostly ethnic Han) civilians are slaughtered by an Islamic mob armed with axes and knives.
23828,29/7/2014,Pakistan,Charsadda,2,1,3,Fundamentalists are suspected of shooting two off-duty policemen to death.
23829,29/7/2014,Libya,Benghazi,3,0,3,Three civilians are killed when an Islamic militia rocket hits their house.
23830,29/7/2014,Libya,Benghazi,30,81,111,Thirty people are killed when Islamist fighters overrun a military base.
23831,29/7/2014,Bangladesh,Sylhet,1,100,101,One person is beaten to death during a riot sparked by a non-fasting person attending Eid prayers.
23832,29/7/2014,Pakistan,Lower Dir,6,0,6,A half-dozen people inside are killed when Taliban militants assault a house.
23833,29/7/2014,Syria,Raqqa,35,0,35,ISIS posts thirty-five more heads in the town square.
23834,29/7/2014,Iraq,Tikrit,200,0,200,The Islamic State releases a video showing the mass execution of hundreds of Shiite men and boys.
23835,29/7/2014,Afghanistan,Kandahar,2,1,3,Two people are assassinated by a suicide bomber who hid the explosives in his turban.
23836,29/7/2014,Nigeria,Anguwar Bolawa,2,0,2,A second suicide bombing at a Shiite mosque leaves two dead.
23837,29/7/2014,Nigeria,Dogo Tebo,11,37,48,A suicide bomber sends eleven worshippers at a rival mosque straight to Allah.
23838,30/7/2014,Somalia,Hosingow,1,0,1,A mother of two is shot to death for refusing to wear the hijab.
23839,30/7/2014,Nigeria,Kano,6,6,12,"A female suicide bomber detonates at a university, killing student volunteers."
23840,30/7/2014,Iraq,Anbar,6,6,12,A brutal Mujahid car bomb claims the lives of six people.
23841,30/7/2014,Iraq,Sadr City,16,28,44,"Sunnis detonate a car bomb amid restaurants and shops populated by Shia, laying out at least sixteen."
23842,30/7/2014,Iraq,Baqubah,15,0,15,Fifteen Sunni civilians are captured and executed by Shia militia.
23843,30/7/2014,Pakistan,Quetta,2,0,2,Two Hazara Shias are gunned down in a targeted sectarian attack.
23844,30/7/2014,China,Kashgar,1,0,1,A pro-government imam is stabbed to death outside his mosque by religious radicals.
23845,31/7/2014,Pakistan,Umerkot,2,0,2,Two Hindu brothers are shot to death during a targeted robbery.
23846,31/7/2014,Thailand,Pattani,1,0,1,A 44-year-old man is hit six times in the chest by Muslim gunmen.
23847,31/7/2014,Iraq,Sadr City,3,13,16,"Terrorists bomb a gas station in a Shia area, killing three people in line."
23848,31/7/2014,Iraq,Kirkuk,1,0,1,A woman is put to death for criticizing the Islamic State.
23849,31/7/2014,Iraq,Haditha,6,18,24,Six local security personnel are ambushed and killed by Islamic State militants.
23850,31/7/2014,Iraq,Tikrit,17,0,17,Islamic State members execute seventeen civilians.
23851,1/8/2014,Afghanistan,Nuristan,3,0,3,A woman and her 3-year-old child are shot to death by Taliban fundamentalists.
23852,1/8/2014,Iraq,Jurf al-Sakhr,17,3,20,A brutal Islamic State attack on a small town leaves seventeen defenders dead.
23853,1/8/2014,Iraq,Sadr City,9,21,30,A Sunni car bomb along a busy street in a Shiite district claims the lives of nine innocents.
23854,1/8/2014,Iraq,Mosul,14,0,14,Fourteen others are killed when Islamic State militants attack a dam.
23855,1/8/2014,Syria,Qalamoun,7,0,7,al-Nusra Islamists kill seven people.
23856,1/8/2014,Somalia,Mogadishu,1,0,1,A politician is shot to death outside a mosque 'on the orders of Allah'
23857,1/8/2014,Iraq,Baghdad,5,16,21,Three sectarian bomb attacks on a Shiite mosque kills five people.
23858,1/8/2014,Pal. Auth.,Rafah,3,0,3,A suicide attack during a ceasefire leaves three IDF dead.
23859,2/8/2014,Bangladesh,Rangpur,1,0,1,A religious minority is beaten to death by a Muslim gang.
23860,2/8/2014,Libya,Tripoli,22,72,94,Another twenty-two people are killed when Islamist militias lay siege to an airport.
23861,2/8/2014,Pakistan,Hangu,1,1,2,One rider is killed when suspected Taliban open fire on a bus.
23862,2/8/2014,Iraq,Kirkuk,1,0,1,Activists behead a citizen who refuses to swear allegiance to the Islamic State.
23863,2/8/2014,Iraq,Balad,5,16,21,A Sunni suicide bomber reduces five Shiites to pulp.
23864,2/8/2014,Iraq,Jurf al-Sakhr,23,0,23,Twenty-three people are reported dead following shelling by Islamic State militants.
23865,2/8/2014,Yemen,Shabwa,4,2,6,"al-Qaeda gunmen open fire point-blank on a group of policemen, killing four."
23866,2/8/2014,Pakistan,Ashraf,2,0,2,A young couple is murdered by her conservative family for marrying without permission.
23867,2/8/2014,Iraq,Mosul,1,0,1,A man is beheaded for refusing to swear allegiance to the caliphate.
23868,3/8/2014,Iraq,Tal Azir,7,0,7,Seven Yazidi minorities are executed in cold blood by the Islamic State.
23869,3/8/2014,Iraq,Sinjar,88,0,88,Eighty-eight members of the Yazidi religious minority are rounded up and 'cleansed' by Islamic State members.
23870,3/8/2014,Iraq,Diyala,1,1,2,Islamic State militants kill a man and abduct his 11-year-old daughter.
23871,3/8/2014,Somalia,Mogadishu,3,7,10,Three elderly female street cleaners are disassembled by an Islamist bomb.
23872,3/8/2014,Lebanon,Arsal,3,0,3,At least three civilians are killed during an attack by al-Nusra.
23873,3/8/2014,Syria,Damascus,12,23,35,A young girl is among a dozen killed when Islamic Union members send mortars into a residential neighborhood.
23874,3/8/2014,Pakistan,Karachi,1,1,2,Sunni Tehreek members shoot a rival to death.
23875,3/8/2014,Egypt,Sheikh Zuweid,1,4,5,A 6-year-old boy bleeds to death after being hit with a rocket fired by religious hardliners.
23876,3/8/2014,Nigeria,Kaduna,1,17,18,"Muslims fire into a Catholic church, killing a guard and injuring several worshippers."
23877,3/8/2014,Tunisia,Sbitla,1,1,2,"Fundamentalists try to storm a military base, killing a defender."
23878,4/8/2014,Syria,Mzeiraa,7,4,11,Two children are among a family of seven religious minorities butchered in their home by Islamic State members.
23879,4/8/2014,Pakistan,Dera Ismail Khan,3,2,5,Three Sufis are killed in a targeted bombing.
23880,4/8/2014,Iraq,Telkef,1,6,7,A Christian is killed by an Islamic State firing.
23881,4/8/2014,Pakistan,Karachi,1,0,1,The 65-year-old principal of a Christian school is gunned down in a targeted attack.
23882,4/8/2014,Iraq,Jalawla,3,6,9,"A suicide bomber detonates inside a coffee shop, liquidating three patrons."
23883,4/8/2014,Israel,Jerusalem,1,6,7,An Arab rams a bus and mows over a rabbi with a tractor.
23884,4/8/2014,Yemen,Hadramout,6,0,6,A half-dozen local soldiers are murdered by al-Qaeda.
23885,4/8/2014,Somalia,Bosaso,5,0,5,An al-Shabaab suicide bomber takes out four Somalis.
23886,4/8/2014,Pakistan,Quetta,2,0,2,Two young people are shot to death for having unmarried sex.
23887,4/8/2014,Iraq,Deir al-Zor,15,120,135,"The Islamic State sends rockets into three non-compliant villages, killing fifteen civilians."
23888,4/8/2014,Lebanon,Arsal,2,3,5,"Islamists fire on a peace delegation, killing two guards."
23889,4/8/2014,Thailand,Yala,2,0,2,Muslim bombers kill two off-duty cops.
23890,4/8/2014,Chad,Dubuwa,6,0,6,"Boko Haram chasing fleeing villagers into Chad, where they cut down six."
23891,5/8/2014,Pal. Auth.,Shejaiya,10,0,10,Ten more Palestinians are reported dead following an Hamas crackdown.
23892,5/8/2014,Iraq,Sinjar,40,0,40,Forty Yazidi children are reported dead as a direct consequence of an Islamic State assault on their town.
23893,5/8/2014,Egypt,Matrouh,5,0,5,"Muslim radicals shoot five policemen sitting in a car, then set fire to it."
23894,5/8/2014,Syria,Damascus,16,79,95,Two children are among sixteen civilians killed when an Islamist brigade sends shells into their neighborhood.
23895,5/8/2014,Dagestan,Shamil,1,0,1,Islamic extremists are suspected of shooting a police officer to death.
23896,5/8/2014,Sudan,Port Sudan,2,0,2,Two men are flogged to death by a Sharia court for consuming alcohol.
23897,5/8/2014,Syria,Jerthe,3,0,3,Islamic State militants behead three men and then post the heads for display.
23898,5/8/2014,Syria,Maaloula,1,0,1,Video surfaces of a Christian man beheaded to shouts of 'Allah akbar'.
23899,5/8/2014,Iraq,Abu Ghraib,2,0,2,"Mujahideen fire on a car, killing two people."
23900,5/8/2014,Afghanistan,Uruzgan,7,0,7,A Taliban in police uniform drugs and murders seven Afghan cops.
23901,5/8/2014,Pakistan,Liaquatabad,2,0,2,"Ahl-e-Sunnat-Wal-Jamaat gunmen open fire on a Shiite-owned salon, killing an uncle and his nephew."
23902,6/8/2014,Egypt,Karama,1,0,1,Ansar Beit al-Maqdis claim the killing of a 58-year-old American oil worker.
23903,6/8/2014,Pakistan,Peshawar,1,2,3,"Sunnis open fire on a group of Sikhs, killing a teenager."
23904,6/8/2014,Cameroon,Zigague,10,0,10,Ten bus passengers are machine-gunned point blank by Boko Haram Islamists.
23905,6/8/2014,Iraq,Sadr City,31,84,115,Thirty-one people at a Shiite shopping center are reduced to pulp by Sunni bombers.
23906,6/8/2014,Yemen,Habban,5,1,6,Five security personnel are machine-gunned in their car by al-Qaeda.
23907,6/8/2014,Lebanon,Tripoli,1,7,8,A civilian is killed when Sunni radicals toss a bomb under a bridge.
23908,6/8/2014,India,Kupwara,1,0,1,"Terrorists fire on a security patrol, killing a member."
23909,6/8/2014,Nigeria,Gwoza,997,40,1037,One-thousand people are reported dead after Boko Haram fire indiscriminately at residents of a Christian village while praising Allah.
23910,6/8/2014,Iraq,Baghdad,11,4,15,A Mujahid bombing claims the lives of eleven Iraqis.
23911,6/8/2014,Iraq,Sinjar,60,0,60,Another thirty children and thirty elderly are reported dead following displacement by the Islamic State.
23912,6/8/2014,Iraq,Qara Qosh,2,3,5,A Christian woman and her baby are killed by ISIS shelling.
23913,6/8/2014,Iraq,Aliya Rash,1,14,15,One other person is killed by a suicide truck bomber.
23914,6/8/2014,Iraq,Baghdad,17,25,42,Seventeen Iraqis are disassembled by a Fedayeen suicide bomber.
23915,6/8/2014,Libya,Tripoli,18,0,18,Eighteen Sudanese nationals are killed by a rocket strike during an assault by Islamic militia.
23916,7/8/2014,Yemen,Seyoun,50,0,50,At least fifty soldiers are reported killed during an al-Qaeda suicide attack.
23917,7/8/2014,Syria,Raqqa,36,0,36,Forty people are reported dead in three suicide blasts and subsequent beheadings by the Caliphate.
23918,7/8/2014,Iraq,Sinjar,397,500,897,The death toll from the slaughter of Yazidi religious minorities by Caliphate militants rises.
23919,7/8/2014,Libya,Zawiya,4,9,13,Four people are killed during an attack by Islamist militia.
23920,7/8/2014,Syria,Deir Ezzor,19,0,19,Nineteen oil workers are lined up and executed by militants who quote verse 5:32 of the Quran.
23921,7/8/2014,Iraq,Kirkuk,11,50,61,Eleven people outside a Shiite are reduced to pulp by co-religionists.
23922,8/8/2014,Yemen,Huta,14,0,14,Religion of Peace proponents capture and behead fourteen soldiers.
23923,8/8/2014,Afghanistan,Sangin,4,0,4,Religious extremists storm a checkpoint and kill four policemen.
23924,8/8/2014,Iraq,Iraq,15,0,15,Fifteen male members of a Yazidi family are beheaded by Islamic State.  The women are taken away for 'marriage'.
23925,8/8/2014,Afghanistan,Tenai Dara,4,2,6,Religious radicals storm a house in the middle of the night and slaughter four family members.
23926,8/8/2014,Syria,Damascus,15,0,15,Fifteen more people are reported killed by Ajnad al-Sham Islamist militia.
23927,9/8/2014,Syria,al-Bulel,2,0,2,ISIL beheads two captives.
23928,9/8/2014,Syria,Alippo,3,12,15,Three children are 'torn apart' by an Islamic State rocket.
23929,9/8/2014,Iraq,Makhmour,1,0,1,A journalist is killed by an ISIL shell.
23930,9/8/2014,Somalia,Buloburde,13,3,16,Thirteen security personnel are reportedly killed in an attack by al-Shabaab.
23931,10/8/2014,Iraq,Nineveh,17,0,17,Seventeen members of the Shabak religious minority are executed in cold blood by the Islamic State.
23932,10/8/2014,Pakistan,Surjani,2,2,4,A Shiite man and his daughter are exterminated by committed Sunnis.
23933,10/8/2014,Iraq,Jalawla,10,80,90,A Fedayeen suicide bomber kills ten Iraqis.
23934,10/8/2014,DRC,Kivu,3,0,3,Three priests kidnapped in 2012 are reported executed after refusing to convert to Islam
23935,10/8/2014,Afghanistan,Kabul,4,7,11,A woman and two children are sectionalized by a Shahid suicide bomber.
23936,10/8/2014,Nigeria,Kaduna,1,0,1,One person is killed when militant Muslims fire into a Catholic church during worship.
23937,10/8/2014,Nigeria,Doron Baga,31,122,153,"Pro-Sharia gunmen fire into a village, killing over thirty residents while shouting 'Allah Akbar'."
23938,10/8/2014,Syria,al-Shaafa,2,0,2,Two tribesmen are beheaded by the caliphate.
23939,11/8/2014,Nigeria,Zarazong,2,0,2,Militant Muslims burn homes and kill two residents of a Christian village.
23940,11/8/2014,Nigeria,Yelwa,14,0,14,Fourteen Christians are 'killed for their faith' by heavily-armed Muslims.
23941,11/8/2014,Iraq,Mosul,1,0,1,Islamists identify a Christian cab driver by his rosary and quickly butcher him.
23942,11/8/2014,Iraq,Bieji,2,0,2,Two Iraqis are kidnapped and shot in the head by al-Qaeda.
23943,11/8/2014,Syria,Mayadin,4,0,4,Four men are crucified by the Islamic State - two for blasphemy and two for 'dealing with apostates'.
23944,11/8/2014,Syria,Deir Ezzor,5,0,5,Five people are beheaded by ISIL.
23945,12/8/2014,Yemen,al-Jouf,15,0,15,At least fifteen are killed when radical Shiites clash with radical Sunnis.
23946,12/8/2014,Pakistan,Dera Ismail Khan,4,2,6,Three brothers are among four people gunned down by Taliban militants.
23947,12/8/2014,Iraq,Diyala,6,0,6,A religious radical shoots six members of his own family to death for trying to prevent him from joining ISIL.
23948,12/8/2014,Pakistan,Karachi,2,0,2,A Shia doctor is among two people killed in separate sectarian shooting attacks.
23949,12/8/2014,Iraq,Baghdad,13,27,40,Thirteen people lose their lives to a Mujahideen bombing outside a family home.
23950,12/8/2014,Iraq,Baghdad,2,5,7,Jihadi car bombers take out two Iraqis.
23951,12/8/2014,Thailand,Yala,2,1,3,Militant Muslims kill two police officers with a roadside bomb.
23952,12/8/2014,Libya,Tripoli,1,0,1,A police chief is shot to death by suspected Islamists.
23953,12/8/2014,Afghanistan,Bahrami Shahid,3,0,3,Three policemen are murdered by Taliban bombers.
23954,13/8/2014,Iraq,Baghdad,6,9,15,Mujahid bombers murder six people outside of an educational directorate.
23955,13/8/2014,India,Galander,3,0,3,Three people are machine-gunned point-blank by militant Muslims.
23956,13/8/2014,Iraq,Baghdad,10,21,31,Ten Iraqis are obliterated by a car bomb in a Sunni district.
23957,13/8/2014,Egypt,el-Mattallah,1,2,3,A 13-year-old child bleeds out from a Hamas rocket fired from Gaza.
23958,13/8/2014,Yemen,Lahj,14,16,30,A bomb planted by al-Qaeda takes out fourteen innocents on a main street.
23959,13/8/2014,Syria,Akhtarin,9,0,9,Caliphate members slit the throats of nine captives.
23960,14/8/2014,Iraq,Fallujah,5,0,5,Four children and a woman are killed during an attack by Sunni radicals.
23961,14/8/2014,Yemen,Mukallah,3,3,6,Three security personnel are killed while foiling an Ansar al-Sharia car bombing.
23962,14/8/2014,Kenya,Garissa,2,2,4,"Pro-Sharia extremists open fire on a crowd of civilians, killing two."
23963,14/8/2014,Kenya,Mandera,1,0,1,al-Shabaab terrorists murder a road construction worker.
23964,15/8/2014,Kenya,Nairobi,0,1,1,A convert to Christianity is left in a coma after being thrown from a balcony by devout Muslims.
23965,15/8/2014,Syria,Deraa,14,12,26,Women and children are among those killed when Islamists bomb a rival mosque.
23966,15/8/2014,Iraq,Sayed Ahmad,6,0,6,Six Iraqis are executed in cold blood by Islamic State.
23967,15/8/2014,Iraq,Jalawla,1,0,1,"A Shiite imam is executed in front of his mosque by dedicated Sunnis, who then blow up the mosque."
23968,15/8/2014,Iraq,Kucho,80,0,80,Eighty men are slaughtered and their women and children enslaved after refusing to convert to Islam.
23969,15/8/2014,Pakistan,Quetta,0,11,11,A sustained Fedayeen suicide assault on an airbase leaves eleven other injured.
23970,15/8/2014,CAR,Mbres,34,0,34,Thirty-four people are reported killed by Muslim 'rebels'.
23971,15/8/2014,Iraq,Said Ahmad,5,0,5,Five members of one family are murdered in their home by members of the Islamic State.
23972,15/8/2014,Iraq,Hit,9,13,22,Nine civilians are turned to paste by an ISIS rocket.
23973,15/8/2014,Syria,Deir al-Zor,700,0,700,"Seven-hundred tribesman are executed by the caliphate over the course of a week, mostly by beheading."
23974,15/8/2014,Iraq,Hardan,300,0,300,Three hundred Yazidis are rounded up and beheaded after being assured of their safety by ISIS if they surrendered.
23975,16/8/2014,Syria,Akhtarin,8,0,8,Eight captives are beheaded by the Islamic State.
23976,16/8/2014,Iraq,Kucho,312,0,312,Another three-hundred religious minorities are slaughtered in cold blood by the Islamic State after refusing to convert.
23977,16/8/2014,Mali,Ber,2,9,11,Two peacekeepers are killed by a Shahid suicide bomber.
23978,16/8/2014,Indonesia,West Nusa Tenggara,1,0,1,A police officer is shot to death by terrorists.
23979,16/8/2014,Iraq,Samarrah,3,11,14,"Religion of Peace bombers target an engineering team trying to repair a bridge, killing three."
23980,16/8/2014,Russia,Vladikavkaz,1,0,1,A moderate imam is shot seven times by suspected Islamic radicals.
23981,16/8/2014,Somalia,Beledweyne,2,0,2,A woman is among two people shot dead by al-Shabaab fundamentalists.
23982,16/8/2014,India,Awantipora,2,4,6,Muslim 'separatists' gun down two guards at an airport.
23983,16/8/2014,Syria,Dama,15,20,35,"Islamist-backed groups attack a Druze village, killing fifteen residents."
23984,16/8/2014,Iraq,Jalawla,13,7,20,"ISIS members send mortars into a Kurdish neighborhood, killing thirteen."
23985,17/8/2014,Iraq,Kucho,20,0,20,"Another twenty bodies are discovered, victims of the Islamic State purge of Yazidis who would not convert."
23986,17/8/2014,Iraq,Jalawla,1,0,1,A captive is executed by the caliphate.
23987,18/8/2014,Nigeria,Maforo,4,0,4,Four people are butchered by Sharia advocates.
23988,18/8/2014,Nigeria,Durwa,6,0,6,Six refugees from an earlier attack are hunted down and killed by Boko Haram.
23989,18/8/2014,Egypt,Gharbiya,1,1,2,Radicals assassinate a police officer.
23990,18/8/2014,Thailand,Yala,2,2,4,"Terrorists target a group of teachers, killing two of their guards."
23991,18/8/2014,Pakistan,Jamrud,2,0,2,Taliban hardliners kill a truck driver and a cleaner.
23992,18/8/2014,Cameroon,Greya,3,15,18,Three civilians are murdered by Boko Haram.
23993,18/8/2014,Pakistan,Karachi,4,0,4,A salesman and an accountant are among four people gunned down for belonging to the wrong branch of Islam.
23994,18/8/2014,Iraq,Tikrit,4,0,4,Four local soldiers are ambushed and killed by Mujahideen.
23995,18/8/2014,Iraq,Albu Jwari,1,0,1,ISIS members cut the throat of an Iraqi.
23996,19/8/2014,Syria,Taftanaz,1,0,1,An American journalists is beheaded by the Islamic State.
23997,19/8/2014,Pakistan,Tangi,6,1,7,Three female teachers and two children are incinerated by a remote-controlled blast.
23998,19/8/2014,Libya,Tripoli,3,8,11,Three people are killed when Islamist militia fire rockets into a residential area.
23999,19/8/2014,Iraq,Hardan,19,2,21,Reports emerge of Islamic State slaughtering nineteen boys and kidnapping two girls from an extended family.
24000,19/8/2014,Pakistan,Karachi,1,0,1,A Quran teacher is picked off by Religion of Peace rivals.
24001,19/8/2014,Pakistan,Karachi,3,0,3,Three policemen are shot to death by fundamentalists.
24002,19/8/2014,Iraq,Baghdad,2,10,12,Two residents are killed when Jihadis send a rocket into their neighborhood.
24003,19/8/2014,Sudan,Port Sudan,1,0,1,A man dies from trauma after a Sharia court flogs him for drinking.
24004,19/8/2014,Iraq,Mosul,1,0,1,A female doctor is murdered after organizing a protest against having to wear the scarf when treating patients.
24005,20/8/2014,Kenya,Lamu,1,0,1,Religion of Peace activists kidnap and behead a Christian.
24006,20/8/2014,Egypt,Sheikh Zuweid,4,0,4,Ansar Beit al-Maqdis members behead four male captives.
24007,20/8/2014,Afghanistan,Uruzgan,3,2,5,A 'gruesome' Taliban bomb attack produces three dead civilians.
24008,20/8/2014,Nigeria,Buni Yadi,2,0,2,Armed fundamentalists invade a small town and execute two people for smoking.
24009,20/8/2014,Syria,Aleppo,3,0,3,Three civilians are pulled in front of a crowd and shot in the head by ISIS.
24010,20/8/2014,Afghanistan,Kabul,1,0,1,A 'foreigner' is brutally stabbed to death.
24011,20/8/2014,Iraq,Kirkuk,2,9,11,Two people lose their lives to a Mujahideen bomb blast.
24012,21/8/2014,Pal. Auth.,Gaza,18,0,18,Eighteen Palestinians are publicly executed and dragged through the streets by Hamas.
24013,21/8/2014,Pakistan,Peshawar,2,0,2,Two truck drivers are murdered by the Taliban.
24014,21/8/2014,Pakistan,Chadrar,1,4,5,One person is killed when Muslim militants throw a grenade into a family home.
24015,22/8/2014,Iraq,Baghdad,8,0,8,Eight Iraqis are reduced to pulp by a suicide bomber.
24016,22/8/2014,Iraq,Tikrit,9,0,9,A Sunni suicide bomber takes out nine Shiites.
24017,22/8/2014,Iraq,Shirqat,12,0,12,A dozen Iraqis are kidnapped and executed by ISIS.
24018,22/8/2014,Iraq,Himreen,5,12,17,A targeted triple-bombing produced five dead Shiites.
24019,22/8/2014,Israel,Sha'ar Hanegev,1,3,4,A 4-year-old boy is taken out by a Hamas rocket.
24020,22/8/2014,Iraq,Baghdad,73,20,93,"Shia militia turn a Sunni mosque into a bloodbath, machine-gunning seventy-three worshippers."
24021,22/8/2014,Israel,Ashdod,1,0,1,An Israeli is killed by an Hamas rocket.
24022,23/8/2014,Afghanistan,Kabul,0,10,10,A suicide bomber detonates along a city street.
24023,23/8/2014,Pakistan,Karachi,1,0,1,Sipah-e-Sahaba gunmen take down a Shiite.
24024,23/8/2014,Pakistan,Sadat Colony,2,0,2,Two Sunnis are murdered in their shop by Shia gunmen.
24025,23/8/2014,Pakistan,Zaman,3,3,6,Three devotees lose their lives when Religion of Peace rivals fire into their shrine.
24026,23/8/2014,Yemen,Shibam,3,6,9,An al-Qaeda ambush kills three local soldiers.
24027,23/8/2014,Iraq,Baghdad,11,24,35,Eleven Iraqis are pulled into pieces by a Fedayeen suicide car bomber.
24028,23/8/2014,Iraq,Kirkuk,31,123,154,Three suicide bombers take out thirty-one patrons in a crowded commercial district.
24029,24/8/2014,Nigeria,Gwoza,35,0,35,Boko Haram releases a video of civilians being executed as the narrator explains that 'Allah commands us to kill without pity'.
24030,24/8/2014,Iraq,Baqubah,2,0,2,ISIS blow up a Shia mosque and kill two people.
24031,24/8/2014,Iraq,Haditha,4,3,7,A Shahid suicide bomber sends four young people to Allah.
24032,24/8/2014,Iraq,Baghdad,7,11,18,Jihadi car bombers take out seven Shiites.
24033,24/8/2014,Syria,Raqqa,150,0,150,One-hundred and fifty Syrian soldiers are captured and beheaded by the Islamic State.
24034,24/8/2014,Nigeria,Taraba,20,85,105,Muslim gunmen kill twenty villagers and burn two churches in a suspected sectarian attack.
24035,25/8/2014,Iraq,Mosul,3,0,3,Three women suspected of prostitution are tortured and shot.
24036,25/8/2014,Kenya,Garissa,1,1,2,A school teacher is murdered by al-Shabaab gunmen.
24037,25/8/2014,Pakistan,Jamrud,2,1,3,Taliban snipers pick off a truck driver and his assistant.
24038,25/8/2014,Nigeria,Ashigashya,3,0,3,Religion of Peace proponents butcher three people in front of a church.
24039,25/8/2014,Iraq,Qayara,3,0,3,Three Iraqis are beheaded by the Islamic State.
24040,25/8/2014,Iraq,Karbala,12,31,43,Sunni bombers massacre a dozen Shiites.
24041,25/8/2014,Iraq,Baghdad,15,21,36,Fifteen patrons at a crowded restaurant are exterminated in mid-bite by two Holy Warrior car bombs.
24042,25/8/2014,Iraq,Shaab,2,10,12,Two patrons at a market are taken out by Jihadi bombers.
24043,25/8/2014,Iraq,Hillah,11,26,37,Two Mujahid car bombs claim the lives of eleven innocents.
24044,25/8/2014,Iraq,Baghdad,15,32,47,A Fedayeen suicide bomber takes out fifteen worshippers at a rival mosque.
24045,25/8/2014,Nigeria,Gambouru,15,3,18,Women and children are among fifteen civilians pulled out of their cars and shot to death by Boko Haram.
24046,25/8/2014,Nigeria,Kafin Hausa,6,0,6,Six people are reported dead after Boko Haram attack two towns and burn a church.
24047,26/8/2014,Iraq,Mosul,5,0,5,Five men are executed with shots to the head after being convicted by a caliphate court.
24048,26/8/2014,Iraq,Baghdad,15,37,52,A Fedayeen suicide bomber takes out fifteen innocents in a Shiite district.
24049,26/8/2014,Iraq,Abbasi,12,0,12,A dozen Iraqis are laid out in a row and machine-gunned by the Islamic State.
24050,26/8/2014,Afghanistan,Farah,1,0,1,A mosque imam is beheaded by the Taliban.
24051,27/8/2014,Bangladesh,Dhaka,1,0,1,A TV personality is tied to a chair and beheaded by a rival cleric.
24052,27/8/2014,Pakistan,Korangi,2,0,2,A doctor is among two Shiites shot to death by sectarian Jihadis.
24053,27/8/2014,Iraq,Habbaniyah,7,2,9,Islamic State militants kill seven Iraqis with a mortar round.
24054,27/8/2014,Iraq,Ramadi,6,0,6,Six family members are killed when religious radicals blow up their house.
24055,27/8/2014,Afghanistan,Aqcha,1,4,5,Young children are among the casualties of a Taliban bomb attack.
24056,28/8/2014,Thailand,Pattani,1,2,3,Muslim terrorists murder a teacher with a bomb.
24057,28/8/2014,Syria,Raqqa,7,0,7,Video emerges of caliphate militants shooting seven kneeling hostages.
24058,28/8/2014,Syria,Raqqa,250,0,250,Video emerges of two-hundred and fifty captives marched into the desert and machine-gunned by the Islamic State.
24059,28/8/2014,Nigeria,Bauchi,2,1,3,A suspected Boko Haram attack leaves two dead.
24060,28/8/2014,Pakistan,Awaran,6,7,13,Six members of a minority religious community are shot to death in their place of worship by suspected Sunni fundamentalists.
24061,28/8/2014,Iraq,Hillah,4,0,4,Four guards at a hospital are shot to death by Muslim terrorists.
24062,28/8/2014,Iraq,Mosul,7,0,7,Seven people are executed on orders of a Sharia court.
24063,28/8/2014,Lebanon,Arsal,1,0,1,A captured Lebanese soldier is beheaded by the Islamic State.
24064,29/8/2014,Yemen,Lahj,2,0,2,al-Qaeda gunmen murder two local officials.
24065,29/8/2014,Iraq,Wahda,6,0,6,Six headless victims are found following the liberation of a town from Islamic State.
24066,29/8/2014,Iraq,Tuz Khurmatu,8,30,38,A brutal terror attack by the Islamic State leaves eight dead.
24067,29/8/2014,Iraq,Mosul,2,0,2,A Shiite and a Kurd are beheaded by the Islamic State.
24068,30/8/2014,Afghanistan,Robaat,12,5,17,"The Taliban stop a bus carrying workers, force them out into a line and machine-gun them in cold blood."
24069,30/8/2014,Iraq,Yousifiya,11,24,35,Eleven Iraqis at a checkpoint are exterminated by a Fedayeen suicide bomber.
24070,30/8/2014,Nigeria,Gamboru Ngala,40,0,40,At least forty more Christians are found hacked to death 'like chickens' by Boko Haram.
24071,30/8/2014,Afghanistan,Jalalabad,6,33,39,A Shahid suicide bomber disassembles six other people.
24072,30/8/2014,Lebanon,Arsal,1,0,1,Another captured Lebanese soldier is beheaded on video.
24073,30/8/2014,Nigeria,Borno,14,215,229,Boko Haram militants spray machine-gun fire into villages while yelling praises to Allah.  At least fourteen are killed.
24074,31/8/2014,Iraq,Saadiya,19,0,19,Nineteen Sunnis are executed for refusing to join the Jihad.
24075,31/8/2014,Pakistan,Sialkot,3,0,3,A man 'honor kills' his wife and two daughters after consulting with other family members.
24076,31/8/2014,Iraq,Jalula,4,24,28,Four Kurds are left dead following a suicide bombing.
24077,31/8/2014,Thailand,Pattani,1,1,2,Militant Muslims shoot a man twice in the head.
24078,31/8/2014,Libya,Benghazi,10,25,35,Ten people are killed when an Islamist militia showers a civilian airport with rockets.
24079,31/8/2014,Syria,Aleppo,1,0,1,A Dutch national is beheaded by ISIS.
24080,31/8/2014,Yemen,Shabwa,6,2,8,Two Shahid suicide bombers take out a half-dozen human beings.
24081,31/8/2014,Somalia,Mogadishu,5,12,17,Five others are killed during a sustained al-Shabaab attack on a prison.
24082,31/8/2014,Iraq,Fallujah,3,13,16,Three civilians are laid out by Islamic State mortars.
24083,31/8/2014,Iraq,Ramadi,37,38,75,Thirty-seven Iraqis are reduced to pulp by a Shahid suicide bomber.
24084,1/9/2014,Iraq,Sinjar,600,0,600,Mass graves unearth at least six-hundred more Yazidi victims of Islamist massacre than previously reported.
24085,1/9/2014,Yemen,Shibam,3,0,3,Three men are tortured and killed by al-Qaeda.
24086,1/9/2014,Nigeria,Bama,59,0,59,Nearly sixty are reported dead following a Boko Haram attack on a large town.
24087,1/9/2014,Iraq,Hawija,6,0,6,Six Iraqi policemen are executed in cold blood by caliphate terrorists.
24088,1/9/2014,Iraq,Bayaa,13,45,58,A pair of Jihad car bombs produce thirteen dead Iraqis.
24089,1/9/2014,Syria,Aleppo,31,0,31,A university professor is among thirty-one people executed over a 10-day stretch by IS Jihadists.
24090,1/9/2014,Egypt,Sinai,4,0,4,Ansar beit al Maqdis behead four more captives.
24091,1/9/2014,Iraq,Bartala,1,0,1,A Christian is tortured and killed by the Islamic State after refusing to convert to Islam.
24092,1/9/2014,Nigeria,Madagali,350,0,350,Over three hundred Christians are reported killed when Boko Haram invade a series of villages.
24093,1/9/2014,Sudan,Kalma,2,4,6,Two women are killed and four children injured during an armed attack on a refugee camp by the Islamic Republic.
24094,2/9/2014,Dagestan,Makhachkala,5,0,5,Muslim militants shoot five people to death and stuff them in a car.
24095,2/9/2014,Pakistan,Waziristan,1,0,1,An off-duty soldier is murdered by al-Qaeda.
24096,2/9/2014,CAR,Nana Bakassa,5,5,10,Muslim rebels shoot five villagers to death.
24097,2/9/2014,Nigeria,Bama,2,0,2,A targeted Islamist attack on a family home leaves two members dead.
24098,2/9/2014,Syria,Taftanaz,1,0,1,A second American journalist is beheaded by the Islamic State.
24099,2/9/2014,Libya,Banghazi,20,36,56,At least twenty others are killed by Ansar al-Sharia.
24100,2/9/2014,Egypt,al-Wefaq,11,2,13,Eleven police officers are blown to bits by a fundamentalist bomb blast.
24101,2/9/2014,Nigeria,Eggon,55,100,155,Muslim 'mercenaries' attack three villages and murder over fifty residents as they also torch a brewery.
24102,2/9/2014,Iraq,Fallujah,3,17,20,"The caliphate sends artillery shells into a neighborhood, killing three residents."
24103,2/9/2014,Nigeria,Bama,120,35,155,Over one-hundred more victims are reported killed during a second Boko Haram attempt to overrun a town.
24104,2/9/2014,Pakistan,Karachi,1,0,1,A 40-year-old Shiite is assassinated in his store by Sunni gunmen.
24105,3/9/2014,Pakistan,Mardan,1,0,1,A Sikh is stabbed to death in a suspected sectarian attack.
24106,3/9/2014,Egypt,al-Arish,1,0,1,A 32-year-old policeman is brutally shot to death by Islamic fundamentalists.
24107,3/9/2014,Iraq,Fallujah,5,13,18,Mujahideen kill five civilians with a rocket barrage.
24108,3/9/2014,Iraq,Ramadi,16,0,16,Sixteen people near a university are kidnapped by the Islamic State and executed.
24109,3/9/2014,Afghanistan,Kunar,7,0,7,Seven local soldiers are ambushed and killed by religious radicals.
24110,4/9/2014,Afghanistan,Ghazni,18,154,172,"Fundamentalists set off a massive truck bomb outside a government office, killing eighteen."
24111,4/9/2014,Iraq,Tikrit,7,17,24,A suicide car bomber lays out seven Iraqis.
24112,4/9/2014,Iraq,Mosul,14,0,14,Fourteen young people are abducted and executed by the Islamic State.
24113,4/9/2014,Iraq,Sulaiman Bek,35,0,35,"The bodies of thirty-five truck drivers, kidnapped months earlier by Sunni militants are discovered in a mass grave."
24114,4/9/2014,Iraq,Karrada,6,17,23,A half-dozen innocents are slain when fundamentalists set off a bomb near alcohol shops.
24115,4/9/2014,Iraq,Baghdad,11,32,43,"Sunnis detonate a car bomb amidst a row of shops and restaurants in a Shiite district, killing eleven."
24116,4/9/2014,Nigeria,Kawuri,30,0,30,Pro-Sharia extremists massacre over thirty villagers.
24117,5/9/2014,Syria,Ashara,1,0,1,A youth is executed and crucified to punish other residents calling for an end to the caliphate.
24118,5/9/2014,Nigeria,Borno,2,0,2,Two family members are murdered when they refuse to turn their 13-year-old over to Boko Haram.
24119,5/9/2014,Pakistan,Rawalpindi,1,0,1,A female polio worker is shot to death in her home.
24120,5/9/2014,Pakistan,Karachi,2,0,2,Two members of the Shia community are gunned down by sectarian Jihadis in separate attacks.
24121,5/9/2014,Iraq,Mosul,6,0,6,"Three women are among six executed by the Islamic State, which include several doctors."
24122,5/9/2014,Iraq,Ameriya,3,9,12,A Fedayeen suicide bomber takes out three people.
24123,6/9/2014,Pakistan,Peshawar,1,0,1,A Sikh is shot to death is shot to death outside his grocery store.
24124,6/9/2014,Yemen,Jawf,20,22,42,Twenty others are reported killed during a sustained assault by Shiite militia.
24125,6/9/2014,Pakistan,Karachi,1,7,8,"The Taliban attack a naval dockyard, killing a sailor."
24126,6/9/2014,Lebanon,Arsal,1,0,1,Another captive is beheaded by caliphate terrorists.
24127,6/9/2014,Pakistan,Azizabad,2,0,2,A prominent Shia and his bodyguard are murdered by Sunni extremists.
24128,6/9/2014,Libya,Warshefana,12,10,22,A dozen people are killed when an Islamist alliance sends shells into a residential neighborhood.
24129,6/9/2014,Nigeria,Gulak,100,0,100,More than a hundred innocents are thought to have been slaughtered during a two day binge by Boko Haram near a Bible college.
24130,7/9/2014,Nigeria,Mbar,4,0,4,Four members of a church are murdered in two attacks by Muslim extremists.
24131,7/9/2014,Nigeria,Michika,60,0,60,'Scores' of young people are rounded up and then forced on to the ground to have their throats slit by Islamists.  Elderly people are also shot at close range.
24132,7/9/2014,Yemen,al-Baida,2,0,2,Two traffic cops are sprayed with bullets by al-Qaeda.
24133,7/9/2014,Pakistan,Sargodha,3,7,10,Three people lose their lives when Religion of Peace rivals fire into a Sufi shrine.
24134,7/9/2014,Iraq,Miqdadiya,2,2,4,Two children are exterminated by a Mujahideen mortar round.
24135,7/9/2014,Iraq,Mosul,40,0,40,Children and a female politician are among forty people reportedly executed by the Islamic State.
24136,7/9/2014,Syria,Aleppo,3,9,12,"ISIS gunmen fire point-blank into a bus, killing three passengers."
24137,7/9/2014,Syria,Aleppo,5,30,35,Five civilians are killed when Islamic State rebels send mortar shells into their neighborhood.
24138,8/9/2014,Somalia,Mogadishu,12,27,39,A dozen people are blown to bits by a Shahid car bomber.
24139,8/9/2014,Afghanistan,Kandahar,3,6,9,Three people are pulled into pieces by a Fedayeen suicide bomber.
24140,8/9/2014,Iraq,Dhuluieh,17,71,88,"Islamic State members pump machine-gun fire and a bomb into a market, killing at least seventeen."
24141,9/9/2014,Iraq,Mosul,1,0,1,A Sunni imam is executed for refusing allegiance to the caliphate.
24142,9/9/2014,Iraq,Mosul,2,0,2,Two women are shot in the back of the head for crimes against Islam.
24143,9/9/2014,Pakistan,Karachi,2,0,2,Sectarian Jihadis shoot a blind man and his nephew to death.
24144,9/9/2014,Nigeria,Baza,24,14,38,Two dozen Nigerians die during an attack by Boko Haram.
24145,9/9/2014,Iraq,Amerli,6,0,6,Several Sunnis are beheaded by Shia militia.
24146,9/9/2014,Iraq,Mosul,5,0,5,Five women are kidnapped and beheaded by the caliphate for 'acting against the religion of Islam' by telling fortunes.
24147,9/9/2014,Syria,Damascus,5,22,27,"Sunni militants send mortars into a Shia suburb, killing five people."
24148,9/9/2014,Yemen,Qattan,4,6,10,Four people are laid out by a Religion of Peace suicide bomber.
24149,9/9/2014,Libya,Benghazi,5,7,12,Five local soldiers are murdered by Majlis al-Shoura.
24150,9/9/2014,CAR,Ngakobo,13,0,13,A priest and three members of his congregation are among thirteen massacred by Muslim 'rebels'.
24151,9/9/2014,Syria,Ram Hamdan,45,5,50,"Islamic State suicide bombers blow up a house hosting a meeting of rivals, killing up to forty-five participants."
24152,10/9/2014,Pakistan,Karachi,1,1,2,A prominent Sunni scholar is shot to death by Religion of Peace rivals.
24153,10/9/2014,Egypt,Ansar beit al Maqdis,1,0,1,A person is kidnapped and beheaded by Ansar beit al Maqdis.
24154,10/9/2014,Pakistan,Damadola,1,0,1,A guard for a polio team is murdered by fundamentalists.
24155,10/9/2014,Pakistan,Sharifabad,1,0,1,A Shiite businessman is shot to death at his shop by sectarian Jihadis.
24156,10/9/2014,Pakistan,Karachi,1,0,1,A Shiite activist is gunned down by Sunni radicals.
24157,10/9/2014,Iraq,Barzak,14,0,14,Fourteen dead Yazidis are found executed by caliphate terrorists.  The victims include children.
24158,10/9/2014,Iraq,Zumar,35,0,35,Yazidi women and children are comprise most of the thirty-five ISIS victims found in a mass grave.
24159,10/9/2014,Iraq,Mosul,31,0,31,Thirty-one police officers are executed for refusing to cooperate with the Islamic State.
24160,10/9/2014,Iraq,Baghdad,6,0,6,Six people are obliterated by a Fedayeen suicide blast.
24161,10/9/2014,Iraq,Baghdad,14,35,49,"Mujahid bomber blow up a pet market, killing over a dozen people and several animals."
24162,10/9/2014,Iraq,Baghdad,5,9,14,A Shahid suicide bomber takes out five Iraqis.
24163,11/9/2014,Philippines,North Cotabato,2,0,2,At least two people  are riddled with bullets by Bangsamoro Islamic gunmen.
24164,11/9/2014,Thailand,Pattani,4,5,9,"Muslim terrorists spray a government building with gunfire, then throw a bomb inside."
24165,11/9/2014,Iraq,Mosul,7,0,7,Seven men are beheaded for speaking out against the Islamic State.
24166,11/9/2014,Thailand,Pattani,1,0,1,Militant Muslims beat a truck driver to death.
24167,11/9/2014,Pakistan,Orangi,2,0,2,Two Shiites are brought down by Sunni gunmen.  One was a doctor in his clinic.
24168,11/9/2014,Pakistan,Tank,1,0,1,Religious extremists murder a peace committee member outside his home.
24169,11/9/2014,Iraq,Baghdad,13,41,54,Two vicious bomb attacks leave thirteen dead.
24170,11/9/2014,Iraq,Najaf,5,12,17,"Jihadi bombers strike a restaurant, taking out five patrons in mid-bite."
24171,11/9/2014,Iraq,Karbalah,3,12,15,"Sunnis blow up a bus stop in a Shia area, killing three commuters."
24172,11/9/2014,Iraq,Diwaniyah,6,16,22,A half-dozen people in a commercial district are laid out by a Mujahideen car bomb.
24173,12/9/2014,Iraq,Rashid,4,0,4,Four brothers are beheaded by the Islamic State for crimes against religion.
24174,12/9/2014,Afghanistan,Badakhshan,6,3,9,A half dozen Afghan soldiers are disintegrated by a Taliban bomb blast.
24175,12/9/2014,Libya,Benghazi,1,0,1,A mosque preacher is gunned down by suspected rivals.
24176,13/9/2014,Iraq,Ghadeer,3,1,4,Three members of a Christian family are taken out by Sunni bombers.
24177,13/9/2014,Nigeria,Ngom,25,16,41,Twenty-five people are machine-gunned at a market by Boko Haram.
24178,13/9/2014,Syria,Aleppo,1,0,1,A British aid worker is beheaded by the Islamic State after being forced to read a statement blaming his own country.
24179,14/9/2014,Nigeria,Bokkos,5,0,5,Two children and two women are among five Christians shot to death by Fulani shouting praises to Allah.
24180,14/9/2014,Pakistan,Bara,2,0,2,A married couple are killed just outside their home by Taliban fundamentalists.
24181,14/9/2014,Iraq,Zab,1,0,1,An engineer is publicly executed by the Islamic State.
24182,14/9/2014,Pakistan,Nasir Bagh,1,0,1,A prayer leader is shot to death for leading police in worship.
24183,14/9/2014,Iraq,Baghdad,5,0,5,Rivals storm the home of a religious figure and murder five members of his family.
24184,14/9/2014,Thailand,Narathiwat,1,1,2,Muslim 'separatists' kill a 50-year-old man and injure his wife on their way back from market.
24185,14/9/2014,Mali,Aguelhoc,1,3,4,A peacekeeper is murdered by Jihadists.
24186,14/9/2014,Iraq,al-Jumasah,8,0,8,Eight Iraqis are rounded-up and executed by the Islamic State for 'plotting against Allah'.
24187,14/9/2014,Pakistan,Spinwam,3,0,3,Three border guards at a remote post are pasted by a Religion of Peace RPG attack.
24188,14/9/2014,Nigeria,Tunari,20,40,60,"Fulani mercenaries attack a Christian village en masse and slaughter over twenty residents, mostly women and children."
24189,14/9/2014,Pakistan,Karachi,1,0,1,A Shiite cleric is shot to death by Sunni radicals while watering his lawn.
24190,14/9/2014,Pakistan,Karachi,1,0,1,A Sunni leader is shot to death by Shiite radicals while sitting outside his store.
24191,15/9/2014,Iraq,Mosul,1,0,1,A Christian who refused to convert to Islam is beaten by the Islamic State and then executed.
24192,15/9/2014,Pakistan,Pishan,1,0,1,One person is killed when fundamentalists open fire on an anti-polio team.
24193,15/9/2014,Afghanistan,Baghlan,1,7,8,A Taliban bomb planted along a city square leaves one dead.
24194,15/9/2014,Pakistan,Dera Ismail Khan,3,0,3,Two brothers and their father are murdered in their home by Sharia advocates.
24195,15/9/2014,Pakistan,Tal,1,2,3,One other person is brought down by a Fedayeen suicide bomber.
24196,15/9/2014,India,Poonch,1,5,6,One person is killed by Muslim bombers.
24197,15/9/2014,Iraq,Mosul,3,0,3,Three young people are executed by the Islamic State.
24198,15/9/2014,Iraq,Baghdad,3,15,18,Three residents are obliterated by a Mujahid car bomb.
24199,15/9/2014,Afghanistan,Shahid Hasas,1,0,1,A cleric is beheaded by fundamentalist rivals.
24200,15/9/2014,Yemen,Jawf,25,0,25,A clash between Sunni and Shia leaves over two dozen dead.
24201,15/9/2014,Pakistan,Swat,3,0,3,Three villagers are shot to death by Islamic terrorists.
24202,16/9/2014,Afghanistan,Kabul,7,20,27,A suicide bomber kills seven people.
24203,16/9/2014,Egypt,Rafah,6,2,8,Six local cops bleed to death following a Religion of Peace bomb blast.
24204,16/9/2014,Israel,Petah Tikva,1,0,1,"Arabs cut the rope holding a Jewish construction worker, sending him to his death."
24205,16/9/2014,Turkey,Bab al-Salam,7,24,31,Terrorists set off a car bomb at a border crossing.
24206,16/9/2014,Afghanistan,Herat,6,6,12,The Taliban shoot six local cops to death.
24207,16/9/2014,Nigeria,Fadan Karshi Daji,33,4,37,Fulani terrorists massacre nearly three dozen villagers.
24208,16/9/2014,Iraq,Fallujah,7,27,34,Two children are among seven killed in two separate attacks by Mujahid terrorists.
24209,16/9/2014,Iraq,Duluiya,7,0,7,Seven woman and children are exterminated by an ISIS rocket.
24210,17/9/2014,Nigeria,Ungwar Ganye,2,15,17,A pastor and one other person are murdered by angry Muslims.
24211,17/9/2014,Nigeria,Fadan-Karshi,12,4,16,"A dozen villagers are burned to death by Muslim terrorists, including the wife of a pastor."
24212,17/9/2014,Iraq,Baghdad,5,20,25,Five civilians are taken out in a series of Jihadi bombings.
24213,17/9/2014,Iraq,Tarmiyah,8,16,24,Eight Iraqis are exterminated by a Fedayeen suicide bomber.
24214,17/9/2014,Iraq,Tikrit,7,0,7,Seven local cops are kidnapped and executed by the Islamic State.
24215,17/9/2014,Pakistan,Sarki,1,0,1,A Shiite is shot to death by Lashker-e-Islam.
24216,17/9/2014,Iraq,Ramadi,7,5,12,"A Shahid suicide bomber detonates on a bridge, sending seven bystanders on to Allah."
24217,17/9/2014,Nigeria,Kano,17,34,51,Two suicide bombers slaughter seventeen innocents at a teacher-training college.
24218,17/9/2014,Libya,Benghazi,9,30,39,Nine others are killed when Ansar al-Sharia attack an airport.
24219,18/9/2014,Mali,Kidal,5,3,8,Five peacekeepers are disassembled by fundamentalist bombers.
24220,18/9/2014,Pakistan,Karachi,1,0,1,A university professor is shot to death after being charged with blasphemy for his liberal views on women.
24221,18/9/2014,Iraq,Baghdad,23,50,73,A suicide bombing is one of three blasts in Shiite districts that lay out two dozen innocents.
24222,19/9/2014,Pakistan,Karachi,2,0,2,Two religious workers are shot to death by sectarian rivals.
24223,19/9/2014,Iraq,Tikrit,12,7,19,Women and children are among a dozen killed when suspected Islamic State militants mortar a residential neighborhood.
24224,19/9/2014,Iraq,Kirkuk,10,14,24,Mujahideen bombers murder ten people outside a shop.
24225,19/9/2014,Iraq,Baghdad,9,23,32,Sunni bombs at two Shiite markets produce nine dead Iraqis.
24226,19/9/2014,Iraq,Mahmoudiyah,3,10,13,Terrorists kill three people with a car bomb at a parking lot.
24227,19/9/2014,Iraq,Karradah,9,18,27,"Sunnis set off a bomb outside a Shiite mosque, laying out nine of their sectarian rivals."
24228,19/9/2014,Afghanistan,Baghlan,6,12,18,Six people outside a mosque are sent straight to Allah by Religion of Peace rivals.
24229,19/9/2014,Lebanon,Arsal,3,0,3,IS militants fire an RPG across the border and kill three Lebanese guards.
24230,19/9/2014,Libya,Benghazi,2,0,2,A blogger and his friend are shot to death by fundamentalists.
24231,19/9/2014,Pakistan,Gadap,1,2,3,A Sunni activist is gunned down by sectarian rivals.
24232,19/9/2014,Yemen,Sanaa,50,0,50,Another fifty people are reported dead in attacks by Shiite radicals on the capital city.
24233,19/9/2014,Thailand,Pattani,1,0,1,Muslim terrorists open fire on a 58-year-old man.
24234,19/9/2014,Nigeria,Mainok,36,16,52,Thirty-six bodies are counted after Islamists pour heavy weapons fire into a market.
24235,19/9/2014,Cameroon,Ganse,4,0,4,Four civilians are riddled with bullets by Boko Haram.
24236,19/9/2014,Pakistan,Karachi,1,0,1,A Shiite banker is shot to death in front of his children by Sunni radicals.
24237,20/9/2014,Libya,Benghazi,8,0,8,Eight people are assassinated by Ansar al-Sharia in a series of attacks.
24238,20/9/2014,Somalia,Mogadishu,2,1,3,Two people are murdered by al-Shabaab gunmen.
24239,20/9/2014,Lebanon,Arsal,1,0,1,A Lebanese hostage is executed in captivity by the Nusra Front.
24240,20/9/2014,Lebanon,Khraybeh,3,3,6,A suicide bomber kills at least three people.
24241,20/9/2014,Egypt,al-Arish,1,0,1,A kidnap victim is beheaded by Ansar Bait al-Maqdis.
24242,21/9/2014,Libya,Derna,12,4,16,Militant Islamists kill a dozen people.
24243,21/9/2014,Egypt,Cairo,3,6,9,Fundamentalist bombers transform three police officers into a puddle of blood.
24244,21/9/2014,Iraq,Sijir,89,43,132,A series of suicide bombings leave eighty local soldiers dead.
24245,21/9/2014,China,Xinjiang,10,54,64,Ten people lose their lives to a series of Muslim bombings.
24246,21/9/2014,Cameroon,Tourou,19,0,19,Boko Haram machine-gun nineteen civilians at a market.
24247,21/9/2014,Pakistan,Punjab,2,1,3,The caretaker of a mosque is among two people gunned down by sectarian rivals.
24248,21/9/2014,Iraq,Mosul,7,0,7,Seven civilians are executed by the Islamic State.
24249,21/9/2014,Iraq,Baghdad,3,7,10,Three Shiites are taken out by Sunni bombers.
24250,21/9/2014,Iraq,Baghdad,4,11,15,"Jihadis set off a bomb along a commercial street, laying out four patrons."
24251,21/9/2014,Iraq,Baghdad,6,17,23,A 12-year-old boy is among a half-dozen victims who bleed to death following a Mujahid mortar attack.
24252,21/9/2014,Iraq,Tikrit,7,43,50,A targeted rocket attack on dozens of houses leaves at least five women and two children dead.
24253,21/9/2014,Iraq,Tigris,7,3,10,Seven civilians lose their lives to ISIS militants.
24254,22/9/2014,Pakistan,Hangu,4,0,4,"Islamic militants open fire from a passing car, killing four people including a child."
24255,22/9/2014,Iraq,Saqlawiya,300,102,402,Three hundred Iraqi soldiers are reported dead following a chlorine gas attack by the Islamic State.
24256,22/9/2014,Iraq,Diyala,4,0,4,Four Kurds are discovered and quickly executed by the caliphate.
24257,22/9/2014,Iraq,Baghdad,12,25,37,A vicious bomb attack by Sunnis claims the lives of a dozen innocents.
24258,23/9/2014,Pakistan,Peshawar,5,29,34,A child is among five people disassembled by a Fedayeen suicide blast.
24259,23/9/2014,Pakistan,Mirpurkhas,1,0,1,An Ahmadi doctor is brutally murdered in his clinic by Sunni extremists.
24260,23/9/2014,Iraq,Duluiya,3,0,3,Two women and a child are taken out by Mujahideen bombers.
24261,23/9/2014,Iraq,Sadr City,18,41,59,Sunnis slaughter eighteen Shiites with a car bomb.
24262,23/9/2014,Nigeria,Nasarawa,10,0,10,Ten people are riddled with bullets in their own homes by Fulani terrorists.
24263,23/9/2014,Pakistan,Peshawar,3,9,12,Three people are laid out when Islamists bomb a railway station.
24264,23/9/2014,Afghanistan,Ghazni,1,0,1,"A 56-year-old Australian is kidnapped, tortured and killed by Sunni fundamentalists."
24265,24/9/2014,Syria,Kobani,2,0,2,A mother and 8-year-old daughter are raped and murdered by caliphate members.
24266,24/9/2014,Syria,Kobani,1,0,1,An 85-year-old man is beheaded by Islamic State militants.
24267,24/9/2014,Nigeria,Shaffa,20,0,20,"A pastor is among twenty villagers massacred by Boko Haram, which also burned ten churches."
24268,24/9/2014,Mali,Zouera,1,0,1,al-Qaeda linked militants cut off a man's head and sit it on a market stall.
24269,24/9/2014,Iraq,Babilan,19,39,58,Nineteen people are ambushed and killed by the Islamic State.
24270,24/9/2014,Thailand,Pattani,1,0,1,A 47-year-old woman is shot to death by Muslim 'insurgents'.
24271,24/9/2014,Australia,Melbourne,0,2,2,An ISIS fan stabs two police officers.
24272,24/9/2014,Iraq,Baiji,9,0,9,At least nine others are killed during a suicide attack on a refinery.
24273,24/9/2014,Iraq,Tikrit,12,8,20,A dozen Iraqis are crushed by ISIS shelling.
24274,24/9/2014,Algeria,Djurdjura,1,0,1,Fundamentalists behead a captured French tourist.
24275,25/9/2014,Israel,Ramle,1,0,1,A mother of six is honor killed by her conservative Islamic family.
24276,25/9/2014,Afghanistan,Ghazni,15,0,15,Women and children are among fifteen locals are beheaded by the Taliban.
24277,25/9/2014,Pakistan,Rawalpindi,1,1,2,A policeman shoots a Christian pastor to death who was in jail for a false charge of blasphemy.
24278,25/9/2014,Pakistan,Karachi,2,7,9,Jundollah terrorists kill two civilians with a roadside bomb.
24279,25/9/2014,Iraq,Mosul,1,0,1,A female human rights attorney is tortured and publicly executed by the caliphate for 'apostasy'.
24280,25/9/2014,Afghanistan,Maimana,1,18,19,A bicycle bomb at a bazaar leaves one patron dead.
24281,25/9/2014,USA,"Moore, OK",1,1,2,A Sharia advocate beheads a woman while shouting Islamic slogans.
24282,25/9/2014,Pakistan,Hayatabad,1,0,1,A Shiite bank employee is murdered outside his own house by sectarian rivals.
24283,25/9/2014,Iraq,Yathrib,2,0,2,Two shepherds are executed by the Islamic State.
24284,25/9/2014,Iraq,Mahmoudiya,5,23,28,"Two Mujahid car bomb blasts, one near a hospital, produce five corpses."
24285,25/9/2014,Iraq,Rutbah,2,0,2,A man and woman are tied up and slowly pelted with rocks for adultery by Sharia enthusiasts.
24286,25/9/2014,Iraq,Kobani,40,0,40,At least forty people are killed by an IS suicide bomber in a truck disguised as an aid vehicle.
24287,26/9/2014,Somalia,Barawe,1,0,1,A woman who 'married several husbands' is buried up to her neck and stoned to death.
24288,26/9/2014,Pakistan,Daweezi,3,0,3,Three peace committee members are taken out in a targeted blast by Tehreek-e-Taliban.
24289,26/9/2014,Afghanistan,Ghazni,100,0,100,Over one-hundred people are reported killed by an Islamic fundamentalist assault on their villages.
24290,26/9/2014,Iraq,Kobani,50,50,100,At least fifty people are reported dead during a massive ISIS assault on a Kurdish town.
24291,27/9/2014,Iraq,Baghdad,4,0,4,A Christian mother and her three sons are murdered in their home by suspected Islamists.
24292,27/9/2014,Nigeria,Makurdi,12,3,15,"Fulani terrorists attack a village, kill a dozen people and rape several women."
24293,27/9/2014,Jordan,Amman,1,0,1,A 17-year-old girl's skull is smashed with a stone upon suspicion that she is having sex.
24294,27/9/2014,Iraq,Tuz Khormato,3,10,13,Three young men at a sporting event are disassembled by a Mujahid bomb blast.
24295,27/9/2014,Iraq,Tikrit,13,4,17,Five women and eight children are taken apart by ISIS mortar shells.
24296,27/9/2014,Iraq,Mahmudiyah,12,24,36,A dozen Iraqis are incinerated in a Jihad car bomb blast.
24297,28/9/2014,Yemen,Marib,15,25,40,An al-Qaeda suicide bomber slaughters fifteen Shiites outside a hospital.
24298,28/9/2014,Pakistan,Jawzjan,5,3,8,Five policemen are cut down by Taliban terrorists.
24299,28/9/2014,Pakistan,Hangu,8,14,22,Islamic militants blow up eight innocents near a refugee camp.
24300,28/9/2014,Yemen,al-Baida,6,0,6,A Shiite family of six is exterminated by Ansar al-Sharia.
24301,28/9/2014,Algeria,Telagh,2,0,2,Two guards at a power plant are murdered by armed fundamentalists.
24302,28/9/2014,Pakistan,Mattani,1,1,2,One person loses his life to a targeted shooting by the Taliban outside a family home.
24303,28/9/2014,Iraq,Mosul,4,0,4,Four young people are executed following a ruling by a Sharia court.
24304,28/9/2014,Iraq,Baiji,21,0,21,Twenty-one worshippers are reported dead following a bombing at a mosque.
24305,28/9/2014,Iraq,Shirqat,6,0,6,Six police officers are executed by the Islamic State.
24306,29/9/2014,Somalia,Beledweyn,1,0,1,A respected cleric is assassinated by rival extremists.
24307,29/9/2014,Nigeria,Michika,40,0,40,"At least forty people, including children and elderly, are reported dead following a 'merciless' Boko Haram attack on two small villages."
24308,29/9/2014,Sudan,Khartoum,1,0,1,A Spanish diplomat is stabbed to death by suspected Islamists.
24309,29/9/2014,Iran,Tehran,1,0,1,A 37-year-old man is put to death for holding 'heretical' religious beliefs.
24310,29/9/2014,Pakistan,Tirah,5,3,8,Five people are killed when Islamists bomb the home of a rival.
24311,29/9/2014,Pakistan,Charsadda,2,0,2,Two conservative families team up to kill a couple of young lovers.
24312,29/9/2014,Afghanistan,Kabul,7,13,20,A Shahid suicide bomber takes out seven civilians.
24313,29/9/2014,Iraq,Riyadh,7,0,7,Seven Iraqis are decapitated by the Islamic State.
24314,29/9/2014,Iraq,Tikrit,5,0,5,ISIS kidnap five policemen and murder them execution-style.
24315,29/9/2014,Afghanistan,Paktia,8,10,18,Suicide bombers sent eight Afghans to Allah.
24316,29/9/2014,Saudi Arabia,Awamiya,1,0,1,Militant Shiites gun down a cop.
24317,30/9/2014,Syria,Kobane,9,0,9,"Three women are among nine Kurds beheaded by the caliphate, which places the heads on display."
24318,30/9/2014,Georgia,Pankisi Gorge,0,1,1,A woman is stabbed in the breast by her fundamentalist brother for not wearing a hijab.
24319,30/9/2014,Iraq,Khanaqin,4,12,16,Four Kurds are ripped to shreds by an Islamic State bombing.
24320,30/9/2014,Iraq,Iskandariyah,5,13,18,A Religion of Peace bomb blast produces five dead Iraqis.
24321,30/9/2014,Iraq,Karbala,8,13,21,Eight people are taken apart by a Sunni car bomb in a Shiite city.
24322,30/9/2014,Iraq,Baghdad,5,15,20,"Terrorists fire mortars into a neighborhood, killing five residents."
24323,30/9/2014,Iraq,Baghdad,20,35,55,Two Mujahideen car bombs a long a packed street leaves at least twenty dead civilians.
24324,1/10/2014,Pakistan,Shabqadar,1,2,3,A female teacher is killed and two students injured when fundamentalists throw a grenade into the school after warnings over the girl's dress code.
24325,1/10/2014,Syria,Homs,45,74,119,Over forty children are among dozens obliterated when a suicide bomber follows a car bombing near a Shiite school and hospital.
24326,1/10/2014,Iraq,Jubur,7,30,37,Seven villagers are killed during an ISIS assault on their town.
24327,1/10/2014,Afghanistan,Kabul,8,21,29,Eight people are pulled into pieces by a Fedayeen suicide bomber.
24328,1/10/2014,Iraq,Baghdad,7,24,31,Seven Iraqis are sent to Allah by a Shahid suicide bomber.
24329,1/10/2014,Iraq,Baghdad,15,40,55,"Religious extremists target a pet and vegetable market with a car bomb, ending the lives of fifteen patrons."
24330,1/10/2014,Pakistan,Karachi,1,0,1,A Sunni is gunned down by sectarian rivals.
24331,1/10/2014,Syria,Kobani,1,0,1,A civilian is captured and beheaded by caliphate terrorists.
24332,2/10/2014,Nigeria,Kano,1,0,1,Radicals capture and stone a man to death for adultery.
24333,2/10/2014,Iraq,Hit,42,32,74,Over forty others lose their lives when a town is overrun by ISIS.
24334,2/10/2014,Libya,Banghazi,7,48,55,Seven security personnel are killed by a suicide bomber at an airport and a separate shooting.
24335,2/10/2014,Pakistan,Peshawar,7,6,13,Seven people incinerated by a Religion of Peace bomb blast in a minivan.
24336,2/10/2014,Libya,Benghazi,29,70,99,Two more suicide bombings take out thirty more security personnel at an airport.
24337,2/10/2014,Pakistan,Haramosh,3,10,13,"Sunnis bomb a bus full of Shiites, killing three."
24338,2/10/2014,Afghanistan,Kabul,3,7,10,A suicide attack on a bus leaves three dead.
24339,2/10/2014,Nigeria,Fang,3,0,3,Three people are killed by Muslim terrorists.
24340,3/10/2014,Nigeria,Dum,2,0,2,Two people lose their lives to Muslim terrorists.
24341,3/10/2014,Iraq,Kobani,1,0,1,Religion of Peace proponents cut off a woman's head.
24342,3/10/2014,Nigeria,Bachit,13,0,13,Thirteen villagers are massacred by Fulani terrorists.
24343,3/10/2014,Mali,Gao,9,0,9,"Nine peacekeepers are burned to a crisp when Jihadists ambush their fuel truck - calling them ""enemies of Islam."""
24344,3/10/2014,Iraq,Beiji,2,0,2,Two pilots are killed when Muslim terrorists shoot down an Iraqi helicopter.
24345,3/10/2014,Nigeria,Yola,1,0,1,Boko Haram beheads a captured Nigerian pilot.
24346,3/10/2014,Iraq,Mosul,1,0,1,A British aid worker is beheaded by the Islamic State for being non-Muslim.
24347,3/10/2014,Libya,Benghazi,12,45,57,An Ansar al-Sharia attack leaves a dozen security personnel dead.
24348,3/10/2014,Nigeria,Michika,70,0,70,A 99-year-old man is among 70 residents of three villages massacred by Boko Haram Islamists.
24349,4/10/2014,Pakistan,Swat,2,0,2,Two men are shot to death by the Taliban.
24350,4/10/2014,Pakistan,Quetta,5,30,35,Women and children are among the casualties when a suicide bomber targets a minority religious center.
24351,4/10/2014,Pakistan,Kohat,6,17,23,"Religious extremists throw a bomb into a bus stop, killing six bystanders, including a child."
24352,4/10/2014,Pakistan,Karachi,2,0,2,Two Shia minorities are shot to death by Ahl-e-Sunnat-Wal-Jamaat.
24353,4/10/2014,Pakistan,Hafizabad,1,0,1,Sipah-e-Sahaba gunmen pick off a Shiite school teacher.
24354,4/10/2014,Iraq,Baiji,12,24,36,"A Shahid suicide bomber takes out a dozen innocents, including women and children."
24355,4/10/2014,Iraq,Tarmiya,7,18,25,Jihad bombers claim seven lives.
24356,4/10/2014,Iraq,Mansouriya,4,14,18,Four Iraqis are killed by Mujahideen.
24357,4/10/2014,Libya,Benghazi,4,5,9,Four security personnel are killed during an Ansar-al-Sharia assault on an airport.
24358,5/10/2014,Nigeria,Sharbutu,3,0,3,Fulani terrorists massacre three villagers.
24359,5/10/2014,Iraq,Hit,6,0,6,Caliphate representatives line up six hostages and machine-gun them in turn.
24360,5/10/2014,Iraq,Anbar,6,0,6,Six Iraqis are publicly executed by the caliphate.
24361,5/10/2014,Iraq,Mosul,14,0,14,Fourteen civilians are shot to death for refusing to fight for the Islamic State.
24362,5/10/2014,Egypt,Sinai,4,0,4,Four gentlemen are beheaded on video by the pro-Sharia group Ansar Beit al-Maqdis.
24363,5/10/2014,Chechnya,Grozny,5,12,17,Five people are sectionalized by a Fedayeen suicide bomber.
24364,5/10/2014,DRC,Beni,7,14,21,ADF-Nalu militants murder seven locals.
24365,6/10/2014,Somalia,Jazeera,2,0,2,Two people are shot to death at the beach by al-Shabaab.
24366,6/10/2014,Egypt,Sheikh Zuweid,1,0,1,A 13-year-old boy is vaporized by a Religion of Peace bomb blast.
24367,6/10/2014,Syria,Hasakah,30,35,65,Thirty Kurds lose their lives to two Shahid suicide blasts.
24368,6/10/2014,Cameroon,Amchide,8,24,32,"Pro-Sharia militants fire a rocket into a town, killing eight residents."
24369,6/10/2014,Nigeria,Ngambi,7,0,7,Seven people are beheaded by Boko Haram Islamists.
24370,6/10/2014,Libya,Banghazi,5,0,5,A man and his son are among five gunned down by suspected Ansar al-Sharia.
24371,7/10/2014,Nigeria,Shonong,6,0,6,Six people are murdered by Fulani terrorists.
24372,7/10/2014,Pakistan,Quetta,2,3,5,Attacks on two Hazara mosques leaves two dead.
24373,7/10/2014,Lebanon,Shebaa,0,2,2,A Hezbollah bomb injures two Israelis.
24374,7/10/2014,Iraq,Alam,2,0,2,Two hostages are executed by their ISIS captors.
24375,7/10/2014,Iraq,Diyala,1,0,1,A woman is executed by ISIS for crimes against Islam.
24376,7/10/2014,Iraq,Samarra,8,10,18,A Fedayeen suicide bombing claims the lives of eight innocents.
24377,7/10/2014,Iraq,Hit,3,3,6,Three people are sent to Allah by a Shahid suicide bomber.
24378,7/10/2014,Iraq,Mosul,4,0,4,Four young men are shot in the back of the head by Islamic State executioners.
24379,7/10/2014,Iraq,Baquba,12,0,12,A suicide bomber takes out a dozen Iraqis.
24380,7/10/2014,Iraq,Baghdad,13,31,44,Thirteen people are pulled into pieces by a Mujahid car bombing along a busy street.
24381,7/10/2014,Mali,Kidal,1,0,1,"Terrorists fire a rocket a UN camp, killing a peacekeeper."
24382,7/10/2014,Libya,Derna,1,0,1,A politician denounces Islamists and is quickly gunned down.
24383,7/10/2014,Iraq,Jalawla,5,0,5,Five people are killed by ISIS.
24384,7/10/2014,Pakistan,Karachi,2,0,2,Two Sunnis are gunned down by sectarian rivals.
24385,7/10/2014,Iraq,Abbasiya,17,13,30,A Shahid suicide car bomber rams into a house and snuffs out seventeen lives.
24386,7/10/2014,Pakistan,Jamrud,1,0,1,Islamists burn down two primary schools and kill a retired policeman.
24387,7/10/2014,Pakistan,Garhi Kapura,2,0,2,A young couple is killed by the girl's conservative brother on suspicion of sex.
24388,8/10/2014,Libya,al-Aziziya,8,3,11,Eight occupants are killed when an Islamist militia sends a rocket into a mosque.
24389,8/10/2014,Pakistan,Safi,2,1,3,Fundamentalist bombers murder two polio workers.
24390,8/10/2014,Yemen,Baida,10,9,19,An al-Qaeda suicide car bomber takes out ten local cops.
24391,8/10/2014,Afghanistan,Lashkar Gah,5,19,24,At least five people lose their lives to a suicide car bomber in a residential neighborhood.
24392,8/10/2014,Afghanistan,Paktika,2,0,2,"A prayer leading imam suffers premature detonation, blowing up both himself and his mother."
24393,8/10/2014,Philippines,North Catabato,2,7,9,A nurse and teacher bleed to death after Islamists throw a hand grenade into a Church of Christ.
24394,8/10/2014,Iraq,Mosul,2,0,2,Two female doctors are executed by the caliphate.
24395,8/10/2014,Iraq,Tal Afar,1,0,1,A female politician is murdered by the Islamic State and thrown down a well.
24396,8/10/2014,Iraq,Sadr City,10,25,35,"Sunnis set off a car bomb near a cafe in a Shiite neighborhood, ending the lives of ten innocents."
24397,9/10/2014,Libya,Benghazi,14,0,14,Fourteen defenders are killed when Islamists stage another assault on the airport.
24398,9/10/2014,Iraq,Baquba,10,11,21,A Fedayeen suicide bomber takes out ten Iraqis.
24399,9/10/2014,Yemen,Mukalla,20,15,35,An al-Qaeda suicide bomber takes twenty others with him.
24400,9/10/2014,Yemen,Sanaa,47,75,122,Fifty people are reduced to pulp by a Shahid suicide bomber targeting Shiites at a rally.
24401,9/10/2014,Iraq,Baghdad,2,8,10,"Jihadis bomb a market, killing two patrons."
24402,9/10/2014,Iraq,Sfiftah,9,13,22,Nine people are disintegrated by a suicide truck bomber.
24403,9/10/2014,Nigeria,Bachi,27,0,27,Twenty-seven people are murdered in a series of Boko Haram attacks on defenseless villages.
24404,9/10/2014,Kenya,Mombasa,1,0,1,Sharia advocates shoot a guard at a casino several times at close range.
24405,9/10/2014,Bangladesh,Nawdabash,1,4,5,"Angry Muslims rampage a Hindu village, killing one person and burning houses."
24406,10/10/2014,DRC,Oicha,9,0,9,Children are among nine people killed by an Islamist group.
24407,10/10/2014,China,Guma,6,0,6,Six people are stabbed to death by a Muslim duo in two separate attacks.
24408,10/10/2014,Pakistan,Millat,2,0,2,A conservative family 'honor kills' a couple for marrying without permission.
24409,10/10/2014,Iraq,Samra,4,0,4,Two journalists are among four civilians publicly executed by the caliphate
24410,10/10/2014,Iraq,Hawija,6,0,6,Six people are publicly executed by the Islamic State.
24411,10/10/2014,Yemen,Sanaa,14,0,14,An al-Qaeda video shows the brutal execution of fourteen 'apostates' by knife-waving Allah praisers.
24412,10/10/2014,Iraq,Mosul,1,0,1,A female lawyer is pulled from her home and murdered by the caliphate.
24413,10/10/2014,Iraq,Baiji,3,0,3,Three men are beheaded by the Islamic State.
24414,10/10/2014,Nigeria,Lwa,7,0,7,"Fulani terrorists burn down a church and kill seven people, including a pregnant woman."
24415,11/10/2014,Pakistan,Khoshta,1,1,2,"Sunnis bomb a vehicle carrying Shias, killing the driver."
24416,11/10/2014,Afghanistan,Lashkar Gah,2,5,7,Two local cops are blown to bits by a Shahid suicide bomber.
24417,11/10/2014,Iraq,Tarmiyah,11,21,32,The lives of eleven are cruelly snuffed out by a Fedayeen suicide bomber at an outdoor market.
24418,11/10/2014,Yemen,Shibam,3,3,6,Three local cops are exterminated by religious extremists.
24419,11/10/2014,Syria,Kobani,20,0,20,"Twenty civilians are reported killed by the Islamic State, including seventeen execution victims."
24420,11/10/2014,Nigeria,Shonong,6,0,6,A half-dozen businessmen are ambushed and murdered by Fulani terrorists.
24421,11/10/2014,Iraq,Tikrit,27,32,59,The caliphate is thought responsible for a double bombing that leaves over two dozen dead.
24422,11/10/2014,Iraq,Meshahda,14,27,41,Women and children are among the casualties of a barbaric Fedayeen suicide bombing.
24423,11/10/2014,Iraq,Shula,18,41,59,"A suicide bomber detonates near the site of an earlier bombing, killing eighteen, including first responders."
24424,11/10/2014,Iraq,Shula,8,24,32,"Sunnis detonate a powerful car bomb outside an ice cream shop in a Shiite area, exterminating eight patrons."
24425,11/10/2014,Iraq,Khazimiyah,13,28,41,A suicide bomber takes out over a dozen Iraqis.
24426,12/10/2014,China,Maralbeshi,22,0,22,Four Muslim terrorists armed with knives hack twenty-two innocents to death at a farmer's market.
24427,12/10/2014,Afghanistan,Wardak,6,8,14,A half dozen locals are cut to pieces by a suicide car bomber.
24428,12/10/2014,Afghanistan,Alishing,3,0,3,Three construction workers are murdered by a Taliban rocket attack.
24429,12/10/2014,Afghanistan,Monogai,3,3,6,Religious extremists ambush and kill three Afghans.
24430,12/10/2014,Afghanistan,Mazar-e-Sharif,2,18,20,Two police officers are picked off by Taliban gunmen who wore police uniforms to gain advantage.
24431,12/10/2014,Somalia,Mogadishu,6,3,9,A half dozen people are disassembled by an Islamist car bomb.
24432,12/10/2014,Iraq,Qara Tappah,58,107,165,Three caliphate suicide bombers massacre sixty Kurds.
24433,12/10/2014,Syria,Kobani,1,0,1,A child is reportedly beheaded by ISIS for touching a Quran.
24434,12/10/2014,Libya,Benghazi,1,1,2,A suspected Ansar al-Sharia car bomb leaves one dead.
24435,12/10/2014,Syria,Kobani,2,0,2,An English teacher and a child are beheaded by caliphate militants.
24436,12/10/2014,Libya,Kikla,23,43,66,Two dozen people are killed when rival Islamist groups work out differences.
24437,12/10/2014,Iraq,Diyala,2,1,3,Two children are disassembled by Islamic State mortars.
24438,12/10/2014,Iraq,Baqubah,6,10,16,Sunni extremists set off two bombs at a market that produce a half-dozen dead shoppers.
24439,13/10/2014,China,Xinjiang,1,0,1,A pregnant police officer is stabbed to death by suspected Islamists.
24440,13/10/2014,Somalia,Mogadishu,13,2,15,Thirteen people at a cafe are obliterated by pro-Sharia bombers.
24441,13/10/2014,Afghanistan,Laghman,22,15,37,Religious extremists attack a local security patrol and kill twenty-two members.
24442,13/10/2014,Pakistan,Peshawar,2,0,2,"Suspected Islamists fire at a man and woman in a car, killing them both."
24443,13/10/2014,Afghanistan,Kabul,1,3,4,A suicide car bomber kills one civilian.
24444,13/10/2014,Afghanistan,Nangarhar,2,6,8,Two civilians are killed by a Religion of Peace suicide bomber.
24445,13/10/2014,India,Kupwara,1,0,1,Muslim terrorists murder a local soldier.
24446,13/10/2014,Iraq,Samarrah,4,5,9,Four Iraqis are gunned down by Islamic State militants.
24447,13/10/2014,Iraq,Balad,13,0,13,Thirteen ISIS execution victims are discovered.
24448,13/10/2014,Iraq,Sadr City,6,24,30,Six people at a market are laid out by a Mujahid bomb blast.
24449,13/10/2014,Iraq,Baghdad,16,30,46,Jihadi bombers claim the lives of sixteen innocents.
24450,13/10/2014,Iraq,Baghdad,22,41,63,Twenty-two people are reduced to pulp by a Holy Warrior with a suicide vest.
24451,14/10/2014,Afghanistan,Baraki,6,0,6,Six local cops are murdered by the Taliban.
24452,14/10/2014,Afghanistan,Kunar,1,1,2,A woman is shot to death by Sharia extremists.
24453,14/10/2014,Afghanistan,Badi Sambor,0,1,1,A student is injured when fundamentalists bomb a girls' school.
24454,14/10/2014,Iraq,Kadhimiyah,21,51,72,A horrific caliphate suicide attack leaves twenty-one dead.
24455,14/10/2014,Iraq,Babil,35,0,35,Thirty-five victims of Muslim terror are found in laying in an open field.
24456,14/10/2014,Iraq,Mosul,4,0,4,Two children are among a family of four exterminated by caliphate bombers.
24457,14/10/2014,Iraq,Mosul,3,0,3,Two women and a journalist are executed by the Islamic State with shots to the head.
24458,14/10/2014,Iraq,Baghdad,4,11,15,The lives of four people are cut tragically short by a Jihadi bomber.
24459,15/10/2014,Syria,Idlib,35,0,35,An Ahrar al-Sham bomb blast reported kills three dozen people.
24460,15/10/2014,Libya,Benghazi,4,8,12,At least four others are killed during an attack by Ansar al-Sharia.
24461,15/10/2014,Egypt,Cairo,0,12,12,A child is among the casualties of a terrorist bombing.
24462,15/10/2014,Pakistan,Tirah,7,5,12,Two children are among seven torn to shreds by a Lashkar-e-Islam suicide bomber.
24463,15/10/2014,Somalia,Mogadishu,5,8,13,"Islamists bomb a restaurant, killing five patrons and bystanders."
24464,15/10/2014,Somalia,Mogadishu,2,0,2,Two people are killed by an al-Shabaab car bomb.
24465,15/10/2014,Afghanistan,Khost,8,5,13,Eight security personnel are laid out during a Fedayeen suicide assault.
24466,15/10/2014,Afghanistan,Kabul,2,3,5,Two civilians are aerated by Religion of Peace shrapnel.
24467,15/10/2014,Pakistan,Safi,1,1,2,"Religious extremists fire on a group of villagers, killing one."
24468,16/10/2014,Sudan,Heiban,9,17,26,Five children from the same family are among nine disassembled by a targeted Islamic Republic bombing of a Christian village.
24469,16/10/2014,DRC,Beni,26,0,26,Twenty-six villagers expire after being set upon with machetes by Islamists.
24470,16/10/2014,DRC,Beni,26,50,76,Over two dozen people are hacked to death by an Islamist group.
24471,16/10/2014,Afghanistan,Farah,4,0,4,Four women are kidnapped by fundamentalists and shot to death for adultery.
24472,16/10/2014,Iraq,Tikrit,11,0,11,Eleven victims of sectarian executioners are discovered.
24473,16/10/2014,Iraq,Tikrit,17,3,20,Women and children are among the members of two families blown up in the middle of the night while sleeping.
24474,16/10/2014,Iraq,Mosul,1,0,1,A female university professor is beheaded in front of her children by the caliphate.
24475,16/10/2014,Pakistan,Karachi,1,0,1,A Shia grocery owner is sitting outside his shop when he is picked off in a Sunni drive-by.
24476,16/10/2014,Pakistan,Rahim Yar Khan,1,1,2,"Sipah-e-Sahaba gunmen fire at a Shia, killing him and injuring his boy."
24477,16/10/2014,Pakistan,Faisalabad,1,0,1,A Shiite is tortured to death by Sunnis in an extra-judicial prison killing.
24478,16/10/2014,Yemen,Udain,5,0,5,"al-Qaeda militants overrun a small town, killing five defenders."
24479,16/10/2014,Iraq,Baghdad,3,4,7,"The Islamic State sets off a bomb near shops, killing three bystanders."
24480,16/10/2014,Iraq,Mahmoudiya,7,12,19,A Sunni car bomb in a Shiite area leaves seven dead.
24481,16/10/2014,Iraq,Shula,6,18,24,"The caliphate sends mortar rounds into a residential neighborhood, killing six."
24482,16/10/2014,Iraq,Hurriyah,6,16,22,A half dozen civilians are laid out by an IS car bomb in a shopping district.
24483,16/10/2014,Iraq,Talibiyah,12,28,40,A dozen people are torn to shreds by a Shahid suicide bomber.
24484,16/10/2014,Iraq,Baghdad,14,34,48,"Two car bombs detonate in a Shia commercial district, claiming fourteen lives."
24485,16/10/2014,Egypt,al-Arish,3,11,14,Three police officers are killed when Ansar al-Maqdis fire a grenade into a bus.
24486,16/10/2014,Pakistan,Attock,1,0,1,A 62-year-old religious minority is shot to death outside his home by radical Sunnis.
24487,16/10/2014,Afghanistan,Bahglan,2,0,2,Two lawyers lose their lives to a Taliban bomb.
24488,16/10/2014,Egypt,Tanta,0,11,11,Bombs at a festival wound eleven people.
24489,16/10/2014,Syria,al-Bukamal,2,0,2,Two people are publicly beheaded by the caliphate.  One was 15-years-old.
24490,16/10/2014,Nigeria,Sabon-Gida,10,0,10,Muslim terrorists kill ten villagers and burn fifty homes.
24491,17/10/2014,India,Maharashtra,1,0,1,A woman is assaulted and set on fire for defying a local fatwa.
24492,17/10/2014,Syria,al-Bab,1,0,1,"The caliphate crucifies a 17-year-old boy for apostasy, quoting verse 5:33 of the Quran."
24493,17/10/2014,Lebanon,Akkar,1,0,1,al-Nusra snipers are suspected of shooting a teenager riding a military bus.
24494,17/10/2014,Syria,Kobani,1,0,1,Video captures the beheading of a very young Alevi girl at the hands of the caliphate because of her status as a religious minority.
24495,17/10/2014,Nigeria,Zhur,7,0,7,Boko Haram slaughter seven innocent people.
24496,17/10/2014,Nigeria,Abadam,1,0,1,An Islamist attack on a village leaves one dead.
24497,17/10/2014,Iraq,Karrada,9,27,36,"Caliphate members set off a car bomb near a theater, killing nine."
24498,17/10/2014,Iraq,Baghdad,7,12,19,A half-dozen people die when fundamentalists bomb a liquor store.
24499,17/10/2014,Iraq,Baghdad,7,13,20,Religious extremists murder seven people at a commercial district.
24500,17/10/2014,Iraq,Baghdad,14,27,41,Islamic State bombers coordinate a blast at a cafe that leaves fourteen dead.
24501,17/10/2014,Libya,Benghazi,3,3,6,A suicide bomber sends three people to Allah.
24502,17/10/2014,DRC,Eringeti,22,10,32,Ten women and eight children are among twenty-two hacked to death by ADF-NALU Islamists.
24503,18/10/2014,Nigeria,Waga,2,40,42,"Boko Haram invade a village, shoot two people to death and abduct forty women for sex slavery."
24504,18/10/2014,Nigeria,Garta,3,0,3,Three people have their throats slit by Sharia activists.
24505,18/10/2014,Nigeria,Maikadiri,8,0,8,Eight are killed when Boko Haram fire indiscriminately into homes.
24506,18/10/2014,Afghanistan,Lashkar Gah,3,6,9,Three policemen are laid out by a Fedayeen suicide bomber.
24507,18/10/2014,Yemen,Yarim,4,0,4,Four innocents are killed when Shiite radicals attack the home of a Sunni politician.
24508,18/10/2014,Afghanistan,Jalalabad,1,0,1,A suicide bomber manages to kill one other civilian.
24509,18/10/2014,Iraq,Baghdad,3,12,15,Mujahideen blow up three civilians with a roadside bomb.
24510,18/10/2014,Iraq,Madaen,4,14,18,Four patrons at a cafe are lifted permanently out of their seats by Jihadi bombers.
24511,19/10/2014,Egypt,al-Arish,7,6,13,Ansar Beit al-Maqdis bombers murder another seven people.
24512,19/10/2014,Iraq,Baghdad,22,25,47,A Shahid suicide bomber exterminates twenty-two mourners attending a funeral at a rival mosque.
24513,19/10/2014,Nigeria,Wukari,31,0,31,"Over two dozen people, including two pastors, are massacred in church by Muslim terrorists."
24514,19/10/2014,Nigeria,Gidin Waya,7,0,7,Seven villagers are murdered by Muslim terrorists.
24515,19/10/2014,Pakistan,Joharabad,1,0,1,A 56-year-old Shiite street vendor is gunned down by Sipah-e-Sahaba.
24516,19/10/2014,Iraq,Amiriyat al-Falluja,3,0,3,Three people are disintegrated by an Islamic State suicide bomber.
24517,19/10/2014,Iraq,Baiji,4,7,11,A Shahid suicide bomber takes out four people.
24518,19/10/2014,Iraq,Zaidan,7,28,35,Seven Iraqis are laid out by a Mujahid bomb blast.
24519,19/10/2014,Afghanistan,Logar,4,0,4,A Taliban assault on a police post leaves four defenders dead.
24520,20/10/2014,Iraq,Baghdad,17,28,45,A suicide bomber takes out seventeen innocent people outside a rival mosque.
24521,20/10/2014,Iraq,Latifiyah,7,0,7,Seven executed Shiite pilgrims are discovered in a mass grave.
24522,20/10/2014,Iraq,Mosul Dam,15,25,40,Fifteen people are laid out by an Islamic State suicide bomb blast.
24523,20/10/2014,Iraq,Karbala,26,55,81,"Five caliphate car bombs target Shiite areas, leaving at least fifteen dead."
24524,20/10/2014,Iraq,Qara Tappa,15,0,15,Caliphate member slip into a community and murder fifteen people.
24525,20/10/2014,Yemen,Rada,20,0,20,"An al-Qaeda car bombing and a series of shootings leave twenty others dead, including children."
24526,20/10/2014,Libya,Benghazi,1,1,2,A woman is picked off by an Islamist bomb.
24527,20/10/2014,Pakistan,Salarzai,2,2,4,Two security personnel are murdered by religious extremists in a roadside attack.
24528,20/10/2014,Iraq,Mosul,2,0,2,A man and his son are shot to death in their home by the Islamic State.
24529,20/10/2014,Canada,"Montreal, QB",1,1,2,A convert to Islam runs down two Canadian soldiers with his car 'in the name of Allah'.
24530,21/10/2014,Nigeria,Pelachiroma,4,0,4,Four people are killed when Islamists burn down churches in a rural community.
24531,21/10/2014,Syria,Kobani,1,0,1,A man with Down's Syndrome is beheaded by caliphate militants on charges of atheism.
24532,21/10/2014,Syria,Idlib,1,0,1,A man is stoned for adultery by al-Nusra.
24533,21/10/2014,Syria,Hama,1,0,1,A woman is stoned for adultery by a group of ISIS volunteers and her own father.
24534,21/10/2014,Afghanistan,Kabul,4,12,16,A Taliban bomb produces four dead Afghans.
24535,21/10/2014,Iraq,Hijaj,6,2,8,A half-dozen Iraqis bleed to death following an ISIS roadside blast.
24536,21/10/2014,Iraq,Fallujah,6,0,6,"Six younger people from poor families are executed by the Islamic State, which then hangs their bodies."
24537,21/10/2014,Iraq,Baghdad,21,42,63,Nearly two dozen people lose their lives to a series of Mujahid bomb attacks on three restaurants.
24538,21/10/2014,Pakistan,Bajaur,1,2,3,Islamic militants kill a tribesman with a well-placed rocket.
24539,22/10/2014,Yemen,al-Bayda,5,0,5,al-Qaeda claims an attack that leaves five other dead.
24540,22/10/2014,Pakistan,Mamund,0,3,3,Religious extremists target an anti polio-team.
24541,22/10/2014,Canada,"Ottawa, ON",1,1,2,A reserve soldier is killed during attacks on a war memorial and parliament building by a Muslim extremist.
24542,22/10/2014,Libya,Dariana,1,4,5,One other person is killed by a Fedayeen suicide bomber.
24543,22/10/2014,Israel,Jerusalem,2,6,8,"A Palestinian plows his car into a group of Israelis waiting at a rail station, killing a 3-month-old baby and a young woman."
24544,22/10/2014,Iraq,Sadr City,9,37,46,Nine people at a hospital are sectionalists by Mujahid bombers.
24545,22/10/2014,Iraq,Baghdad,18,37,55,"Fundamentalists bomb a theater, killing eighteen bystanders."
24546,22/10/2014,Egypt,Cairo,0,11,11,Ajnad Misr members detonate a bomb outside a university.
24547,22/10/2014,Afghanistan,Helmand,3,0,3,Three children burn to death when their house is caught up in a Taliban attack.
24548,22/10/2014,Philippines,Maguindanao,2,0,2,Two guards at a hospital are murdered by a militant Muslim group.
24549,23/10/2014,CAR,Yamale,30,0,30,Thirty Christians are massacred by Islamic extremists.
24550,23/10/2014,Nigeria,Mafa,17,30,47,Boko Haram militants murder seventeen villagers and abduct thirty children.
24551,23/10/2014,Pakistan,Quetta,8,1,9,"Suspected Lashkar-e-Jhangvi board a bus carrying Shiites and open fire, killing eight innocents."
24552,23/10/2014,Nigeria,Azare,5,12,17,A pro-Sharia group is suspected in a bomb blast at a bus stop that takes down five passengers.
24553,23/10/2014,Philippines,Bagumbayan,1,0,1,Bangsamoro Islamic shoot a man to death.
24554,23/10/2014,USA,"NYC, NY",0,5,5,Four rookie cops and a female bystander are assaulted with an axe by a Muslim who says he is acting in the cause of Allah.
24555,23/10/2014,Pakistan,Quetta,1,0,1,A Hazara minority is shot to death by Sunnis.
24556,23/10/2014,Pakistan,Quetta,2,22,24,Two people are blown to bits by a Shahid suicide bomber.
24557,23/10/2014,Pakistan,Quetta,2,10,12,A sectarian car bomb blast kills two civilians.
24558,23/10/2014,Tunisia,Tunis,1,1,2,Islamic extremists gun down a policeman.
24559,24/10/2014,Egypt,al-Arish,3,0,3,Three security personnel are gunned down in cold blood by Islamic fanatics.
24560,24/10/2014,Egypt,al-Kharouba,30,28,58,Thirty people are torn to shreds by an Ansar Bayt al-Maqsis suicide car bomber.
24561,24/10/2014,Iraq,al-Ameriya,12,30,42,A dozen people lose their lives to various injuries suffered during an ISIS mortar attack.
24562,24/10/2014,Iraq,Mosul,20,0,20,Caliphate members line up twenty people and shoot them in the back of the head.
24563,24/10/2014,Afghanistan,Khogyani,5,2,7,Five civilians lose their lives when Sunni radicals suddenly open fire point-blank on their vehicle.
24564,25/10/2014,Iraq,Mosul,3,0,3,Three doctors are executed by the caliphate.
24565,25/10/2014,Iraq,Anbar,3,7,10,Three children at a playground are pulled into pieces by an Islamic State mortar round.
24566,25/10/2014,Iraq,Muqdadiya,1,0,1,A woman is beheaded by Sharia activists.
24567,25/10/2014,Iraq,Taji,8,17,25,A Fedayeen suicide bomber sends eight Iraqis to Allah.
24568,25/10/2014,Iraq,Zumar,7,0,7,Seven Kurds lose their lives to an Islamic State car bomb.
24569,25/10/2014,Iraq,Jurf al-Sakhr,8,0,8,Eight defenders are killed during an Islamic State assault on a town.
24570,25/10/2014,Somalia,Mogadishu,1,1,2,An Islamist car bomb leaves one dead.
24571,26/10/2014,Nigeria,Borno,17,25,42,Boko Haram kill seventeen people and abduct several girls in attacks on a series of villages.
24572,26/10/2014,Yemen,al-Baydah,10,0,10,Ten civilians are killed when Shiite radicals send rocket fire into a town held by Sunnis.
24573,26/10/2014,Syria,Albu Kamal,4,0,4,Four people are publicly beheaded by the caliphate.
24574,26/10/2014,Yemen,al-Manassah,33,0,33,Over thirty are left dead after an al-Qaeda suicide car bomber plows into a group of Shia.
24575,26/10/2014,Syria,Raqqa,3,0,3,Three men are beheaded for 'cursing Allah'.
24576,26/10/2014,Iraq,Jurf al-Sakhar,15,0,15,Fifteen Sunnis are tied up and executed by Shiite militia.
24577,26/10/2014,Syria,Aleppo,2,24,26,"Militant Sunnis send a mortar round into a school, killing two children."
24578,26/10/2014,Iraq,Baiji,11,8,19,Eleven people at a refinery are reduced to pulp by a Shahid suicide bomber.
24579,27/10/2014,CAR,Nana Bakassa,2,0,2,"Two church workers, including a pastor, are shot to death by Muslim rebels in separate attacks."
24580,27/10/2014,Iraq,Baghdad,10,18,28,"Mujahideen car bombers detonate a blast along a street lined with shops, killing ten innocents."
24581,27/10/2014,Syria,Idlib,20,0,20,An al-Nusra Fedayeen suicide attack leaves twenty others dead.
24582,27/10/2014,Afghanistan,Wardoj,4,17,21,Four local police are murdered by Taliban terrorists.
24583,27/10/2014,Syria,Kobani,1,0,1,A 28-year-old woman is captured and beheaded by ISIS.
24584,27/10/2014,Syria,Idlib,70,0,70,Seventy captives are beheaded by the Islamic State.
24585,27/10/2014,Nigeria,Kukawa,3,0,3,At least three villagers are shot to death during a Boko Haram raid.
24586,27/10/2014,Afghanistan,Kunduz,10,10,20,A suicide bomber and three Taliban gunmen storm a courthouse and murder ten others.
24587,27/10/2014,Iraq,Jurf al-Sakhar,27,60,87,A Sunni suicide bomber targets a crowd of Shiites and snuffs out over two dozen lives.
24588,27/10/2014,Iraq,Tuz,2,20,22,Two civilians are killed by a Mujahid bomb planted on a motorcycle.
24589,27/10/2014,Iraq,Mosul,2,0,2,A university professor and his son are executed by the Islamic State.
24590,27/10/2014,Pakistan,Gujranwala,3,7,10,An Ahmadi woman and her two granddaughters are burned alive by a Sunni mob angered over an alleged 'blasphemous' Facebook post.
24591,28/10/2014,Afghanistan,Herat,2,4,6,"Pro-Sharia radicals open fire on a police checkpoint, killing two officers."
24592,28/10/2014,Pakistan,Swat,1,0,1,A 50-year-old man is shot to death by the Tehreek-e-Taliban.
24593,28/10/2014,Syria,Aleppo,1,0,1,"News surfaces that a Russian engineer, taken hostage by ISIS, was dragged from his cell and executed."
24594,28/10/2014,Pakistan,Karachi,1,8,9,A 10-month-old girl bleeds to death after Sunnis lob a grenade into a Shia worship hall.
24595,28/10/2014,Nigeria,Uba,24,0,24,A lecturer and his family are among dozens killed when Boko Haram overrun a small town.
24596,29/10/2014,Morocco,Kemisset,1,0,1,A 77-year-old man is strangled by his religious family for having sex out of wedlock.
24597,29/10/2014,Syria,Sheer,30,0,30,Thirty people are executed by ISIS.
24598,29/10/2014,Nigeria,Mubi,5,0,5,At least five people are reported dead after Boko Haram members roll into a small town.
24599,29/10/2014,Pakistan,Amanullah Baghdar,2,0,2,A young man and woman are honor killed by her uncle.
24600,29/10/2014,Iraq,Yusufiya,4,16,20,Four souls are laid out by a Shahid suicide bomber.
24601,29/10/2014,Iraq,Baiji,6,14,20,A Fedayeen suicide bomber takes out a half-dozen Iraqis.
24602,29/10/2014,Pakistan,Hangu,4,6,10,Religious extremists are suspected of placing a bomb at a relief camp that claims four lives.
24603,29/10/2014,Syria,Homs,12,25,37,At least a dozen people are blown to bits by Jihadi car bombers.
24604,29/10/2014,Iraq,Hit,46,0,46,Forty-six Iraqis are bound and executed in cold blood by the Islamic State.
24605,29/10/2014,Israel,Jerusalem,0,1,1,A prominent Jewish activist is shot by an Islamic Jihad gunman.
24606,29/10/2014,Mali,Kidal,1,0,1,A French soldier is shot to death by Islamists.
24607,30/10/2014,Niger,Ouallam,12,0,12,Border guards and civilians are killed by al-Qaeda.
24608,30/10/2014,Pakistan,Karachi,1,0,1,A Shiite auto parts dealer is brutally killed by Sipah-e-Sahaba.
24609,30/10/2014,UAE,Abu Dhabi,1,0,1,A woman is stabbed to death by a mosque worker for removing a sticker containing Quran verses.
24610,30/10/2014,Iraq,Qayara,3,0,3,"Three police officers are executed by the caliphate, including one by beheading."
24611,30/10/2014,Iraq,Baiji,8,5,13,Eight Iraqis are killed by ISIS militants.
24612,30/10/2014,Iraq,Tikrit,5,11,16,Five lives are snuffed out by two Shahid suicide bombers.
24613,30/10/2014,Iraq,Tikrit,17,0,17,Seventeen Iraqis are murdered by the Islamic State.
24614,30/10/2014,Iraq,Hit,70,0,70,Seventy more victims of ISIL executions are found in a mass grave.
24615,30/10/2014,Yemen,Lahij,2,0,2,Two off-duty security personnel are ambushed and killed by al-Qaeda.
24616,30/10/2014,Iraq,Ramadi,150,0,150,"The Islamic State rounds up one-hundred and fifty Iraqi men from their villages, executes them and throws their bodies into a mass grave."
24617,30/10/2014,DRC,Kampi ya Chui,14,0,14,Fourteen villagers are hacked to death by ADF-NALU.
24618,31/10/2014,Iraq,Mount Sinjar,3,6,9,An ISIS attack on Yazidi families leaves three dead.
24619,31/10/2014,Thailand,Pattani,1,2,3,A waitress is killed when terrorists bomb a restaurant.
24620,31/10/2014,Nigeria,Gombe,8,41,49,"Pro-Sharia activists set off three bombs near rush-hour traffic at a bus station, killing eight innocents."
24621,31/10/2014,Iraq,Ras al-Maa,85,0,85,Eighty-five men and women are lined up and executed by the Islamic State.
24622,31/10/2014,Iraq,Kubaisa,4,0,4,Four civilians are publicly executed by caliphate militants.
24623,31/10/2014,Iraq,Youssifiyah,4,10,14,"An IS bomb blast rips through a crowded commercial district, claiming four lives."
24624,31/10/2014,Iraq,Madain,4,11,15,"ISIS bombs an outdoor market, killing four innocents."
24625,31/10/2014,Iraq,Baghdad,2,9,11,Mujahid bombers take out two Iraqis.
24626,31/10/2014,Iraq,Baghdad,5,13,18,Five patrons are killed when terrorists bomb a sheep market.
24627,31/10/2014,Iraq,Anbar,24,0,24,"Two dozen more victims of Islamic State executions are found buried, including children and the elderly."
24628,31/10/2014,Afghanistan,Bagram,1,25,26,"Sunni fundamentalists fire a rocket into a prison, killing one detainee."
24629,1/11/2014,Syria,Albu Kamal,8,0,8,Eight men are crucified by the Islamic State.
24630,1/11/2014,Yemen,Jabal Ras,20,0,20,Twenty security personnel are reported dead following an al-Qaeda attack.
24631,1/11/2014,Pakistan,Badnikhel,1,0,1,Holy Warriors take out an 8-year-old girl with an IED.
24632,1/11/2014,Iraq,Ras al-Maa,50,0,50,Fifty victims of an Islamic State execution are discovered in a well.
24633,1/11/2014,Pal. Auth.,Ramle,1,0,1,A mother of six is 'honor' killed by her family.
24634,1/11/2014,Pakistan,Bajaur,1,1,2,A tax official is murdered by the Tehreek-e-Taliban.
24635,1/11/2014,Pakistan,Layyah,1,0,1,A young woman is gunned down by her conservative brother after 'refusing to mend her ways'.
24636,1/11/2014,Thailand,Songkhla,2,4,6,Two people are shot to death by suspected Muslim 'separatists'.
24637,1/11/2014,Pakistan,Orakzai,8,3,11,Taliban militants attack a check post and kill eight defenders.
24638,1/11/2014,Yemen,Ibb,3,2,5,"Shiite radicals target a political office, killing two guards and one bystander."
24639,1/11/2014,Afghanistan,Logar,11,20,31,Eleven Afghans are pulled into pieces by a Fedayeen suicide bomber.
24640,1/11/2014,Pakistan,Karachi,2,4,6,Two Shiites are machine-gunned by Sunni radicals while sitting in their car.
24641,1/11/2014,Iraq,Baghdad,24,52,76,Two dozen people are pulled into disparate parts by parts by a Shahid suicide bomber.
24642,1/11/2014,Iraq,Baghdad,11,42,53,"Jihadis set off a car bomb along a packed city street servicing Shiite pilgrims, killing at least eleven."
24643,2/11/2014,Pakistan,Wagah,61,120,181,Women and children are heavily represented among the victims of a vicious Jamaat-ul-Ahrar suicide blast at a border crossing with India.
24644,2/11/2014,Philippines,Sumisop,6,1,7,Six guards at a road construction project are riddled with bullets by Abu Sayyaf.
24645,2/11/2014,Pakistan,Orakzai,2,2,4,"Hardliners fire a rocket into a government building, killing two officials."
24646,2/11/2014,DRC,Beni,8,0,8,Eight villagers are butchered by ADF-NALU terrorists.
24647,2/11/2014,Kenya,Mombasa,1,0,1,"Twenty al-Shabaab youth armed with knives and machetes attack an army barracks, killing one person."
24648,2/11/2014,Nigeria,Sabon Gari,12,0,12,At least a dozen people heading to church are massacred by Islamists.
24649,2/11/2014,Iraq,Ras al-Maa,50,0,50,Ten women and children are among dozens of Iraqis lined up and executed by caliphate members.
24650,2/11/2014,Nigeria,Kogi,1,0,1,One person is killed during a Boko Haram attack.
24651,2/11/2014,Thailand,Narathiwat,1,4,5,"Muslim terrorists fire into a Buddhist home, killing an occupant."
24652,2/11/2014,Yemen,Sanaa,1,0,1,The leader of a liberal party is shot to death on the street by religious extremists.
24653,2/11/2014,Iraq,Baghdad,14,32,46,"Sunni extremists blow up a tent full of Shiite pilgrims, killing at least fourteen."
24654,2/11/2014,Somalia,Mogadishu,1,2,3,One person is sent to Allah by Mujahideen car bombers.
24655,2/11/2014,Iraq,Sadr City,6,19,25,"Sunnis bomb a tent serving Shiite pilgrims, sending a half dozen straight to Allah."
24656,2/11/2014,Iraq,Baghdad,3,10,13,"Jihadis bomb rivals at a funeral, killing another three."
24657,2/11/2014,Iraq,Baghdad,5,17,22,Five people bleed out following a Mujahid car bombing.
24658,2/11/2014,Mali,Almoustrate,2,4,6,Islamists kill two local troops with an IED.
24659,2/11/2014,Afghanistan,Ghor,1,0,1,Islamic law proponents murder a judge on his way home.
24660,3/11/2014,Afghanistan,Kandahar,1,0,1,The Taliban shoot a student through the window of a classroom.
24661,3/11/2014,Nigeria,Potiskum,32,119,151,A Sunni suicide bomber slaughters over thirty innocents at a Shiite religious festival.
24662,3/11/2014,Australia,Greenacre,0,1,1,A Shiite caretaker is shot in the face outside his mosque by Sunni radicals.
24663,3/11/2014,Saudi Arabia,al-Dalwah,8,12,20,al-Qaeda gunmen pick off eight sectarian rivals leaving a Shiite place of worship.
24664,3/11/2014,India,Chattergam,2,2,4,"Islamic militants open fire on a passing security vehicle, killing two occupants."
24665,3/11/2014,Afghanistan,Gardez,4,24,28,Four people at a bazaar are modularized by Religion of Peace bomb blast.
24666,3/11/2014,Iraq,Ramadi,1,0,1,A doctor is murdered by suspected ISIS gunmen.
24667,3/11/2014,Iraq,Ramadi,36,0,36,Thirty-six more ordinary Iraqis are executed by the Islamic State.
24668,4/11/2014,Pakistan,Lahore,2,0,2,A Muslim bomb burns a Christian man and his pregnant wife alive for alleged 'blasphemy'.  The victims where tortured for two days prior to being shoved into an oven.
24669,4/11/2014,Pakistan,Mirazai,3,28,31,Three Shiite mourners are blown to bits when Sunnis send shrapnel through their procession.
24670,4/11/2014,Nigeria,Nafada,10,0,10,Ten people are killed by militants shouting 'Allah akbar'.
24671,4/11/2014,Kenya,Mombasa,1,0,1,Radicals gun down a moderate cleric on his way home from mosque.
24672,4/11/2014,Iraq,Mosul,2,0,2,Two women are executed by the Islamic State.
24673,4/11/2014,Iraq,Latifiya,2,12,14,"Sunnis bomb a bus carrying Shiite pilgrims, killing two."
24674,5/11/2014,Tunisia,Kef,4,11,15,Four local soldiers are ambushed and killed by armed Islamists.
24675,5/11/2014,Israel,Jerusalem,2,12,14,"A Palestinian slams his car into a group waiting for a train, killing two people, including a teenaged student."
24676,5/11/2014,Thailand,Narathiwat,1,0,1,A young female Buddhist student dies after being shot in the head by Muslim 'insurgents'.
24677,5/11/2014,Pakistan,Quetta,1,0,1,A 6-year-old religious minority girl is raped and murdered in what is suspected to be a targeted sectarian attack.
24678,5/11/2014,Pakistan,Karachi,3,0,3,The Taliban is suspected in the shooting of three members of a secular party.
24679,5/11/2014,Iraq,Kut,3,15,18,Three Iraqis are taken out by Jihadi bombers.
24680,5/11/2014,Iraq,Baqubah,1,0,1,A cleric is gunned down by Religion of Peace rivals.
24681,5/11/2014,Iraq,Baiji,10,4,14,Several woman and children are among those crushed to death by a suspected ISIS mortar attack.
24682,5/11/2014,Iraq,Baiji,4,7,11,Four Iraqis are disassembled by a Fedayeen suicide bomber.
24683,5/11/2014,Iraq,Ramadi,46,0,46,"Forty-six more victims of Islamic State executions are discovered, including women and children."
24684,5/11/2014,Afghanistan,Paktia,11,0,11,Eleven civilians are executed by Sunni fundamentalists.
24685,5/11/2014,Pakistan,Gujrat,1,0,1,A 50-year-old man is hacked to death with an axe by police after allegedly making derogatory remarks about Muhammad's companions.
24686,5/11/2014,Nigeria,Whitambaya,2,0,2,Two people are killed when Boko Haram invade a small town and burn churches.
24687,5/11/2014,Nigeria,Malam Fatori,21,30,51,Twenty-one civilians are killed after pro-Sharia militants fire indiscriminately into a small farming community.
24688,6/11/2014,Libya,Derna,2,0,2,Two teenaged rights activists are abducted and beheaded by a Sharia court.
24689,6/11/2014,Iraq,Mosul,5,0,5,Five local journalists are rounded up and executed by the caliphate.
24690,6/11/2014,Iraq,Baghdad,6,8,14,A half-dozen civilians are disassembled by two Jihad bomb blasts.
24691,6/11/2014,Iraq,Abu Ghraib,6,2,8,Mujahid bombers blow six locals into bits.
24692,6/11/2014,Iraq,al-Baghdadi,5,12,17,A Shahid suicide bomber sends five souls to the great beyond.
24693,6/11/2014,Iraq,Shiwaish,7,0,7,A woman and child are among seven members of a family shot in the back of the head by the Islamic State.
24694,6/11/2014,Iraq,Fallujah,16,24,40,"ISIS sends shells into a residential neighborhood, taking out over a dozen innocents, mostly women and children."
24695,6/11/2014,Iraq,Kubaisa,17,0,17,Seventeen civilians are lined up and executed by the Islamic State.
24696,6/11/2014,Pakistan,Rahim Yar Khan,1,2,3,Two religious scholars are shot by rivals.
24697,6/11/2014,Afghanistan,Jawzjan,2,0,2,Two locals are murdered in cold blood by the Taliban.
24698,6/11/2014,Egypt,Menoufa,5,15,20,"Hardliners set off a bomb at a train station, claiming five live."
24699,7/11/2014,Nigeria,Azare,11,24,35,A suspected Boko Haram blast at a bank kills eleven bystanders.
24700,7/11/2014,Pakistan,Ghallanai,4,2,6,A vicious roadside blast produces four dead civilians.
24701,7/11/2014,Iraq,Baghdad,5,24,29,Five people are killed in a series of Mujahideen attacks.
24702,7/11/2014,Iraq,Jubba,3,3,6,Three fisherman are murdered by the Islamic State.
24703,7/11/2014,Iraq,Mosul,3,0,3,Three female employees of a beauty shop are arrested and quickly executed by the caliphate.
24704,7/11/2014,Iraq,Baiji,8,15,23,Eight Iraqis are dismantled by a Fedayeen suicide bomb blast 'for Allah'.
24705,7/11/2014,Pakistan,Safi,7,2,9,"TTP radicals hurl bombs into a group of peace volunteers, killing at least seven."
24706,7/11/2014,Pakistan,Badhaber,1,1,2,One person is killed after an Islamist throws a grenade at a group of police.
24707,7/11/2014,Pakistan,Peshawar,1,0,1,A Shia cleric is shot to death by Ahl-e-Sunnat-Wal-Jamaat.
24708,8/11/2014,Syria,Raqqa,3,0,3,Three 'heretics' are executed by trampling after being sentenced by a caliphate court.
24709,8/11/2014,Somalia,Kudha,2,0,2,Two young women are beheaded by al-Shabaab.
24710,8/11/2014,Somalia,Kudhaa,60,0,60,Sixty locals are reported dead as al-Shabaab fighters invade a small town.
24711,8/11/2014,Afghanistan,Kabul,1,6,7,A suicide bomber kills a policeman.
24712,8/11/2014,Yemen,Rada,70,0,70,al-Qaeda claims a suicide attack that killed as many as seventy Shia.
24713,8/11/2014,Pakistan,Tirah Vally,2,1,3,A Lashkar-e-Islam blast leaves two dead.
24714,8/11/2014,Pakistan,Batala,2,0,2,A young couple is shot to death by the woman's conservative family for marrying by choice.
24715,8/11/2014,Iraq,Yousifiya,8,17,25,"Two bombings by Sunni hardliners leave eight dead, including two people at a fruit market."
24716,8/11/2014,Nigeria,Libyabo,33,0,33,Women are among thirty-three villagers massacred by Fulani terrorists.
24717,8/11/2014,Cameroon,Kerawa,1,0,1,A border guard is murdered by Boko Haram.
24718,8/11/2014,Iraq,Ramadi,5,0,5,Five are reported dead following a Shahid martyrdom blast.
24719,8/11/2014,Iraq,Baqubah,1,1,2,Religion of Peace bombers kill a 10-year-old boy.
24720,8/11/2014,Iraq,Baghdad,10,34,44,Two Mujahid car bombs produce ten dead Iraqis.
24721,8/11/2014,Iraq,Sadr City,11,21,32,Radical Sunnis set of a bomb in a Shia commercial district that leaves at least eleven dead.
24722,8/11/2014,Iraq,Karrada,10,18,28,"Sunnis bomb a street in a Shiite district, killing ten innocents."
24723,9/11/2014,Iraq,Hit,100,0,100,One hundred Iraqi tribesmen are lined up and executed by the Islamic State.
24724,9/11/2014,Pakistan,Karachi,1,0,1,A Sunni rickshaw driver is shot dead by sectarian rivals.
24725,9/11/2014,Iraq,Baqubah,3,0,3,Two brother are among three shepherds shot to death by suspected ISIS.
24726,9/11/2014,Cameroon,Kolofata,3,0,3,Three civilians are killed when Boko Haram stage attacks on their town.
24727,10/11/2014,Thailand,Narathiwat,1,1,2,A Buddhist man is shot to death in a Muslims attack that leaves his wife seriously injured.
24728,10/11/2014,Somalia,Mogashishu,1,0,1,al-Shabaab gunmen pick off a government official.
24729,10/11/2014,Iraq,Makhoul,15,0,15,Women and children are heavily represented among fifteen civilians killed by targeted bomb attacks on their homes.
24730,10/11/2014,Iraq,Baiji,5,11,16,Five Iraqis are cut to shreds by a Religion of Peace IED.
24731,10/11/2014,Pakistan,Karachi,1,0,1,A 22-year-old pregnant woman is shot to death by her father for marrying by choice.
24732,10/11/2014,Nigeria,Potiskum,58,117,175,A horrific suicide blast at a school assembly claims the lives of sixty students and teachers.
24733,10/11/2014,Israel,Tel Aviv,1,0,1,A soldier is stabbed by an Arab terrorist.
24734,10/11/2014,Israel,Alon Shvut,1,4,5,Palestinians stab an Israeli woman to death.
24735,10/11/2014,Afghanistan,Jalalabad,3,1,4,Three teachers are killed when fundamentalists bomb a school.
24736,10/11/2014,Afghanistan,Puli Alam,9,3,12,Nine Afghans are sent to Allah by a Fedayeen suicide bomber.
24737,10/11/2014,Syria,Damascus,5,0,5,al-Nusra is blamed for the murder of five engineers.
24738,10/11/2014,Pakistan,Sadiqabad,2,2,4,Sunni gunmen kill two people at a Shiite worship hall.
24739,10/11/2014,Yemen,Sanaa,3,0,3,Radical Shiites attack an airport and kill three people.
24740,11/11/2014,Iraq,Tarmiya,3,16,19,Three Iraqis are taken out by a Shahid suicide bomber.
24741,11/11/2014,Iraq,Baghdad,8,23,31,Eight people are eliminated by Jihadi bombers.
24742,11/11/2014,Afghanistan,Kandahar,1,0,1,Fundamentalists shoot a teacher to death on his way to school.
24743,11/11/2014,Afghanistan,Jalalabad,1,3,4,A civilians is left dead after Sharia advocates send a mortar round into a neighborhood.
24744,11/11/2014,Pakistan,Kyber,3,1,4,A student is among three people murdered by Taliban militants.
24745,11/11/2014,Pakistan,Lahore,3,0,3,Three alleged prostitutes are 'honor' killed by family members.
24746,11/11/2014,Pakistan,Bajaur,3,2,5,Three guards are killed when fundamentalist bombers target an anti-polio medical team.
24747,11/11/2014,Pakistan,Shirindara,2,6,8,Fifty Islamists attack a police checkpoint and kill two officers.
24748,11/11/2014,Nigeria,Rim,1,0,1,"Muslim gunmen target church-goers, killing one."
24749,11/11/2014,Pakistan,Peshawar,1,0,1,A local Shia leader is picked off in a grocery store by Sunni gunmen.
24750,11/11/2014,Egypt,al-Arish,0,10,10,Religious extremists set off a bomb at a fast food restaurant.
24751,11/11/2014,Iraq,Baiji,8,15,23,Eight people are reduced to pulp by a Fedayeen suicide bomber.
24752,11/11/2014,Pakistan,Quetta,1,32,33,Islamists are suspected in a bombing that kills an 11-year-old boy.
24753,11/11/2014,Somalia,Mogadishu,1,4,5,One person is killed during two Islamist shooting attacks.
24754,12/11/2014,Egypt,Domyat,8,5,13,Eight Egyptian sailors are dead following a boat attack by Islamic militants.
24755,12/11/2014,Somalia,Mogadishu,1,0,1,A man is shot to death in his car by al-Shabaab.
24756,12/11/2014,Syria,Karnaz,7,9,16,Seven children are bleed out after Sunni terrorists fire a rocket into their school.
24757,12/11/2014,Iraq,Diyala,6,0,6,Six are reported dead following a suicide car bombing.
24758,12/11/2014,Iraq,Yusifiya,6,20,26,A half-dozen Iraqis are pulled into pieces by a Shahid suicide bomber.
24759,12/11/2014,Iraq,Baghdad,11,21,32,A Fedayeen suicide bomber takes out eleven people milling around a town square.
24760,12/11/2014,Pakistan,Quetta,1,0,1,A Hindu trader is shot in the head by Muslim gunmen.
24761,12/11/2014,Libya,Tobruk,9,20,29,At least nine people lose their lives to two Islamist car bombs.
24762,12/11/2014,Iraq,Kobani,3,8,11,Three civilians are killed when ISIS shells a town.
24763,12/11/2014,Yemen,Rada,16,0,16,An al-Qaeda suicide car bomber dispatches over a dozen Shiites.
24764,12/11/2014,Pakistan,Qambar,1,0,1,A secular party leader is assassinated by the Tehreek-e-Taliban.
24765,12/11/2014,Nigeria,Kontagora,0,4,4,Four others are injured when a female suicide bomber detonates at a teachers college.
24766,12/11/2014,Yemen,Rada,26,0,26,Two dozen devout Shiites are sent to Allah by equally devout al-Qaeda bombers.
24767,12/11/2014,Pakistan,Karachi,1,0,1,The bullet-riddled body of a Shiite is found after being kidnapped by suspected Sunnis.
24768,12/11/2014,Pakistan,Charsadda,1,2,3,The caretaker of a Shia shrine is picked off in a sectarian drive-by.
24769,13/11/2014,Iraq,Baghdad,5,11,16,Five patrons at a restaurant are blown up in mid-bite by Mujahid bombers.
24770,13/11/2014,Iraq,Thar Thar,16,0,16,Two children are among sixteen victims of a brutal Islamic State execution.
24771,13/11/2014,Iraq,Baghdad,17,0,17,"Seventeen victims of a suspected Shia militia execution are discovered, each shot in the head."
24772,13/11/2014,Egypt,Sinai,5,16,21,Five security personnel are murdered by Muslim extremists.
24773,13/11/2014,Libya,Derna,2,0,2,Two more secularists are beheaded by Islamic supremacists.
24774,13/11/2014,Thailand,Yala,1,1,2,Militant Muslims gun down a cleric and injure his young son.
24775,13/11/2014,Afghanistan,Kandahar,1,5,6,Children are among the casualties of a fundamentalist bombing.
24776,13/11/2014,Afghanistan,Kabul,4,0,4,The Taliban murder four local soldiers with IEDs.
24777,13/11/2014,Afghanistan,Nangarhar,1,1,2,One civilian is killed by a Shahid suicide bomber.
24778,13/11/2014,Afghanistan,Herat,1,0,1,A moderate cleric is gunned down by co-religionists.
24779,13/11/2014,Nigeria,Gwoza,16,0,16,Boko Haram murder sixteen civilians looking for food.
24780,13/11/2014,Iraq,Fallujah,2,0,2,Two tribal elders are dragged to a bridge and murdered by caliphate loyalists.
24781,14/11/2014,Iraq,Fallujah,2,7,9,A woman and child are disassembled by an ISIS rocket.
24782,14/11/2014,Iraq,Tikrit,15,5,20,Fifteen Iraqis are taken out by a suicide bomber near a university.
24783,14/11/2014,Iraq,Waziriya,9,34,43,"Fundamentalists set off a car bomb near a theater, killing nine."
24784,14/11/2014,Iraq,Baghdad,10,36,46,Two car bombs produce ten dead Iraqis.
24785,14/11/2014,Philippines,Talipao,5,26,31,Five local soldiers are ambushed and killed by Abu Sayyaf.
24786,14/11/2014,Nigeria,Kano,6,5,11,A suicide bomber at a petrol station incinerates six other souls.
24787,14/11/2014,Iraq,Azamiyah,11,24,35,Eleven lose their lives when Jihadis bomb a street packed with shops and vendors.
24788,14/11/2014,Afghanistan,Mehraban Kalay,1,0,1,A man is publicly beheaded by religious fundamentalists.
24789,14/11/2014,Nigeria,Chibok,12,0,12,A dozen are killed when Islamists invade a peaceful town and throw explosives into homes.
24790,15/11/2014,Indonesia,Sulawesi,1,0,1,A Christian father is murdered in front of his family b Religion of Peace extremists.
24791,15/11/2014,Nigeria,Gombi,2,0,2,Two town residents are murdered by Boko Haram.
24792,15/11/2014,Thailand,Yala,1,0,1,A Buddhist teacher is brought down by Muslim gunmen.
24793,15/11/2014,Iraq,Jalawla,2,0,2,Two civilians are executed by the Islamic State.
24794,15/11/2014,Iraq,Anbar,4,0,4,Four truck drivers are kidnapped and executed by the caliphate.
24795,15/11/2014,Iraq,Taji,4,21,25,Four people are murdered at a market by Jihadi bombers.
24796,15/11/2014,Afghanistan,Arandu,2,4,6,Two defenders are killed when the Taliban attack a border checkpoint.
24797,15/11/2014,Philippines,Pikit,2,3,5,Two civilians die when Bangsamoro Islamic terrorists send a mortar into their village.
24798,16/11/2014,Afghanistan,Kabul,3,17,20,Three people are killed when a suicide bomber tries to assassinate a female lawmaker.
24799,16/11/2014,Syria,Dabiq,18,0,18,Caliphate members line up and slit the throats of eighteen prisoners in a mass beheading.
24800,16/11/2014,Syria,Dabiq,1,0,1,The Islamic State beheads a humanitarian worker while crediting Allah.
24801,16/11/2014,Iraq,Mosul,1,0,1,A woman who ran for political office is arrested and executed by the Islamic State.
24802,16/11/2014,Iraq,Mosul,5,0,5,Three children and their parents are slaughtered by ISIS for refusing to allow a member to 'marry'  their daughter.
24803,16/11/2014,Afghanistan,Faryab,3,1,4,Two women are among three family members executed by a religious fundamentalist.
24804,16/11/2014,Iraq,Hillah,2,1,3,Terrorists take out two children with a roadside bomb.
24805,16/11/2014,Pakistan,Datta Khel,4,11,15,"Religious hardliners fire rockets into a checkpoint, killing four security personnel."
24806,16/11/2014,Nigeria,Azere,13,65,78,"A female suicide bomber detonates at a mobile phone market, killing thirteen patrons."
24807,16/11/2014,Bangladesh,Rajshahi,1,0,1,A professor is hacked to death near his university for opposing full-face veils.
24808,16/11/2014,Thailand,Pattani,2,0,2,Two women are shot to death by suspected Muslim 'separatists'.
24809,16/11/2014,India,Dogripora,1,0,1,A civilian is promptly eliminated after running afoul of Islamic extremists.
24810,16/11/2014,Iraq,Beiji,9,15,24,A Religion of Peace car bomb sends nine souls to Allah.
24811,16/11/2014,Iraq,Baghdad,3,14,17,Two bombings at an airport - one a suicide blast - leave three others dead.
24812,16/11/2014,Philippines,North Cotabato,1,17,18,One person is killed when Islamists set off a bomb near an elementary school.
24813,17/11/2014,Somalia,Mogadishu,1,0,1,A Somali-American engineer is shot by al-Shabaab while working on a sanitation project.
24814,17/11/2014,Philippines,Mindanao,3,0,3,Three off-duty soldiers are machine-gunned in their pickup truck by Bangsamoro Islamic members.
24815,17/11/2014,Iraq,Tikrit,3,12,15,Three people are killed when the Islamic State blows up their homes.
24816,17/11/2014,Afghanistan,Farah,2,1,3,A civilian and police officer succumb following at Taliban ambush.
24817,17/11/2014,Iraq,Mosul,6,0,6,Six doctors are executed in cold blood by the caliphate.
24818,17/11/2014,Pakistan,Manghopir,1,0,1,A seminary administrator is assassinated by Religion of Peace rivals.
24819,17/11/2014,Thailand,Narathiwat,1,1,2,A man is shot dead and his wife injured by Muslim militants.
24820,17/11/2014,Iraq,al-Baghdadi,3,8,11,"Two bombings, one a suicide blast, leave three dead."
24821,17/11/2014,Iraq,Majjara,18,44,62,A sustained assault by the caliphate that included a suicide bomber leaves eighteen defenders dead.
24822,17/11/2014,Iraq,Baghdad,6,16,22,Six Iraqis are laid out by a Mujahid car bomb.
24823,17/11/2014,Iraq,Baghdad,8,22,30,Jihadis set off a car bomb in a commercial district that claims the lives of eight innocents.
24824,18/11/2014,Pakistan,Shabqadar,2,0,2,"al-Qaeda member throw a grenade at two traffic cops, killing them both."
24825,18/11/2014,Yemen,Taez,1,0,1,A prominent Sunni politician is assassinated by suspected Shia radicals.
24826,18/11/2014,Kenya,Mombasa,3,0,3,Youth rampage through the streets and stab three people to death 'in revenge' for police raids on two mosques
24827,18/11/2014,Afghanistan,Kabul,2,0,2,Three suicide bombers manage to take out two security guards near a housing complex.
24828,18/11/2014,Pakistan,Nasti Kot,2,5,7,An 11-year-old boy is among two killed when the Taliban bomb a school bus carrying Shia students.
24829,18/11/2014,Israel,Jerusalem,5,7,12,"Three Americans are among four rabbis and a guard, who are hacked to death at a synagogue by two Palestinian terrorists with axes shouting praises to Allah."
24830,18/11/2014,Afghanistan,Baghlan,0,20,20,Children are among the casualties when fundamentalists bomb a crowd gathered to watch a sporting event.
24831,19/11/2014,Nigeria,Azaya Kura,45,0,45,"Forty-five villagers are slaughtered by armed Islamists, who tied the victims and slit their throats."
24832,19/11/2014,Iraq,Tikrit,15,50,65,Shiite militia attack a Sunni village and murder fifteen people.
24833,19/11/2014,Iraq,Tikrit,12,0,12,Twelve young ISIS execution victims are found bound and shot.
24834,19/11/2014,Pakistan,Peshawar,1,0,1,A Shia police officer is gunned down in a targeted sectarian attack.
24835,19/11/2014,Egypt,Negah Shabana,10,1,11,Three women and three children are among ten civilians killed when their houses are hit by Ansar Bayt al-Maqdis mortars.
24836,19/11/2014,Iraq,Erbil,6,29,35,A suicide bomber takes out five Kurdish 'apostates'.
24837,20/11/2014,Nigeria,Doron Baga,56,0,56,"Fifty-six fish vendors are brutally butchered by Islamists, some by beheading and others by drowning."
24838,20/11/2014,Afghanistan,Asadabad,1,5,6,A young boy is taken out by a Taliban rocket.
24839,20/11/2014,DRC,Beni,50,0,50,Fifty villagers are butchered by axe and machete-wielding Islamists.
24840,20/11/2014,Egypt,al-Sharqiya,1,1,2,A policeman is gunned down by Religion of Peace radicals.
24841,20/11/2014,Iraq,al-Zawiya,18,0,18,Eighteen children die when ISIS display their families and force them to march through the desert.
24842,21/11/2014,Iraq,Raqqa,6,0,6,Six Sunnis are executed by the Islamic State.
24843,21/11/2014,Iraq,Zab,2,0,2,ISIS beheads two people at a market after accusing them of apostasy.
24844,21/11/2014,Pakistan,Mithra,2,0,2,Islamic militants kill two people with a bomb planted on a motorcycle.
24845,21/11/2014,Iraq,Albu Farraj,5,10,15,Five people are sectionalized by a Fedayeen suicide bomber.
24846,22/11/2014,Saudi Arabia,Riyadh,0,1,1,A Danish citizen is shot by ISIS members.
24847,22/11/2014,Pakistan,Orangi,1,36,37,One person is killed when the Taliban throw a grenade into a political rally.
24848,22/11/2014,Afghanistan,Ghazni,3,1,4,Two brothers are among three Afghans gunned down by Sunni extremists.
24849,22/11/2014,Afghanistan,Jalalabad,1,2,3,At least one person is killed by a Taliban bomb targeting a family vehicle.
24850,22/11/2014,Iraq,al-Sajariya,25,0,25,Twenty-five locals are shot to death by Islamic State 'fighters'.
24851,22/11/2014,Kenya,Mandera,28,0,28,"Religion of Peace proponents stop a bus, single out and slaughter twenty-eight non-Muslims (including nine women) after identifying them as Christians."
24852,22/11/2014,Iraq,Mosul,2,0,2,Two middle-aged women are executed by the Islamic State.
24853,22/11/2014,Iraq,Baghdad,8,21,29,Two Mujahid bombings leave eight dead.
24854,22/11/2014,Iraq,Balad,12,18,30,A dozen civilians are killed during a sustained ISIS assault on their town.
24855,22/11/2014,Mali,Aguelhoc,2,10,12,Islamists kidnap a dozen children and kill two for trying to escape.
24856,23/11/2014,Iraq,Badush,50,0,50,A mass grave containing the remains of fifty victims executed by the Islamic State is discovered.
24857,23/11/2014,Iraq,Diyala,7,18,25,A suicide bomber kills seven Iraqis.
24858,23/11/2014,Iraq,Yusufiyah,7,16,23,"Muslim terrorists bomb a busy market, killing seven."
24859,23/11/2014,Afghanistan,Paktika,61,66,127,"Sixty people, including seventeen children, are torn to shreds by a suicide bomber at a volleyball match."
24860,23/11/2014,Thailand,Yala,2,0,2,A Buddhist couple on their way to sell vegetables are shot to death by Muslim 'insurgents'.
24861,23/11/2014,Pakistan,Orangi,1,0,1,A secular party leader is assassinated by religious radicals.
24862,23/11/2014,Philippines,M'lang,3,22,25,Bangsamoro Islamic bombers lay three civilians at a plaza out cold.
24863,24/11/2014,Egypt,Cairo,1,0,1,A man slashes the throat of his unmarried sister after discovering that she is pregnant.
24864,24/11/2014,Nigeria,Damasak,50,100,150,At least fifty people are thought to have been killed during a Boko Haram attack on a village.
24865,24/11/2014,Nigeria,Chibok,20,3,23,Twenty villagers are shot and burned by pro-Sharia militants.
24866,24/11/2014,Afghanistan,Kabul,3,1,4,Three civilians are aerated by a bomb planted on a bicycle.
24867,24/11/2014,Iraq,Shaab,12,32,44,A caliphate car bomb at a packed market in a majority-Shiite area claims a dozen lives.
24868,24/11/2014,Afghanistan,Kunduz,6,5,11,Two women are among six who bleed to death in the aftermath of a blast from a bomb planted on a motorcycle at a market.
24869,24/11/2014,DRC,Beni,45,0,45,Forty-five more victims of Islamist violence are found buried in a common grave.
24870,24/11/2014,Iraq,Mosul,6,0,6,Three women are among six executed by the Islamic State.
24871,24/11/2014,Syria,Homs,1,0,1,A religious minority is beheaded by the caliphate for apostasy.
24872,25/11/2014,Pakistan,Korangi,1,5,6,Two women and a child are among the casualties of a motorcycle bomb.
24873,25/11/2014,Iraq,Baghdad,4,0,4,A man and three women are shot to death in their home by Mujahideen.
24874,25/11/2014,Iraq,Trebil,5,9,14,A Shahid suicide bomber exterminates five Iraqis.
24875,25/11/2014,Syria,Deir Ezzor,2,0,2,Two men are stoned to death by the caliphate after being declared homosexual.
24876,25/11/2014,Nigeria,Maiduguri,78,54,132,"Two young female suicide bombers detonate in a packed market, killing nearly eighty, including those who rushed to help victims of the first blast."
24877,25/11/2014,Israel,Jerusalem,0,2,2,Two Jewish seminary students are stabbed by Arab youth.
24878,25/11/2014,Mali,Bourem,2,4,6,Two people are killed by a bomb planted by suspected al-Qaeda.
24879,26/11/2014,Syria,Irbin,1,0,1,al-Nusra shoot a man to death for 'insulting the prophet Muhammad'.
24880,26/11/2014,Egypt,al-Arish,3,0,3,Three Egyptians are shot to death by Islamic extremists.
24881,26/11/2014,Yemen,Shabwa,5,3,8,Five local soldiers are murdered at their base by al-Qaeda gunmen.
24882,26/11/2014,Iraq,Mosul,2,0,2,Two former female candidates for parliament are captured and executed by a Sharia court.
24883,26/11/2014,Iraq,Badghis,2,7,9,A Fedayeen suicide bomber kills two people.
24884,26/11/2014,Pakistan,Quetta,4,3,7,Three women are among four polio workers machine-gunned by fundamentalists.
24885,26/11/2014,Nigeria,Mubi,5,7,12,A Boko Haram bomb leaves five dead.
24886,26/11/2014,Iraq,Baghdad,5,8,13,Five shoppers at an outdoor market are reduced to pulp by Jihadi bombers.
24887,26/11/2014,Iraq,Sadr City,7,15,22,"Sunnis car bomb a Shiite commercial district, killing seven."
24888,26/11/2014,Pakistan,Parachinar,1,0,1,A prayer leader is gunned down by Religion of Peace rivals.
24889,27/11/2014,India,Jammu,7,2,9,Lashkar-e-Toiba terrorists militants murder three Indian soldiers and four civilians in a suicide assault.
24890,27/11/2014,Afghanistan,Kabul,6,33,39,Three members of the same family are among six people blown apart by a suicide bomb blast.
24891,27/11/2014,Nigeria,Mubi,40,35,75,"Islamists bomb a bus stop, killing over three dozen."
24892,27/11/2014,Iraq,Madaen,3,11,14,Women are among the casualties of a Mujahideen bomb blast.
24893,28/11/2014,Afghanistan,Camp Bastion,6,16,22,A massive suicide assault on a local army base leaves six defenders dead.
24894,28/11/2014,Pakistan,Hayatabad,2,1,3,A Taliban bomb kills two people.
24895,28/11/2014,Egypt,Cairo,2,0,2,Two police officers are murdered by suspected Islamists.
24896,28/11/2014,Afghanistan,Nawzad,4,5,9,A suicide truck bomber takes out four Afghans.
24897,28/11/2014,Afghanistan,Khogyani,0,36,36,Radicals bomb a rival mosque during Friday prayers.
24898,28/11/2014,Nigeria,Kano,120,270,390,One-hundred and twenty members of a mosque are taken out by two suicide bombers shortly after their imam calls for peace.
24899,28/11/2014,Iraq,Sabaa al-Bour,3,12,15,Mujahid bombers send shrapnel through a commercial district and claim three shoppers.
24900,28/11/2014,Iraq,Husseiniyah,4,9,13,Four people at a market are blown to bits by Jihadi bombers.
24901,28/11/2014,Pakistan,Kuchesar Chauplato,2,0,2,A Hindu and his Muslim bride are quickly hacked to death by her conservative family.
24902,29/11/2014,Yemen,Hadramawt,3,0,3,"al-Qaeda militants fire an RPG point-blank at a vehicle, killing three occupants."
24903,29/11/2014,Iraq,Mosul,10,0,10,Ten doctors are executed by the Islamic State.
24904,29/11/2014,Syria,Kobani,11,0,11,At least eleven others are killed in a series of ISIS suicide bombings.
24905,29/11/2014,China,Xinjiang,3,15,18,A Muslim bombing and stabbing attack leaves at least three others dead.
24906,29/11/2014,Pakistan,Sukkur,1,0,1,A religious leader is gunned down in his own mosque by Religion of Peace rivals.
24907,29/11/2014,Afghanistan,Kabul,3,0,3,Three suicide bombers murder a charity worker and his two children at a foreign guesthouse.
24908,29/11/2014,Thailand,Pattani,1,1,2,A Buddhist woman dies from injuries suffered during a shooting by Muslim 'insurgents' at her grocery.
24909,29/11/2014,Nigeria,Shani,40,0,40,Scores are reported killed when Islamists ride motorbikes into a Christian town and fire indiscriminately at fleeing residents.
24910,29/11/2014,Pakistan,Korangi,1,1,2,"Radical Sunnis fire on two Shiites, killing one."
24911,30/11/2014,Nigeria,Bama,55,0,55,At least fifty-five people are brutally machine-gunned on video as they lay on the floor of a dormitory by those who credit their 'religious duty'.
24912,30/11/2014,Iran,Jahrom,0,6,6,Six 'improperly veiled' women are stabbed following a call for violence by a cleric.
24913,30/11/2014,Syria,Aleppo,4,0,4,A woman and her three children are pulverized by an al-Nusra mortar.
24914,30/11/2014,Iraq,Baghdad,4,9,13,Four people at a restaurant are taken out in mid-bite by Sunni bombers.
24915,30/11/2014,Iraq,Baghdad,3,12,15,"Holy Warriors bomb a grocery, killing three patrons."
24916,30/11/2014,India,Shopian,1,0,1,A man is killed in his home by religious radicals.
24917,30/11/2014,Pakistan,Islamabad,2,0,2,A cleric is one of two Shiites picked off by Sunni gunmen.
24918,30/11/2014,Pakistan,Karachi,2,0,2,Two members of a secular-leaning party are cut down by suspected Taliban.
24919,30/11/2014,Iraq,Nineveh,3,0,3,Three tribal elders are executed by the caliphate.
24920,30/11/2014,Iraq,Samarrah,6,4,10,Pro-Sharia car bombers kill six Iraqis.
24921,1/12/2014,Iraq,al-Walid,16,4,20,Sixteen border guards are murdered by ISIS.
24922,1/12/2014,Afghanistan,Spin Boldak,3,0,3,Three border guards are machine-gunned by Taliban fundamentalists.
24923,1/12/2014,Tunisia,El Kef,1,0,1,A police officer is beheaded by radical Muslims.
24924,1/12/2014,Afghanistan,Burka,9,18,27,Nine mourners at a funeral are exterminated by a suicide bomber.
24925,1/12/2014,Nigeria,Maiduguri,22,40,62,Nearly two dozen people are laid out at a market by young female suicide bombers.
24926,1/12/2014,Somalia,Wajir,1,12,13,"al-Shabaab hurl grenades into a bar, killing at least one patron."
24927,1/12/2014,Nigeria,Ekiti,1,0,1,One person is killed during by attackers chanting praises to Allah.
24928,1/12/2014,Bangladesh,Gournadi,0,13,13,A Muslim gang smashes idols and beats Hindus in their homes and near a temple.
24929,1/12/2014,Iraq,Balad,8,20,28,Eight residents are killed when ISIS send mortars into a Shiite neighborhood.
24930,1/12/2014,Nigeria,Damaturu,47,78,125,"The bodies of forty-seven defenders, doctors and children are found after Boko Haram storm a small town."
24931,1/12/2014,Israel,Samaria,1,0,1,A 63-year-old Jewish man is deliberately struck and killed by three Arabs.
24932,1/12/2014,UAE,Abu Dhabi,1,0,1,An American kindergarten teacher and mother of three is stabbed to death in a targeted attack at a mall.
24933,2/12/2014,Libya,Benghazi,9,27,36,A child is among nine killed when Ansar al-Sharia fire a shell at a hospital.
24934,2/12/2014,Iraq,Husseiniya,3,7,10,"Mujahideen bomb a popular market, laying out three patrons."
24935,2/12/2014,Iraq,Tuz Khormato,5,12,17,Five people lose their lives to a shrapnel bomb blast along a city street.
24936,2/12/2014,Iraq,Baghdad,3,6,9,Three people die from a Jihadi bomb placed on a bus.
24937,2/12/2014,Afghanistan,Bala Murghab,6,0,6,"A half-dozen local soldiers are ambushed and murdered at their guard post by Sunni hardliners, including an 'insider'."
24938,2/12/2014,Kenya,Korome,36,0,36,Islamists slaughter three dozen Christian quarry workers after separating them from Muslims.  Several are beheaded.
24939,2/12/2014,Lebanon,Ras Baalbek,6,1,7,Islamic State militants ambush and kill six Lebanese soldiers.
24940,3/12/2014,Somalia,Mogadishu,4,9,13,Four are left dead after an al-Shabaab suicide bomber detonates near an airport.
24941,3/12/2014,Nigeria,Lassa,11,20,31,At least eleven innocents lose their lives when Boko Haram go on a church-burning spree.  Twenty girls are kidnapped for sex slavery.
24942,3/12/2014,Israel,Mishor Adumim,0,2,2,Two Israelis in their 50's are stabbed at a supermarket.
24943,3/12/2014,India,Pohu,1,6,7,"Islamic militants hurl a grenade at a group of police, killing one."
24944,3/12/2014,Syria,Deir al-Zor,19,0,19,Nineteen others are reported dead after an ISIS suicide attack.
24945,3/12/2014,Pakistan,Lower Kurrum,1,1,2,"Sunni radicals kidnap, torture and execute a Shiite man."
24946,3/12/2014,Yemen,Sanaa,1,6,7,A suicide bomber at an ambassador's residence takes out a guard.
24947,3/12/2014,Lebanon,Arsal,1,2,3,One person is killed by a bomb planted just outside of a Christian village.
24948,3/12/2014,Iraq,Arab Jubur,9,7,16,Three children are among nine civilians who bleed to death when terrorists lob mortars into their neighborhood.
24949,3/12/2014,Thailand,Yala,2,0,2,Two volunteers are ambushed and killed by Islamic separatists.
24950,4/12/2014,Thailand,Pattani,1,0,1,A 50-year-old man is brought down in a hail of bullets by Muslim 'insurgents' on his way to a tea shop.
24951,4/12/2014,Iraq,Kirkuk,16,22,38,Sixteen innocents at a restaurant are murdered by Fedayeen suicide car bomber.
24952,4/12/2014,Iraq,Shaab,3,12,15,"Sunnis bomb a Shiite restaurant, killing three."
24953,4/12/2014,Iraq,Sadr City,7,21,28,Seven people at a market are aerated by Mujahid shrapnel.
24954,4/12/2014,Iraq,Sadr City,11,25,36,"Sunni bombers target a row of restaurants in a Shiite part of town, killing eight patrons."
24955,4/12/2014,Chechnya,Grozny,14,28,42,Fourteen guards are killed in a brazen attack on a housing complex by Islamic militants.
24956,4/12/2014,Somalia,Mogadishu,2,1,3,A former lawmaker is assassinated by al-Shabaab along with a bodyguard.
24957,4/12/2014,Thailand,Narathiwat,1,0,1,A 52-year-old woman expires after being hit in the head and back by Muslim gunmen.
24958,4/12/2014,Nigeria,Bajoga,24,0,24,Dozens are reportedly killed when thirty Boko Haram gunmen on motorcycles roll up on two unsuspecting villages.
24959,4/12/2014,Pakistan,Gwadar,1,0,1,Fundamentalists assassinate the principal of a co-educational school.
24960,4/12/2014,Pakistan,Nawagai,3,0,3,"A man, wife and child are murdered by Taliban militants."
24961,4/12/2014,Iraq,Mosul,3,0,3,Three musicians are executed by the Islamic State.
24962,4/12/2014,Iraq,Tikrit,4,1,5,A woman is among four civilians machine-gunned in their car by the Islamic State.
24963,4/12/2014,Syria,Deir al-Zor,11,0,11,Eleven men are beheaded on video by caliphate members.
24964,5/12/2014,Lebanon,Bekaa Valley,1,0,1,al-Nusra shoot a captured Lebanese policeman in the head.
24965,5/12/2014,Syria,Wafideen,2,2,4,"Terrorists send a mortar round into a refugee camp, killing a child and one other."
24966,5/12/2014,Somalia,Baidoa,15,41,56,"A suicide bomber detonates outside a tea shop, slaughtering fifteen passersby."
24967,5/12/2014,India,Uri,13,0,13,Thirteen others are killed during a cross-border Fedayeen suicide assault.
24968,5/12/2014,Syria,Deir al-Zor,19,0,19,Nineteen lives are snuffed out by a Shahid suicide bomber.
24969,5/12/2014,Iraq,Mosul,3,0,3,Three tribal leaders are kidnapped and executed by the Islamic State.
24970,5/12/2014,India,Tral,2,5,7,"Islamists toss a grenade into a bus, killing two passengers."
24971,5/12/2014,CAR,Bambari,12,13,25,A dozen Christian villagers are pulled out of their homes and stabbed or shot to death by 'young Muslims'.
24972,6/12/2014,Somalia,Baledogle,2,0,2,"Islamists spray a car with bullets near an airport, killing two occupants."
24973,6/12/2014,Afghanistan,Chamtal,4,20,24,Four people die from splinter injuries when a fundamentalist tosses a grenade into a wedding party playing music.
24974,6/12/2014,Iraq,Hit,16,0,16,Sixteen Iraqis are kidnapped and executed by the Islamic State.
24975,6/12/2014,Yemen,Wadi Abdan,2,0,2,An aid worker and American photographer are executed in cold blood by al-Qaeda.
24976,6/12/2014,Iraq,Baghdad,3,8,11,Three Shiite pilgrims at a food stall are pulled into pieces by Sunni bombers.
24977,6/12/2014,Iraq,Husseiniya,3,8,11,Roadside bombers take out three Iraqis.
24978,6/12/2014,Iraq,Mahmoudiya,5,12,17,"Sunnis blow up a market in a Shiite part of town, killing five patrons."
24979,6/12/2014,Nigeria,Ashaka,10,12,22,At least ten people lose their lives when Boko Haram attack a cement factory.
24980,7/12/2014,Saudi Arabia,Ortawwiyah,1,1,2,One of two victims die after being shot by a mosque official for being late to prayer.
24981,7/12/2014,Afghanistan,Bashran,1,0,1,A 17-year-old girl is stabbed to death by her strict Muslim family after getting pregnant.
24982,7/12/2014,Pakistan,Taimuria,1,1,2,A Sunni activist is shot to death by sectarian rivals.
24983,7/12/2014,DRC,Beni,36,4,40,Islamist rebels massacre over thirty villagers in overnight attacks.
24984,7/12/2014,Iraq,Tarmiyah,9,11,20,Nine people are killed in a suspected ISIS attack.
24985,7/12/2014,Afghanistan,Trikh Nawar,5,0,5,Five local cops are gunned down at a security post.
24986,7/12/2014,Iraq,Salman,9,11,20,A suicide blast at a police station leaves nine dead.
24987,7/12/2014,Iraq,Balad,12,10,22,A dozen Iraqis are captured and executed while defending their village from ISIS.
24988,8/12/2014,Yemen,Sanaa,15,36,51,Fifteen Shiites are killed in a targeted al-Qaeda suicide attack on two houses.
24989,8/12/2014,Pakistan,Buner,2,0,2,Two guards for a polio team are assassinated by Muslim terrorists.
24990,8/12/2014,Afghanistan,Kandahar,5,7,12,Four civilians are among five killed during a Fedayeen suicide attack on a government office.
24991,8/12/2014,Iraq,Hawija,19,0,19,Nineteen Iraqis are executed for refusing to swear allegiance to the caliphate.
24992,8/12/2014,Syria,Sulouk,1,0,1,A man is beheaded in front of children for 'blasphemy'.
24993,8/12/2014,Bahrain,Damistan,1,0,1,A local cop is killed by Hezbollah-linked radicals.
24994,9/12/2014,Bosnia,Trnovi,0,1,1,An imam is stabbed shortly after condemning ISIS.
24995,9/12/2014,Yemen,Sayoun,7,8,15,Two al-Qaeda suicide bombings leave seven others dead.
24996,9/12/2014,Afghanistan,Haska Mina,4,0,4,Four civilians are captured and executed by the Taliban.
24997,9/12/2014,Iraq,Baghdad,4,0,4,A vicar reports that four Christian children were beheaded for 'refusing to follow Muhammad'.
24998,9/12/2014,Iraq,Kirkuk,1,2,3,"Militants fire on a bus carrying university students, killing a young woman."
24999,9/12/2014,Iraq,Muqdadiyah,2,0,2,Two civilians are shot to death by Muslim terrorists.
25000,9/12/2014,Philippines,Maramag,10,42,52,Bangsamoro Islamists are blamed for a bombing that kills ten people on a bus.
25001,9/12/2014,Syria,Wilayet al-Furat,1,0,1,A gay man is thrown from a roof and then stoned after being sentenced by a Sharia court.
25002,9/12/2014,Pakistan,Faisalabad,1,0,1,'Soldiers of Allah' shoot a member of an polio vaccination team to death.
25003,9/12/2014,Pakistan,Athara Hazari,6,1,7,A family of six is hacked to death for the woman leaving her conservative husband thirty years earlier.
25004,10/12/2014,Iraq,Mkeshiefa,38,0,38,Over three dozen people are blown to bits by Mujahideen shrapnel.
25005,10/12/2014,Nigeria,Gajigana,13,0,13,Women and children are among a dozen villagers laid out by Boko Haram.
25006,10/12/2014,Nigeria,Kano,7,30,37,"Two female suicide bombers hit a loading area at a textile market, scattering the remains of seven innocents."
25007,10/12/2014,Somalia,Tayeglow,2,0,2,Two women are beheaded by al-Shabaab.
25008,10/12/2014,Iraq,Baghdad,6,23,29,A half-dozen people lose their lives to Islamic State bombers.
25009,10/12/2014,Iraq,Maqalaa,16,0,16,Sixteen victims of a mass ISIS execution are found in a grave.
25010,10/12/2014,Iraq,Tikrit,9,13,22,Nine people are pulled into disparate parts by a Fedayeen suicide bomber.
25011,10/12/2014,Thailand,Songkhla,1,1,2,A Buddhist shop owner is shot to death by two Muslim terrorists.
25012,11/12/2014,Uganda,Kaliro,1,1,2,An imam beats his 15-year-old daughter to death for converting to Christianity.  Her 12-year-old sister barely survives the same beating.
25013,11/12/2014,Nigeria,Jos,37,47,84,"Islamic extremists bomb a crowded food stand, ending the lives of over three dozen innocents."
25014,11/12/2014,Afghanistan,Kabul,6,11,17,"A Shahid suicide bomber detonates next to a bus, killing six passengers."
25015,11/12/2014,Afghanistan,Kabul,2,16,18,A civilian is left dead following a suicide blast at a high school play.  A cameraman dies from injuries on the 20th.
25016,11/12/2014,Iraq,Baghdad,4,0,4,"Suspected Sunni snipers pick off four civilians, including a woman."
25017,11/12/2014,Iraq,Ramadi,2,0,2,An Islamic State suicide bomber take out two people on a bridge.
25018,12/12/2014,Iraq,Ramadi,14,10,24,A Shahid suicide bomber takes out fourteen Iraqis with the push of a button.
25019,12/12/2014,Yemen,Rada,6,0,6,At least six Shiites are killed by al-Qaeda.
25020,12/12/2014,Algeria,Fercha,1,0,1,Islamists shoot and then slit the throat of a 56-year-old man.
25021,12/12/2014,Iraq,Karbalah,1,7,8,A 3-year-old is reduced to pulp by a caliphate mortar round.
25022,12/12/2014,Syria,Aleppo,152,436,588,"An additional one-hundred and fifty are reported dead from improvised mortar bombs fired by Sunni terrorists, including forty-two children and twenty-five women."
25023,12/12/2014,Israel,Gush Etzion,0,5,5,"A Palestinian throws acid onto a family, including young children."
25024,12/12/2014,Iraq,Muqdadiyah,8,21,29,Eight worshippers are killed when Sunnis lob mortar rounds into a Shiite mosque.
25025,12/12/2014,India,Sopore,1,0,1,A village official is taken out to a field and shot in the head by religious extremists.
25026,12/12/2014,Iraq,Beiji,8,0,8,Eight tribesmen are ambushed and executed by the Islamic State.
25027,12/12/2014,Syria,Manbij,2,0,2,A couple are stoned to death for adultery.
25028,13/12/2014,Syria,Homs,4,0,4,Four people are beheaded for 'blasphemy'.
25029,13/12/2014,Afghanistan,Kabul,1,0,1,A Taliban court clerk is murdered by Taliban gunmen.
25030,13/12/2014,Afghanistan,Kabul,7,18,25,Seven Afghans are torn to shreds by a Fedayeen suicide blast.
25031,13/12/2014,Afghanistan,Lashkar Gah,12,6,18,Twelve workers are machine-gunned by the Taliban while trying to clear an area of mines.
25032,13/12/2014,Iraq,al-Baghdadi,21,0,21,Twenty-one Sunni tribesmen are captured and executed by the Islamic State.
25033,13/12/2014,Iraq,al-Wafa,19,0,19,ISIS storms a town and kills nineteen defenders.
25034,13/12/2014,Iraq,Mosul,2,0,2,Two police officers are executed by caliphate members.
25035,13/12/2014,Iraq,Haditha,12,17,29,Two Shahid suicide bombings leave twelve dead.
25036,13/12/2014,Somalia,Qandho,1,0,1,A religious teacher is beheaded by Religion of Peace rivals.
25037,13/12/2014,Somalia,Bur Hakaba,2,0,2,Two local soldiers are abducted and beheaded by Islamic extremists.
25038,14/12/2014,Nigeria,Gumsuri,33,191,224,At least thirty-three villagers are slaughtered by pro-Sharia militants.
25039,14/12/2014,Saudi Arabia,Awamiya,1,0,1,A cop is shot and killed by Shiite radicals.
25040,14/12/2014,Iraq,Mosul,3,0,3,Three Christians die after being tortured by the Islamic State.
25041,14/12/2014,Egypt,al-Arish,1,1,2,"Religious fanatics open fire on two police officers, killing one."
25042,14/12/2014,Afghanistan,Ghurband,4,4,8,Four local cops are gunned down by religious fanatics.
25043,14/12/2014,Afghanistan,Kunduz,1,2,3,A woman is killed and her two children injured when fundamentalists hit her house with a rocket.
25044,15/12/2014,Syria,Raqqa,100,0,100,One hundred former members if ISIS are beheaded for trying to escape.
25045,15/12/2014,Iraq,al-Alam,17,0,17,Caliphate militants execute seventeen captured tribesmen.
25046,15/12/2014,Iraq,Mosul,30,0,30,Thirty young men are reportedly executed for refusing to join the Islamic State.
25047,15/12/2014,Australia,Sydney,2,5,7,"Two others, including a woman, are killed when a radical cleric takes employees and patrons of a cafe hostage and proclaims his faith in Allah."
25048,15/12/2014,Pakistan,Tangy,1,0,1,"A Shiite is abducted, tortured and strangled by Sipah-e-Sahaba."
25049,15/12/2014,Syria,Raqqa,1,0,1,A man is beheaded by Sunnis on video for belonging to the Alawite religious minority.
25050,15/12/2014,Somalia,Lower Shabelle,10,0,10,An al-Shabaab attack on a local security base leaves ten personnel dead.
25051,15/12/2014,Afghanistan,Sabokhil,1,1,2,The Taliban take out a civilian with a roadside bomb.
25052,15/12/2014,Syria,Yarmouk,2,0,2,al-Nusra publicly executes two Palestinians for blasphemy.
25053,15/12/2014,Saudi Arabia,Riyadh,1,2,3,One person is killed when a suspected terrorist takes several people hostage.
25054,15/12/2014,Nigeria,Cross Kawa,10,2,12,Islamic extremists massacre ten travelers and abduct a woman and her 2-year-old baby.
25055,15/12/2014,Pakistan,Karachi,1,0,1,An older Shiite man is abducted and strangled by Sunni rivals.
25056,16/12/2014,CAR,Mbres,1,0,1,Muslim terrorists kill a Christian with a grenade.
25057,16/12/2014,Syria,Haresta,18,0,18,Eighteen civilians on a bus are machine-gunned by terrorists.
25058,16/12/2014,Iraq,Khan Bani Saad,2,0,2,Shiites kidnap two Sunnis and torture them to death.
25059,16/12/2014,Pakistan,Peshawar,148,122,270,"One-hundred and thirty-two children are among over one-hundred and forty murdered in cold blood by Taliban gunmen, who attacked their school shouting praises to Allah."
25060,16/12/2014,Yemen,Radaa,31,12,43,Twenty schoolgirls are among thirty-one innocents pulled into pieces by two Sunni suicide bombers.
25061,16/12/2014,Iraq,Mosul,13,0,13,ISIS releases video of a mass beheading with thirteen victims kneeling in front of Shahada flags.
25062,17/12/2014,Afghanistan,Lashkar Gah,10,14,24,A Fedayeen suicide assault on a bank leaves ten others dead.
25063,17/12/2014,Afghanistan,Jalalabad,2,5,7,Two people are sectionalized by a Taliban bomb.
25064,17/12/2014,Syria,Deir al-Zor,230,0,230,The bodies of over two-hundred tribal victims of an ISIS execution are discovered in a mass grave.
25065,17/12/2014,Iraq,Anbar,150,0,150,Human rights groups report the execution of one-hundred and fifty women for refusing to be brides for caliphate Jihadis.
25066,17/12/2014,Iraq,Abu Ghraib,4,5,9,An 8-year-old boy and his mother are among five people dismantled by a Mujahid roadside blast.
25067,17/12/2014,Nigeria,Sabon Gida Shagogo,10,0,10,"Fulani terrorists burn down a church and kill ten villagers, including the pastor."
25068,17/12/2014,Nigeria,Angwan Dauda,5,0,5,A 1-year-old boy and his mother are among five Christians slaughtered by Muslim raiders.
25069,18/12/2014,USA,"Morganton, NC",1,0,1,A 74-year-old man is shot several times in the head by a 'radicalized' ISIS supporter.
25070,18/12/2014,Iraq,Nahyat al-Alam,1,0,1,A rival cleric is beheaded by fundamentalists on charges of 'sorcery'.
25071,18/12/2014,Afghanistan,Kabul,1,3,4,A Shahid suicide bomber kills one other person.
25072,18/12/2014,Pakistan,Damadola,3,0,3,Three members of a security patrol are blown to bits by religious extremists.
25073,18/12/2014,Yemen,Hodeida,18,15,33,Hardline Sunni suicide bombers take out eighteen Shiites.
25074,18/12/2014,Iraq,Baghdad,4,6,10,A bombing near a mosque leaves four dead.
25075,18/12/2014,Iraq,Mosul,2,0,2,Two sheikhs are kidnapped and killed by the Islamic State.
25076,18/12/2014,Iraq,Mahmoudiya,4,0,4,A married couple and their two children are murdered in their own home by Mujahideen gunmen.
25077,18/12/2014,Iraq,Qasreej,7,0,7,Seven Iraqis are reportedly blown up by a suicide bomber.
25078,19/12/2014,Iraq,Baghdad,4,9,13,Four patrons at a market are cut to ribbons by Islamic bombers.
25079,19/12/2014,Iraq,Baghdad,2,0,2,Two people at a car repair shop are modularized by a Mujahid bomb blast.
25080,19/12/2014,Iraq,Baghdad,2,8,10,"Jihadis bomb a commercial district, killing two."
25081,19/12/2014,Iraq,Baghdad,3,7,10,A bomb near an industrial area kills three.
25082,19/12/2014,Afghanistan,Laghman,1,6,7,A child is killed and six others injured from Taliban shrapnel.
25083,19/12/2014,Yemen,Seyun,3,5,8,An al-Qaeda bomb produces three dead locals.
25084,19/12/2014,Pakistan,Daudzai,1,0,1,A traffic cop is machine-gunned in the road by Jihadis on a motorcycle.
25085,19/12/2014,Pakistan,Muridke,2,0,2,A married couple are shot to death by the woman's conservative family for marrying without permission.
25086,20/12/2014,Nigeria,Gwoza,50,0,50,Islamic extremists round up fifty - mostly elderly - innocents and massacre them at a high school.
25087,20/12/2014,Afghanistan,Kunar,7,3,10,Two young girls are among seven civilians disassembled by a Religion of Peace IED.
25088,20/12/2014,Afghanistan,Jawzjan,7,4,11,Seven local cops are killed when Taliban ambush their check post.
25089,20/12/2014,France,Joue-les-Tours,0,3,3,A foreign-born Muslim attacks French police officer with a knife while shouting praises to Allah.
25090,20/12/2014,Syria,Aleppo,1,0,1,A man is publicly beheaded by the caliphate.
25091,20/12/2014,Iraq,Madain,4,9,13,Terrorists detonate a bomb in a commercial district that leaves four dead.
25092,20/12/2014,Iraq,Hardan,70,0,70,"The remains of many Yazidi victims of ISIS execution are found in a mass grave, including women and children."
25093,20/12/2014,Iraq,Tikrit,17,0,17,Women and children are among seventeen Iraqis executed in their homes by caliphate members.
25094,20/12/2014,Iraq,Taji,3,12,15,Three Iraqis standing outside a shop are sectionalized by Mujahid bombers.
25095,21/12/2014,Yemen,Arhab,42,0,42,Forty-two Shiites are killed in a revenge attack by Sunni radicals.
25096,21/12/2014,Iraq,Mosul,5,0,5,The caliphate executes five Yazidi women.
25097,21/12/2014,Iraq,Muqdadiya,2,4,6,A married couple lose their lives to an Islamic State mortar round.
25098,21/12/2014,France,Dijon,0,13,13,A convert to Islam praises Allah as he runs down pedestrians with his car 'for the children of Palestine'.
25099,21/12/2014,Yemen,Arhab,4,26,30,An Ansarullah ambush leaves four dead.
25100,21/12/2014,Afghanistan,Shor Darya,5,0,5,Five children are disassembled by a Taliban landmine.
25101,22/12/2014,Nigeria,Gombe,20,21,41,"Sharia proponents detonate a bomb at a bus station, sending shrapnel through dozens of bystanders."
25102,22/12/2014,France,Nantes,1,9,10,One person is left clinically dead when yet another man shouting Allah Akbar plunges his car into a Christmas market.
25103,22/12/2014,Nigeria,Bauchi,8,20,28,"Religion of Peace bombers hit a market at closing time, killing at least eight innocents."
25104,22/12/2014,Pakistan,Gulberg,1,2,3,A sectarian drive-by on three Shiites sitting outside motorcycle showroom leaves one dead.
25105,23/12/2014,Uganda,Mayuge,1,0,1,A moderate Shia cleric is shot to death by ADF.
25106,23/12/2014,Yemen,Sanaa,2,2,4,al-Qaeda is thought responsible for bombing and small arms attacks that kill two Shiites.
25107,23/12/2014,Libya,Sirte,2,1,3,Muslim radicals murder a Christian couple and abduct their daughter.
25108,23/12/2014,Egypt,Sinai,2,0,2,Two captives are shot in the head by Ansar Beit al-Maqdis.
25109,23/12/2014,Yemen,Sanaa,1,2,3,An al-Qaeda bomb produces one dead Shiite.
25110,23/12/2014,Afghanistan,Kunduz,1,6,7,"A Taliban bomb explodes in front of a bank, killing one person."
25111,23/12/2014,Iraq,Baghdad,2,7,9,Two people are disassembled by Mujahideen bombers.
25112,23/12/2014,Iraq,Jurf al-Sakhar,20,0,20,Twenty victims of 'brutal' ISIS executions are discovered in a mass grave.
25113,23/12/2014,Somalia,Kismayo,1,2,3,Islamists gun down a local official.
25114,24/12/2014,Somalia,Garbahaarreey,2,0,2,Two brothers are captured and executed by al-Shabaab.
25115,24/12/2014,Iraq,Madain,43,61,104,At least forty Iraqis are exterminated by a Fedayeen suicide bomber.
25116,24/12/2014,Iraq,al-Baghdadi,4,0,4,Four children are reported dead during a siege in which ISIS lobs chlorine canisters into a town.
25117,24/12/2014,Iraq,Yusufiya,4,7,11,Four civilians at a market are pulled into pieces by a Mujahid bomb blast.
25118,25/12/2014,Iraq,Jalawla,10,0,10,Ten victims of an ISIS ambush are found in a shallow grave.
25119,25/12/2014,Afghanistan,Faryab,2,1,3,A woman and daughter are murdered in their own home in a suspected honor killing.
25120,25/12/2014,Israel,Jerusalem,0,2,2,"Palestinians fire-bomb a family vehicle, severely injuring an 11-year-old girl."
25121,25/12/2014,Libya,Sirte,1,0,1,A 13-year-old Coptic girl is murdered and dumped after being abducted by Islamists.
25122,25/12/2014,Somalia,Mogadishu,4,0,4,Four others are killed during an al-Shabaab small arms attack targeting Christians celebrating Christmas.
25123,25/12/2014,Egypt,al-Arish,1,1,2,Religious extremists kill one person with a planted landmine.
25124,25/12/2014,Libya,al-Sidra,22,0,22,Twenty-two local soldiers are killed during a surprise attack by Fajr Libya.
25125,25/12/2014,Libya,Benghazi,20,0,20,"Six people are beheaded, and fourteen others shot by Islamists."
25126,25/12/2014,DRC,Ndalya,10,12,22,ADF terrorists hack ten villagers to death in the middle of the night.
25127,26/12/2014,Pakistan,Sarki Mela,1,2,3,A civilian is killed when militant Muslims open indiscriminate fire at a checkpoint.
25128,26/12/2014,Afghanistan,Nad-e-Ali,3,0,3,A woman and child are among three killed by a Religion of Peace IED.
25129,26/12/2014,Afghanistan,Kandahar,4,0,4,Four Afghans are exterminated by Taliban bombers.
25130,27/12/2014,Nigeria,Tattaura,10,0,10,Muslims slaughter ten Christians.
25131,27/12/2014,Indonesia,Tamadue,1,2,3,"Three Christian are abducted by Islamic terrorists, one of whom is executed in captivity."
25132,27/12/2014,Egypt,Cairo,2,0,2,Two guards at a bank are gunned down by suspected extremists.
25133,27/12/2014,Pakistan,Bhiri Sha Rehman,1,0,1,An Ahmadi is shot in the head shortly after a TV preacher rails against the religious minority.
25134,27/12/2014,Afghanistan,Wardak,3,5,8,"Fundamentalists send a rocket into a volleyball match, killing three participants."
25135,27/12/2014,Cameroon,Mozogo,30,3,33,Boko Haram burn down a village and slaughter at least thirty residents.
25136,27/12/2014,Iraq,Tuz Khurmatu,1,0,1,A Kurdish imam is shot to death by Shiite militia.
25137,27/12/2014,Yemen,Sanaa,12,0,12,A dozen people are left dead after Sunnis and Shia clash.
25138,28/12/2014,Nigeria,Potiskum,1,0,1,A bomb targeting soccer fans kills a food vendor.
25139,28/12/2014,Syria,Aleppo,6,10,16,Two children are among six souls sent to Allah by a caliphate car bomb.
25140,28/12/2014,Afghanistan,Lahgman,2,2,4,Two civilians are blown to bits by fundamentalist bombers.
25141,28/12/2014,Yemen,Aden,1,2,3,One person is taken out by an al-Qaeda blast.
25142,28/12/2014,Egypt,Alexandria,1,4,5,"Suspected Islamists spray gunfire at a security checkpoint, killing one person."
25143,28/12/2014,Iran,Saravan,3,0,3,Jaish-ul Adl members are suspected of an attack that leaves three border guards dead.
25144,28/12/2014,Uganda,Kampala,1,0,1,A Muslim scholar is shot to death for refusing to cooperate with Islamic radicals.
25145,28/12/2014,India,Bangalore,1,3,4,Students Islamic Movement of India are suspected of a blast near a bar that leaves a woman dead
25146,29/12/2014,Nigeria,Kautikari,15,0,15,Fifteen people are machine-gunned in the street by Boko Haram.
25147,29/12/2014,Yemen,Hadramawt,2,11,13,al-Qaeda take out two members of a security patrol.
25148,29/12/2014,Syria,Homs,8,12,20,"Two suicide bombers target separate natural gas facilities, killing at least eight others."
25149,29/12/2014,Iraq,Taji,17,35,52,A Shahid suicide bomber dismantles seventeen Shiite mourners at a funeral tent.
25150,29/12/2014,Afghanistan,Kandahar,1,0,1,Terrorists shoot a man to death at a market.
25151,29/12/2014,Iraq,Baqubah,2,3,5,Terrorists riddle two civilians with bullets as they drive by.
25152,29/12/2014,Iraq,al-Baghdadi,4,13,17,"A Fedayeen suicide bomber detonates inside a restaurant, killing four patrons."
25153,29/12/2014,Yemen,Marib,1,2,3,al-Qaeda bombers kill a civilian.
25154,29/12/2014,Syria,Deir al-Zor,70,0,70,Seventy tribal victims of a mass Islamic State execution are discovered in a mass grave.
25155,29/12/2014,Afghanistan,Helmand,4,3,7,Four Afghans are murdered by militants seeking a theocratic state.
25156,30/12/2014,Syria,Raqqa,13,0,13,Thirteen prisoners are pulled out of a truck and executed by the Islamic State.
25157,30/12/2014,Iraq,Mosul,2,0,2,Two physicians are executed by the Islamic State.
25158,30/12/2014,Pakistan,Karachi,1,0,1,A Shia activist is lynched by devout Sunnis.
25159,30/12/2014,Libya,Tobruk,0,11,11,Eleven others are wounded when a suicide bomber detonates outside parliament.
25160,30/12/2014,Iraq,Mosul,3,0,3,Three Kurds are captured at Sinjar and beheaded by ISIS.
25161,30/12/2014,Syria,Aleppo,15,5,20,Jabha Shamiyeh claim a bombing that leaves fifteen dead.
25162,30/12/2014,Somalia,Mogadishu,2,0,2,A young woman is among two people murdered by suspected al-Shabaab.
25163,31/12/2014,Nigeria,Kantoma,3,0,3,Three members of a church are cut down in a vicious assault by Muslim terrorists.
25164,31/12/2014,Iran,Sarbaz,2,0,2,A Shiite teacher is among two people killed in a suspected sectarian attack.
25165,31/12/2014,Pakistan,Swat,3,1,4,Sunni fundamentalists attack and kill three members of a security patrol.
25166,31/12/2014,Nigeria,Fika,6,6,12,A pro-Sharia suicide car bomber kills six people.
25167,31/12/2014,Afghanistan,Qush Tepa,5,9,14,The Taliban ambush and kill five militants trying to give up their arms.
25168,31/12/2014,Yemen,Ibb,49,70,119,"A suicide bomber dressed as a woman slaughters nearly fifty innocents at a Shiite celebration, including women and children."
25169,31/12/2014,Philippines,Mlang,2,30,32,"Muslim 'rebels' set off a bomb packed with nails at a market crowded with New Year's revelers, killing two."
25170,31/12/2014,Afghanistan,Oruzgan,3,5,8,A Taliban in police uniform shoots eight local cops.
25171,31/12/2014,Afghanistan,Bati Kot,2,5,7,"Sunni hardliners fire bullets into a store, killing two people."
25172,1/1/2015,Pakistan,Karachi,1,0,1,A Shiite doctor is assassinated outside his clinic by Sunni radicals.
25173,1/1/2015,Iraq,Yathrib,7,0,7,Seven Iraqis are killed in a house by caliphate members.
25174,1/1/2015,Cameroon,Maroua,15,10,25,"Islamists pour machine-gun fire into a bus, killing fifteen passengers."
25175,1/1/2015,Nigeria,Gombe,0,8,8,A suicide bomber detonates at the entrance of a church service.
25176,1/1/2015,Afghanistan,Kapisa,1,3,4,One person is killed when Jihadis bomb a car.
25177,1/1/2015,Syria,Aleppo,13,18,31,"Terrorists fire rockets into a neighborhood, killing over a dozen."
25178,1/1/2015,Iraq,Basra,3,2,5,Three Sunni preachers are shot to death by sectarian Jihadis.
25179,1/1/2015,Iraq,Samarrah,2,5,7,Two worshippers bleed to death when Sunnis mortar a Shiite shrine.
25180,1/1/2015,Iraq,Baqubah,3,0,3,Mujahideen murder three people in their own home.
25181,1/1/2015,Iraq,Fallujah,15,0,15,Fifteen tribesmen are executed by the Islamic State.
25182,1/1/2015,Afghanistan,Jalalabad,1,2,3,Sunni hardliners murder a border guard.
25183,2/1/2015,Libya,Sabha,14,0,14,Fourteen local soldiers are captured and executed by Islamic State supporters.
25184,2/1/2015,Somalia,Galkayo,1,5,6,Teachers are among the casualties of a deadly car bomb attack outside a school.
25185,2/1/2015,Afghanistan,Lashkargah,4,0,4,Four bank employees are killed by a planted bomb.
25186,2/1/2015,Somalia,Baidoa,7,3,10,A surprise attack by al-Shabaab leaves seven local soldiers dead.
25187,2/1/2015,Iraq,Tuz,3,0,3,Three civilians are kidnapped and executed by the Islamic State.
25188,2/1/2015,Iraq,Baghdad,23,0,23,Sectarian Jihadis execute two dozen people and throw their bodies into a river.
25189,2/1/2015,Thailand,Narathiwat,1,0,1,A security guard at a school is picked off by Muslim gunmen.
25190,2/1/2015,Nigeria,Ambe-Madaki,15,40,55,Fifteen villagers are massacred when Muslim terrorists attack a Christian village.
25191,2/1/2015,Libya,Sukna,17,0,17,Jihadists slit the throats of fourteen soldiers and three civilians.
25192,3/1/2015,Nigeria,Baga,1,0,1,A woman in labor is killed by Boko Haram.
25193,3/1/2015,Iraq,Anbar,1,0,1,A local journalist is arrested and executed by the Islamic State for 'being an infidel'.
25194,3/1/2015,Iraq,Garma,15,0,15,Fifteen Iraqis are lined up and shot in the back of the head by caliphate members.
25195,3/1/2015,Iraq,Shirquat,7,0,7,A child and two women are among seven civilians disassembled by Religion of Peace bombers.
25196,3/1/2015,Mali,Gao,2,0,2,A man and son are ambushed and killed by Islamic extremists.
25197,4/1/2015,Somalia,Baladweyne,1,0,1,A teenager is beheaded by al-Shabaab.
25198,4/1/2015,Nigeria,Lugda,1,4,5,One person dies from injuries suffered from a Boko Haram bombing.
25199,4/1/2015,Iraq,Fallujah,4,5,9,Four are killed when ISIS sends shells into a town.
25200,4/1/2015,Somalia,Mogadishu,4,1,5,Four civilians are reduced to pulp by a Fedayeen suicide bomber.
25201,4/1/2015,Nigeria,Kantoma,2,10,12,Two people preparing for church are shot to death by Fulani terrorists.
25202,4/1/2015,Yemen,Ansarullah,4,25,29,A journalist is among four people blown to bits by an al-Qaeda bomb.
25203,4/1/2015,Tunisia,Zaghouan,1,0,1,Religious extremists slit the throat of an off-duty policeman.
25204,4/1/2015,Afghanistan,Ghazni,2,0,2,A female doctor and her husband are murdered by fundamentalists.
25205,5/1/2015,Mali,Nampala,7,0,7,An al-Qaeda-backed attack on a small border town leaves seven dead.
25206,5/1/2015,Iraq,Salaheddin,8,0,8,Eight Iraqis are lined up and shot in the head by the Islamic State.
25207,5/1/2015,Afghanistan,Zabul,3,11,14,A Taliban suicide bomber takes out three civilians.
25208,5/1/2015,Saudi Arabia,Arar,3,3,6,A suicide blast leaves three border guards dead.
25209,5/1/2015,Pakistan,Kalya,5,11,16,"Terrorists bomb a playground, claiming five lives."
25210,5/1/2015,Afghanistan,Zabul,2,9,11,Two civilians at a market are sent to Allah by Taliban bombers.
25211,5/1/2015,Afghanistan,Kabul,1,5,6,Six civilians are affected by a Shahid suicide bomber.
25212,5/1/2015,Nigeria,Baga,31,0,31,At least ten women are among over thirty killed during an assault on a village by Boko Haram.
25213,6/1/2015,Syria,Deir al-Zor,1,0,1,A man is beheaded - allegedly for smoking.
25214,6/1/2015,Iraq,al-Jubba,23,21,44,A suicide attack on a mosque and the ensuing clash leave two dozen dead.
25215,6/1/2015,Egypt,Cairo,2,0,2,Two men guarding a church are shot to death by extremists.
25216,6/1/2015,Afghanistan,Shekhzo,3,2,5,Three family members are modularized when fundamentalists fire a rocket into their home.
25217,6/1/2015,Pakistan,Nazimabad,2,0,2,Two Shiite brothers are murdered in their shop by Sipah-e-Sahaba.
25218,6/1/2015,Iraq,Mosul,2,0,2,Radical Muslims murder a bride and groom for putting wedding decorations on their car.
25219,6/1/2015,Iraq,Mosul,23,0,23,Three female lawyers and twenty young men are executed in cold blood by caliphate members.
25220,6/1/2015,Egypt,Cairo,1,3,4,An Ajnad Misr bomb hidden in a flower pot kills a policeman trying to defuse it.
25221,6/1/2015,Iraq,Haditha,7,13,20,Seven Iraqis are taken out by a Shahid suicide bomber.
25222,6/1/2015,Pakistan,Landhi,2,0,2,Two security personnel are slain by Islamist militants.
25223,6/1/2015,Dagestan,Khasavyurt,2,2,4,Suspected extremists ambush and kill two local cops.
25224,6/1/2015,Turkey,Sultanahmet,1,1,2,Police blame al-Qaeda after a pregnant Russian woman sets off a suicide blast at a station.
25225,7/1/2015,Nigeria,Askira,26,0,26,Over two dozen residents of a small village are slaughtered by Boko Haram.
25226,7/1/2015,Nigeria,Baga,2000,500,2500,More than 2000 villagers are feared dead following a massive killing spree by Boko Haram that spanned 16 villages.
25227,7/1/2015,Pakistan,Kamra,1,0,1,A mentally-challenged man is accused of blasphemy and quickly shot to death in his home.
25228,7/1/2015,Pakistan,Qila Saifullah,1,0,1,"Tehreek-e-Taliban kidnap, execute a man and then toss his body by the side of the road."
25229,7/1/2015,Iraq,Mosul,4,3,7,A Fedayeen suicide bomber claims the lives of four others.
25230,7/1/2015,Iraq,Ghazlani,5,0,5,Five Iraqis are abducted from their homes and shot in the back of the head by the Islamic State.
25231,7/1/2015,Iraq,Baghdad,4,11,15,"Jihadis set off two bombs near a restaurant, killing four."
25232,7/1/2015,Afghanistan,Baghlan,6,3,9,Six road workers are machine-gunned point-blank by Religion of Peace gunmen.
25233,7/1/2015,Afghanistan,Jalalabad,1,2,3,A Jihadi bomb blast kills a judge and injures his two daughters.
25234,7/1/2015,Yemen,Sanaa,37,67,104,A al-Qaeda suicide bus bomber scatters body parts and snuffs out thirty-seven lives at a college.
25235,7/1/2015,Syria,Raqqa,1,0,1,A magician is beheaded by the Islamic State on the grounds that illusions are an insult to Allah.
25236,7/1/2015,Afghanistan,Baghlan,0,3,3,Three suicide bombers attack an academy.
25237,7/1/2015,France,Paris,12,10,22,A dozen people are slaughtered by gunmen 'avenging' the prophet at a newspaper office which printed satirical cartoons critical of Islam.
25238,7/1/2015,Afghanistan,Zhari,2,11,13,Taliban bombers take out two children gathering firewood.
25239,7/1/2015,Afghanistan,Nawzad,1,0,1,A local cop dies trying to stop a suicide bomber.
25240,7/1/2015,Pakistan,Karachi,2,0,2,A Shiite and his friend are shot to death on a bridge by Sipah-e-Sahaba
25241,7/1/2015,Iraq,Mosul,320,0,320,"Five mass graves are discovered containing the bodies of three-hundred ISIS victims, including minority women and children."
25242,8/1/2015,France,Montrouge,1,1,2,A policewoman investigating a traffic accident is ambushed and killed by a Muslim extremist.
25243,8/1/2015,Syria,Abu Khuyut,1,0,1,"An imam is beheaded by the caliphate for ""insulting Allah"" by denouncing beheadings."
25244,8/1/2015,Libya,Barqa,2,0,2,"The Islamic State applies the ""law of Allah"" to two Tunisian journalists."
25245,8/1/2015,Iraq,Baghdad,8,16,24,A Sunni suicide bomber wades into a Shiite mosque and slaughters at least eight worshippers.
25246,8/1/2015,Iraq,Samarrah,8,23,31,Eight Iraqis are disassembled by a Fedayeen suicide bomber.
25247,8/1/2015,Iraq,Yusufiyah,7,21,28,A Shahid suicide bomber sends seven other souls to Allah.
25248,8/1/2015,Pakistan,Nazimambad,2,0,2,Two policemen are shot to death by suspected Sunni extremists.
25249,8/1/2015,Iraq,Fallujah,17,0,17,Seventeen Iraqis are rounded up and shot in the back of the head by the Islamic State.
25250,9/1/2015,Pakistan,Orakzai,1,5,6,One person is killed when militants fire a rocket at a rival mosque.
25251,9/1/2015,Pakistan,Rawalpindi,8,20,28,Eight worshippers are blown to bits by a suicide bomber at a Shia mosque.
25252,9/1/2015,France,Paris,4,5,9,Four hostages are taken and killed by an Islamic gunman at a Jewish grocery.
25253,9/1/2015,Iraq,Muqdadiya,1,0,1,A woman is murdered by ISIS.
25254,9/1/2015,Pakistan,Orakzai,4,2,6,Jihadis set off a roadside bomb that kills four members of a security patrol.
25255,9/1/2015,Iraq,Jazira,4,8,12,A Fedayeen suicide bomber murders four police at a checkpoint after pretending to need medical help.
25256,9/1/2015,Iraq,Fallujah,8,0,8,Eight Iraqis are publicly executed by the Islamic State.
25257,10/1/2015,Iraq,Gwer,26,0,26,"Over two dozen people are killed by a sustained IS attack on a town, including a father shot in front of his family."
25258,10/1/2015,Iraq,Madian,3,9,12,Three people in a commercial district are vaporized by Islamic bombers.
25259,10/1/2015,Pakistan,Islamabad,1,0,1,A captive is beheaded on video by local ISIS.
25260,10/1/2015,Nigeria,Potiskum,1,2,3,A suicide bomber kills a guard.
25261,10/1/2015,Yemen,Sanaa,2,0,2,al-Qaeda gunmen assassinate two Shiites.
25262,10/1/2015,Bangladesh,Chittagong,1,0,1,A Hindu nurse is hacked to death on her way to work by suspected Jammat Islamists.
25263,10/1/2015,Pakistan,Hayatabad,1,0,1,An older doctor is shot multiple times at his clinic for being a Shiite.
25264,10/1/2015,Egypt,Sheikh Zuweid,2,0,2,Two people are beheaded by Islamic extremists.
25265,10/1/2015,Iraq,Baghdad,5,11,16,Five people at a wholesale market are reduced to parts by Jihadi bombers.
25266,10/1/2015,Pakistan,Baldia,1,0,1,A Sunni leader is shot to death by sectarian rivals.
25267,10/1/2015,Lebanon,Tripoli,8,36,44,Two caliphate suicide bombers at a Shiite cafe blows eight patrons to bits.
25268,10/1/2015,Nigeria,Maiduguri,20,18,38,"Islamists strap a suicide vest to a 10-year-old girl and send her into crowded market, killing over twenty."
25269,11/1/2015,Pakistan,Karachi,2,0,2,"Two Shiites, one a doctor, are gunned down in separate attacks."
25270,11/1/2015,Nigeria,Potiskum,6,46,52,Six others are killed when two female suicide bombers detonate in succession at a popular market.
25271,11/1/2015,Kenya,Mombasa,1,0,1,Terrorists kill a priest during a church service.
25272,11/1/2015,Iraq,Dour,40,0,40,Forty Iraqis policemen are summarily executed for refusing allegiance to the caliph.
25273,12/1/2015,Iraq,Mosul,5,0,5,Five men are publicly executed by the caliphate because their wives did not wear a burqa.
25274,12/1/2015,Egypt,Rafah,1,0,1,Muslim radicals kidnap and murder a local cop.
25275,12/1/2015,Cameroon,Kolofata,1,6,7,At least one person is killed during a Boko Haram attack.
25276,12/1/2015,Iraq,Abasiyat,12,18,30,A dozen Shiites are sent to Allah by a Sunni suicide bomber.
25277,12/1/2015,Afghanistan,Khost,1,0,1,Taliban militants kill an educator on his way to work.
25278,12/1/2015,Pakistan,Mekhtar,7,1,8,Seven security personnel are ambushed and killed by Sunni hardliners.
25279,12/1/2015,Iraq,Mosul,2,0,2,A former pilot and his son are forced to kneel and then shot in the head by the Islamic State.
25280,12/1/2015,Iraq,Baqubah,2,8,10,Two civilians are killed by ISIS shelling.
25281,12/1/2015,Iraq,Mosul,13,0,13,Thirteen teenage boys are rounded up and executed by the Islamic State for the crime of watching soccer on TV.
25282,13/1/2015,Egypt,Luxor,1,0,1,A Muslim radical shoots a 38-year-old Copt to death.
25283,13/1/2015,Iraq,Diyala,3,0,3,At least three men are abducted and murdered by fundamentalists for the 'UnIslamic' practice of raising birds.
25284,13/1/2015,Afghanistan,Paktia,3,0,3,Three civilians are pulled into pieces by a Taliban bomb.
25285,13/1/2015,Pakistan,Rizvia,2,0,2,Two members of a secular party are shot outside their home by suspected Taliban.
25286,13/1/2015,Iraq,Samarrah,4,18,22,Sunni suicide bombers kill four Shiites.
25287,13/1/2015,Syria,Raqaa,2,0,2,An ISIS video show a child executing two prisoners.
25288,13/1/2015,Libya,Ajdabiya,3,4,7,Three people are taken out by a Shahid suicide car bomber.
25289,13/1/2015,Afghanistan,Kabul,2,2,4,Talibanis kill two civilians with a bomb planted in a Toyota.
25290,14/1/2015,Nigeria,Gombe,2,14,16,"A suicide bomber detonates outside a mosque, taking two others with him."
25291,14/1/2015,Syria,Idlib,1,0,1,A woman is shot to death by al-Nusra for adultery.
25292,14/1/2015,Somalia,Puntland,2,3,5,Islamists murder two police officers at a remote post.
25293,14/1/2015,Pakistan,Dera Ismail Khan,3,3,6,Three policemen bleed to death after suspected Taliban fire a rocket at them.
25294,14/1/2015,Pakistan,Dera Ismail Khan,1,0,1,"Religious militants lob a grenade into a house, killing one person."
25295,14/1/2015,Iraq,Kobachi,16,0,16,Sixteen Islamic State victims are found shot in the back of the head.
25296,14/1/2015,Iraq,al-Karma,11,0,11,A child is among eleven Iraqis executed in front of their families by ISIS.
25297,14/1/2015,Iraq,Jalawa,6,0,6,Six bodies are found in an ISIS mass grave.
25298,15/1/2015,Syria,Mayadin,1,0,1,The caliphate beheads a captive.
25299,15/1/2015,Algeria,Kabylie,1,0,1,"The body is found of a French tour guide, taken hostage by Jihadis and beheaded."
25300,15/1/2015,Afghanistan,Almar,2,1,3,Two Afghans are opened wide by Taliban shrapnel.
25301,15/1/2015,Syria,Mosul,2,0,2,Two men are thrown from the roof of a building by Islamists who cite Muhammad's rule for dealing with homosexuals.
25302,15/1/2015,Iraq,Qayara,3,0,3,Three captives are publicly hanged by the caliphate.
25303,16/1/2015,Syria,Deir Ezzor,16,0,16,Sixteen civilians are executed and 'mutilated' by the Islamic State.
25304,16/1/2015,Mali,Tenenkou,9,0,9,Nine people are murdered in a surprise attack by men shouting praises to Allah.
25305,16/1/2015,Iraq,Mosul,1,0,1,An engineer is executed by the Islamic State.
25306,16/1/2015,Iraq,Baqubah,1,0,1,A child is taken out by a suicide bomber.
25307,16/1/2015,Iraq,Husseiniya,3,11,14,"Sunni bombers strike a Shiite commercial district, killing three."
25308,16/1/2015,Iraq,Zalaya,8,12,20,"Hardcore Islamists booby-trap a house, managing to kill eight security personnel lured to help the occupants."
25309,16/1/2015,Iraq,Baghdad,4,13,17,"Terrorists fire mortars into a neighborhood, killing four residents."
25310,16/1/2015,Nigeria,Gombe,6,10,16,At least a half dozen patrons at an outdoor market are sectionalized by a Fedayeen suicide bomber.
25311,16/1/2015,Niger,Zinder,1,22,23,"Muhammad cartoon protesters attack the police, killing one and injuring several."
25312,17/1/2015,Indonesia,Tamadue,5,0,5,Muslim terrorists murder five Christians in two attacks.
25313,17/1/2015,Syria,Deir Ezzor,17,0,17,Seventeen people are crucified by the Islamic State over a two day period.
25314,17/1/2015,Iraq,Sabaa al-Bour,5,14,19,Five Shiites at a market are reduced to pulp by Sunni bombers.
25315,17/1/2015,Iraq,Iskandariyah,4,14,18,"Jihadis set off a bomb at a vegetable market, killing four innocents."
25316,17/1/2015,India,Kulgam,1,1,2,Muslim radicals shoot a local cop to death.
25317,17/1/2015,Mali,Kidal,1,1,2,A peacekeeper is murdered by Islamic extremists.
25318,17/1/2015,Niger,Zinder,1,0,1,An angry Muslim mob burns a church with one person inside.
25319,17/1/2015,Pakistan,Rawalpindi,3,0,3,A Shiite lawyer and his two nephews are sprayed with automatic weapons fire by dedicated Sunnis.
25320,17/1/2015,Somalia,Baidoa,1,0,1,Islamists gun down a rival cleric.
25321,17/1/2015,Iraq,Mosul,5,0,5,Five women in their thirties are summarily executed by Muslim fundamentalists.
25322,17/1/2015,Iraq,Samarra,22,0,22,Twenty-two people are reportedly killed by a Fedayeen suicide car bomber.
25323,17/1/2015,Iraq,Sadr City,9,25,34,Sunnis blow up nine Shiites waiting for cell phone service outside a shop.
25324,18/1/2015,Jordan,Zarqa,1,0,1,A woman's throat is slit by her three uncles for meeting with a man without permission.
25325,18/1/2015,Afghanistan,Helmand,4,10,14,Four Afghans are wiped out by a Shahid suicide bombing.
25326,18/1/2015,Cameroon,Tourou,4,24,28,"Boko Haram capture dozens of children from a village, killing at least four who resist."
25327,18/1/2015,Nigeria,Potiskum,4,48,52,"A female suicide bomber detonates at a bus station, claiming four kills."
25328,18/1/2015,Afghanistan,Kandahar,0,3,3,A child is among the victims of a Fedayeen suicide bomber.
25329,18/1/2015,India,Bihar,1,0,1,A young Hindu man is murdered by Muslims for dating a Muslim girl.  (This triggers a deadly riot).
25330,18/1/2015,Pakistan,Nazimabad,2,0,2,Two guards are shot to death by Sunni Jihadis for providing security at a Shiite mosque.
25331,18/1/2015,Pakistan,Korangi,1,0,1,A Shiite is shot to death by Sunni radicals.
25332,18/1/2015,Iraq,Baiji,12,6,18,Twelve Iraqis lose their lives to an Islamic State attack.
25333,19/1/2015,Afghanistan,Laghman,2,1,3,Two people are killed by a Taliban landmine.
25334,19/1/2015,Pakistan,Karachi,4,1,5,Islamic militants are suspected in two shooting attacks that end the lives of four local cops.
25335,19/1/2015,Afghanistan,Khost,1,6,7,A Taliban bomb at a shop leaves one dead.
25336,19/1/2015,Pakistan,Karachi,1,0,1,A guard loses his life when Islamists attack a polio team.
25337,19/1/2015,Iraq,Mahmoudiya,2,9,11,Jihadi bombers take down two civilians outside a cafe.
25338,19/1/2015,Iraq,Hajaj,7,12,19,Seven Iraqis are disassembled by a series of Mujahid bomb blasts.
25339,19/1/2015,Syria,Damascus,1,2,3,A child is killed when terrorists fire a mortar into a sports complex.
25340,20/1/2015,Iraq,Mosul,1,0,1,An elderly cleric is put to depth for refusing allegiance to the caliph.
25341,20/1/2015,Afghanistan,Jaghuri,8,2,10,Women and children are among eight civilians ripped to shreds by a Sunni roadside bomb.
25342,20/1/2015,Iraq,Sadr City,3,7,10,Sunnis blow up three Shiite bus passengers.
25343,20/1/2015,Iraq,Diyala,26,0,26,The bodies of over two dozen ISIS execution victims are discovered in a mass grave.
25344,20/1/2015,Iraq,Baghdad,5,11,16,Five people outside a clinic are reduced to pulp by Religion of Peace bombers.
25345,21/1/2015,Syria,New Sabri,2,35,37,A Fedayeen suicide bombing takes out two Christians.
25346,21/1/2015,Syria,Homs,7,30,37,"Terrorists set off a car bomb in a shopping district, killing seven patrons."
25347,21/1/2015,Israel,Tel Aviv,0,13,13,Thirteen bus passengers are stabbed by a Palestinian.
25348,21/1/2015,Iraq,Albu Ghanem,2,13,15,A Fedayeen suicide bomber murders two Iraqis.
25349,22/1/2015,Somalia,Mogadishu,5,23,28,Five people are blown to bits by a Shahid suicide bomber at a hotel.
25350,22/1/2015,Libya,Sirte,2,0,2,Two men are shot to death by suspected Fajr Libya.
25351,22/1/2015,Iraq,Taji,8,21,29,Eight Iraqis  are liquidated by a Fedayeen suicide bomber.
25352,22/1/2015,Afghanistan,Lashkar Gah,2,16,18,A Shahid suicide bombing claims the lives of two locals.
25353,22/1/2015,Iraq,Samarra,4,14,18,A booby-trapped house produces four dead bodies.
25354,23/1/2015,Nigeria,Bantaje,1,0,1,Muslim extremists butcher a pastor and father of two.
25355,23/1/2015,Syria,Damascus,1,6,7,A civilian bleeds out following an al-Nusra mortar attack on a neighborhood.
25356,23/1/2015,Lebanon,Ras Baalbak,3,7,10,"Islamists stage a cross-border attack on Lebanese troops, killing three."
25357,23/1/2015,Iraq,Mosul,4,0,4,Four university professors are executed by the Islamic State.
25358,23/1/2015,Iraq,Baghdad,2,11,13,A blast targeting soccer fans takes out two.
25359,23/1/2015,Philippines,Zamboanga,2,54,56,An Abu Sayyaf car bombing outside a bar leaves two dead and four dozen injured.
25360,23/1/2015,Libya,Tripoli,1,0,1,Islamists gun down a guard outside a UN office.
25361,23/1/2015,Syria,Raqqa,1,0,1,A Japanese hostage is beheaded by the Islamic State.
25362,23/1/2015,Nigeria,Kambari,15,0,15,Fifteen villagers are slaughtered by Boko Haram.
25363,23/1/2015,Iraq,Muqdadiyah,7,0,7,Two journalists are among seven people reportedly killed by the Islamic State.
25364,23/1/2015,Iraq,Basra,5,0,5,Five imams are assassinated by Religion of Peace rivals.
25365,23/1/2015,Iraq,Sinjar,50,0,50,Fifty people are summarily executed by the Islamic State.
25366,24/1/2015,Pakistan,Korangi,2,0,2,Two Shiite shopkeepers are murdered by Sunni radicals.
25367,24/1/2015,Iraq,al-Amin,3,7,10,Sunnis take out three Shiites with a bomb planted near a produce stand.
25368,24/1/2015,Iraq,Baghdad,3,8,11,A bomb blast at a cafe leaves three dead.
25369,24/1/2015,Iraq,Baghdad,3,8,11,Terrorists kill three civilians with a car bomb.
25370,24/1/2015,Iraq,Zafaraniyah,4,13,17,"Jihadis bomb a Shiite restaurant, killing four patrons."
25371,25/1/2015,Iraq,Mosul,1,0,1,A captive is beheaded on video by ISIS.
25372,25/1/2015,Syria,Damascus,7,43,50,At least seven are killed when Jaysh al-Islam send dozens of rockets into a neighborhood.
25373,25/1/2015,Iraq,Mosul,7,0,7,Seven women are executed for refusing 'temporary marriage' with caliphate members.
25374,25/1/2015,Pakistan,Karachi,1,0,1,A Shiite dies from injuries suffered during a targeted attack by Sipah-e-Sahaba.
25375,25/1/2015,Iraq,Tikrit,4,0,4,Four Iraqis are executed by the Islamic State.
25376,25/1/2015,Syria,Aleppo,3,11,14,Sunni terrorists kill three civilians with a rocket attack on their neighborhood.
25377,25/1/2015,Iraq,Arab Jabour,3,2,5,Three defense volunteers are pulled into pieces by an ISIS bomb.
25378,25/1/2015,Philippines,Barangay Tukanalipao,49,11,60,"Moro Islamists open fire on police, killing nearly fifty."
25379,25/1/2015,Iraq,Baghdad,4,8,12,Four patrons are killed when Jihadis bomb a cafe.
25380,25/1/2015,Iraq,Baghdad,7,11,18,A bomb placed outside a restaurant nets seven dead bodies.
25381,26/1/2015,Yemen,Abyan,5,0,5,Five local soldiers are ambushed and killed by al-Qaeda.
25382,26/1/2015,Pakistan,Karachi,1,0,1,Fundamentalist gunmen pick off a guard for a polio team.
25383,26/1/2015,Afghanistan,Kabul,1,0,1,A former court official is assassinated by suspected Taliban.
25384,26/1/2015,Iraq,Barwanah,72,0,72,Shiite militias pull seventy-two Sunnis from their homes and execute them.
25385,26/1/2015,Iraq,Abu Ghraib,6,8,14,Children are among six civilians disassembled by a Mujahideen blast targeting an humanitarian aid agency.
25386,26/1/2015,Syria,al-Shadadi,1,0,1,A young man is beheaded to shouts of 'Allah Akbar.'
25387,26/1/2015,Nigeria,Michika,30,6,36,Thirty people are reported killed when Boko Haram attack two villages.
25388,27/1/2015,Iraq,Tikrit,6,4,10,A half dozen Iraqis are blown to bits by Mujahideen bombers.
25389,27/1/2015,India,Tral,1,1,2,"Hizb-ul-Mujahideen gunmen open fire on a security patrol, killing one member."
25390,27/1/2015,Afghanistan,Kot,2,0,2,Two brothers are shot to death by suspected Taliban.
25391,27/1/2015,Egypt,Alexandria,1,2,3,Fundamentalists set off a car bomb that leaves one dead.
25392,27/1/2015,Libya,Tripoli,10,2,12,Five foreign guests and five guards are killed when Islamists storm a hotel after setting off a bomb.
25393,27/1/2015,Iraq,Mosul,10,0,10,Ten more physicians are reported executed by the Islamic State.
25394,27/1/2015,Iraq,Maria,6,0,6,Six civilians are executed for arguing with caliphate members.
25395,27/1/2015,Iraq,Saladin,10,0,10,Ten Kurds are lined up and shot in the head by devout Sunnis chanting praises to Allah.
25396,28/1/2015,Nigeria,Adamawa,10,0,10,Ten more victims are reported 'slaughtered like rams' from a seven town murderous rampage by Boko Haram.
25397,28/1/2015,Yemen,Radda,7,5,12,Seven Shiites are laid out during an al-Qaeda attack on a house.
25398,28/1/2015,Mali,Tabankort,9,0,9,At least nine are killed by two suicide bombers.
25399,28/1/2015,Lebanon,Shebaa Farms,2,7,9,Two Israeli soldiers are killed by Hezbollah terrorists.
25400,28/1/2015,Afghanistan,Herat,1,2,3,A woman is taken out by a Taliban bomb.
25401,28/1/2015,Pakistan,Sargodha,4,0,4,A man shoots his sister and three children to death over suspicion of unIslamic morals.
25402,28/1/2015,Afghanistan,Ghanzi,11,6,17,Eleven Afghans are shot to death by Sunni hardliners.
25403,28/1/2015,Somalia,Kismayu,13,0,13,At least thirteen others lose their lives to an al-Shabaab attack.
25404,29/1/2015,Ireland,North Belfast,1,0,1,An immigrant from Somalia stabs a man to death on the street while yelling a 'Jihadi war cry'.
25405,29/1/2015,Afghanistan,Mehtarlam,16,39,55,Sixteen mourners at a funeral are shredded by a Shahid suicide bomber.
25406,29/1/2015,Egypt,al-Arish,26,58,84,Over two dozen civilians and soldiers are killed when Ansar Beit al-Maqdis attack a hotel and barracks with rockets.
25407,29/1/2015,Afghanistan,Jalalabad,1,2,3,A child is sectionalized by a Religion of Peace bomb blast.
25408,29/1/2015,Afghanistan,Mesri Kala,4,0,4,Three civilians are among four killed by a Taliban landmine.
25409,29/1/2015,Egypt,Rafah,1,6,7,"Ansar Bayt al-Maqdis open fire on a police checkpoint, killing one member."
25410,29/1/2015,Iraq,Tarmiya,3,11,14,Three people in a farming community are laid out by a Mujahideen blast.
25411,29/1/2015,Iraq,Mishahada,7,28,35,A double suicide bombing produces seven dead Iraqis including first responders.
25412,29/1/2015,Yemen,Marib,2,2,4,Two local soldiers are murdered by al-Qaeda.
25413,29/1/2015,Iraq,Mahmoudiya,2,10,12,A Jihadi bomb at a commercial center claims the lives of two bystanders.
25414,29/1/2015,Iraq,Youssifiyah,4,12,16,"Terrorists bomb an outdoor market, killing four patrons."
25415,29/1/2015,Afghanistan,Kabul,3,1,4,Three US contractors are shot in the back by a terrorist in uniform.
25416,29/1/2015,Egypt,Sheikh Zuweid,3,0,3,Three people are kidnapped and beheaded by Ansar Beit Al Maqdis.
25417,29/1/2015,Iraq,Latifiyah,1,2,3,A woman bleeds to death following a Mujahid bomb blast.
25418,30/1/2015,Iraq,Kirkuk,6,70,76,"ISIS fighters fire rockets into a town, killing at least six."
25419,30/1/2015,Egypt,Sheikh Zuweid,2,0,2,Two children die from gunshot injuries suffered during an attack by Islamic fundamentalists.
25420,30/1/2015,Iraq,al-Dour,37,0,37,Forty-four people are abducted from their homes by the Islamic State - which subsequently executed thirty-seven.
25421,30/1/2015,Egypt,al-Arish,1,0,1,A 50-year-old road worker is shot in the head by Ansar Beit al-Maqdis.
25422,30/1/2015,Cameroon,Fotokol,3,12,15,Three defenders are killed during a cross-border raid by Boko Haram.
25423,30/1/2015,Pakistan,Orangi,1,0,1,A man dies from head injuries suffered during a fundamentalist attack on a polio team.
25424,30/1/2015,Thailand,Pattani,1,3,4,A Buddhist police officer is ambushed and killed by Muslim gunmen.
25425,30/1/2015,Afghanistan,Dara-e-Suf,0,7,7,Sunnis bomb a rival mosque during Friday prayers.
25426,30/1/2015,Syria,Tal Abyad,1,0,1,A gay man is thrown from a roof and then beaten to death when he survives.
25427,30/1/2015,Pakistan,Shikarpur,61,100,161,"A Jundullah member sets off explosives inside a crowded Shia mosque, killing over sixty members including children."
25428,30/1/2015,Nigeria,Nwonko,27,0,27,Women and children comprise the bulk of twenty-seven villagers massacred by Fulani terrorists.
25429,30/1/2015,Iraq,Nukhaib,6,0,6,A half-dozen people are incinerated when a suicide truck bomber rams a reception hall.
25430,30/1/2015,Iraq,Samarrah,14,29,43,Fourteen Iraqis lose their lives to two Fedayeen suicide blasts.
25431,30/1/2015,Iraq,Jalawla,7,0,7,At least seven Kurds are killed by a suicide bomber.
25432,30/1/2015,Iraq,Baghdad,27,30,57,Over two dozen people are killed in back to back Jihad bombings.
25433,31/1/2015,Egypt,al-Arish,1,0,1,A 50-year-old Copt is shot to death in his home simply because of his religion.
25434,31/1/2015,Iraq,Harbaya,6,0,6,Six members of a family are exterminated by a Shahid suicide bomber.
25435,31/1/2015,Pakistan,Karachi,1,0,1,A 70-year-old Shiite is murdered by Sipah e-Sahaba.
25436,31/1/2015,Syria,Raqqa,1,0,1,A Japanese journalist who converted to Christianity is beheaded by caliphate members in the name of Allah.
25437,31/1/2015,Afghanistan,Herat,2,2,4,A man and his son are reduced to parts by a bomb planted by religious hardliners
25438,31/1/2015,Afghanistan,Nuristan,4,0,4,Four border guards are taken out by Taliban bombers.
25439,31/1/2015,Iraq,Baghdad,3,10,13,Three civilians are killed when ISIS fire mortars into their neighborhood.
25440,31/1/2015,Iraq,Baghdad,3,10,13,Mujahid bombers lay out three people near an auto repair shop.
25441,31/1/2015,Iraq,Madain,4,11,15,Four people at a sheep market are sectionalized by a Jihadi bomb blast.
25442,1/2/2015,Syria,Damascus,6,20,26,"Terrorists blow up a bus carrying Shiite pilgrims, killing six."
25443,1/2/2015,Iraq,Mosul,2,0,2,Two Iraqi captives are beheaded by the Islamic State.
25444,1/2/2015,Afghanistan,Chasht,4,3,7,"Fundamentalists pour automatic-weapons fire into a police post, killing four officers."
25445,1/2/2015,Pakistan,Jhang,2,0,2,Two sisters are honor killed by their family for refusing to marry men picked out for them.
25446,1/2/2015,Nigeria,Potsikum,9,24,33,A suicide bomber murders nine innocents at a political gathering.
25447,1/2/2015,Nigeria,Gombe,3,7,10,A bomb at a market leaves three dead.
25448,1/2/2015,Nigeria,Maiduguri,12,37,49,A dozen people lose their lives when Boko Haram gunmen attack a small city.
25449,1/2/2015,Syria,Aleppo,2,16,18,"Army of Islam members target a neighborhood with rockets, killing two residents."
25450,1/2/2015,Egypt,Rafah,3,4,7,Two women and a child are crushed to death by two rocket attacks on their homes.
25451,1/2/2015,Pakistan,Karachi,4,1,5,Four Sunnis are gunned down in two sectarian attacks.
25452,1/2/2015,Iraq,Karaghol,2,5,7,Jihadis blow up two civilians.
25453,1/2/2015,Iraq,Sensil,11,0,11,The remains of eleven ISIS execution victims are found in a mass grave.
25454,1/2/2015,Nigeria,Dalwa,22,5,27,Nearly two dozen others lose their lives during a Boko Haram attack.
25455,1/2/2015,Iraq,Sinuni,25,0,25,"Twenty-five Yazidi victims of an ISIS execution are discovered, including women and children."
25456,2/2/2015,Bangladesh,Gaibandha,0,3,3,A married couple and one other are beaten by a Muslim mob angry about their conversion to Christianity
25457,2/2/2015,Syria,Raqqa,1,0,1,Another gay man is thrown from a building by Sharia activists.
25458,2/2/2015,Libya,Tripoli,1,2,3,One person is taken out by suspected Fajr Libya bombers.
25459,2/2/2015,Nigeria,Gombe,5,8,13,Two suicide bombers kill five people at a market.
25460,2/2/2015,Iraq,Fallujah,2,0,2,Two Shiites are beheaded by Sunnis.
25461,2/2/2015,Pakistan,Nari Baba,3,2,5,Religious radicals blow up three locals.
25462,2/2/2015,Iraq,Tikrit,7,28,35,Seven Iraqis are sent to Allah by a Fedayeen suicide bomber.
25463,3/2/2015,Libya,Mabrook,13,0,13,Islamists storm an oilfield and slit the throats of thirteen employees.
25464,3/2/2015,Thailand,Yala,1,0,1,A 35-year-old man is murdered in his home by Muslim gunmen.
25465,3/2/2015,Somalia,Baidoa,1,0,1,A cleric is assassinated near his mosque by radicals.
25466,3/2/2015,France,Nice,0,3,3,Three French soldiers standing guard at a Jewish center are stabbed by a radical Muslim.
25467,3/2/2015,Syria,Raqqa,1,0,1,The caliphate releases a video showing a captured Jordanian pilot being burned alive in a cage.
25468,3/2/2015,Pakistan,Ormagi,4,0,4,Four people are disintegrated by a Tehreek-e-Taliban IED.
25469,3/2/2015,Egypt,Alexandria,1,2,3,A civilian is killed - and a child injured - by an Islamist bomb at a checkpoint.
25470,3/2/2015,Somalia,Mogadishu,1,3,4,A civilian is taken out by an al-Shabaab bomb blast.
25471,3/2/2015,Iraq,Baghdad,8,25,33,Eight people are blown to bits in three separate Mujahid bomb blasts.
25472,3/2/2015,Iraq,Baghdad,5,15,20,"Jihadis set off a series of bombs at a popular square, killing five bystanders."
25473,3/2/2015,Libya,Sidra,5,13,18,Five others are killed during an assault by Fajr Libya.
25474,4/2/2015,Yemen,Bayda,5,3,8,A suicide car bomber takes out five security personnel.
25475,4/2/2015,Iraq,Mosul,1,0,1,A priest is beheaded by the Islamic State.
25476,4/2/2015,Afghanistan,Ganjgal,2,0,2,A 23-year-old woman is among two people shot to death by a Sharia court.
25477,4/2/2015,Cameroon,Fotokol,110,500,610,Boko Haram overrun a small town and massacre over one-hundred innocents.
25478,4/2/2015,DRC,Beni,21,0,21,Seven women are among twenty-one villagers hacked to death by ADF-NALU.
25479,4/2/2015,Pakistan,Quetta,1,0,1,A guard for a polio team is shot dead by fundamentalist.
25480,4/2/2015,Iraq,Mahmoudiyyah,3,6,9,A woman is among three civilians who bleed to death following a Mujahid bombing near a bus.
25481,4/2/2015,Iraq,Mosul,4,0,4,Four people are beheaded by ISIS for condemning the burning of a pilot on Facebook.
25482,4/2/2015,Iraq,Mosul,2,0,2,Two imams are executed by Religion of Peace rivals.
25483,5/2/2015,Afghanistan,Herat,2,0,2,Suspected Taliban gunmen pull up on a motorcycle and murder two traffic cops.
25484,5/2/2015,Syria,Damascus,10,50,60,"The Army of Islam sends rockets into mainly Christian neighborhoods, killing ten residents."
25485,5/2/2015,Egypt,Cairo,1,1,2,One person is killed when Islamic extremists firebomb and fire into a KFC restaurant.
25486,5/2/2015,Iraq,Shirqat,2,0,2,A married couple is dragged into the public square and shot to death by pro-Sharia militants.
25487,5/2/2015,Iraq,Tikrit,11,22,33,Eleven Iraqis are killed during a violent ISIS attack.
25488,5/2/2015,Iraq,Mosul,2,0,2,A father and son are beheaded by the Islamic State.
25489,6/2/2015,Syria,Raqqa,1,0,1,A 26-year-old female American aid worker is reported dead by the Islamic State after being held for a year and a half.
25490,6/2/2015,Iraq,Bardiyan,23,0,23,Twenty-three Yazidi victims of Islamic State execution are found in another mass grave.
25491,6/2/2015,Niger,Bossa,4,13,17,At least four others are killed during a massive cross-border Boko Haram assault.
25492,6/2/2015,Iraq,Zumar,16,0,16,Women and children are among sixteen Yazidi victims of an ISIS execution.
25493,6/2/2015,Libya,Benghazi,2,20,22,A suicide bomber kills a man and child.
25494,6/2/2015,Afghanistan,Kandahar,1,3,4,Two suicide bombings claim the life of one other person.
25495,6/2/2015,Afghanistan,Washir,2,3,5,Two civilians are pulled into pieces by a Taliban bomb.
25496,6/2/2015,Afghanistan,Ghanikhil,2,0,2,Two policemen are shot to death by Sunni hardliners.
25497,6/2/2015,Iraq,Tikrit,7,4,11,A suicide car bomber murders seven Iraqis.
25498,6/2/2015,Iraq,Baghdad,3,5,8,A bomb blast at a market leaves three dead.
25499,6/2/2015,Iraq,Ramadi,6,9,15,Six Iraqis are blown to bits by a Shahid suicide bomber.
25500,7/2/2015,Iraq,Baghdad,5,13,18,Five Iraqis are disassembled by a Fedayeen suicide bomber at a commercial district.
25501,7/2/2015,Iraq,Baghdad,22,45,67,A brutal suicide bombing at a packed restaurant snuffs out the lives of twenty-two innocents.
25502,7/2/2015,Iraq,Baghdad,11,26,37,Two bombs at a market produce eleven bodies.
25503,7/2/2015,Pakistan,Parachinar,1,0,1,A Shiite is shot to death by Sunni radicals.
25504,7/2/2015,Iraq,Jalawla,1,0,1,A Kurd is tortured and killed on video by Shiite militia.
25505,8/2/2015,Syria,Aldbsa,1,0,1,An elderly man is publicly beheaded for 'witchcraft'.
25506,8/2/2015,Afghanistan,Nangarhar,2,1,3,Militants enter a rival mosque and gun down two people.
25507,8/2/2015,Somalia,Puntland,2,5,7,"Islamic activists roll up to a police checkpoint and throw in a grenade, killing two officers."
25508,8/2/2015,Niger,Diffa,5,15,20,"A Shahid suicide bomber detonates at a pepper market, killing five patrons."
25509,8/2/2015,Pakistan,Nari Baba,3,5,8,Lashkar-e-Islam kill ten members of a peace committee with an IED in a house.
25510,9/2/2015,Iraq,Saniya,13,6,19,Over a dozen people at a popular gathering place are torn to pieces by a Shahid suicide bomber.
25511,9/2/2015,Iraq,Mosul,5,0,5,Five Iraqis are executed by the Islamic State.
25512,9/2/2015,Iraq,Mosul,0,15,15,Fifteen women are reportedly arrested and disfigured with acid by the caliphate for not wearing the niqab.
25513,9/2/2015,Somalia,Mogadishu,3,0,3,A member of parliament is assassinated by a group fighting for Islamic law.  Two bodyguards are also killed.
25514,9/2/2015,Iraq,Kadhimiyah,18,42,60,A Sunni suicide bomber takes out eighteen innocents near a Shia shrine.
25515,9/2/2015,Iraq,Husseiniyah,4,8,12,"A Jihadi bomb blast rips through a commercial area, claiming four souls."
25516,9/2/2015,Pakistan,Hayatabad,1,0,1,Sipah-e-Sahaba gunmen murder a Shiite doctor.
25517,9/2/2015,Pakistan,Karachi,1,0,1,A Shia museum official is taken down in a Sunni drive-by.
25518,10/2/2015,Afghanistan,Jalalabad,2,3,5,"A massive suicide attack leaves two dead, including a female politician."
25519,10/2/2015,Iraq,Tarmia,3,10,13,Ten Shiites are laid out by a Sunni bomb.
25520,10/2/2015,Somalia,Guri-El,12,30,42,A dozen people lose their lives when Ahlu Sunna Wal Jama'a attack a government building.
25521,10/2/2015,Iraq,Madain,2,7,9,Two civilians are taken out by an IED.
25522,10/2/2015,Iraq,Baghdad,4,18,22,Two Mujahid bomb blasts produce a four dead Iraqis.
25523,10/2/2015,Afghanistan,Kunduz,1,3,4,Five suicide bombers manage to kill only one other person.
25524,10/2/2015,Nigeria,Logo,22,20,42,Fulani terrorists massacre over twenty villagers.
25525,10/2/2015,Cameroon,Koza,7,8,15,"Boko Haram hijacks a bus with passengers, kills seven and kidnaps eight young girls."
25526,10/2/2015,Egypt,Arish,10,0,10,Ten people are beheaded on video by Ansar Bait al-Maqdis.
25527,10/2/2015,Iraq,Samarrah,6,29,35,A Fedayeen suicide bomber takes out six other people.
25528,11/2/2015,Iraq,Baghdad,9,25,34,Two Jihadi bombings leave nine dead.
25529,11/2/2015,Iraq,Tikrit,12,37,49,Three ISIS suicide bombers kill a dozen Iraqis.
25530,11/2/2015,Iraq,Baghdad,10,25,35,Ten civilians lose their lives when terrorists send mortar shells into two Shiite neighborhoods.
25531,11/2/2015,Libya,Benghazi,40,0,40,Forty severed heads are discovered at a training camp for Islamists.
25532,11/2/2015,Syria,Raqqa,1,0,1,An ISIS prisoner is executed with a shotgun blast to the head.
25533,11/2/2015,Iraq,Mosul,1,0,1,A female politician is publicly executed by the Islamic State.
25534,12/2/2015,Iraq,Salamiya,30,0,30,Thirty people are rounded up and executed for refusing to fight for the Islamic State.
25535,12/2/2015,Pakistan,Maldilan,2,2,4,"A bomb shaped like a toy kills two children, ages 6 and 13."
25536,12/2/2015,Nigeria,Biu,11,20,31,A female suicide bomber slaughters eleven people at a packed market.
25537,12/2/2015,Yemen,Baihan,8,0,8,Eight defenders are killed during an al-Qaeda attack which began with a suicide bombing.
25538,12/2/2015,Nigeria,Mbuta,9,0,9,Nine villagers are massacred by Boko Haram.
25539,12/2/2015,Nigeria,Akida,12,0,12,Twelve villagers are massacred by Boko Haram.
25540,12/2/2015,Yemen,Lahij,1,0,1,A pilot is shot to death by al-Qaeda.
25541,13/2/2015,Egypt,Cairo,1,8,9,A policeman is killed in a roadside bombing by Islamic extremists.
25542,13/2/2015,Pakistan,Peshawar,22,65,87,At least twenty worshippers are massacred by Jundallah gunmen with suicide vests at a Shiite mosque.
25543,13/2/2015,Iraq,Rutba,1,0,1,A boy is executed for criticizing the Islamic State on Facebook.
25544,13/2/2015,Iraq,Samarrah,6,0,6,Two children and a woman are among a family of six disassembled by a Mujahid bomb.
25545,13/2/2015,Iraq,Qadisiya,7,0,7,An ISIS crew executes seven policemen.
25546,13/2/2015,Iraq,Qaim,9,0,9,Nine civilians are executed by the Islamic State.
25547,13/2/2015,Chad,Ngouboua,10,0,10,Islamists row across a lake and murder ten villagers in a surprise attack.
25548,13/2/2015,Egypt,al-Minya,1,0,1,A Coptic youth is reportedly burned alive by Muslim miscreants.
25549,14/2/2015,Iraq,Nineveh,2,0,2,Two physicians are executed by Islamic radicals.
25550,14/2/2015,USA,"Detroit, MI",0,2,2,Two men are stabbed by a Muslim who first verified that they were unbelievers.
25551,14/2/2015,Tanzania,Tanga,1,5,6,A police officer is murdered by members of an al-Shabaab offshoot.
25552,14/2/2015,Mali,Mopti,2,3,5,Two local soldiers are left dead after a surprise attack by a suspected al-Qaeda linked group.
25553,14/2/2015,Pakistan,Orangi,1,0,1,A 32-year-old Shiite is gunned down by Sunni radicals outside his photo shop.
25554,14/2/2015,Pakistan,Shalman,1,1,2,The driver for a polio vaccination team is murdered by fundamentalist gunmen.
25555,14/2/2015,Syria,al-Bab,3,0,3,The caliphate publicly executes two men and crucifies another to a cheering crowd.
25556,14/2/2015,Pakistan,Shar Sadardin,1,0,1,A young woman is shot to death by her conservative brother on suspicion of sexual activity.
25557,14/2/2015,Iraq,Sadr City,9,0,9,"A Shiite militia ambushes and brutally executes a Sunni leader, his son and seven others."
25558,14/2/2015,Denmark,Copenhagen,1,3,4,"A gunman praises Allah and fires into a cafe hosting a free speech event organized by a cartoonist critical of Islam, killing one participant."
25559,14/2/2015,Libya,Sirte,21,0,21,"Twenty-one Christians are abducted by Islamists, forced to their knees and then beheaded."
25560,15/2/2015,CAR,Nana Grebizi,2,1,3,"A pastor and his congregant are killed by Muslims, who also torture another."
25561,15/2/2015,Iraq,Udhaim,15,0,15,Fifteen defenders are killed during an ISIS attack on a dam.
25562,15/2/2015,Denmark,Copenhagen,1,2,3,A 37-year-old Jewish man guarding a synagogue is gunned down by a Muslim radical.
25563,15/2/2015,Nigeria,Damaturu,16,30,46,"A teenaged girl blows herself up at a crowded bus station, taking at least sixteen bystanders with her."
25564,15/2/2015,Egypt,Benha,1,3,4,A policeman is picked off in a Muslim drive-by.
25565,15/2/2015,Pakistan,Rawalpindi,1,1,2,A Sunni activist is assassinated by sectarian rivals.
25566,15/2/2015,Egypt,Sheikh Zuweyid,0,2,2,Islamic militants stage two suicide car bombings on a police station.
25567,15/2/2015,Iraq,al-Baghdadi,3,0,3,Three policemen are kidnapped and executed by the Islamic State.
25568,15/2/2015,Iraq,Hawija,15,0,15,Fifteen Kurds are captured and executed by ISIS.
25569,16/2/2015,Somalia,Mogadishu,4,0,4,Four airport workers are machine-gunned at point-blank range by al-Shabaab.
25570,16/2/2015,Afghanistan,Kandahar,13,0,13,Thirteen local cops lose their lives to an ambush by armed Taliban fundamentalists.
25571,16/2/2015,Cameroon,Waza,4,10,14,Islamists slay four local soldiers.
25572,16/2/2015,Syria,Aleppo,9,20,29,Four children are among nine killed when Sunnis fire into a Shia-held neighborhood.
25573,16/2/2015,Iraq,Saladin,12,0,12,A dozen Kurds are ambushed and killed by the Islamic State.
25574,16/2/2015,Iraq,Mansouriya,1,3,4,An electrical worker is dismantled by a roadside bomb.
25575,17/2/2015,Nigeria,Hong,27,0,27,Over two dozen people in two villages are massacred by Boko Haram.
25576,17/2/2015,Nigeria,Tamsu-Shehuri,12,0,12,A dozen people are gunned down by Sharia advocates.
25577,17/2/2015,Afghanistan,Logar,22,8,30,Two dozen local recruits are massacred by a suicide bomber at a dining hall.
25578,17/2/2015,Pakistan,Zhob,4,0,4,Four members of a polio vaccination team are kidnapped and murdered by the Taliban.
25579,17/2/2015,Chad,Dikwa,2,0,2,Two guards are killed during a cross-border raid by Boko Haram.
25580,17/2/2015,Nigeria,Potiskum,4,11,15,"A Shahid suicide bomber blows himself up in a restaurant, killing the manager, a waiter and two customers."
25581,17/2/2015,Iraq,Baghdadi,45,0,45,Forty-five people are burned to death by the Islamic State.
25582,17/2/2015,Nigeria,Yamarkumi,36,20,56,Children are heavily represented in the three dozen innocents blown to bits by suicide bombers.
25583,17/2/2015,Iraq,Baghdadi,27,0,27,Islamists capture and execute twenty-seven Iraqi policemen.
25584,17/2/2015,Iraq,Fallujah,11,0,11,Eleven residents of the city are reportedly burned alive by ISIS.
25585,17/2/2015,Afghanistan,Kabul,4,0,4,A bomb blast takes out all four members of a family.
25586,17/2/2015,Iraq,Mosul,3,0,3,Three physicians are executed by the caliphate.
25587,17/2/2015,Iraq,Mosul,4,0,4,Four people are put to death for 'witchcraft'.
25588,17/2/2015,Tunisia,Kasserine,4,0,4,"al-Qaeda militants open fire on a police checkpoint, killing four officers."
25589,17/2/2015,Pakistan,Lahore,8,23,31,At least eight people are killed when a suicide bomber detonates outside a hotel.
25590,17/2/2015,Iraq,Camp Speicher,4,18,22,A Shahid suicide bomber takes out four Iraqis.
25591,17/2/2015,Iraq,Mashad,15,0,15,"Fifteen civilians are executed by the Islamic State, three of whom are burned alive."
25592,17/2/2015,Iraq,Qaim,8,0,8,Eight citizens are executed by the Islamic State.
25593,18/2/2015,Egypt,Cairo,1,0,1,A bomb planted by religious extremists kills a street cleaner.
25594,18/2/2015,Iraq,Samarrah,6,16,22,Six Iraqis are sent to Allah by a Fedayeen suicide bomber.
25595,18/2/2015,Iraq,Mosul,1,0,1,An elderly man is tied up and stoned to death after being accused of adultery.
25596,18/2/2015,Pakistan,Islamabad,4,6,10,"A Jundullah suicide bomber detonates outside a Shiite mosque, killing four innocents."
25597,18/2/2015,Egypt,Suez,1,1,2,One person is killed by Islamic radicals.
25598,18/2/2015,Pakistan,Nazimabad,2,0,2,A prominent Shiite and his driver are murdered by sectarian rivals.
25599,19/2/2015,Iraq,Mosul,1,0,1,A journalist is executed by the Islamic State.
25600,19/2/2015,Pakistan,Karachi,1,0,1,A young political worker is murdered by religious extremists.
25601,19/2/2015,Iraq,Baghdad,2,0,2,A farmer and his wife die from splinter injuries after caliphate militants lob mortars into their home.
25602,19/2/2015,Iraq,Ghazaliyah,2,8,10,Two people in a commercial district are reduced to pulp by a Mujahid bomb blast.
25603,19/2/2015,Iraq,al-Baghdadi,100,0,100,One-hundred tribesmen are publicly executed by ISIS.
25604,19/2/2015,India,Karnataka,1,1,2,A Hindu man is hacked to death by members of an Islamist group.
25605,19/2/2015,Nigeria,Chibok,30,0,30,At least thirty are left dead when Boko Haram gunmen open up randomly on villagers.
25606,19/2/2015,Syria,Raqaa,3,0,3,Three prisoners are beaten to death by an angry mob of Islamists.
25607,19/2/2015,Afghanistan,Spin Boldak,6,10,16,Three civilians are among a half dozen people killed during by a Taliban suicide attack.
25608,19/2/2015,Niger,Tourba Guida,3,3,6,Three people are murdered by a Boko Haram attack on a village.
25609,19/2/2015,Iraq,Baghdad,3,11,14,Three people at a cafe are taken out in mid-bite by Jihadi bombers.
25610,20/2/2015,CAR,Bangui,16,0,16,Sixteen Christians are massacred by a Muslim mob.  Some are decapitated.
25611,20/2/2015,Somalia,Mogadishu,25,40,65,A Shahid suicide bomber exterminates twenty-five  'apostates' at a luxury hotel.
25612,20/2/2015,Nigeria,Ribadu,13,0,13,Boko Haram murder thirteen villagers and set their homes on fire.
25613,20/2/2015,Nigeria,Gatamarwa,10,0,10,Women are among ten people killed when Islamists attack a village.
25614,20/2/2015,Iraq,al-Ghazlani,5,0,5,"Five tribal elders are kidnapped, tortured and murdered by the caliphate."
25615,20/2/2015,Libya,al-Qubah,47,80,127,Fifty people are blown to bits by three Islamic State suicide car bombs.
25616,20/2/2015,Thailand,Narathiwat,0,13,13,Muslim 'insurgents' set off a car bomb outside a karaoke bar.
25617,20/2/2015,Niger,Karamga,8,0,8,A surprise Boko Haram attack on an island community leaves eight others dead.
25618,21/2/2015,Iraq,Baiji,1,0,1,An elderly woman is shot to death by religious extremists.
25619,21/2/2015,Iraq,al-Baghdadi,43,0,43,Forty-three moderate Sunnis are burned alive by the caliphate.
25620,21/2/2015,Iraq,Shirqat,4,0,4,Three woman are among four executed by the Islamic State for 'moral crime'.
25621,21/2/2015,Syria,Qardaha,4,0,4,At least four others are killed by a suicide bomber at a hospital.
25622,21/2/2015,Syria,Aleppo,6,10,16,"A Sunni group sends mortars into a neighborhood, killing six residents."
25623,21/2/2015,Nigeria,Gaya,23,0,23,Two dozen people are slaughtered by Boko Haram.
25624,22/2/2015,Iraq,Tikrit,8,15,23,A Fedayeen suicide truck bomber sends eight souls to Allah.
25625,22/2/2015,Israel,Jerusalem,0,1,1,An ultra-Orthodox Jew is stabbed by a Palestinian.
25626,22/2/2015,Nigeria,Potiskum,5,48,53,A child suicide bomber murders seven patrons at an outdoor market.
25627,22/2/2015,Iraq,Baghdad,7,14,21,"Muslim radicals set off a car bomb outside a row of car repair shops, killing seven innocents."
25628,22/2/2015,Iraq,Baghdad,2,6,8,A Mujahid car bomb blast in a commercial district leaves two dead.
25629,22/2/2015,Iraq,Youssfiyah,2,10,12,"Jihadis bomb an outdoor market, killing two shoppers."
25630,23/2/2015,Egypt,al-Arish,1,0,1,A Copt is murdered in his shop by Ansar Bait al-Maqdis.
25631,23/2/2015,Pakistan,Chaman,1,9,10,The Taliban is blamed for killing an 8-year-old boy with a motorcycle bomb outside a Hindu temple.
25632,23/2/2015,Syria,Tel Goran,4,90,94,ISIS 'fighters' attack a series of Christian villages and kidnap ninety women and children.
25633,23/2/2015,Syria,Damascus,6,13,19,Twin suicide attacks on a Shia shrine claim the lives of six worshippers and guards.
25634,23/2/2015,Iraq,Muqdadiyah,1,0,1,A civilian is executed by the caliphate.
25635,23/2/2015,Syria,al-Hasakah,6,60,66,"Six people are murdered during an ISIS attack on a Christian village, including one woman reportedly raped and killed."
25636,24/2/2015,Iraq,Jisr Diyala,25,50,75,A double bombing at a Shia neighborhood leaves over two dozen dead.
25637,24/2/2015,Nigeria,Kano,12,30,42,"Two teen boys self-detonate at a bus park, incinerating a dozen innocents."
25638,24/2/2015,Nigeria,Potiskum,17,53,70,Seventeen bus passengers are torn to shreds by a teenaged suicide bomber.
25639,24/2/2015,Libya,Tripoli,2,0,2,A female activist and her aunt are shot to death by suspected Islamists.
25640,24/2/2015,Afghanistan,Logar,20,8,28,Four Taliban suicide bombers slaughter twenty local police officers.
25641,24/2/2015,Syria,Ghibsh,2,0,2,Two civilians are executed by the Islamic State for 'dealing with Kurds'.
25642,24/2/2015,Iraq,Diyala,7,12,19,Seven Iraqis are pulled into pieces during two ISIS car bomb attacks.
25643,24/2/2015,Iraq,Mosul,3,0,3,Three lawyers are executed by the Islamic State.
25644,24/2/2015,Pakistan,Karachi,1,0,1,A Sunni leader is gunned down by sectarian rivals.
25645,24/2/2015,Iraq,Latifiyah,2,7,9,Mujahid bombers kill two civilians at an outdoor market.
25646,24/2/2015,Iraq,Mishada,4,12,16,A Jihadi car bomb claims four lives.
25647,24/2/2015,Iraq,Baghdad,3,8,11,A bombing at a restaurant leaves three dead.
25648,24/2/2015,Nigeria,Gonori,4,0,4,Four residents are murdered by activists fighting for Sharia.
25649,25/2/2015,Nigeria,Borno,100,0,100,Over one hundred villagers are massacred by Boko Haram in attacks on three villages.
25650,25/2/2015,Yemen,Sanaa,10,0,10,"Shiite radicals send shells into an army camp, killing ten people."
25651,26/2/2015,Nigeria,Jos,17,14,31,A dozen students are among seventeen innocents shredded by Islamist bombers at a bus station.
25652,26/2/2015,Niger,Zaourararm,2,0,2,Two villagers on a horse-driven car are taken out by Boko Haram bombers.
25653,26/2/2015,Somalia,Mogadishu,1,0,1,One person is killed during an al-Shabaab rocket attack.
25654,26/2/2015,Nigeria,Biu,19,17,36,"Nineteen people, including several women, are reduced to pulp by a suicide bomber at a market."
25655,26/2/2015,Bangladesh,Dhaka,1,1,2,"An atheist blogger is hacked to death by Islamists, who also injure his wife."
25656,26/2/2015,Syria,al-Masamier,15,0,15,"Fifteen Christians taken hostage earlier in the week are executed, including a woman who is beheaded."
25657,26/2/2015,Egypt,Cairo,1,1,2,A person bleeds to death outside a pizzeria following a Religion of Peace bomb blast.
25658,26/2/2015,Afghanistan,Kabul,2,1,3,A suicide car bomber takes out two other people.
25659,26/2/2015,Iraq,al-Baghdadi,26,0,26,Twenty-six more people are reported burned to death by order of a fatwa.
25660,26/2/2015,Iraq,Mahmoudiya,4,8,12,"Jihadis set off a bomb outside a courthouse, killing four bystanders."
25661,27/2/2015,Pakistan,Karachi,1,1,2,A Sunni cleric is gunned down by Religion of Peace rivals.
25662,27/2/2015,Syria,Dmeir,11,0,11,Eleven people near a mosque are killed by Sunni bombers.
25663,27/2/2015,Yemen,Houta,4,0,4,"A local security patrol is sprayed with gunfire on a city street, cutting down all four members."
25664,27/2/2015,Iraq,Mosul,4,0,4,Four Iraqis are paraded before the camera and then shot in the head by observant Muslims.
25665,27/2/2015,Nigeria,Mainok,14,24,38,Islamist gunmen walk into a market and shoot fourteen traders to death.
25666,27/2/2015,Pakistan,Hayatabad,1,0,1,A Shia man dies from injuries suffered at the hands of Sunni radicals.
25667,27/2/2015,Iraq,Husseiniyah,6,0,6,A man and his five sons are executed in their home by a Shiite militia.
25668,27/2/2015,Afghanistan,Nangarhar,2,13,15,Two children are disassembled by a Fedayeen suicide bomber.
25669,27/2/2015,Iraq,Baghdad,6,16,22,A rocket attack and a car bombing leave six dead.
25670,27/2/2015,Pakistan,Peshawar,1,0,1,Radical Sunnis gun down a prominent Shia businessman.
25671,27/2/2015,Pakistan,Karachi,2,0,2,Two Shiites are picked off outside a hospital by Sunni gunmen.
25672,27/2/2015,Iraq,al-Baghdadi,1,0,1,ISIS reportedly executes a 5-year-old girl as punishment for her family fleeing.
25673,28/2/2015,Iraq,Singar,5,0,5,Five young teens are executed by the Islamic State.
25674,28/2/2015,Syria,Aleppo,2,17,19,A child is among two civilians who bleed out following an Islamist mortar attack.
25675,28/2/2015,Syria,Aleppo,29,0,29,"al-Nusra turns on a moderate rebel group, killing nearly thirty in a surprise attack."
25676,28/2/2015,Iraq,Samarrah,16,31,47,Two suicide car bombings claim sixteen souls.
25677,28/2/2015,Iraq,Balad Ruz,11,50,61,Jihadi bombers take out a dozen people at a market.
25678,28/2/2015,Iraq,al-Baghdadi,5,6,11,Five civilians bleed out after ISIS send mortars into a residential area.
25679,28/2/2015,Iraq,Baghdad,7,8,15,Two Jihad bomb blasts produce seven dead Iraqis.
25680,28/2/2015,Nigeria,Ngamdu,2,0,2,Two female suicide bombers murder two other people at a bus stop.
25681,1/3/2015,Egypt,Aswan,2,5,7,Islamists kill two people in a tourist town with a planted bomb.
25682,1/3/2015,Libya,Benghazi,2,30,32,"Islamists are suspected of lobbing rockets into a government controlled area, killing two residents."
25683,1/3/2015,Iraq,Anbar,2,2,4,Two people are sent to Allah by a Shahid suicide bomber.
25684,1/3/2015,Iraq,al-Baghdadi,32,0,32,Nearly three dozen Iraqis are kidnapped and executed by the Islamic State.
25685,1/3/2015,Iraq,al-Baghdadi,3,3,6,Three children are exterminated by an ISIS mortar.
25686,1/3/2015,Lebanon,Kuweikhat,1,0,1,Sunnis assassinate a prominent Shia.
25687,2/3/2015,Libya,Mechili,1,0,1,Islamists behead a Coptic man.
25688,2/3/2015,Nigeria,Baga,2,0,2,Two men are beheaded on video by radical Islamists.
25689,2/3/2015,Nigeria,Njaba,68,24,92,Over sixty are reported dead after Islamists circulate a village and fire randomly into houses.  Children were targeted.
25690,2/3/2015,Iraq,Tikrit,4,0,4,Four tribesmen are shot in the back of the head by the Islamic State.
25691,2/3/2015,Egypt,Cairo,2,9,11,Two civilians standing outside a courtroom are obliterated by an Islamist bomb.
25692,2/3/2015,Iraq,Sinjar,77,0,77,More mass graves are discovered containing seventy-seven victims of ISIS killings - mostly minority women and children.
25693,2/3/2015,Afghanistan,Jalalabad,2,2,4,Two children are pulled into pieces by Holy Warrior bombers.
25694,2/3/2015,Iraq,al-Baghdadi,3,3,6,"ISIS militants send shells into a home, killing a woman and two children."
25695,2/3/2015,Niger,Bosso,2,0,2,Boko Haram members burn down a village and murder two fishermen.
25696,2/3/2015,Iraq,Baghdad,3,15,18,"Two Mujahid bombs, one at a soccer field and the other at a shop, leave three dead."
25697,2/3/2015,Iraq,al-Jalam,7,15,22,"A truck bomb explodes, killing seven people nearby."
25698,2/3/2015,Iraq,al-Dour,4,30,34,Four Iraqis are sectionalized by a Fedayeen suicide bomb blast.
25699,2/3/2015,Afghanistan,Nangarhar,6,2,8,Two children and two women are among a family cut down by Taliban roadside bombers.
25700,2/3/2015,Pakistan,Marriabad,3,3,6,Evidence strongly suggests a targeted rocket attack was responsible for a blast that killed a religious minority and her two children in their home.
25701,3/3/2015,Afghanistan,Sangin,7,7,14,A Fedayeen suicide bomber makes mincemeat out of seven Afghans.
25702,3/3/2015,Syria,Raqqa,1,0,1,A gay man is thrown from a rooftop by the Islamic State.
25703,3/3/2015,Iraq,al-Baghdadi,3,10,13,A child and two women are killed when caliphate terrorists send mortars into a neighborhood.
25704,3/3/2015,Yemen,al-Qatan,3,2,5,Three security personnel are exterminated by al-Qaeda bombers.
25705,3/3/2015,Yemen,al-Baida,5,15,20,Five others are killed by a double suicide bombing.
25706,3/3/2015,Iraq,Baqubah,3,0,3,Three civilians are brought down by Jihadi bombers.
25707,3/3/2015,Niger,Lake Chad,17,0,17,Seventeen people are reported drowned or burned to death during a Boko Haram attack on their village.
25708,4/3/2015,Syria,Aleppo,15,0,15,An al-Nusra bomb leaves fifteen dead.
25709,4/3/2015,Iraq,al-Dour,5,0,5,Five Iraqis are cut down by a Fedayeen suicide bomber.
25710,4/3/2015,Philippines,Jolo,3,6,9,Abu Sayyaf terrorists ambush and kill three local soldiers.
25711,4/3/2015,Pakistan,Hub,1,0,1,A Shia doctor is abducted and brutally tortured to death by Sunnis.
25712,4/3/2015,Pakistan,Karachi,2,0,2,A prominent Sunni and his driver are murdered by sectarian gunmen.
25713,4/3/2015,Pakistan,Korangi,1,0,1,A Shia lawyer is shot twice in the head by Sunni gunmen.
25714,5/3/2015,Afghanistan,Adam Khan,7,0,7,Seven police officers are poisoned and then shot by fundamentalists.
25715,5/3/2015,Nigeria,Gwoza,6,0,6,A half-dozen elderly men are rounded up and executed by Boko Haram.
25716,5/3/2015,Afghanistan,Uruzgan,2,0,2,Two local cops are gunned down by a Taliban insider.
25717,5/3/2015,Syria,al-Qanafz,5,1,6,Two children are among five Shiite family members slaughtered by ISIS.
25718,5/3/2015,China,Guangzhou,0,13,13,Thirteen people at a train station are slashed by a group of Muslim terrorists.
25719,5/3/2015,Iraq,Baghdad,3,12,15,"A bomb rips through an outdoor market, taking three souls."
25720,6/3/2015,Egypt,Mahalla,3,16,19,"Terrorists detonate a bomb outside a bank, killing three bystanders."
25721,6/3/2015,Syria,Raqqa,2,0,2,Two men are shot in the back of the head by caliphate members.
25722,6/3/2015,Israel,Jerusalem,0,5,5,"A Palestinian rams his car into a group of people, injuring five."
25723,6/3/2015,Libya,al-Ghani,11,0,11,"Eleven guards at an oilfield are murdered by Islamists, some by beheading."
25724,6/3/2015,Iraq,Mosul,1,0,1,A secular judge is executed by the Islamic State.
25725,6/3/2015,Iraq,Tikrit,4,28,32,Four Iraqis are taken out by a suicide truck bomber.
25726,6/3/2015,Somalia,Beledweyne,3,0,3,A child is among three people murdered by al-Shabaab gunmen.
25727,7/3/2015,Nigeria,Maiduguri,62,139,201,Sixty people lose their lives to three separate suicide attacks on civilian population centers.
25728,7/3/2015,Afghanistan,Kabul,6,5,11,Sunni extremists attack a Sufi house of worship and slaughter eleven innocents.
25729,7/3/2015,Mali,Bamako,5,8,13,"Islamists throw a grenade into a nightclub, then hack some of the survivors to death with machetes while praising Allah."
25730,7/3/2015,Iraq,Anbar,3,3,6,A Fedayeen suicide bomber sends three souls to Allah.
25731,7/3/2015,Iraq,Khan Bani Saad.,2,0,2,Two people at a sports venue are exterminated by Jihadi bombers.
25732,7/3/2015,Iraq,Baghdad,3,11,14,Three people bleed to death following an Islamic bomb attack on a bus.
25733,7/3/2015,Iraq,Hawija,20,0,20,Twenty men are butchered by Religion of Peace activists and hung at the gate to a city.
25734,7/3/2015,Iraq,Baghdad,2,7,9,Two people at a market are disassembled by a Mujahid bomb blast.
25735,7/3/2015,Iraq,Baghdad,4,9,13,"Jihadis send mortars into a neighborhood, killing four residents."
25736,7/3/2015,Iraq,Tuz Khurmatu,8,32,40,A suicide bomber murders eight people in a town center.
25737,7/3/2015,Afghanistan,Greshk,1,3,4,A suicide bomber kills one other person.
25738,8/3/2015,Uganda,Iganga,1,0,1,A 16-year-old girl is suspected to have been poisoned to death by relatives after being beaten for converting to Christianity.
25739,8/3/2015,Egypt,Alexandria,1,9,10,One person is killed when Islamic militants set off a bomb outside a supermarket.
25740,8/3/2015,Afghanistan,Jawzjani,2,15,17,Talibanis murder two prison guards and set another man on fire.
25741,8/3/2015,Mali,Kidal,3,8,11,Two children are among three killed when suspected al-Qaeda send rockets into a town.
25742,8/3/2015,Bangladesh,Joypurhat,1,1,2,One passenger is killed when Islami Chatra Shibir bombers target a bus.
25743,8/3/2015,Iraq,Madaen,2,0,2,Two passersby are obliterated by a Mujahid bomb blast targeting a city bus.
25744,8/3/2015,Iraq,Mahmoudiya,3,17,20,A Sunni car bomb in a Shia area leaves three dead and seventeen others with splinter injuries.
25745,8/3/2015,Iraq,Hussainiya,3,0,3,A blast at a restaurant in a Shiite area leaves three dead.
25746,8/3/2015,Iraq,Baghdad,5,4,9,Five Iraqis are taken out by two Jihadi bomb blasts.
25747,9/3/2015,Iraq,Zoba,3,9,12,Three Iraqis are laid out by a Fedayeen suicide bomb blast.
25748,9/3/2015,Iraq,Kirkuk,5,35,40,Three ISIS car bombs leave five dead.
25749,9/3/2015,Pakistan,Chagharzai,2,0,2,Two women are honor killed over moral activity by family members with machine-guns.
25750,9/3/2015,Yemen,Mahfad,2,0,2,Two others are killed during an al-Qaeda attack.
25751,9/3/2015,Egypt,al-Kharouba,3,1,4,Islamists murder three local soldiers with a roadside bomb.
25752,9/3/2015,Pakistan,Karachi,1,0,1,A Shiite university student is shot to death in a suspected targeted attack by Sunnis.
25753,9/3/2015,Libya,Derna,2,0,2,Two hostages are executed in cold blood by Islamists.
25754,10/3/2015,Austria,Liesing,1,0,1,A 'migrant' stabs an older man to death on the grounds that his music was against Islam.
25755,10/3/2015,Afghanistan,Pul-e-Khumri,1,15,16,One woman bleeds from shrapnel injuries following a Mujahid bomb blast.
25756,10/3/2015,Afghanistan,Tirin Kot,4,5,9,Two children are disassembled along with two others by Taliban bombers.
25757,10/3/2015,Afghanistan,Lashkar Gah,7,28,35,Seven civilians are exterminated by a Shahid suicide bomber.
25758,10/3/2015,Pakistan,Karachi,4,0,4,Four young cops are ambushed and murdered by Islamic terrorists.
25759,10/3/2015,Egypt,al-Arish,1,30,31,A civilian is killed when a Shahid suicide bomber rams a water tanker.
25760,10/3/2015,Nigeria,Maiduguri,34,17,51,A female suicide bomber slaughters nearly three dozen people at a market.
25761,10/3/2015,Egypt,al-Arish,1,6,7,Islamists kill a local soldier with a roadside bomb.
25762,10/3/2015,Nigeria,Maiduguri,8,15,23,Eight travelers are shot to death by Boko Haram terrorists.
25763,11/3/2015,Syria,Raqqa,1,0,1,The caliphate releases video of one of their children executing a Palestinian while praising Allah.
25764,11/3/2015,Iraq,Nineveh,3,0,3,Two homosexuals and a 'blasphemer' are beheaded in the two square by religious fundamentalists.
25765,11/3/2015,Iraq,Baghdad,2,7,9,Jihadis set off a bomb at a parking lot which leaves two dead.
25766,11/3/2015,Iraq,Hurriya,9,30,39,A suicide car bomber eliminates nine people along a city street.
25767,11/3/2015,Somalia,Wanlaweyn,2,0,2,al-Shabaab militants attack a small town and kill two people.
25768,11/3/2015,Egypt,Rafah,1,0,1,An ISIS affiliate shoots a 26-year-old Egyptian to death.
25769,11/3/2015,Iraq,Ramadi,17,30,47,At least seventeen others are killed by a series of ISIS suicide car bombings.
25770,12/3/2015,Somalia,Baidoa,6,8,14,A Fedayeen assault at a government compound leaves six defenders dead.
25771,12/3/2015,Yemen,Baida,1,7,8,"Shiite militia open fire on a protest rally, killing one member."
25772,12/3/2015,Afghanistan,Takhar,8,0,8,"Eight police officers, including four unarmed, are brutally murdered by the Taliban."
25773,12/3/2015,Iraq,Tal Tamr,22,0,22,At least twenty-two Kurds lose their lives to an assault by ISIS terrorists.
25774,12/3/2015,Pakistan,Peshawar,2,8,10,"Religious extremists pour machine-gun fire into a checkpoint, killing two officers."
25775,12/3/2015,Iraq,Tikrit,1,1,2,A suicide car bomber kills one other person.
25776,13/3/2015,Iraq,Saqlawiya,3,5,8,Three others lose their lives to suicide bombers.
25777,13/3/2015,Afghanistan,Deh Yak,7,3,10,Seven local cops are gunned down by Taliban fundamentalists.
25778,13/3/2015,Kenya,Mandera,3,5,8,Islamists ambush a car and shoot three occupants to death.
25779,13/3/2015,Syria,Raqqa,8,0,8,Eight prisoners are forced to their knees and then beheaded with meat cleavers by the Islamic State.
25780,13/3/2015,Syria,al-Kheir,1,0,1,A mentally-challenged man is executed by the Islamic State.
25781,13/3/2015,Syria,Deir Ezzor,1,0,1,An older woman is burned to death for not paying taxes to ISIS.
25782,14/3/2015,Iraq,Baghdad,4,11,15,"Jihadis bomb a busy market, killing four shoppers."
25783,14/3/2015,Iraq,Ramadi,2,0,2,Two Iraqis are taken out by a suicide bomber.
25784,14/3/2015,Iraq,Shamsa,19,0,19,Nineteen ISIS execution victims are found in a mass grave.
25785,14/3/2015,Egypt,Cairo,1,0,1,A garbage collector and his donkey are killed by a planted bomb.
25786,14/3/2015,Afghanistan,Nangarhar,3,6,9,Three children are pulled into pieces by fundamentalist bombers.
25787,15/3/2015,Pakistan,Lahore,17,70,87,Targeted suicide bombings near two churches by Jamaat-ul-Ahrar leave fifteen dead worshippers.
25788,15/3/2015,Iraq,Baghdad,2,12,14,Two people near a shopping center lose their lives to Mujahideen bombers.
25789,15/3/2015,Iraq,Baghdad,3,6,9,"Jihadis bomb a Shiite neighborhood, killing three residents."
25790,15/3/2015,Pakistan,Quetta,2,0,2,Two Shiite brothers are gunned down by radical Sunnis.
25791,15/3/2015,Libya,Misrata,1,1,2,At least one person is taken down by an ISIS car bomb.
25792,15/3/2015,Somalia,Gedo,6,0,6,"Six family members, including two children and two women, are slaughtered in their own home by al-Shabaab."
25793,15/3/2015,Chad,Djargagoroum,1,0,1,A villager is murdered by Boko Haram.
25794,15/3/2015,Kenya,Mandera,1,3,4,"Islamists fire on a car carrying mechanics, killing one."
25795,15/3/2015,Iraq,Mosul,9,0,9,Nine people are shot in the back of the head for 'betraying the religion of Allah'.
25796,15/3/2015,Nigeria,Egba,82,0,82,"Fulani terrorists massacre nearly one hundred Christian villagers, mostly women and children."
25797,15/3/2015,Pakistan,Shaktai,13,0,13,Thirteen mutilated victims of the Tehreek-i-Taliban are discovered.
25798,15/3/2015,Iraq,Samarrah,3,0,3,Three Iraqis are taken down by a Shahid suicide bomber.
25799,15/3/2015,Iraq,Ramadi,23,43,66,A devastating caliphate car bomb claims two dozen lives.
25800,15/3/2015,Iraq,Mosul,11,0,11,"Eleven youth are executed by the Islamic State, five of whom are beheaded."
25801,15/3/2015,Iraq,Bashir,50,0,50,At least fifty ISIS execution victims are discovered in a mass grave.
25802,15/3/2015,Iraq,Tikrit,16,0,16,"A survivor reports that sixteen members of his family, including children, were butchered by the Islamic State."
25803,16/3/2015,Afghanistan,Lashkar Gah,4,5,9,A woman and child Fare among four people liquidated by a Fedayeen suicide car bomber.
25804,16/3/2015,Afghanistan,Gandir Area,2,5,7,Children are among the casualties when the Taliban bomb a family vehicle.
25805,16/3/2015,Afghanistan,Oruzgan,1,0,1,A man is murdered in front of his wife and child by religious extremists.
25806,16/3/2015,Iraq,Albu Ajeel,13,0,13,Thirteen beheaded corpses are recovered by security forces fighting ISIS.
25807,17/3/2015,Iraq,Fallujah,9,0,9,The Islamic State executes nine tribesmen.
25808,17/3/2015,Kenya,Wajir,3,3,6,"Three are killed when Islamists throw a grenade into a shop, followed by machine-gun fire."
25809,17/3/2015,Iraq,Tikrit,2,0,2,Two doctors are executed by the Islamic State.
25810,17/3/2015,Pakistan,Dana,3,0,3,Two women are gunned down along with their guard as they administer polio drops to children.
25811,17/3/2015,Pakistan,Swat,2,3,5,Two children are neatly dispatched by a Jihadi mortar.
25812,17/3/2015,Iraq,Salahuddin,4,0,4,Four Iraqis are forced to their knees and beheaded by the Islamic State.
25813,17/3/2015,Cameroon,Golfo,1,2,3,"Sharia advocates on motorbikes fire into a crowd, killing a civilian."
25814,17/3/2015,Libya,Ghiran,2,6,8,An Islamist bomb leaves two dead.
25815,17/3/2015,Iraq,Youssifiyah,2,5,7,Two local cops are murdered by Islamic State bombers.
25816,17/3/2015,Iraq,Baghdad,3,11,14,Jihadis kill three shoppers with a well-placed bomb at a market.
25817,17/3/2015,Iraq,Tarmiyah,4,14,18,Four Iraqis are blown to bits by a Fedayeen suicide bomber.
25818,17/3/2015,Pakistan,Peshawar,1,0,1,Radicals assassinate a lawyer working on behalf of the man who helped kill bin Laden.
25819,18/3/2015,Afghanistan,Lashkar Gah,7,20,27,A suicide car bomber sends seven innocents to the hereafter.
25820,18/3/2015,Iraq,Umm Qasr,3,5,8,Terrorists take out three civilians with a booby-trapped vehicle at a trailer park.
25821,18/3/2015,Libya,Nofaliya,10,4,14,Ten personnel guarding an oil facility are murdered by ISIS.
25822,18/3/2015,Yemen,Sanaa,1,0,1,A prominent Shia journalist is assassinated by al-Qaeda.
25823,18/3/2015,Tunisia,Tunis,23,44,67,Twenty Western tourists are among twenty-three innocents shot to death at a museum by Islamic terrorists.
25824,18/3/2015,Pakistan,Bajaur,1,0,1,A polio worker is gunned down in the field by Tehreek-i-Taliban.
25825,18/3/2015,Pakistan,Yakutat,1,0,1,The Taliban gun down a secular-leaning politician.
25826,18/3/2015,Iraq,Shirqat,2,0,2,A man and his wife are executed by the caliphate for her not wearing a veil.
25827,18/3/2015,Iraq,Sawfan,5,7,12,Five civilians are burnt to a crisp when Jihadis set off explosives near a water plant.
25828,18/3/2015,Iraq,Diyala,40,0,40,A mass grave is discovered containing the bodies of forty ISIS execution victims.
25829,18/3/2015,Nigeria,Bama,24,0,24,Dozens of women are slaughtered by Boko Haram to keep them from marrying non-believers.
25830,19/3/2015,Iraq,Mosul,3,10,13,Three women are executed for refusing to have sex with caliphate members.  Ten more succumb to rape.
25831,19/3/2015,Iraq,Ismaelawa,3,0,3,A father of six is among three killed when moving a Quran booby-trapped by ISIS.
25832,19/3/2015,Egypt,Giza,2,0,2,Two people go up in flames when suspected Ansar Beit Al Maqdis firebomb a youth center.
25833,19/3/2015,Afghanistan,Kabul,1,0,1,A woman is burned alive by a crowd after being accused of burning a copy of the Quran.
25834,19/3/2015,Afghanistan,Kabul,1,0,1,At least one other person is killed by a suicide bomber.
25835,19/3/2015,Nigeria,Gamboru,11,0,11,Eleven villagers are shot to death during an attack by Boko Haram.
25836,19/3/2015,Iraq,Mosul,3,0,3,Three Kurds are beheaded by the Islamic State.
25837,19/3/2015,Iraq,Mosul,5,0,5,Five residents are beheaded by the caliphate on charges of drug use and sorcery.
25838,20/3/2015,Pakistan,Sheikhupura,1,0,1,A Christian youth dies after being set on fire by his Muslim boss.
25839,20/3/2015,Somalia,Galhareer,1,0,1,A young man is shot to death by al-Shabaab.
25840,20/3/2015,Pakistan,Gulshan,2,4,6,Two Shias are gunned down in cold blood by dedicated Sunnis.
25841,20/3/2015,Pakistan,Saddar,2,3,5,Sunnis place a bomb outside a Shia mosque that leaves two dead.
25842,20/3/2015,Iraq,Sabaa al-Bour,3,6,9,"Jihadis bomb an outdoor market, eliminating a mother and child along with one other."
25843,20/3/2015,Nigeria,Damasak,100,0,100,One-hundred dumped bodies with slit throats are discovered after a town is recaptured from Boko Haram.
25844,20/3/2015,Pakistan,Nazimabad,3,4,7,A woman is among three Pakistanis sent to Allah by a suicide bomber.
25845,20/3/2015,Syria,Hassakeh,49,177,226,Fifty Kurds celebrating their New Year are turned into paste by a suicide bomber.
25846,20/3/2015,Yemen,Sanaa,142,351,493,A large number of children are among one-hundred and forty innocents eliminated by Sunni suicide bombers as they worshipped at two Shiite mosques.
25847,20/3/2015,Iraq,Baghdad,13,0,13,Thirteen Iraqis are shredded by an ISIS bomb blast.
25848,20/3/2015,India,Kathua,4,10,14,Radical Muslims storm a police station and murder four people.
25849,20/3/2015,Yemen,al-Houta,29,0,29,Twenty-nine local servicemen are taken hostage at a government building and then summarily executed by religious extremists.
25850,21/3/2015,Somalia,Afgoye,2,5,7,"Islamists toss a grenade into a market, killing two bystanders."
25851,21/3/2015,Syria,Hama,70,0,70,At least seventy others are killed when ISIS terrorists storm a small city.
25852,21/3/2015,Afghanistan,Kunduz,3,1,4,Fundamentalist bombers send shrapnel through a car and three occupants.
25853,21/3/2015,Thailand,Yala,1,2,3,Islamic separatists shoot a rubber tapper to death in his home in front of his family.
25854,21/3/2015,Iraq,Hamam al-Alil,5,0,5,Five Kurds are beheaded by Religion of Peace proponents.
25855,22/3/2015,Iraq,al-Baghdadi,2,5,7,Two innocents are crushed to death when ISIS fires rockets into a residential area.
25856,22/3/2015,Iraq,Samarrah,2,7,9,A Fedayeen suicide bomber murders two people.
25857,22/3/2015,Iraq,Askari,1,0,1,Roadside bombers pick off a child.
25858,22/3/2015,Afghanistan,Khost,2,0,2,Two civilians are turned into paste by a Taliban bomb in front of a shop.
25859,22/3/2015,CAR,Kaga-Bandoro,11,0,11,An unprovoked sectarian attack on a village by Muslim terrorists leaves eleven dead.
25860,22/3/2015,India,Hazipur,1,1,2,A Hindu man is fatally stabbed by a gang of Muslims for marrying a Muslim woman.
25861,23/3/2015,Iraq,Mosul,1,0,1,A television journalist is executed for helping other journalists escape the Islamic State.
25862,23/3/2015,Iraq,Baghdad,4,0,4,"A family of four, including two children, are exterminated by Mujahideen."
25863,23/3/2015,Iraq,Sadr City,9,22,31,Nine people registering at a mosque lose their lives to Religion of Peace rival bombers.
25864,23/3/2015,Iraq,Baghdad,6,14,20,Sunni bombers murder six people at a vegetable market.
25865,23/3/2015,Iraq,Mosul,1,0,1,The caliphate shoots a hostage in the back of the head.
25866,23/3/2015,Yemen,Taiz,1,4,5,On person is killed when Shiite radicals fire into a crowd.
25867,23/3/2015,Syria,Alippo,13,30,43,"Sunni militants fire mortars into a city during rush hour, killing thirteen."
25868,23/3/2015,Iraq,Fallujah,4,4,8,Four Iraqis are eliminated by a Shahid suicide car bomber.
25869,23/3/2015,Iraq,Qayyarah,5,0,5,Five hostages are executed in cold blood by the Islamic State.
25870,24/3/2015,Pakistan,Lahore,0,2,2,Islamists on motorbikes open fire on a church.
25871,24/3/2015,Iraq,Tel Thahab,11,0,11,The remains of eleven ISIS victims are discovered in a mass grave.
25872,24/3/2015,Yemen,Taiz,6,33,39,"Shiite militia open fire on a group of unarmed demonstrators, killing six."
25873,24/3/2015,Libya,Benghazi,7,12,19,Seven others are reduced to parts by a Fedayeen suicide bomber.
25874,24/3/2015,Afghanistan,Wardak,13,0,13,Thirteen bus passengers are singled out and shot to death by Muslim radicals.
25875,24/3/2015,Afghanistan,Ghazni,5,10,15,Five children at a playground are disassembled by fundamentalist bombers.
25876,24/3/2015,Egypt,al-Kharouba,2,6,8,Islamists kill two locals soldiers with a roadside bomb.
25877,24/3/2015,Iraq,al-Baghdadi,8,10,18,"Caliphate terrorists send mortars into a neighborhood that take apart eight innocents, including three children and their mother."
25878,25/3/2015,Iraq,Mosul,2,0,2,A couple is handcuffed and then stoned to death for adultery.
25879,25/3/2015,Afghanistan,Kabul,8,31,39,Eight people are pulled into pieces by a Fedayeen suicide bomber.
25880,25/3/2015,Libya,Sirte,5,0,5,Five volunteers are killed when an ISIS militant fires a rocket into their checkpoint.
25881,25/3/2015,Afghanistan,Nangarhar,4,6,10,"Three children, a farmer and a cow are all sent to Allah by Taliban bombers."
25882,25/3/2015,Egypt,Fayum,1,0,1,Ansar Beit al-Maqdis is suspected of leaving a bomb that kills a 10-year-old girl.
25883,25/3/2015,Nigeria,Gwoza,75,0,75,Seventy-five people have their throats slit by Boko Haram.
25884,25/3/2015,Libya,Sirte,5,0,5,Five people near a power station are lit up by a suicide bomber.
25885,25/3/2015,Iraq,Mosul,3,0,3,Three brothers are beheaded by the Islamic State.
25886,26/3/2015,Afghanistan,Ali Shir,5,2,7,Five people are crushed to death when Taliban fundamentalists fire rockets into their homes.
25887,26/3/2015,Kenya,Mombasa,1,0,1,A local cop is shot to death by Islamists.
25888,26/3/2015,Afghanistan,Mata Khan,2,1,3,"The Taliban stop a vehicle with a landmine, then machine-gun the occupants."
25889,26/3/2015,Iraq,Mosul,1,0,1,An Iraqi is beheaded by caliphate members.
25890,26/3/2015,Pakistan,Loralai,6,4,10,Muslim terrorists machine-gun six police officers point-blank in their vehicles.
25891,26/3/2015,Iraq,Ishaki,7,0,7,Seven civilians are exterminated by an ISIS roadside bomb.
25892,26/3/2015,Iraq,Baqubah,3,0,3,Sectarian Jihadis gun down three family members in their home.
25893,26/3/2015,India,Kolkata,0,1,1,A school principal is beaten with iron rods by students after allegedly disparaging Islam.
25894,27/3/2015,Egypt,Minya,0,7,7,Young Muslim radicals firebomb a church built to memorialize Coptic victims of ISIS beheadings.
25895,27/3/2015,Somalia,Mogadishu,18,28,46,"Eighteen others lose their lives when Islamists set off a suicide blast at a hotel, then riddle guests with bullets."
25896,27/3/2015,Somalia,Kismayo,6,0,6,al-Shabaab releases a video showing the brutal execution of six young Christians.
25897,27/3/2015,Pakistan,Karachi,2,14,16,Muslim militants claim two lives with a motorcycle bomb.
25898,27/3/2015,Pakistan,Nowshera,1,0,1,A religious scholar is gunned down by Religion of Peace rivals.
25899,28/3/2015,Nigeria,Shole,7,0,7,"Seven people are shot, stabbed or burned to death when religious extremists invade their village."
25900,28/3/2015,Iraq,Kirkuk,2,0,2,Two Iraqis are picked off by Islamic State snipers.
25901,28/3/2015,Egypt,Cairo,0,8,8,Ajnad Misr set off a bomb at a university.
25902,28/3/2015,Pakistan,Jaffarabad,3,0,3,Conservative Muslims enter a vice den and murder three people.
25903,28/3/2015,Nigeria,Buratai,25,30,55,Twenty-five villagers are massacred by Islamists - all but two beheaded with chainsaws.
25904,28/3/2015,Nigeria,Tilen,2,0,2,Two people are murdered by Sharia proponents.
25905,28/3/2015,Nigeria,Dukku,3,2,5,Boko Haram roll up on a polling station and gun down three innocents.
25906,28/3/2015,Nigeria,Birin Fulani,1,0,1,A shooting attack on a second polling station by Islamists yields another dead voter.
25907,28/3/2015,Nigeria,Birin Bolawa,1,0,1,"Boko Haram gun down a voter at a polling station, claiming that it is Allah's will."
25908,29/3/2015,Syria,Hama,8,0,8,Eight Shiites are beheaded by the Sunni co-religionists.
25909,29/3/2015,Afghanistan,Kabul,2,8,10,A Fedayeen suicide bomber takes out two innocents.
25910,29/3/2015,Iraq,Mosul,1,0,1,A woman who previously ran for political office is captured and executed by the Islamic State.
25911,29/3/2015,Iraq,Baghdad,7,0,7,At least seven Iraqis lose their lives to three Jihadi bombings.
25912,29/3/2015,Iraq,Dujail,6,14,20,A Fedayeen suicide assault leaves six others dead.
25913,29/3/2015,Pakistan,Hayatabad,1,0,1,The Taliban are suspected of gunning down an off-duty soldier.
25914,30/3/2015,Uganda,Kampala,1,0,1,Sharia advocates shoot a top prosecutor to death.
25915,30/3/2015,Libya,Zawiya,1,5,6,Fajr Libya is suspected of killing a foreign oil worker with a rocket.
25916,30/3/2015,Mali,Gao,1,1,2,"Mujao Jihadists fire an aid truck, killing a Red Cross worker."
25917,30/3/2015,Syria,Damascus,1,30,31,"An al-Nusra allied group fires a rocket into a historical district, killing a shopper."
25918,30/3/2015,Afghanistan,Mazar-e-Sharif,1,0,1,A government official is assassinate by the Taliban.
25919,30/3/2015,Iraq,Baghdad,11,20,31,Sunni extremists blast the life out of eleven people at two Shiite commercial districts.
25920,30/3/2015,Bangladesh,Dhaka,1,0,1,Another atheist blogger is found out by Islamists and hacked to death with meat cleavers.
25921,30/3/2015,Afghanistan,Khogyani,2,5,7,The lives of two Afghans are cut short by Taliban bombers.
25922,30/3/2015,Iraq,Tal Afar,6,0,6,A half-dozen teachers are reportedly executed for speaking out against ISIS.
25923,30/3/2015,Iraq,Fallujah,7,9,16,A Shahid suicide bomber blows seven other souls to bits.
25924,31/3/2015,Philippines,Pitogo,1,1,2,Abu Sayyaf gunmen kill a 2-year-old girl and abduct her teen sister.
25925,31/3/2015,Syria,Mabujeh,37,21,58,"The Islamic State executes thirty-seven Shiites and Sunni 'apostate' civilians, including women and children."
25926,31/3/2015,Afghanistan,Ghazni,7,0,7,Three children and three women are among seven family members cut to ribbons by a Religion of Peace roadside bomb.
25927,31/3/2015,Afghanistan,Faryab,1,0,1,A captive is beheaded by the Islamic Movement of Uzbekistan.
25928,31/3/2015,Nigeria,Gaamber Tyev,30,0,30,"Thirty villagers, including women and children, are massacred by Fulani terrorists."
25929,31/3/2015,Iraq,Kirkuk,1,0,1,ISIS bombers pick off a taxi driver.
25930,31/3/2015,Iraq,Taji,6,11,17,A suicide bomber slaughters six Shiite pilgrims aboard a bus.
25931,31/3/2015,Pakistan,Tank,1,2,3,Lashkar-e-Islam members take out a member of a peace committee.
25932,31/3/2015,Yemen,Aden,2,0,2,"Two people, including a 14-year-old boy, bleed to death following an attack by Shiite radicals."
25933,1/4/2015,Kenya,Dadaab,1,3,4,Suspected al-Shabaab shoot and kill a teacher at a refugee camp.
25934,1/4/2015,Pakistan,Narai Baba,2,3,5,Tehreek-e-Taliban murder two cops with a shrapnel bomb.
25935,1/4/2015,India,Sultanpora,1,3,4,"Mujahideen open fire on a group of police, killing one."
25936,1/4/2015,Iraq,Baqubah,1,0,1,Fundamentalists gun down a secular educator.
25937,1/4/2015,Iraq,Mosul,1,0,1,A man is stoned to death for 'violating Allah's law'.
25938,1/4/2015,Sudan,al-Fashar,41,11,52,Janjiweed militants massacre forty-one villagers.
25939,2/4/2015,Kenya,Garissa,148,79,227,"A handful of devout Muslims storm a Christian college, separate out the non-Muslims and execute one-hundred and fifty in cold blood."
25940,2/4/2015,Iraq,Hamidiye,3,0,3,Three Iraqis are shot to death by Muslim terrorists.
25941,2/4/2015,Afghanistan,Khost,20,62,82,Twenty civilians are torn to shreds by a Shahid suicide bomber with a nail-packed vest.
25942,2/4/2015,Egypt,Sheikh Zuweyid,15,19,34,"Ansar Beit al-Maqdis gunmen open up on a group of local soldiers at a checkpoint, killing fifteen."
25943,2/4/2015,Nigeria,Malam Fatori,9,16,25,Nine soldiers are ambushed and killed by Boko Haram.
25944,2/4/2015,Libya,Misrata,7,0,7,An ISIS attack leaves seven dead.
25945,2/4/2015,Iraq,Zagarit,6,11,17,Six Iraqis lose their lives to Islamic State terrorists.
25946,2/4/2015,Iraq,Samarrah,4,12,16,Four others are killed during an ISIS shooting.
25947,2/4/2015,Iraq,Baghdad,5,17,22,A brutal sectarian bomb attack takes the lives of five Shiites.
25948,2/4/2015,Pakistan,Shamshikhel,1,0,1,A terrorist bomb claims the life of a young girl.
25949,2/4/2015,Nigeria,Gombe,20,15,35,Twenty people waiting for a bus are mowed down by Boko Haram gunmen.
25950,3/4/2015,Syria,Hasakah,2,0,2,Two 'apostates' are executed by the Islamic State.
25951,3/4/2015,Chad,Maidogo,7,0,7,Seven innocents are murdered during an assault by Sharia radicals.
25952,3/4/2015,Iraq,Husseiniyah,3,8,11,Sunnis kill three patrons at a Shiite restaurant with a car bomb.
25953,3/4/2015,Iraq,Baghdad,8,18,26,Women are among eight people pulled into pieces by a Jihad bomb blast at a market.
25954,3/4/2015,India,Nalagonda,1,2,3,Students Islamic Movement of India members gun down a local cop.
25955,3/4/2015,Afghanistan,Logar,7,0,7,Four children and two women are among a family of seven disassembled by Religion of Peace bombers.
25956,3/4/2015,Yemen,Aden,4,0,4,Two humanitarian workers are among four cut down by Muslim terrorists.
25957,3/4/2015,Egypt,Sinai,3,0,3,Three civilians are murdered by a branch of the Islamic State.
25958,3/4/2015,Pakistan,Dera Ismail Khan,2,0,2,Sunni extremists gun down two people outside a children's hospital.
25959,3/4/2015,India,Saryam,3,2,5,Three civilians are reduced to ribbons by an Islamist landmine.
25960,3/4/2015,Iraq,Hammam al-Alil,1,0,1,An imam is executed by Religion of Peace rivals.
25961,4/4/2015,Mali,Bamako,1,2,3,Islamists are suspected of a planted bomb blast that leaves one dead.
25962,4/4/2015,Sudan,Tunguli,9,0,9,Seven children are among nine villagers blown apart by an Islamic Republic airstrike.
25963,4/4/2015,Afghanistan,Baghlan,4,5,9,Taliban bombers take out four civilians and leave five others with splinter injuries.
25964,4/4/2015,Saudi Arabia,Asir,2,0,2,Two border guards are taken out by Shiite snipers.
25965,4/4/2015,Syria,Yarmuk,8,0,8,Six civilians are killed in the crossfire between al-Nusra and ISIS.  Two others are beheaded.
25966,4/4/2015,Pakistan,Nanno,2,0,2,The Tehreek-i-Taliban exterminate two local soldiers.
25967,5/4/2015,Afghanistan,Jawzan,3,4,7,The Taliban ambush and kill three former members who had laid down their weapons for peace.
25968,5/4/2015,Iraq,Romana,25,0,25,Twenty-five civilians are executed by firing squad and then hung from poles by the caliphate.
25969,5/4/2015,Iraq,Baghdad,5,13,18,Two separate bombing and shooting attacks produce five dead Iraqis.
25970,5/4/2015,Iraq,Baghdad,4,10,14,Jihadis slay four patron at an outdoor market.
25971,5/4/2015,Somalia,Bossaso,2,1,3,Two people are killed when Sharia proponents open fire on a checkpoint.
25972,5/4/2015,Egypt,Alexandria,0,4,4,Ajnad Misr members open fire on a church bus.
25973,5/4/2015,Iraq,Mandali,7,0,7,Terrorists enter a quarry and shoot seven workers to death.
25974,5/4/2015,Iraq,Qadsiyah,1,1,2,Shia radicals beat a Sunni professor to death at his home in front of his family.
25975,5/4/2015,Iraq,Mosul,8,0,8,Eight Iraqis are executed by the Islamic State.
25976,5/4/2015,Nigeria,Kwajafa,24,30,54,"Islamists roll up to a village, preach Islam to the people and then turn their guns on the crowd, mowing down two dozen."
25977,5/4/2015,Afghanistan,Pul-e-Khumir,5,7,12,The lives of five civilians are obliterated by Sunni fundamentalists.
25978,5/4/2015,Mali,Gao,1,3,4,A woman is killed when religious radicals fire a shell into her home.
25979,5/4/2015,Nigeria,Kayamla,4,0,4,"Islamists raid a local market, kill four traders and take their food for the cause of Allah."
25980,5/4/2015,Libya,Misrata,6,20,26,A woman and two children are among six innocents laid out by a Shahid suicide bomber.
25981,5/4/2015,Egypt,Cairo,1,3,4,A group linked to the Muslim Brotherhood is blamed for a bomb blast on a bridge that leaves one dead.
25982,6/4/2015,Afghanistan,Baghlan,3,2,5,Three people are torn to shreds by a Taliban bomb blast.
25983,6/4/2015,Afghanistan,Qarabagh,6,0,6,Fundamentalists take out six Afghans with a roadside bomb.
25984,6/4/2015,Saudi Arabia,Awamiya,1,4,5,"Shiite radicals open fire on a police patrol, killing one member."
25985,6/4/2015,India,Ashipora,3,2,5,Three policemen on patrol are ambushed and murdered by Muslim extremists.
25986,6/4/2015,Iraq,al-Qaim,52,0,52,Fifty-two Iraqis are lined up and mowed down by caliphate gunmen.
25987,6/4/2015,Pakistan,Mamond,1,0,1,An official is taken out by Tehreek-e-Taliban bombers on his way to school.
25988,6/4/2015,India,Baramulla,1,0,1,"Muslim terrorists fire on a bus, killing one passenger."
25989,6/4/2015,Nigeria,Kaduna,14,20,34,Sharia activists massacre fourteen when they open fire on a group of market traders.
25990,6/4/2015,Bangladesh,Sreemongal,0,2,2,A pastor and parishioner are attacked and stabbed by a group of thirty-five Muslims.
25991,7/4/2015,Syria,Yarmouk,1,0,1,An ISIS sniper picks off a 13-year-old girl at a refugee camp.
25992,7/4/2015,Afghanistan,Kunar,3,3,6,Three civilians are machine-gunned by the Taliban.
25993,7/4/2015,Iraq,Mosul,4,0,4,Four men accused of theft are beheaded and crucified by the Islamic State.
25994,7/4/2015,Pakistan,Negur,8,0,8,Eight border guards are killed by Jaish-ul Adl cadres.
25995,7/4/2015,Yemen,Aden,17,110,127,At least seventeen civilians are killed when Shiite militia attack a port city.
25996,7/4/2015,Syria,Marea,9,15,24,An ISIS car bomb claims nine lives.
25997,7/4/2015,Tunisia,Sbitla,5,3,8,"Islamic extremists attack a border checkpoint, killing five guards."
25998,7/4/2015,Syria,Hawar Kilas,23,30,53,The Islamic State takes out twenty-three rivals with a car bomb.
25999,8/4/2015,Iraq,al-Qaim,248,0,248,Two-hundred and forty-eight more Iraqis are executed by the Islamic State.
26000,8/4/2015,Syria,al-Ghab,5,5,10,Terrorists take out five civilians at a parking garage.
26001,8/4/2015,Iraq,Hammam al-Alil,10,0,10,Ten physicians are executed by the Islamic State.
26002,8/4/2015,Saudi Arabia,Riyadh,2,0,2,Two cops are gunned down by drive-by ISIS terrorists.
26003,8/4/2015,Afghanistan,Kabul,1,0,1,Sunni radicals behead a Shiite man kidnapped from a bus.
26004,8/4/2015,Nigeria,Gidan Maso,1,0,1,A pastor's daughter suffocates when Muslims torch a church over another Muslim's conversion.
26005,8/4/2015,Nigeria,Kwara,7,0,7,At least seven innocents are killed by Muslim raiders in a series of attacks.
26006,8/4/2015,Afghanistan,Jalalabad,1,2,3,A US soldier is shot in the back by a Taliban in uniform.
26007,9/4/2015,Nigeria,Dile,20,10,30,"Gunmen invade a village and ""shoot anyone in sight"" while chanting 'Allah Akbar'."
26008,9/4/2015,Afghanistan,Mazar-e-Sharif,10,70,80,Ten others are killed when Sharia proponents storm a judicial office in a suicide assault.
26009,9/4/2015,Iran,Mehrestan,2,0,2,Sunni extremists fire across the border and kill two signal officers.
26010,9/4/2015,Egypt,al-Arish,11,6,17,Eleven women and children are blown apart when Ansar Beit al-Maqdis send mortar rounds into a neighborhood.
26011,9/4/2015,Afghanistan,Zabul,2,0,2,Two religious minorities are kidnapped and executed by Muslim fundamentalists.
26012,9/4/2015,Syria,Salamiyeh,1,0,1,A civilian bleeds to death after being hit with a Sunni bomb blast.
26013,9/4/2015,Syria,Homs,17,0,17,"The Islamic State kills seventeen people, including three who are beheaded."
26014,9/4/2015,Iraq,Albu Faraj,25,0,25,Twenty-five people are killed defending a small town against an ISIS assault.
26015,9/4/2015,Afghanistan,Chanarto,5,0,5,Fundamentalists kidnap and shoot five 'Save the Children' aid workers in the head.
26016,9/4/2015,Nigeria,Buratai,2,0,2,Two residents of a fishing village are murdered by Boko Haram.
26017,10/4/2015,Iraq,Albu Faraj,15,0,15,"After capturing a town, ISIS rounds up and executes seven children, six women and two elderly men."
26018,10/4/2015,Syria,Homs,1,9,10,A 10-year-old child is disassembled by a Sunni car bomb.
26019,10/4/2015,Yemen,Bayhan,25,24,49,An al-Qaeda car bomb claims the lives of two dozen Shiites.
26020,10/4/2015,Afghanistan,Ghazni,10,0,10,Fundamentalists take out a family of twelve with a roadside bomb.
26021,10/4/2015,Iraq,Baghdad,5,12,17,Jihadi bombers murder five people in a commercial district.
26022,10/4/2015,Iraq,Mishada,7,16,23,"A suicide bomber sets off his explosives vest inside a small restaurant, killing seven patrons in mid-bite."
26023,10/4/2015,Iraq,Tikrit,47,0,47,A mass grave containing forty-seven victims of ISIS executions is discovered.
26024,10/4/2015,Syria,Raqqa,1,0,1,A man is beheaded to shouts of 'Allah Akbar' by the Islamic State.
26025,10/4/2015,Syria,Homs,1,0,1,A man is stoned to death by the caliphate for sodomy.
26026,10/4/2015,Afghanistan,Jalalabad,3,4,7,Three civilians outside an airport are obliterated by a suicide car bomber.
26027,10/4/2015,Yemen,Najran,3,2,5,"Radical Shiites fire an explosive at a Saudi border checkpoint, killing three guards."
26028,10/4/2015,Afghanistan,Badakhshan,28,44,72,At least twenty-eight Afghans are killed - some by beheading - when Sunni extremists attack a check post.
26029,11/4/2015,Egypt,Sinai,2,0,2,Islamic extremists behead a civilian and execute a soldier on video.
26030,11/4/2015,Iraq,Albu Farraj,18,0,18,Eighteen more civilian hostages are executed by the Islamic State.
26031,11/4/2015,Cameroon,Dabanga,3,0,3,A Boko Haram attack leaves three dead.
26032,11/4/2015,Syria,Aleppo,20,24,44,"Terrorists shell a Christian neighborhood, killing twenty residents."
26033,11/4/2015,Syria,Huwayk,2,1,3,Sunni radicals set off a car bomb that kills two rivals.
26034,11/4/2015,Iraq,Baghdad,2,2,4,Two people lose their lives to an Islamist bombing.
26035,11/4/2015,Iraq,Baghdad,4,11,15,Four people at an outdoor market are sectionalized by a Jihadi bomb blast.
26036,11/4/2015,Afghanistan,Maidan Wardak,1,0,1,A government worker is shot to death by the Taliban on his way to the office.
26037,12/4/2015,Iraq,Ramadi,35,0,35,Video is released showing the execution of thirty-five Iraqis by the Islamic State.
26038,12/4/2015,Iraq,Albu Faraj,5,37,42,Five civilians are sectionalized by a Religion of Peace bomb blast.
26039,12/4/2015,Libya,Tripoli,2,1,3,Islamic State gunmen kill two guards outside the South Korean embassy.
26040,12/4/2015,Mali,Segou,2,3,5,Islamic militants kill two local soldiers with a roadside bomb.
26041,12/4/2015,Iraq,Baghdad,8,21,29,Three Jihadis bombings at two markets leave eight dead.
26042,12/4/2015,Iraq,Baghdad,4,9,13,A Mujahideen bomb blast in a commercial district produces four dead Iraqis.
26043,12/4/2015,Egypt,al-Arish,8,45,53,"A suicide truck bomber decimates a neighborhood, killing at least eight residents."
26044,12/4/2015,Egypt,Sheikh Zuweid,6,2,8,Religion of Peace extremists murder six local soldiers with a roadside bomb.
26045,12/4/2015,Afghanistan,Ahmadkhil,2,5,7,Two civilians lose their lives when Taliban members attack a house.
26046,12/4/2015,Thailand,Narathiwat,4,0,4,Four people are killed in their own home by Muslim terrorists.
26047,13/4/2015,Thailand,Yala,2,0,2,Militant Muslims gun down a middle-aged couple as they are working their farm.
26048,13/4/2015,Yemen,Aden,5,0,5,Three civilians are among five killed when Shiite radicals fire on a government building.
26049,13/4/2015,Iraq,Baghdad,10,25,35,An Islamic State car bomb kills ten patrons at an outdoor market.
26050,13/4/2015,Iraq,Taji,2,7,9,Two patrons at a market are pulled into pieces by a Religion of Peace car bomb.
26051,13/4/2015,Iraq,Baghdad,3,9,12,A Jihadi car bomb leaves three dead.
26052,13/4/2015,Pakistan,Karachi,1,1,2,A Shiite man is shot to death in front of his daughter by Ahle Sunnat Wal Jamaat.
26053,13/4/2015,Thailand,Narathiwat,1,0,1,A 52-year-old health inspector is shot to death by militant Muslims.
26054,13/4/2015,Afghanistan,Shahr-e-Safa,2,1,3,Two local cops are murdered by Islamic fundamentalists.
26055,14/4/2015,Pakistan,Nazimabad,2,0,2,Two people are beheaded by Muslim radicals.
26056,14/4/2015,Iraq,Muqdadiya,1,4,5,Jihadis kill a female university student with a well-placed bomb.
26057,14/4/2015,Iraq,Baghdad,8,21,29,Two women are among eight people disassembled by Sunni bombers.
26058,14/4/2015,Tunisia,Kasserine,3,3,6,"Islamic militants attack a checkpoint, killing three security personnel."
26059,14/4/2015,Iraq,al-Wihdi,6,13,19,Two ISIS car bombs at parking lots leave a half-dozen dead victims.
26060,14/4/2015,Iraq,Baghdad,3,8,11,Three people at a market are sectionalized by an Islamic State car bomb blast.
26061,14/4/2015,Iraq,Baghdad,4,10,14,"Terrorists set off a bomb outside a hospital, killing four."
26062,14/4/2015,Iraq,Mahmoudiyah,7,13,20,Sunnis blow up seven people waiting in line at a Shia bakery.
26063,14/4/2015,Afghanistan,Maidan Wardak,3,1,4,Three civilians are sent to Allah by Taliban bombers.
26064,14/4/2015,Egypt,Shibeen al-Qanatar,1,1,2,Islamists murder a traffic cop.
26065,14/4/2015,Somalia,Mogadishu,18,16,34,A suicide assault on an education building leaves eighteen innocents dead.
26066,14/4/2015,Syria,Hama,1,0,1,A man in handcuffs is beheaded for blasphemy.
26067,15/4/2015,Egypt,al-Taweela,1,1,2,A woman is kidnapped and then shot two times in the chest by Islamic hardliners.
26068,15/4/2015,Pakistan,Lahore,0,1,1,A 10-year-old boy is beaten and burned alive for telling two Muslims that he is Christian.
26069,15/4/2015,Afghanistan,Paktika,1,3,4,A child is killed when Sunni extremists fire a missile into a home.
26070,15/4/2015,Israel,Jerusalem,1,1,2,The son of a rabbi dies after being intentionally run over by an Arab driver.
26071,15/4/2015,Iraq,Albu Ghanem,9,0,9,Nine Iraqis are executed by the Islamic State.
26072,15/4/2015,Mali,Ansongo,3,16,19,A suicide bomber takes out three civilians.
26073,15/4/2015,Egypt,Kafr al-Sheikh,2,10,12,Islamic bombers kill two people waiting for a bus.
26074,15/4/2015,Yemen,Sanaa,15,0,15,Fifteen captured Yemenis are beheaded by the Islamic State.
26075,15/4/2015,DRC,Beni,19,0,19,"A pregnant woman is among nineteen victims murdered by the ADF-NALU, nine of whom were beheaded."
26076,15/4/2015,Iraq,Baiji,16,0,16,Sixteen refinery workers are reportedly killed by a suicide bomber.
26077,16/4/2015,Iraq,Ramadi,32,0,32,"The Islamic State executes thirty-two civilians, beheading the men and shooting the women and children."
26078,16/4/2015,Italy,Sicily,12,0,12,A dozen Christians on a refugee boat are thrown to their deaths by Muslims.
26079,16/4/2015,Egypt,Sheikh Zuweid,1,3,4,Fundamentalists kill a local solider with a roadside bomb.
26080,16/4/2015,Iraq,Mosul,2,0,2,Two Iraqis are publicly beheaded by the Islamic State.
26081,17/4/2015,Cameroon,Kolofata,10,0,10,An early morning raid by Boko Haram leads nineteen villagers dead.  Most were beheaded.
26082,17/4/2015,Syria,al-Mayadin,6,0,6,Six people are beheaded in front of children by the caliphate.
26083,17/4/2015,Egypt,Sheikh Zuweid,1,5,6,A local soldier bleeds out following an Islamist bomb attack.
26084,17/4/2015,Pakistan,Karachi,0,1,1,A 55-year-old American woman serving as vice-principal at a medical school is shot by Muslim extremists.
26085,17/4/2015,Iraq,Ramadi,8,5,13,Eight Iraqis are disassembled by an ISIS suicide bomber.
26086,17/4/2015,Pakistan,Muzaffargarh,1,0,1,A woman is set on fire by her husband and father-in-law for leaving the house without permission.
26087,17/4/2015,Pakistan,Lahore,0,3,3,Extremists open fire on a Catholic school.
26088,17/4/2015,Iraq,Erbil,4,18,22,An ISIS suicide car bomb claims the lives of four Kurds.
26089,17/4/2015,Nigeria,Gwoza,12,0,12,Islamists slit the throats of a dozen people.
26090,17/4/2015,Iraq,Baghdad,3,0,3,Three Iraqis lose their lives to a bomb blast at a cafe.
26091,17/4/2015,Iraq,Baghdad,3,0,3,Three shoppers are laid out by terrorists at a market.
26092,17/4/2015,Iraq,Baghdad,4,9,13,Four people at a commercial district are murdered by Islamist bombers.
26093,17/4/2015,Iraq,Amil,13,24,37,ISIS bombers take out thirteen patrons at an outdoor market.
26094,17/4/2015,Iraq,Habibya,15,26,41,Fifteen people at a car dealership are reduced to pulp by a Sunni bomb blast.
26095,18/4/2015,Somalia,Mogadishu,1,0,1,A lawmaker is assassinated by al-Shabaab.
26096,18/4/2015,Afghanistan,Ghazni,4,0,4,Four locals are abducted and beheaded by Religion of Peace enthusiasts.
26097,18/4/2015,Afghanistan,Jalalabad,36,124,160,Thirty-six people waiting outside a bank are obliterated by an ISIS suicide bomber.
26098,18/4/2015,Iraq,Diyala,13,38,51,Thirteen Iraqis are killed in a series of ISIS bombings.
26099,19/4/2015,Iraq,Zab,24,0,24,ISIS executes two dozen 'infidels'.
26100,19/4/2015,Somalia,Lower Shabelle,3,0,3,Three AU troops are killed by Islamic terrorists.
26101,19/4/2015,Libya,Sirte,30,0,30,"The Islamic State releases a video showing the brutal execution of thirty captured Ethiopian Christians, at least a dozen of whom are beheaded."
26102,19/4/2015,France,Villejuif,1,0,1,A 24-year-old woman is shot to death by an Islamic extremist who planned a shooting rampage.
26103,19/4/2015,Nigeria,Baga,2,7,9,A Boko Haram bomb blast claims two lives.
26104,19/4/2015,Afghanistan,Helmand,3,19,22,The Taliban shoot three local policemen to death.
26105,20/4/2015,Egypt,Sheikh Zuweid,2,0,2,Two boys are killed in their home by an Ansar Beit Al-Maqdis mortar round.
26106,20/4/2015,Somalia,Garowe,9,4,13,A Fedayeen suicide bomber slaughters nine UNICEF workers.
26107,20/4/2015,Egypt,Rafah,3,1,4,Three border guards are taken out by an ISIS roadside bomb.
26108,20/4/2015,Mali,Gao,1,0,1,Islamists murder a driver for a UN convoy.
26109,20/4/2015,Iraq,Baiji,7,0,7,Caliphate activists execute seven tribal elders.
26110,20/4/2015,Nigeria,Potiskum,0,3,3,A suicide bomber detonates outside a Shia mosque.
26111,20/4/2015,Syria,Deir ez-Zor,3,0,3,Three men are beheaded in the street by the caliphate.
26112,21/4/2015,Bangladesh,Ashulia,8,15,23,Members of the Bangladeshi Jihadi Group shoot eight people to death during a bank robbery.
26113,21/4/2015,Egypt,Cairo,2,0,2,Two security officers are murdered by Sunni extremists.
26114,21/4/2015,Afghanistan,Kunduz,1,5,6,A civilian is taken out by a hardliner bomb blast.
26115,21/4/2015,Afghanistan,Kandahar,3,17,20,"A planted Taliban bomb produces three dead Afghanis, including a woman."
26116,21/4/2015,Somalia,Mogadishu,10,15,25,"A Shahid suicide bomber rams straight into a crowded restaurant, sending at least ten patrons to Allah."
26117,21/4/2015,Iraq,Salaheddin,11,0,11,Eleven kneeling Iraqis are shot in the back of the head by Religion of Peace proponents.
26118,21/4/2015,Syria,Hajar al-Aswad,2,0,2,Two 'apostates' are beheaded by Muslim radicals.
26119,21/4/2015,Iraq,Madain,3,4,7,Mujahideen bombers take out three Iraqis at a commercial district.
26120,21/4/2015,Iraq,Kirkuk,3,19,22,A Jihadi bomb blast at a funeral yields three more bodies.
26121,21/4/2015,Syria,Jisr al-Shughur,7,0,7,A couple and their four children are among seven exterminated by an al-Nusra shell.
26122,22/4/2015,Libya,Derna,6,0,6,"Six members of a family are killed by Islamists, including three who are crucified."
26123,22/4/2015,Iraq,Erbil,1,0,1,A father of five is beheaded by the Islamic State.
26124,22/4/2015,Syria,Ariha,70,0,70,al-Nusra claims to have killed at least seventy others with a series of suicide attacks.
26125,22/4/2015,Afghanistan,Behsood,2,0,2,A local prosecutor and his driver are blown to bits by Sharia activists.
26126,22/4/2015,Afghanistan,Khashrod,6,1,7,Four children and their parents fall victim to Sunni fundamentalist bombers.
26127,22/4/2015,Afghanistan,Bala Murghab,9,0,9,Nine border guards are massacred by the Taliban.
26128,22/4/2015,Yemen,Yarim,5,0,5,ISIS kills five Shiites with a roadside bomb.
26129,22/4/2015,Iraq,Baghdad,3,6,9,"Jihadi bombers send shrapnel through a commercial district, taking out three bystanders."
26130,22/4/2015,Iraq,Baghdad,7,16,23,Seven Iraqis lose their lives to a Mujahid bomb blast outside a car repair shop.
26131,23/4/2015,Afghanistan,Daikundi,6,0,6,Six more innocent Shiites are brutally beheaded by Sunni fundamentalists.
26132,23/4/2015,Syria,Raqqa,2,0,2,Two men are stoned to death on charges of homosexuality.
26133,23/4/2015,Iraq,Balad,8,16,24,Sunnis liquidate eight Shiite pilgrims with a car bomb.
26134,23/4/2015,Iraq,Kirkuk,34,0,34,Thirty-four young Iraqis are executed by the Islamic State.
26135,23/4/2015,Pakistan,Lahore,1,0,1,A 19-year-old woman is strangled  - honor killed - by her father on suspicion of a sexual affair.
26136,24/4/2015,Israel,Husan,1,7,8,A 65-year-old woman is killed in a suspected terror attack.
26137,24/4/2015,Afghanistan,Maidan Wardak,2,6,8,Two civilians are sent to Allah by Mujahideen bombers.
26138,24/4/2015,Pakistan,Karachi,1,0,1,A prominent female human rights activists is shot to death by fundamentalists for holding a Valentines Day rally.
26139,24/4/2015,Iraq,Jalka,2,0,2,"Two children, ages 12 and 16, are executed by the Caliphate."
26140,24/4/2015,Pakistan,Peshawar,1,6,7,Islamic militants kill a local cop with an IED.
26141,24/4/2015,Nigeria,Bultaram,21,0,21,Twenty-one civilians carrying food are massacred by Boko Haram outside their village.
26142,24/4/2015,Afghanistan,Alingar,5,11,16,Four women are among five family members wiped out by a Taliban rocket.
26143,24/4/2015,Iraq,Nadhem al-Taqseem,14,0,14,A suicide bomb attack leaves fourteen others dead.
26144,24/4/2015,Iraq,Mosul,1,0,1,A captive is beheaded by the caliphate.
26145,24/4/2015,Afghanistan,Farah,3,0,3,"Talibanis attack a wedding party, killing the groom along with his father and brother."
26146,24/4/2015,Somalia,Jamame,1,0,1,A man is executed by an Islamist firing squad for 'insulting Allah'.
26147,24/4/2015,DRC,Kithevya,5,0,5,Five villagers are murdered by the ADF-NALU
26148,24/4/2015,Tunisia,Kasserine,3,7,10,al-Qaeda militants kill three local soldiers.
26149,24/4/2015,Thailand,Narathiwat,0,4,4,Children are among the victims of a shrapnel-packed cylinder bomb.
26150,24/4/2015,Iraq,Mahmoudiyah,3,9,12,Three people outside a courthouse are laid out by Mujahid bombers.
26151,25/4/2015,Nigeria,Plateau,6,0,6,A half-dozen Christians are murdered by Muslim radicals in attacks on three villages.
26152,25/4/2015,Iraq,Baghdad,4,11,15,Four people at an outdoor market are sectionalized by a Religion of Peace bomb blast.
26153,25/4/2015,Iraq,Anbar,4,12,16,ISIS suicide bombers kill four border guards.
26154,25/4/2015,Nigeria,Mafa,5,0,5,Five people are murdered by Sharia advocates in an early-morning attack.
26155,25/4/2015,Niger,Karamga,74,71,145,"Islamists pull up on an island and begin burning homes and shooting those trying to flee, killing at least eighty."
26156,25/4/2015,Afghanistan,Tireen Kot,2,0,2,Two people are ambushed and shot to death by the Taliban.
26157,25/4/2015,Iraq,Tarmiyiah,4,8,12,Sectarian bombers claim four souls at an outdoor market.
26158,25/4/2015,Somalia,Mogadishu,3,0,3,Three officials are assassinated by Sharia radicals.
26159,25/4/2015,Iraq,Trebil,15,22,37,Three suicide bombers take out fifteen others at a border crossing.
26160,25/4/2015,Iraq,Bayaa,4,0,4,Four men are kidnapped from a house by the Islamic State and then shot in the head.
26161,25/4/2015,Iraq,Manbij,6,0,6,Six Kurdish civilians are beheaded by the Islamic State.
26162,26/4/2015,Nigeria,Shonong,4,0,4,Boko Haram members sneak up on a village and machine-gun four residents.
26163,26/4/2015,Afghanistan,Shinkay,6,0,6,Two children and a woman are among a family of six disassembled by a Taliban bomb blast.
26164,26/4/2015,Syria,Aleppo,3,1,4,A father and daughter are among three killed by an Islamist rocket.
26165,26/4/2015,Syria,Jisr al-Shughour,30,0,30,"Thirty civilians - said to be mostly women and children - are rounded up and executed by al-Nusra, shortly after a group prayer."
26166,26/4/2015,Iraq,Nukhaib,7,2,9,Suicide bombers take out seven Iraqis.
26167,26/4/2015,Kenya,Mandera,1,0,1,"Sharia activists kidnap a secular official, tie him to a tree and execute him."
26168,26/4/2015,Afghanistan,Uruzgan,1,0,1,Religious radicals gun down a bank official.
26169,26/4/2015,Afghanistan,Noor-ul-Huda,1,0,1,A cleric who opposed violent extremism is quickly dispatched by fundamentalist bombers.
26170,26/4/2015,Iraq,Baghdad,6,17,23,A car bomb near a two square claims six lives.
26171,26/4/2015,Iraq,Baghdad,7,25,32,A suicide bomber kills seven people outside a rival mosque.
26172,26/4/2015,Iraq,Mahmoudiya,4,9,13,Religion of Peace car bombers take down four innocents.
26173,26/4/2015,Iraq,Baghdad,6,10,16,A series of Mujahideen bombings leave six dead.
26174,27/4/2015,Iraq,Mosul,1,0,1,A journalist is beheaded by the Islamic State.
26175,27/4/2015,Iraq,Baghdad,10,27,37,Children are among the casualties when a brutal bomb blast in a shopping district claims ten lives.
26176,27/4/2015,Iraq,Baghdad,7,16,23,Jihadis murder seven people with a car bomb outside a real estate office.
26177,27/4/2015,Afghanistan,Kunduz,8,2,10,A Taliban assault on a small town leaves eight defenders dead.
26178,27/4/2015,Libya,Bayda,6,0,6,Six journalists are found with their throats slit months after being taken by the Islamic State.
26179,27/4/2015,Bosnia,Zvornik,1,2,3,"A man yelling 'Allah Akbar' opens fire on a police station in the Serbian area, killing one person inside."
26180,27/4/2015,Nigeria,Guma,13,0,13,Thirteen Christians are slaughtered in their homes by Muslim raiders.
26181,27/4/2015,Iraq,Kobani,10,0,10,Islamic State militants sneak into a town and execute ten Kurds.
26182,27/4/2015,Iraq,Nineveh,2,0,2,Two are stoned to death for adultery as children look on.
26183,27/4/2015,Nigeria,Damasak,400,0,400,Officials announce the discovery of a mass grave containing four-hundred Boko Haram victims.
26184,27/4/2015,Pakistan,Mekran,3,0,3,Three Shiites are shot to death by Sunnis while waiting for a bus.
26185,27/4/2015,Thailand,Narathiwat,1,0,1,A village chief is assassinated by Muslim 'separatists'.
26186,27/4/2015,Thailand,Pattani,1,1,2,A bomb planted by Muslim terrorists kills one person and injures another.
26187,27/4/2015,Libya,Benghazi,2,0,2,Two young brothers are taken out by a suspected Ansar al-Sharia mortar.
26188,27/4/2015,Nigeria,Kogi,4,0,4,Four people are killed when fundamentalists bomb a radio station.
26189,27/4/2015,Afghanistan,Sarobi,2,0,2,Two people are shot to death by a family member for engaging in adultery.
26190,28/4/2015,Iraq,Baghdad,6,0,6,Six members of a family are abducted and executed by sectarian rivals.
26191,28/4/2015,Pakistan,Khyber Pakhtunkhwa,2,3,5,Two Tehreek-i-Taliban bombs leave two dead.
26192,28/4/2015,Afghanistan,Zabul,2,0,2,Two men carrying food are ambushed and riddled with bullets by Sunni hardliners.
26193,29/4/2015,Pakistan,Karachi,1,0,1,Fundamentalists are suspected in the targeted killing of a secular university professor.
26194,29/4/2015,Libya,Tripoli,2,0,2,Two journalists are murdered by Sharia activists.
26195,29/4/2015,Iraq,Mosul,10,0,10,Ten oil workers are forced to their knees and shot in the head by the Islamic State.
26196,29/4/2015,Yemen,Khor Maksar,12,0,12,A dozen civilians are killed when Shiite militia pour tank and sniper fire into a neighborhood.
26197,29/4/2015,Mali,Goundam,3,0,3,Islamic gunmen kill two soldiers and a child.
26198,29/4/2015,Iraq,Baghdad,3,20,23,Islamic bombers take out three patrons at a market.
26199,29/4/2015,Iraq,Amiriyah,3,12,15,Three people standing in a commercial district are liquidated by a Mujahid bomb blast.
26200,29/4/2015,DRC,Bango,47,0,47,Forty-seven victims of an Islamist massacre are discovered in a mass grave.
26201,30/4/2015,Egypt,Ibrahmiya,1,0,1,A 48-year-old Coptic woman is stabbed to death.
26202,30/4/2015,Nigeria,Barkin Ladi,2,0,2,Two Christians returning from a funeral are ambushed and killed by Muslim radicals.
26203,30/4/2015,Afghanistan,Zabul,3,2,5,Three passengers are pulled from their car and shot to death by the Taliban.
26204,30/4/2015,Saudi Arabia,Yemen Border,3,0,3,Three border guards are killed during an incursion by Shiite militia.
26205,30/4/2015,Iraq,Hurriya,4,14,18,"Jihadis bomb an ice cream shop, killing four."
26206,30/4/2015,Iraq,Mansour,5,12,17,A Mujahid bomb blast claims five souls.
26207,30/4/2015,Saudi Arabia,Jizan,1,0,1,A Saudi border guard is killed by a Shiite mortar round.
26208,30/4/2015,Iraq,Mosul,1,0,1,A man is executed by ISIS by having his head crushed with a piece of concrete.
26209,30/4/2015,Yemen,Shabwa,15,0,15,The Islamic State releases a video showing the beheading and shooting of fifteen captives.
26210,30/4/2015,Pakistan,Sherpao,2,3,5,A suicide bomber takes down two cop guarding a former official.
26211,30/4/2015,Afghanistan,Herat Darwaza,1,0,1,A government official is assassinated by religious radicals.
26212,30/4/2015,Iraq,Mahmoudiya,4,2,6,A bomb placed at a mosque leaves four dead.
26213,30/4/2015,Iraq,Madain,3,11,14,Three people at a cafe are obliterated in mid-bite by Religion of Peace bombers.
26214,30/4/2015,Iraq,Baghdad,7,18,25,Seven Iraqis are laid out in a series of bomb blasts in Shiite areas.
26215,30/4/2015,Iraq,Talibiyah,2,10,12,"Sunnis bomb a row of restaurants, killing two Shiites."
26216,30/4/2015,Syria,Aleppo,8,34,42,Eight civilians are dismantled by Sunni rockets.
26217,30/4/2015,Iraq,al-Jabour,3,0,3,Three tribal elders are executed by the Islamic State.
26218,30/4/2015,Syria,Derna,3,0,3,Three accused homosexuals are shot in the head by the caliphate following morning prayer.
26219,1/5/2015,Libya,Benghazi,3,7,10,Three medics are exterminated by a suspected Ansar al-Sharia mortar round.
26220,1/5/2015,Pakistan,Nawagi Khas,1,0,1,The Tehreek-i-Taliban murder a peace committee member with a roadside bomb.
26221,1/5/2015,Pakistan,Mangah,2,0,2,A father and son are pulled into pieces by a an Islamic bomb blast.
26222,1/5/2015,Pakistan,Karachi,4,0,4,Four locals are murdered by the Tehreek-e-Taliban drive-by.
26223,1/5/2015,Iraq,Baiji,16,10,26,Sixteen Iraqis are blown to bits by a Shahid suicide bomber.
26224,1/5/2015,Afghanistan,Farah,1,0,1,A man is shot to death in his home by the Taliban.
26225,1/5/2015,Iraq,Tal Afar,300,0,300,"At least 300 Yazidi captives are reportedly executed by the Islamic State, including former sex slaves."
26226,1/5/2015,Nigeria,Adamawa,10,0,10,Ten captured women are stoned to death by Boko Haram to keep them from being rescued.
26227,1/5/2015,Egypt,Sohag,1,0,1,A Coptic man is abducted and murdered by Muslims.
26228,2/5/2015,Nigeria,Zakupang,13,0,13,Women and children comprise the bulk of thirteen Christians cut down by Muslim militants.
26229,2/5/2015,Nigeria,Vat,17,0,17,Muslim terrorists shoot seventeen Christians to death.
26230,2/5/2015,Nigeria,Barkin Ladi,27,0,27,Twenty-seven Christians are slaughtered by Muslim raiders at a church.
26231,2/5/2015,Nigeria,Foron,2,0,2,Militant Muslims gun down a pastor and a female member of his congregation.
26232,2/5/2015,Iraq,Mosul,20,0,20,Twenty people associated with a travel agency are executed by the Islamic State for helping other people escape the city.
26233,2/5/2015,Iraq,Garma,12,0,12,Suicide bombers at a train station take out a dozen Iraqis.
26234,2/5/2015,Syria,Aleppo,22,45,67,"al-Nusra members send shells into residential neighborhoods, killing twenty-two."
26235,2/5/2015,Iraq,Diyala,7,0,7,Five women are among seven passengers torn to shreds by a Mujahid blast on a bus.
26236,2/5/2015,Iraq,Karrada,10,31,41,A second bomb blast kills ten first responders at the site of an earlier blast.
26237,2/5/2015,Iraq,Karrada,9,20,29,"Caliphate members set off a bomb blast in a shopping district, killing seven patrons."
26238,3/5/2015,Thailand,Yala,1,1,2,A man his killed and his wife wounded when Muslim 'insurgents' fire into his truck.
26239,3/5/2015,Iraq,Baghdad,6,9,15,Six Iraqis are sent to Allah by a Shahid suicide bomber.
26240,3/5/2015,USA,"Garland, TX",0,1,1,Two Muslims stage a suicide assault on a conference critical of Islam.
26241,3/5/2015,Afghanistan,Badakhshan,17,20,37,"Religious extremists pour machine-gun fire into a checkpoint, killing seventeen."
26242,3/5/2015,Syria,Aleppo,2,36,38,A woman and child bleed out following a rocket attack by Sunni militants.
26243,3/5/2015,Iraq,Baqubah,5,6,11,Five Iraqis are laid out by an ISIS bomb.
26244,4/5/2015,Nigeria,Zakupang,30,0,30,Thirty Christians are massacred by Fulani terrorists.
26245,4/5/2015,Somalia,Yalho,3,0,3,Islamists storm a police station and murder three cops.
26246,4/5/2015,Somalia,Bosasso,1,2,3,A civilian is killed when al-Shabaab militants toss a grenade into the street.
26247,4/5/2015,Syria,Homs,2,0,2,Two older gentlemen are tied up and shot in the back of the head by Islamic State members.
26248,4/5/2015,Libya,Derna,3,0,3,Three brothers are crucified by the Islamic State.
26249,4/5/2015,Pakistan,Deri Ghazi Khan,1,0,1,One person is killed when Islamic militants attack a school.
26250,4/5/2015,Syria,Damascus,1,3,4,A Fedayeen suicide bomber takes one other soul with him.
26251,4/5/2015,Afghanistan,Kabul,1,15,16,One other person is killed when a Shahid suicide bomber attacks a civilian bus.
26252,4/5/2015,Iraq,Rashad,2,6,8,"Jihadi bombers target a displaced family, killing two female members."
26253,4/5/2015,Iraq,Baiji,3,5,8,Three Iraqis are blown to bits by a Fedayeen suicide bomber.
26254,5/5/2015,India,Nadia,3,8,11,Three Hindu pilgrims are killed when a Muslim mob attack their procession.
26255,5/5/2015,Afghanistan,Kandahar,1,3,4,Hardliners shoot a scrap dealer to death then plant a bomb that injures responders.
26256,5/5/2015,Yemen,Aden,6,0,6,Shiite radicals kill one man with a mortar and then six of this rescuers.
26257,5/5/2015,Saudi Arabia,Najran,2,5,7,"Shiite militia in Yemen shell a town across the border, killing two residents."
26258,5/5/2015,Iraq,Baghdad,6,11,17,An ISIS car bomb in front of a hotel kills six civilians.
26259,5/5/2015,Syria,Sweida,2,23,25,Two civilians are killed during a series of mortar barrages by al-Nusra on a neighborhood.
26260,5/5/2015,DRC,Kikiki,2,2,4,Two UN peacekeepers are ambushed and murdered by Islamists.
26261,5/5/2015,Afghanistan,Jalriz,1,1,2,A child is pulled into pieces by a Taliban bomb blast.
26262,6/5/2015,Nigeria,Ngulde,8,8,16,An 80-year-old man is among eight villagers slaughtered by Boko Haram.
26263,6/5/2015,Niger,Koukodou,5,0,5,Boko Haram members burn houses and murder five villagers.
26264,6/5/2015,Thailand,Yala,2,0,2,A Buddhist couple is shot and then burned by Muslim terrorists.
26265,6/5/2015,Saudi Arabia,Najran,5,11,16,"Shiite radicals shell a small town, killing five residents."
26266,6/5/2015,Iraq,Khanaqin,3,0,3,ISIS members murder three oil tank drivers in cold blood along a highway.
26267,6/5/2015,Syria,Hasaka,3,0,3,A suicide bombing by the Islamic State kills three people in a neighborhood.
26268,6/5/2015,Somalia,Mogadishu,1,0,1,A politician is assassinated by Sharia activists.
26269,6/5/2015,Yemen,Tawahi,50,100,150,Women and children are heavily represented in the casualties of an hours long rocket barrage of a refugee camp by Shiite radicals.
26270,6/5/2015,Pakistan,Lower Kurram,1,3,4,A botched suicide attack on a school kills one innocent.
26271,6/5/2015,Syria,Hassakeh,16,0,16,An ISIS suicide assault produces sixteen dead Kurds.
26272,6/5/2015,Afghanistan,Sulaimanzai,2,4,6,Two children are reduced to pulp by a Taliban bomb blast.
26273,7/5/2015,Pakistan,Alingar,1,0,1,A peace committee member is laid out by a Jihadi bomb blast.
26274,7/5/2015,Cameroon,Mayo-Tsanaga,7,0,7,Seven people are brutally killed during a Boko Haram rampage through their village.
26275,7/5/2015,Iraq,Hamrin,22,34,56,Shahid suicide bombers take out twenty-two Iraqis
26276,7/5/2015,Syria,Aleppo,2,0,2,"Two men are paraded by the Islamic State, then shot in the back of the head."
26277,7/5/2015,Egypt,Rafah,2,0,2,Religious extremists roll up on and gun down two guards.
26278,7/5/2015,Syria,Deir al-Zor,4,0,4,Four local soldiers are captured and beheaded by the Islamic State.
26279,7/5/2015,Iraq,Allas,2,0,2,A Fedayeen suicide bomber takes two victims with him.
26280,7/5/2015,Iraq,Shajarat al-Dur,4,16,20,Four Iraqis are soundly eliminated by a suicide bomber.
26281,7/5/2015,Syria,Aleppo,4,0,4,Three children and a woman bleed to death when militant Sunnis send rockets into a neighborhood.
26282,7/5/2015,Syria,Aleppo,2,0,2,A father and son are picked off by Islamist snipers.
26283,7/5/2015,Libya,Benghazi,2,5,7,Two civilians are killed when Islamists mortar their neighborhood.
26284,8/5/2015,DRC,Matembo,7,4,11,"Islamists hack seven villagers to death with machetes, including two women."
26285,8/5/2015,Syria,Deir al-Zor,19,0,19,Nineteen others lose their lives to an ISIS suicide blast and subsequent assault on an airport.
26286,8/5/2015,Iraq,Balad Ruz,18,41,59,A Sunni suicide bomber massacres eighteen worshippers as they are leaving a Shiite mosque.
26287,8/5/2015,Saudi Arabia,Riyadh,1,0,1,Terrorists gun down a local cop.
26288,8/5/2015,Iraq,Kanaan,4,18,22,"A suicide car bomber plows into a crowd of Shiite worshippers, killing four."
26289,8/5/2015,Syria,Homs,2,0,2,Two men are hacked to death for 'insulting Allah'.
26290,8/5/2015,Nigeria,Potiskum,3,10,13,A suicide bomber detonates at a college.
26291,8/5/2015,Somalia,Galkayo,1,0,1,Religious extremists shoot an 'apostate' to death.
26292,8/5/2015,Egypt,al-Arish,2,0,2,Four guards are shot to death in separate attacks on a school and market.
26293,9/5/2015,Iraq,Nineveh,13,0,13,Thirteen Kurds are executed by the Islamic State.
26294,9/5/2015,Afghanistan,Paktia,2,5,7,Fundamentalists attack a cricket tournament and murder two people.
26295,9/5/2015,Syria,Raqqa,10,0,10,"Ten hostages are forced to kneel, then executed with gunshots by the Islamic State."
26296,9/5/2015,Syria,Aleppo,5,19,24,Women and children are heavily represented among the casualties of an al-Nusra rocket attack.
26297,9/5/2015,Pakistan,Nazimabad,1,0,1,Sectarian Jihadis gun down a homeopathic doctor for being Shiite.
26298,9/5/2015,Iraq,Baghdad,7,20,27,A bomb targeting Shiite pilgrims takes down seven of them.
26299,9/5/2015,Iraq,al-Khalis,12,14,26,Terrorists kill a dozen guards at a prison.
26300,9/5/2015,Pakistan,Lakki Mechankhel,2,1,3,Mujahideen enter a home and shoot a man and his mother to death.
26301,10/5/2015,Somalia,Baidoa,2,0,2,Two Ethiopians are beheaded by al-Shabaab.
26302,10/5/2015,Iraq,Fallujah,6,11,17,A suicide bombing and several other blasts claim the lives of six people.
26303,10/5/2015,Iraq,Taji,3,8,11,"Jihadis set off a bomb at an outdoor market, killing three patrons."
26304,10/5/2015,Iraq,Tarmiyah,5,10,15,Five innocents are reduced to pulp by a suicide car bomber.
26305,10/5/2015,Macedonia,Kumanovo,8,37,45,"Muslim terrorists wage a running battle with police, killing at least eight."
26306,10/5/2015,Afghanistan,Kabul,3,18,21,A suicide bomber kills three riders on a bus.
26307,10/5/2015,Pakistan,Karachi,2,0,2,Two friends are gunned down by Ahle Sunnat Wal Jamaat.
26308,10/5/2015,Syria,Jisr al-Shughur,32,0,32,Thirty-two others are killed during a massive al-Qaeda attack on a town that began with a suicide bombing.
26309,10/5/2015,Cameroon,Zelevet,2,0,2,Boko Haram ambush and kill two local soldiers.
26310,11/5/2015,Yemen,Najran,1,4,5,One resident is killed when Shiite militia send a rocket into a neighborhood from across the border.
26311,11/5/2015,Pakistan,Barkamar,6,0,6,The lives of six tribesmen are brutally snuffed out by Taliban roadside bombers.
26312,11/5/2015,Pakistan,Rialto Chowk,3,6,9,Fundamentalists are suspected in a drive-by attack on transgenders that leaves three dead.
26313,11/5/2015,India,Anantnag,2,0,2,Muslim terrorists murder two guards at a road construction project.
26314,11/5/2015,DRC,Mavivi,5,7,12,Five people are hacked to death with machetes by Islamist 'rebels'.
26315,11/5/2015,Iraq,Muqdadiyah,8,0,8,A father and son are among eight victims of sectarian executions found tortured and shot.
26316,12/5/2015,Kenya,Garissa,1,0,1,A guard at a refugee camp is cut down by al-Shabaab gunmen.
26317,12/5/2015,Libya,Benghazi,4,0,4,Four children are exterminated by an Islamic State rocket.
26318,12/5/2015,Iraq,Mashahidah,3,8,11,Three pilgrims are laid out by an ISIS roadside bomb.
26319,12/5/2015,Iraq,Bab al-Sham,4,12,16,Three Islamic State rockets end the lives of four Shiite pilgrims.
26320,12/5/2015,Iraq,Baghdad,2,9,11,Two Shiite pilgrims are sent to Allah by Sunni bombers.
26321,12/5/2015,Iraq,Kazimiyah,10,25,35,"The Islamic State bomb a roadside stand serving food to Shiite pilgrims, killing ten."
26322,12/5/2015,Pakistan,Sheikh Otar,4,0,4,Four people lose their lives when religious radicals fire at random into a construction site.
26323,12/5/2015,Syria,Homs,4,17,21,Four bystanders are blown to bits when terrorists sit off two bombs in a Shiite district.
26324,12/5/2015,Afghanistan,Kandahar,5,3,8,The Taliban are thought responsible for the bombing of a car that leave five family members dead.
26325,12/5/2015,Pakistan,Quetta,1,7,8,An innocent Shiite is gunned down in a targeted attack.
26326,12/5/2015,Bangladesh,Bankalaparha,1,0,1,Four fundamentalists hack a secular blogger to death with knives on charges of being an atheist.
26327,12/5/2015,Pakistan,Kot Sabzol,1,0,1,A teen bride is honor killed by her conservative family over alleged sexual impropriety.
26328,12/5/2015,Thailand,Pattani,1,0,1,Muslim terrorists gun down a village elder in his pickup truck.
26329,13/5/2015,Syria,al-Sukhna,30,0,30,Thirty others are killed during an ISIS attack on a small town.
26330,13/5/2015,Afghanistan,Dukon,1,0,1,A government official is kidnapped from his home and beheaded by Sharia proponents.
26331,13/5/2015,Afghanistan,Lashkar Gah,7,7,14,Seven people are killed when gunmen attack a rival mosque.
26332,13/5/2015,Pakistan,Mashpangai,3,0,3,Three security personnel are machine-gunned at point-blank range by the Tehreek-e-Taliban.
26333,13/5/2015,Nigeria,Baale,29,0,29,Boko Haram murder twenty-nine people and torch their village.
26334,13/5/2015,Iraq,Nineveh,3,0,3,Three men are forced to kneel on the street and then beheaded by religious 'fanatics'.
26335,13/5/2015,Pakistan,Karachi,47,24,71,"Sunni extremists open fire point-blank on a bus carrying Ismaili minorities, slaughtering fifty."
26336,13/5/2015,Thailand,Pattani,1,0,1,A 35-year-old man dies from injuries after being shot by Muslim 'insurgents'.
26337,13/5/2015,Egypt,Rafah,3,0,3,Islamists kill three civilians with a roadside bomb.
26338,14/5/2015,Iraq,Mosul,39,0,39,Thirty-nine Indian hostages are reportedly executed by the Islamic State.
26339,14/5/2015,Afghanistan,Kabul,1,0,1,Sharia proponents murder a prosecutor in his home.
26340,14/5/2015,Thailand,Yala,1,0,1,A 32-year-old security guard loses his life to Muslim terrorists.
26341,14/5/2015,Nigeria,Kojiti,7,0,7,"Boko Haram open fire on families preparing for bed, killing seven members."
26342,14/5/2015,Nigeria,Kayamla,30,0,30,Thirty villagers are massacred by Sharia fanatics.
26343,14/5/2015,Afghanistan,Kabul,14,7,21,Nine foreigners are among fourteen people massacred when the Taliban storm a guesthouse.
26344,14/5/2015,Nigeria,Maiduguri,12,12,24,At least twelve Nigerians lose their lives to three female suicide bombers.
26345,14/5/2015,DRC,Mbau,23,0,23,Twenty-three more villagers are hacked to death with machetes and hatchets by ADF Islamists.
26346,14/5/2015,Iraq,Baghdad,4,17,21,Shiite militia burn four Sunnis to death in their homes.
26347,14/5/2015,Syria,Palmyra,26,0,26,"Twenty-six villagers are butchered by the Islamic State, including ten beheaded."
26348,14/5/2015,Syria,al-Sukhna,1,0,1,A man is riddled with bullets after identifying himself as Shia to Sunnis.
26349,14/5/2015,Libya,Benghazi,8,11,19,Seven children are among eight killed when the Islamic State fires a rocket into an apartment building.
26350,14/5/2015,Thailand,Yala,0,20,20,Militant Muslims set off twenty-eight bombs within a few hours.
26351,14/5/2015,Iraq,Badush,20,0,20,Twenty captives are executed by the Islamic State.
26352,14/5/2015,Iraq,al-Baghdadi,3,27,30,ISIS car bombers take out three Iraqis.
26353,15/5/2015,Thailand,Narathiwat,1,3,4,Muslim terrorists ambush and kill security personnel riding past on motorbikes.
26354,15/5/2015,Kenya,Garissa,2,0,2,Islamists ambush and kill two police officers at their station.
26355,15/5/2015,Iraq,Ramadi,10,7,17,Three suicide bombers murder ten Iraqis.
26356,15/5/2015,Iraq,Jamiya,27,0,27,Thirteen people are killed in an ISIS attack.  Fourteen others are taken captive and executed.
26357,15/5/2015,Somalia,Shabelle,15,0,15,"Islamists pour grenades and machine-gun fire into two towns, killing fifteen."
26358,15/5/2015,Pakistan,Hyderabad,1,1,2,A Shiite man is killed in front of his wife by Sunni gunmen.
26359,15/5/2015,Iraq,Najaf,1,0,1,A prominent cleric is gunned down by Religion of Peace rivals.
26360,15/5/2015,Pakistan,Karachi,1,0,1,A policeman is shot to death by a Taliban on a motorbike.
26361,16/5/2015,Afghanistan,Karikote,1,5,6,Fundamentalists shoot a youth to death for celebrating a soccer win.
26362,16/5/2015,Pakistan,Pewar,1,0,1,A Shiite man is murdered by Sunnis while out collecting firewood.
26363,16/5/2015,Egypt,al-Arish,4,0,4,Three judges and their driver are machine-gunned by activists fighting for Islamic law.
26364,16/5/2015,Nigeria,Damaturu,7,31,38,"Islamists strap a young girl into an explosives vest and send her into a bus station.  At least seven others are massacred, not including the 'suicide' bomber."
26365,16/5/2015,Yemen,Taez,15,100,115,"Shiite radicals capture an artillery battery and turn it on a town, killing at least fifteen civilians."
26366,16/5/2015,Syria,Palmyra,23,0,23,"Twenty-three civilians, including nine children, are massacred by the Islamic State."
26367,16/5/2015,Iraq,Baghdad,5,0,5,Fundamentalists storm a brothel and murder three men and two women.
26368,16/5/2015,Iraq,Mahmoudiya,2,9,11,Two Iraqis are blown to bits by Mujahid bombers.
26369,16/5/2015,Nigeria,Madagali,3,20,23,Boko Haram murder three men and kidnap seven women.
26370,17/5/2015,Yemen,Shabwah,21,0,21,al-Qaeda claims to have killed twenty-one Shiites with heavy weapons.
26371,17/5/2015,Iraq,Shura,3,0,3,Three civilians are buried alive by the Islamic State after being forced to dig their own graves.
26372,17/5/2015,Iraq,Baiji,8,0,8,Eight refinery guards are blown up by a Shahid suicide bomber.
26373,17/5/2015,Israel,Nes Ziona,1,0,1,A 68-year-old security guard is brutally stabbed to death by a Palestinian.
26374,17/5/2015,Iraq,Ramadi,5,12,17,Five people are blown to bits by a Shahid suicide car bomber.
26375,17/5/2015,Iraq,Ramadi,10,15,25,A Fedayeen suicide car bomber slaughters ten Iraqis.
26376,17/5/2015,Syria,Palmyra,6,0,6,"Six more people are reported killed by ISIS, including three by beheading."
26377,17/5/2015,Afghanistan,Kabul,4,18,22,"Four innocents, including two women, are disintegrated by a Fedayeen suicide bomber near an airport."
26378,17/5/2015,Afghanistan,Zankhan,2,3,5,Two policemen on patrol are laid out by a Taliban bomb.
26379,17/5/2015,Iraq,Ramadi,500,0,500,Five hundred civilians and soldiers are butchered when the Islamic State overrun a city.
26380,18/5/2015,Afghanistan,Ghazni,1,0,1,The Taliban murder a police chief.
26381,18/5/2015,Syria,Palmyra,5,0,5,Two children are among five residents pulled apart when ISIS fire rockets into their neighborhood.
26382,18/5/2015,Afghanistan,Khas Uruzgan,7,0,7,Seven Afghans lose their lives when Sunni extremists attack a government building.
26383,18/5/2015,Afghanistan,Uruzgan,12,0,12,A series of attacks on police checkpoints by armed fundamentalists leave a dozen dead.
26384,18/5/2015,Iraq,Kirkuk,2,0,2,Two brothers are kidnapped and tortured to death by sectarian rivals.
26385,18/5/2015,Iraq,Rashid,5,2,7,Five civilians are reduced to parts by Mujahid bombers.
26386,18/5/2015,Iraq,Husaybah,10,0,10,Ten civilians are killed trying to defend their homes from ISIS.
26387,18/5/2015,Afghanistan,Kandahar,0,7,7,A Fedayeen suicide bomber self-detonates outside a hospital.
26388,18/5/2015,Yemen,Nassab,10,0,10,Ten Shiites are killed by al-Qaeda in a roadside attack.
26389,18/5/2015,Afghanistan,Janikhil,4,2,6,Four Afghans are shot to death by Sunni militants.
26390,19/5/2015,Afghanistan,Kabul,4,42,46,"Four people, including a woman, bleed out following a suicide bombing in a parking lot."
26391,19/5/2015,Syria,Haqef,6,0,6,A woman is among those killed during an ISIS attack on a Druze village.
26392,19/5/2015,Nigeria,Barkin Ladi,27,0,27,Fulani terrorists massacre twenty-seven residents in overnight attacks on two Christian villages.
26393,19/5/2015,Libya,Qubbah,1,7,8,A Fedayeen suicide bomber kills one other person.
26394,19/5/2015,Nigeria,Garkida,8,14,22,A Fedayeen suicide bomber takes the lives of eight patrons at a livestock market.
26395,19/5/2015,Iraq,Mosul,1,0,1,A journalist is executed for refusing to join the caliphate.
26396,19/5/2015,Afghanistan,Uruzgan,4,8,12,Taliban bombers take out four locals.
26397,20/5/2015,Pakistan,Peshawar,1,0,1,"A man is gunned down in front of his daughter by Sharia activists, while taking her to school."
26398,20/5/2015,Syria,Deir Ezzor,1,0,1,Religion of Peace proponents tie a man to a post and then blast him with a bazooka.
26399,20/5/2015,Libya,Hawara,1,0,1,A Fedayeen suicide bomber kills one other person.
26400,20/5/2015,Saudi Arabia,Najran,18,0,18,Shiite militias reportedly kill eighteen Saudis with a cross-border rocket barrage.
26401,20/5/2015,Syria,Damascus,1,23,24,"Sunnis lob a mortar into a school, killing a teacher and injuring twenty-three students."
26402,21/5/2015,Uganda,Kireka Cell,1,0,1,A cleric is gunned down by Religion of Peace rivals.
26403,21/5/2015,Saudi Arabia,Dhahran,1,3,4,A civilian bleeds to death after Shia militia fire a rocket across the border.
26404,21/5/2015,Syria,Palmyra,100,0,100,ISIS releases pictures of some one-hundred beheading victims shortly after taking a small city.
26405,21/5/2015,Libya,Misrata,2,2,4,Two people are killed by an ISIS suicide bomber.
26406,21/5/2015,Iraq,Fallujah,1,0,1,A man is paraded through the streets and then hung from a bridge by the Islamic State.
26407,21/5/2015,Pakistan,Karachi,3,0,3,A Sunni man and his two sons are murdered in a targeted sectarian attack.
26408,21/5/2015,Iraq,Diyala,2,0,2,Two civilians lose their lives when suspected ISIS burn five homes.
26409,21/5/2015,Nigeria,Ropp,9,0,9,Muslim 'mercenaries' set fire to a house and then surround it to prevent the family from leaving.  Nine are burned alive.
26410,22/5/2015,Yemen,Sanaa,0,13,13,Children are among the casualties when ISIS set off bombs at rival mosques.
26411,22/5/2015,Pakistan,Hayatabad,2,2,4,Two are killed when Sunni radicals fire on a Shiite family.
26412,22/5/2015,Egypt,Sinai,1,0,1,A local soldier is abducted from an ambulance and executed in cold blood by Ansar Beit al-Maqdis.
26413,22/5/2015,Syria,Palmyra,200,0,200,Two-hundred more Syrians are rounded up and executed by the Islamic State.
26414,22/5/2015,Saudi Arabia,Qadeeh,21,81,102,"An ISIS suicide bomber detonates at a Shia mosque, slaying twenty-one worshippers."
26415,22/5/2015,Afghanistan,Ankhoy,0,15,15,Fundamentalists throw a grenade into a wedding party over music.
26416,22/5/2015,Syria,Hasakah,2,0,2,Children watch as two captives are shot in the back of the head by caliphate members.
26417,22/5/2015,Afghanistan,Faryab,2,0,2,A woman kills herself after the Taliban murder her husband with a roadside bomb.
26418,22/5/2015,Somalia,Awdigle,7,17,24,At least seven others are killed when al-Shabaab members attack a small town.
26419,22/5/2015,Somalia,Mogadishu,3,1,4,Pro-Sharia activists block a transport carrying government workers and machine-gun three point-blank.
26420,22/5/2015,Saudi Arabia,Tawal,1,3,4,A child is dismantled by a Shiite rocket.
26421,22/5/2015,Nigeria,Jwamda-Kobla,10,0,10,Sharia proponents sneak into a village and slaughter ten residents with knives.
26422,23/5/2015,Afghanistan,Bala Boluk,4,1,5,Four local cops are shot to death by religious radicals.
26423,23/5/2015,Somalia,Mogadishu,1,0,1,A member of parliament is gunned down by an Islamist group.
26424,23/5/2015,Egypt,Sharqeya,1,8,9,"Islamists detonate a bomb under a bridge, killing a passerby."
26425,23/5/2015,Pakistan,Datta Khel,3,3,6,Religious extremists are blamed for an ambush that leaves three security personnel dead.
26426,23/5/2015,Afghanistan,Uruzgan,2,0,2,Two gentlemen are turned into pulp by Taliban bombers.
26427,23/5/2015,Iraq,Baiji,16,0,16,Caliphate members slit the throats of sixteen traders transporting food into a city.
26428,23/5/2015,Afghanistan,Gilan,4,0,4,"A family of four, including two children, is neatly disassembled by a well-placed Taliban bomb."
26429,23/5/2015,Pakistan,Badrashi,2,2,4,Islamic militants are thought responsible for a shooting attack that leaves a mother and her son dead.
26430,24/5/2015,Afghanistan,Sangin,13,24,37,A Taliban assault on police checkpoints leaves thirteen defenders dead.
26431,24/5/2015,Syria,Palmyra,400,0,400,Women and children comprise the bulk of 400 civilians executed in cold blood by the Islamic State.
26432,24/5/2015,Syria,Raqqa,1,0,1,A 20-year-old captive is burned alive for refusing sex with Islamic State members.
26433,24/5/2015,Nigeria,Benue,96,0,96,Ninety-six are confirmed dead following a church-burning spree by militant Muslims.
26434,24/5/2015,Pakistan,Bolochistan,3,15,18,The Taliban is suspected of a bomb attack that produces three bodies.
26435,24/5/2015,Iraq,Mosul,2,0,2,Two men are shot in the back of the head by ISIS.
26436,24/5/2015,Afghanistan,Jawzjan,2,0,2,An adulterous couple is shot to death by their families on orders of a religious council.
26437,25/5/2015,Somalia,Diinsoor,4,0,4,Four men are executed by al-Shabaab.
26438,25/5/2015,India,Shyamnagar,1,0,1,A 19-year-old is 'honor' strangled by her brother after marrying without her conservative family's permission.
26439,25/5/2015,Afghanistan,Zabul,5,73,78,Two women are among five killed in a massive suicide truck bombing that leaves over seventy others wounded.
26440,25/5/2015,Afghanistan,Guzara,1,0,1,A tribal elder is ambushed and killed by the Taliban.
26441,25/5/2015,India,Sopore,1,2,3,"Fundamentalists fire on a mobile shop, killing an employee."
26442,25/5/2015,Nigeria,Gubio,43,50,93,Children are among dozens killed after Boko Haram briefly takes over a small village.
26443,25/5/2015,Afghanistan,Naw Zad,26,3,29,Over two-dozen defenders lose their lives to a brutal suicide assault by armed fundamentalists on a police compound.
26444,25/5/2015,Afghanistan,Shaheedan,3,0,3,Taliban in uniform murder three policemen.
26445,25/5/2015,Pakistan,Quetta,2,9,11,A female doctor is among two Hazara religious minorities murdered in an attack outside a medical center.
26446,25/5/2015,Pakistan,Quetta,1,0,1,A Shiite trader is shot to death on the street by Sunni extremists.
26447,25/5/2015,India,Kashmir,3,4,7,"Lashkar-e-Islam fire on a patrol of soldiers, killing three."
26448,25/5/2015,Tunisia,Tunis,6,10,16,The Islamic State claims an attack at a barracks in which an alleged recruit shot six soldiers in the back.
26449,25/5/2015,Afghanistan,Shah Wali Kot,6,0,6,All six people in a civilian vehicle are blown to bits by a Sunni bomb blast.
26450,26/5/2015,Afghanistan,Maidan Wardak,2,3,5,Two Taliban suicide bombers kill two guards.
26451,26/5/2015,Iraq,Nimrud,1,0,1,An 80-Year-Old Christian woman is burned alive for failing to comply with Sharia restrictions.
26452,26/5/2015,Thailand,Pattani,2,0,2,A teacher is among two people riddled with bullets by militant Muslims.
26453,26/5/2015,Kenya,Yumbis,25,0,25,Over two dozen police are murdered by al-Shabaab in a single attack.
26454,27/5/2015,Syria,Palmyra,20,0,20,Twenty more people are executed by the Islamic State - this time in an ancient theater.
26455,27/5/2015,Iraq,Shingal,1,0,1,A sex slave who tried to escape ISIS is killed by having her legs cut off.
26456,27/5/2015,Pakistan,Quetta,2,1,3,Two Hazara religious minorities are gunned down outside their shop by Sunni radicals.
26457,27/5/2015,Pakistan,Gulberg,3,2,5,Three local cops are gunned down by suspected Islamists.
26458,27/5/2015,Iraq,Kirkuk,1,0,1,A mosque's imam is kidnapped and abducted by Religion of Peace rivals.
26459,27/5/2015,Iraq,Fallujah,17,9,26,Seventeen Iraqis are taken out by Fedayeen suicide bombers.
26460,28/5/2015,Saudi Arabia,Zahran,2,4,6,Two people are killed when Shia militia fire rockets across the border from Yemen.
26461,28/5/2015,Thailand,Pattani,1,1,2,"Muslim 'insurgents' fire on a married couple, killing the man and injuring his wife."
26462,28/5/2015,Pakistan,Dera Ismail Khan,2,2,4,"Religious extremists fire a rocket at a group of cops, killing two."
26463,28/5/2015,Iraq,Mosul,3,0,3,Three Kurds are executed by the Islamic State.
26464,28/5/2015,Iraq,Baghdad,4,15,19,A second blast outside a different hotel lays out five more.
26465,28/5/2015,Iraq,Baghdad,10,27,37,"ISIS sets off a bomb outside a hotel, killing ten innocents."
26466,28/5/2015,Yemen,Aden,1,1,2,A local governor is assassinated by Shiite radicals.
26467,29/5/2015,Chad,Choua,4,4,8,A Boko Haram attack leaves four dead.
26468,29/5/2015,Pakistan,Malir,2,0,2,Two men sitting outside a music event are shot to death by terrorists.
26469,29/5/2015,Libya,Benghazi,8,8,16,Eight people lose their lives to an Islamist rocket attack on their neighborhood.
26470,29/5/2015,Nigeria,Tashan Alade,7,30,37,Seven people at a wedding are blown to bits by a Shahid suicide bomber.
26471,29/5/2015,Saudi Arabia,Dammam,3,4,7,At least three others are killed by a suicide bomber outside a Shia mosque..
26472,29/5/2015,Syria,Palmyra,1,0,1,A captive is forced to dig his own grave before being beheaded to shouts of 'Allah Akbar'.
26473,29/5/2015,Iraq,Baghdad,3,10,13,Three passengers are killed when Jihadis set off a bomb on a bus.
26474,29/5/2015,Pakistan,Lahore,1,6,7,"A suicide bomber detonates at an international cricket match, killing a guard."
26475,30/5/2015,Nigeria,Dala,7,0,7,A family of seven is wiped out by a Boko Haram RPG.
26476,30/5/2015,Thailand,Pattani,2,0,2,Two off-duty soldiers are shot off their motorbikes by militant Muslims.
26477,30/5/2015,Nigeria,Maiduguri,13,16,29,"Boko Haram fire rockets into homes, killing thirteen, including women and five children."
26478,30/5/2015,Nigeria,Maiduguri,26,28,54,Over two dozen worshippers at a mosque are disassembled by a Fedayeen suicide bomber.
26479,30/5/2015,Afghanistan,Lashkar Gah,1,0,1,A secular teacher is assassinated by Sharia proponents.
26480,30/5/2015,Philippines,Jolo,0,15,15,Muslim bombers injure fifteen people at a rival mosque.
26481,30/5/2015,Afghanistan,Dara-e-Sof,5,1,6,Talibanis attack a security checkpoint and kill five officers.
26482,30/5/2015,Iraq,Balad,6,14,20,A half-dozen Shiites are sent to Allah by ISIS bombers.
26483,31/5/2015,Libya,Misrata,5,7,12,An Islamic State suicide car bomber takes the lives of five bystanders at a city entrance.
26484,31/5/2015,Iraq,Baghdad,1,0,1,"Video is released of a man being burned alive by the Shia militia group, Imam Ali."
26485,31/5/2015,Afghanistan,Logar,3,4,7,A teacher and two students are killed when Muslim extremists fire a rocket into a government school.
26486,31/5/2015,Thailand,Pattani,1,11,12,Two bomb blasts by Muslim 'separatists' leave one dead.
26487,31/5/2015,Syria,Aleppo,12,15,27,"An al-Qaeda linked group sends rockets into a neighborhood, killing a dozen residents."
26488,31/5/2015,Pakistan,Kamoke,3,0,3,A man and his son are among three election workers machine-gunned by the Tehreek-e-Taliban.
26489,1/6/2015,Iraq,Ramadi,47,63,110,A coordinated attack by three ISIS suicide bombers leaves forty-seven Iraqi soldiers dead.
26490,1/6/2015,Afghanistan,Asmar,1,0,1,A secular school teacher is shot to death by pro-Sharia radicals.
26491,1/6/2015,Afghanistan,Helmand,1,4,5,A woman is disassembled in her own home by a Sunni rocket.
26492,1/6/2015,Afghanistan,Surkh Abad,2,1,3,A father and son are blown to smithereens by a Taliban rocket.
26493,1/6/2015,Pakistan,Tank,7,8,15,At least seven people bleed out following a bombing at party by suspected Islamists.
26494,1/6/2015,Pakistan,Wana,3,0,3,An early morning blast claims the lives of three election workers.
26495,1/6/2015,Afghanistan,Balkh,11,0,11,Nine aid workers and their two guards are shot to death in their compound by religious radicals.
26496,1/6/2015,Iraq,Jadaa,80,0,80,"A mass grave is discovered containing the victims of eighty Yazidi religious minorities butchered by the Islamic State, including thirty-three children and twenty women."
26497,1/6/2015,Syria,Mayadin,4,0,4,Four young people are executed for apostasy.
26498,1/6/2015,Syria,Mayadin,1,0,1,A gay man is thrown off a rooftop by the Caliphate.
26499,1/6/2015,Pakistan,Angor Adda,2,0,2,Two people are kidnapped and shot to death by Sharia proponents.
26500,1/6/2015,Iraq,Baghdad,10,27,37,Jihadis murder ten Iraqis in a series of attacks.
26501,2/6/2015,Syria,Umm al-Qura,35,0,35,"Thirty-five Syrians are beheaded or otherwise executed by ISIS ""with help from Allah."""
26502,2/6/2015,Nigeria,Maiduguri,53,30,83,Islamists send a suicide bomber into a meat market to claim the lives of about fifty innocents.
26503,2/6/2015,Nigeria,Maiduguri,5,8,13,"A Muslim detonates a suicide vest at an abattoir, taking five bystanders with him."
26504,2/6/2015,Syria,Deir Ezzor,1,0,1,A woman is stoned to death for adultery.
26505,2/6/2015,Afghanistan,Herat,1,0,1,A former translator for the U.S. is tortured and killed by Taliban fundamentalists.
26506,2/6/2015,Iraq,Baiji,28,36,64,Four Holy Warrior suicide bombers slaughter twenty-eight Iraqis.
26507,2/6/2015,Iraq,Baghdad,6,13,19,Mujahideen take out six patrons in mid-bite with a car bomb blast outside a restaurant.
26508,3/6/2015,Nigeria,Maiduguri,6,29,35,Six people are sectionalized by a Boko Haram blast at a mechanic's garage.
26509,3/6/2015,Afghanistan,Nangarhar,10,0,10,Ten captives are beheaded by ISIS.
26510,3/6/2015,Syria,Hasaka,2,0,2,Two men are shot in the back of the head by the Islamic State.
26511,3/6/2015,Thailand,Yala,4,0,4,Off-duty soldiers riding in a civilian vehicle are machine-gunned point-blank by Muslim terrorists.
26512,3/6/2015,Egypt,Giza,2,0,2,Fundamentalists on motorcycles shoot two tourism guards to death near the pyramids.
26513,3/6/2015,Iraq,Nineveh,1,0,1,A gay man is hung by his feet and then dropped from a building by Allah praisers.
26514,3/6/2015,Iraq,Fallujah,4,7,11,Four people are blown to bits by a Fedayeen suicide bomber.
26515,3/6/2015,Iraq,Baghdad,7,17,24,Terrorists set off three bombs that leave seven dead.
26516,3/6/2015,Iraq,Baghdad,4,11,15,Four people are killed when Jihadis set off a bomb near an auto parts shop.
26517,3/6/2015,Algeria,Batna,5,2,7,Two attacks by al-Qaeda leave five others dead.
26518,4/6/2015,Iraq,Fallujah,2,0,2,Two more gay men are thrown from a rooftop by the Islamic State.
26519,4/6/2015,Afghanistan,Lashkar Gah,4,6,10,A suicide bomber takes out four Afghans.
26520,4/6/2015,Libya,Derna,1,0,1,A local soldier is beheaded in front of a mosque by ISIS as kids look on.
26521,4/6/2015,Nigeria,Maiduguri,8,0,8,Eight Nigerians are pulled into pieces by a Fedayeen suicide bomber.
26522,4/6/2015,Nigeria,Yola,45,40,85,"Two suicide bombers detonate at a packed market, slaughtering over forty innocents."
26523,4/6/2015,Iraq,Tharthar Lake,2,6,8,A suicide bomber kills two other people.
26524,4/6/2015,Iraq,Baghdad,2,7,9,Two people bleed to death following an Islamist bomb blast at an industrial area.
26525,4/6/2015,Iraq,Barwana,6,4,10,"The Islamic State sends rockets into a small town, killing six."
26526,4/6/2015,Iraq,al-Mazraa,4,9,13,Four people are left dead following an ISIS mortar barrage.
26527,4/6/2015,Iraq,Fallujah,17,8,25,A suicide assault on a security base produces seventeen dead Iraqis.
26528,5/6/2015,Saudi Arabia,Jizan,4,0,4,Four Saudis are killed in a cross-border attack by Shiite militia.
26529,5/6/2015,Iraq,Baqubah,5,0,5,A brutal roadside blast takes out five civilians.
26530,6/6/2015,Somalia,Wajir,3,0,3,"An Islamist opens fire on a group of people, killing three - including a woman."
26531,6/6/2015,Philippines,Maluso,1,0,1,A man is captured and beheaded by Abu Sayyaf.
26532,6/6/2015,Iraq,Baghdad,10,28,38,A series of Islamic State bomb blasts produce ten dead Iraqis.
26533,6/6/2015,Iraq,Balad Ruz,15,37,52,A suicide car bomber lays out fifteen patrons at a restaurant district.
26534,7/6/2015,Iraq,Qara Tapa,1,0,1,A civilian is kidnapped and burned alive by caliphate members.
26535,7/6/2015,Iraq,Qayara,2,0,2,Two Iraqi policemen are executed by ISIS.
26536,7/6/2015,Pakistan,Quetta,5,0,5,Five people are shot to death in Sunni raids on two tea shops belonging to the Hazara religious minority.
26537,7/6/2015,Nigeria,Maiduguri,16,24,40,Boko Haram bombers turn an outdoor market into a mass of blood and body parts.
26538,7/6/2015,Libya,Misrata,4,2,6,Islamic State members capture four guards and slit their throats.
26539,7/6/2015,Nigeria,Borno,2,4,6,Two people are reduced to parts by a female suicide bomber along a highway.
26540,8/6/2015,Saudi Arabia,Dhahran Al-Janoub,2,0,2,Two border guards are killed by Shiite rockets.
26541,8/6/2015,Pakistan,North Waziristan,7,14,21,Seven others are killed by a religious radical with a suicide vest.
26542,8/6/2015,Egypt,Sheihk Zuweid,1,5,6,Velayat Sinai Islamists gun down a local soldier manning a checkpoint.
26543,8/6/2015,Nigeria,Huyum,19,3,22,"Islamists walk into a village and begin shooting indiscriminately, slaughtering nineteen innocents."
26544,9/6/2015,Thailand,Narathiwat,2,0,2,A 53-year-old man and his teenage son are shot to death in their truck by Muslim 'separatists'.
26545,9/6/2015,Iraq,Fallujah,9,15,24,Two suicide bombers take out nine Iraqis.
26546,9/6/2015,Afghanistan,Bagram,1,1,2,A female American civilian is killed by a Taliban rocket.
26547,9/6/2015,Nigeria,Borno,27,0,27,Over two dozen people lose their lives when Islamists open fire on residents of two villages (Buraltima and Dirmanti).
26548,9/6/2015,Nigeria,Matangale,16,0,16,"Boko Haram open fire on women gathered to do laundry, killing sixteen."
26549,9/6/2015,Pakistan,Shah Latif,1,0,1,A Shiite official is gunned down by the Tehreek-e-Taliban.
26550,9/6/2015,Iraq,Youssifiyah,4,8,12,Four Iraqis are sent to Allah by Mujahid bombers.
26551,9/6/2015,Iraq,Baghdad,6,21,27,"Jihadis bomb a vegetable market, taking out a half-dozen shoppers."
26552,9/6/2015,Iraq,Baghdad,10,24,34,Three women are among ten restaurant patrons pulled into pieces by a Religion of Peace blast.
26553,9/6/2015,Pakistan,Sopore,1,0,1,A pharmacist is shot to death by Lashkar-e-Islam.
26554,9/6/2015,Libya,Sirte,3,0,3,Three guards at a power plant are killed by Islamic State militants.
26555,9/6/2015,Afghanistan,Faryab,5,2,7,A family of five is wiped out by a Taliban bomb blast at their home.
26556,10/6/2015,Mali,Misseni,1,0,1,Gunmen murder a cop while shouting praises to Allah.
26557,10/6/2015,Egypt,Luxor,0,4,4,Two suicide bombers attack a popular tourist site.
26558,10/6/2015,Iraq,Mahmoudiya,3,7,10,Jihadis plant a bomb on a motorcycle that leaves three dead patrons in a commercial district.
26559,10/6/2015,Iraq,Ghazlani,130,0,130,An ISIS mass execution produces one-hundred and thirty dead captives.
26560,10/6/2015,Iraq,Baghdad,9,22,31,Nine people are disassembled by a suicide bomb blast along a city street.
26561,10/6/2015,Syria,Qalb Loze,20,0,20,A child and several elderly people are among twenty Druze murdered in cold blood by al-Qaeda.
26562,11/6/2015,Cameroon,Makari,2,23,25,Two Cameroon soldiers are killed by a Boko Haram rocket attack on their way to protect a village.
26563,11/6/2015,Pakistan,Hayatabad,2,6,8,The Taliban take credit for a Shahid suicide bombing that leaves two others dead.
26564,11/6/2015,Egypt,Sinai,1,0,1,ISIS in Egypt force a man to dig his own grave before shooting him in the head.
26565,12/6/2015,Egypt,Sharqia,1,0,1,A teacher who opposed the Muslim Brotherhood is assassinated by three members.
26566,12/6/2015,Saudi Arabia,Jizan,1,1,2,A civilian is killed by a Shiite rocket attack on a rival mosque.
26567,12/6/2015,Pakistan,Sopore,1,0,1,A shopkeeper is shot to death by militant Muslims.
26568,12/6/2015,Libya,Derna,7,30,37,Seven protesters are quickly shot to death for protesting the Islamic State in Libya.
26569,12/6/2015,Pakistan,Torkham,2,4,6,Jihadis take out two civilians with a bomb hidden in a push cart full of quilts.
26570,12/6/2015,Iraq,Mosul,6,0,6,Six hostages are executed by the Islamic State.
26571,13/6/2015,DRC,Beni,8,10,18,Eight people are hacked to death by ADF Islamists.
26572,13/6/2015,Afghanistan,Nangarhar,1,0,1,A captive is beaten and beheaded by the Islamic State.
26573,13/6/2015,Afghanistan,Helmand,20,10,30,Twenty local police officers are ambushed and killed by armed fundamentalists.
26574,13/6/2015,Egypt,North Sinai,3,0,3,Several Bedouin are reportedly beheaded by Islamic radicals.
26575,13/6/2015,Kenya,Mangai,2,0,2,"Islamists invade a village, preach at the mosque for hours, then murder two people."
26576,13/6/2015,Iraq,Hajjaj,13,29,42,Two Fedayeen suicide bombers kill thirteen Iraqis.
26577,13/6/2015,Iraq,Garma,18,25,43,A mass ISIS suicide attack leaves eighteen others dead.
26578,13/6/2015,Nigeria,Bale,3,5,8,"A suicide bomber on a bicycle pedals to paradise, taking three innocents with him."
26579,14/6/2015,Afghanistan,Khalil Bagh,2,3,5,A woman is among two people whose lives are cut short by Taliban bombers.
26580,14/6/2015,Iraq,Mosul,1,0,1,A woman is stoned to death for adultery.
26581,14/6/2015,Iraq,Shalalat,1,0,1,A former female candidate is executed by the caliphate.
26582,14/6/2015,Nigeria,Babbangida,4,0,4,Four people lose their lives to a shooting and burning spree by Sharia activists.
26583,14/6/2015,Iraq,Riyahah,4,6,10,Four others are killed by ISIS gunmen.
26584,14/6/2015,Iraq,Mosul,25,0,25,Twenty-five Iraqis are executed by the Islamic State.
26585,14/6/2015,Syria,Homs,0,32,32,"Sunni terrorists set off a bomb outside a school, injuring over thirty."
26586,14/6/2015,Afghanistan,Takhar,4,0,4,Taliban bombers murder four people with a roadside bomb.
26587,14/6/2015,Iraq,Baghdad,10,20,30,Ten patrons are sectionalized by a Fedayeen suicide bomber at an outdoor market.
26588,15/6/2015,Thailand,Narathiwat,1,0,1,Muslim terrorists murder a local cop on a motorbike.
26589,15/6/2015,Afghanistan,Sarak-e-Bala,6,0,6,A half-dozen Afghans are machine-gunned at a checkpoint by Sunni fundamentalists.
26590,15/6/2015,Pakistan,Sopore,2,0,2,Two men are shot to death in separate attacks blamed on Lashkar-e-Islam.
26591,15/6/2015,Nigeria,Potiskum,11,9,20,Two women are among eleven civilians taken out by two Shahid suicide bombers at a tea stand.
26592,15/6/2015,Tunisia,Sidi Bouzid,3,1,4,Three policemen are shot point blank by Islamists at a checkpoint.
26593,15/6/2015,Chad,N'Djamena,33,101,134,A bloody suicide attack by Boko Haram leaves nearly three dozen others dead.
26594,15/6/2015,Iraq,Fallujah,13,23,36,ISIS militants kill thirteen Iraqis.
26595,16/6/2015,Syria,al-Mezzeh,1,7,8,One resident dies when Sunnis send a mortar into a rival neighborhood.
26596,16/6/2015,Afghanistan,Daykundi,3,16,19,"Taliban bombers take out three civilians, including a child."
26597,16/6/2015,India,Bijbehara,1,0,1,"Islamic radicals fire into a police station, killing an officer."
26598,16/6/2015,Somalia,Mogadishu,3,9,12,Three Somalis are ripped to shreds by an al-Shabaab roadside blast.
26599,16/6/2015,Philippines,Sitio Bohepeyat,1,8,9,Muslim 'extremists' kill a local soldier on patrol with a pipe bomb.
26600,16/6/2015,Nigeria,Damboa,8,0,8,At least eight security personnel are killed by a Boko Haram roadside bomb.
26601,16/6/2015,Iraq,Diyala,4,6,10,Caliphate members slaughter four female students with a roadside bomb.
26602,16/6/2015,Syria,Damascus,9,13,22,"Terrorists shell a park packed with Ramadan shoppers, killing nine, including five women."
26603,16/6/2015,Afghanistan,Kunduz,3,2,5,Three people are shot to death by the Taliban.
26604,16/6/2015,Iraq,Baiji,4,6,10,Four people bleed out following a brutal attack by the Islamic State.
26605,16/6/2015,Iraq,Amiriyat Al Falluja,5,6,11,"ISIS fire rockets into a small town, killing five defenders."
26606,16/6/2015,Iraq,Garma,4,0,4,Four Iraqis are disassembled by a suicide bomber.
26607,17/6/2015,Uganda,Nabuli,1,0,1,A mother of eleven is poisoned by her own family after leaving Islam for Christianity.
26608,17/6/2015,Egypt,al-Arish,1,3,4,Religious radicals kill a local police officer with a planted bomb.
26609,17/6/2015,Nigeria,Monguno,63,45,108,Boko Haram bombs claim the lives of over sixty innocents at a market.
26610,17/6/2015,Yemen,Mukalla,2,0,2,Two Saudi hostages are executed by an al-Qaeda firing squad.
26611,17/6/2015,Syria,Raqqa,1,0,1,Caliphate members tie a man to a cross and cut off his hand and foot before beheading him.
26612,17/6/2015,Iraq,Anbar,2,0,2,Two Iraqis are forced to the ground and shot in the head by the Islamic State.
26613,17/6/2015,Iraq,Qara Taba,1,1,2,"Islamic bombers target a car carrying two teachers, killing one and wounding the other."
26614,17/6/2015,Iraq,Anbar,12,0,12,ISIS fanatics sneak onto a military base and massacre a dozen personnel in their barracks.
26615,17/6/2015,Afghanistan,Musa Qala,11,0,11,Eleven security personnel at a government building are slain during a Taliban assault.
26616,17/6/2015,Yemen,Sanaa,31,60,91,Five Sunni suicide bombers massacre over thirty people at Shia mosques.
26617,17/6/2015,Iraq,Baghdad,7,16,23,A Shahid suicide bomber blows seven innocents into disparate parts.
26618,17/6/2015,Philippines,Barangay Pamalian,4,0,4,"Bangsamoro Islamic members fire into a civilian vehicle, killing all four occupants."
26619,18/6/2015,Niger,Diffa,38,24,62,"Boko Haram believers set fire to two small towns while shooting and burning about forty residents, including fourteen women and ten children."
26620,18/6/2015,Somalia,Adado,1,0,1,A bystander loses his life to a suicide bomber.
26621,18/6/2015,Iraq,Mosul,25,0,25,Twenty-five more Iraqis are executed by the Islamic State.
26622,18/6/2015,Iraq,Fallujah,11,23,34,ISIS mortars take the lives of a dozen Iraqis.
26623,18/6/2015,Somalia,Gedweyne,4,6,10,al-Shabaab claims an attack that kills four Somalis.
26624,18/6/2015,Lebanon,Ain al-Hilweh,1,1,2,A bystander is killed during a dispute between Jund al-Sham and Fatah.
26625,18/6/2015,Nigeria,Wakama,2,0,2,Muslims shoot an Anglican pastor and a 9-year-old boy to death.
26626,18/6/2015,Syria,Aleppo,12,21,33,A dozen people die from shrapnel caused by Sunni rocket attacks on two neighborhoods.
26627,18/6/2015,Iraq,Khurmatu,1,4,5,"Shiite militia open fire on a civilian vehicle, killing a father of three."
26628,19/6/2015,Libya,Benghazi,5,0,5,An ISIS mortar claims the lives of five Libyans.
26629,19/6/2015,Yemen,Shibam,1,0,1,al-Qaeda gunmen assassinate a rival imam.
26630,19/6/2015,Afghanistan,Girishk,2,0,2,An attempted assassination by the Taliban leaves two bodyguards dead.
26631,19/6/2015,Israel,Dolev,1,1,2,A 25-year-old Jewish man is shot in his car by a Palestinian terrorist who feigned needing help.
26632,19/6/2015,Pakistan,Adda,1,0,1,A 17-year-old girl is 'honor' strangled by her father on suspicion of an affair.
26633,19/6/2015,Afghanistan,Nangarhar,3,0,3,The Islamic State shoots two men in the back of the head and beheads another.
26634,19/6/2015,Iraq,Anbar,30,30,60,A 15-year-old suicide bomber wades into a funeral and sends thirty mourners to Allah.
26635,19/6/2015,Iraq,Hit,3,0,3,Three Iraqis are forced to their knees and then shot in the head by caliphate members.
26636,20/6/2015,Syria,Aleppo,3,18,21,Three residents are killed when Sunni radicals fire rockets into their neighborhood.
26637,20/6/2015,Pakistan,Sopore,1,4,5,"Islamists attack a police vehicle, injuring four and killing a prisoner."
26638,20/6/2015,Yemen,Sanaa,2,6,8,Two people at a mosque are taken out by an ISIS suicide bomber.
26639,20/6/2015,Somalia,Afgoi,8,0,8,Islamic hardliners shoot eight policemen to death and steal their vehicles.
26640,20/6/2015,Pakistan,Punjab,2,0,2,Two women are honor killed by their brother and nephew.
26641,20/6/2015,Iraq,Mosul,3,0,3,Three former candidates for the Iraqi parliament are captured and executed by the caliphate.
26642,20/6/2015,Somalia,Mogadishu,1,0,1,At least one other person is killed by three al-Shabaab suicide bombers.
26643,20/6/2015,Afghanistan,Baghlan,1,0,1,Fundamentalists are suspected of shooting a doctor to death in his home.
26644,20/6/2015,Afghanistan,Nangarhar,1,0,1,The Islamic State kidnaps and beheads a rural rehabilitation worker.
26645,20/6/2015,Afghanistan,Marjah,18,4,22,A family of eighteen is exterminated by Religion of Peace bombers.
26646,20/6/2015,Iraq,Garma,30,0,30,A mass grave containing thirty ISIS execution victims is discovered.
26647,20/6/2015,Iraq,Julan,3,16,19,Three children bleed to death from shrapnel injuries caused by ISIS mortars.
26648,20/6/2015,Afghanistan,Qara Bagh,6,2,8,"A half-dozen police officers are massacred by religious radicals, who began with a suicide bombing."
26649,21/6/2015,Iraq,Mahmudiyah,3,9,12,"Terrorists bomb an outdoor market, killing three civilians."
26650,21/6/2015,India,Kulgam,1,0,1,Police claim that a civilian was killed by a Lashkar-e-Toiba bullet.
26651,21/6/2015,Syria,Qamishli,2,4,6,A suicide bomber takes out two security guards.
26652,21/6/2015,Austria,Graz,3,34,37,A 4-year-old boy is among three slain in a shopping district by a 'mentally ill' Muslim with a stated interest in Jihad.
26653,22/6/2015,Iraq,Tal Afar,70,0,70,"A mass grave is discovered, containing the remains of seventy victims of ISIS executions."
26654,22/6/2015,Libya,Benghazi,4,20,24,An Islamist car bomb claims four souls.
26655,22/6/2015,Syria,Izra,4,3,7,Four people are torn apart by a Sunni car bomb blast at the entrance to a Christian town.
26656,22/6/2015,Philippines,Shariff Aguak,2,0,2,Bangsamoro Islamists gun down two unarmed off-duty soldiers were helping to repair a school.
26657,22/6/2015,Nigeria,Maiduguri,30,30,60,"Two teenage girls blow themselves up at a mosque, laying out thirty rival worshippers."
26658,22/6/2015,Iraq,Baghdad,2,7,9,"Jihadis set off a bomb at a crowded market, killing two."
26659,22/6/2015,Iraq,Baghdad,2,1,3,A Religion of Peace drive-by leaves two dead.
26660,22/6/2015,Afghanistan,Kabul,2,31,33,A suicide assault on parliament claims the lives of a woman and 10-year-old girl.
26661,22/6/2015,Afghanistan,Chakhansor,1,0,1,A cleric is gunned down by Religion of Peace rivals.
26662,22/6/2015,Afghanistan,Logharo Peerano,3,0,3,Three people are shot point-blank in their car by suspected Sunni radicals.
26663,22/6/2015,Iraq,Habariya,8,0,8,A suicide bombing is one of four Mujahid blasts that leave eight dead.
26664,22/6/2015,Iraq,Ramadi,2,8,10,A Fedayeen suicide bomber kills two and injures eight.
26665,22/6/2015,Iraq,Mosul,26,0,26,Over two dozen Iraqis are lined up and shot in front of a crowd by the Islamic State.
26666,23/6/2015,Israel,Pedaya,1,0,1,A 70-year-old Jewish farmer is beaten to death in his field by Palestinian terrorists.
26667,23/6/2015,Syria,Aleppo,2,8,10,Two civilians are reduced to pulp by a Sunni rocket attack on their neighborhood.
26668,23/6/2015,Niger,Yebi,5,0,5,Boko Haram kill five villagers and set fire to their homes.
26669,23/6/2015,Nigeria,Borno,42,24,66,"Boko Haram burn homes, shoot children and cut the throats of women in a night-long rampage across two villages that leaves forty dead."
26670,23/6/2015,Yemen,Aden,7,94,101,Seven civilians are killed when Shiite militia fire rockets into their neighborhood.
26671,23/6/2015,Iraq,Nineveh,7,0,7,"The caliphate straps explosives to the necks of seven men, then decapitate them by detonation."
26672,23/6/2015,Iraq,Nineveh,5,0,5,"The Islamic State puts five men in a cage, then slowly lowers it into a pool, drowning them."
26673,23/6/2015,Iraq,Nineveh,4,0,4,Four men are executed by the Islamic State by being strapped into a car and then burned alive.
26674,23/6/2015,Syria,Deir Ezzor,0,2,2,Two children are tortured for not fasting during Ramadan.
26675,23/6/2015,Nigeria,Wagir,10,30,40,A '12-year-old' girl self-detonates in a crowded market.  Shrapnel from the suicide vest lays out ten patrons.
26676,23/6/2015,Syria,al-Tall,13,0,13,Thirteen worshippers at a mosque are sent straight to Allah by rival car bombers.
26677,23/6/2015,Iraq,Balad Ruz,12,24,36,A dozen Iraqis at a tribal meeting are slaughtered by two Fedayeen suicide bombers.
26678,23/6/2015,Syria,Hassakeh,10,16,26,Two Shahid suicide bombers claim ten other souls near a children's hospital.
26679,23/6/2015,Philippines,Sumisip,2,3,5,An Abu Sayyaf bomb kills two soldiers on patrol.
26680,24/6/2015,Egypt,Suez,1,0,1,A Christian is found shot twice in the chest after resisting pressure to convert to Islam.
26681,24/6/2015,China,Tahtakoruk,3,0,3,At least three defenders are killed when a Muslim mob descends on a police checkpoint with knives and bombs.
26682,24/6/2015,Iraq,Mandli,14,21,35,Over a dozen civilians are wiped out by a car bomb outside their home.
26683,24/6/2015,Somalia,Mogadishu,12,5,17,A dozen people are blown to bits by al-Shabaab car bombers.
26684,24/6/2015,Afghanistan,Badakhshan,1,1,2,A Taliban bomb claims the life of a regional official.
26685,24/6/2015,Iraq,Jub al-Jarah,3,6,9,An ISIS assault on an Alawite village leaves three defenders dead.
26686,24/6/2015,Somalia,Mogadishu,3,7,10,Three Somalis are laid out by a Shahid suicide bomber.
26687,24/6/2015,Iraq,Nukhaib,2,8,10,A suicide bomber takes care of two Iraqis.
26688,24/6/2015,Iraq,Tal Afar,5,0,5,Five citizens are murdered by ISIS.
26689,25/6/2015,Syria,Kobane,2,1,3,Islamists cut off the fingers of a young girl and murder her parents.
26690,25/6/2015,Pakistan,Mubarkakpur,1,0,1,A young woman is beaten to death by her conservative father and brother over suspicion of an affair.
26691,25/6/2015,Iraq,Hit,9,13,22,Rocket fire targeting an irrigation facility also kills nine civilians.
26692,25/6/2015,Iraq,Nadheem al-Taqseem,14,27,41,ISIS fighters kill fourteen Iraqis.
26693,25/6/2015,Syria,Raqqa,12,0,12,A dozen captives are beheaded by the Islamic State.
26694,25/6/2015,Syria,Bakha Botan,23,0,23,"Twenty-three civilians, including women and children, are rounded up and executed by caliphate members."
26695,25/6/2015,Syria,Kobane,15,70,85,Women and children are among fifteen Kurds killed by an ISIS car bomb.
26696,25/6/2015,Syria,Kobane,5,5,10,Five Iraqis are taken out by a Fedayeen suicide bomber.
26697,25/6/2015,Iraq,Mahmudiyah,2,6,8,An 8-year-old child is among two disassembled by a Jihadi bombing at a market.
26698,25/6/2015,Iraq,Baghdad,6,16,22,A half-dozen Iraqis are reduced to part by a Mujahideen car bomb blast at a commercial district.
26699,25/6/2015,Pakistan,Oarmagai,2,2,4,"Religious militants bomb a water truck, killing two occupants."
26700,26/6/2015,Somalia,Leego,50,20,70,Fifty people are reported dead following a Shahid suicide bombing on an African Union base followed by shooting and beheading.
26701,26/6/2015,Sudan,Kadugli,2,0,2,Two traders are ambushed and shot dead by Janjiweed militia.
26702,26/6/2015,Afghanistan,Want Waigal,12,25,37,A dozen local police and unknown number of civilians lose their lives to a Taliban attack.
26703,26/6/2015,Syria,Ain al-Arab,18,0,18,Children are among eighteen more victims found after an Islamic State rampage.
26704,26/6/2015,Syria,Hassakeh,20,0,20,An ISIS suicide bomber takes out twenty people at a government building.
26705,26/6/2015,France,Lyon,1,2,3,"A 'normal Muslim' attacks a factory, beheads one worker and raises the Islamist flag after hoisting the severed head on a fence."
26706,26/6/2015,Tunisia,Sousse,38,36,74,Islamists massacre thirty-eight innocents with machine-guns at a beach resort popular with foreign tourists.
26707,26/6/2015,Syria,Kobani,103,150,253,Over one-hundred more civilians are butchered when the Islamic State overrun a Kurdish town and go 'house to house'.
26708,26/6/2015,Kuwait,Kuwait City,27,227,254,"Sunni radicals stage a suicide bombing at a Shiite mosque, calling it the 'temple of the rejectionists' and leave over two dozen dead."
26709,26/6/2015,Afghanistan,Alishang,2,1,3,Two people bleed out following a Taliban bomb blast at a bazaar.
26710,26/6/2015,Iraq,Mosul,1,0,1,A physician is dragged from his hospital and executed by religious radicals.
26711,26/6/2015,DRC,May-Moya,8,20,28,Five villagers and three guards are killed by ADF Islamists.
26712,27/6/2015,Iraq,Baghdad,2,3,5,"Religion of Peace enthusiasts bomb a vegetable market, killing two."
26713,27/6/2015,Syria,Kobane,42,0,42,Forty-two more civilians are discovered butchered by the Islamic State.
26714,27/6/2015,Syria,Sheikh Hilal,40,0,40,At least forty are reported dead after three coordinated ISIS attacks.
26715,27/6/2015,Iraq,Baiyaa,2,10,12,Two shoppers in a commercial district are exterminated by a well-hidden bomb.
26716,27/6/2015,Iraq,Baghdad,3,8,11,A bomb blast at an outdoor market claims the lives of three innocents.
26717,27/6/2015,Iraq,Baghdad,5,13,18,Jihadi bombers take out five people near an auto-parts shop.
26718,27/6/2015,Syria,Daraa,9,24,33,At least nine civilians are killed during a two barrage of rockets into their neighborhood by Sunni extremists.
26719,27/6/2015,Nigeria,Maiduguri,3,16,19,Two female suicide bombers murder three people at a leprosy hospital.
26720,27/6/2015,Mali,Nara,3,0,3,Bearded Jihadis attack a small town and kill three defenders.
26721,27/6/2015,Syria,Deir ez-Zor,4,0,4,Four homosexuals are tossed one after the other to their deaths from a roof.
26722,28/6/2015,Somalia,Kismayo,9,0,9,Islamists capture and behead nine AU soldiers at their base.
26723,28/6/2015,Iraq,Fallujah,15,27,42,Fifteen people lose their lives when Islamic State shells hit a hospital.
26724,28/6/2015,Thailand,Yala,1,1,2,Muslim militants ambush and kill a rubber tapper in front of his wife.
26725,28/6/2015,Syria,Raqqa,2,0,2,Two men are shot and then crucified by the caliphate.
26726,28/6/2015,Syria,Damascus,4,13,17,"Sunni militants send a mortar into a residential neighborhood, killing four civilians."
26727,28/6/2015,Iraq,Kirkuk,1,0,1,Terrorists assassinate a senior oil executive.
26728,28/6/2015,Pakistan,Khyber Pakhtunkhwa,3,0,3,Three people are shot to death in separate attacks by terrorists.
26729,29/6/2015,Syria,Kobane,27,48,75,Twenty-seven more civilian victims of ISIS executions and attacks are discovered in their homes.
26730,29/6/2015,Iraq,Fallujah,26,0,26,Twenty-six captives are executed by the Islamic State.
26731,29/6/2015,Syria,Hasakeh,12,0,12,A dozen Syrians are taken out by ISIS car bombs.
26732,29/6/2015,Chad,N'Djamena,6,3,9,A Boko Haram suicide blast kills six security personnel.
26733,29/6/2015,Egypt,Cairo,1,7,8,An Islamist bomb blast claims the life of the country's top prosecutor.
26734,29/6/2015,Iraq,Baghdad,3,9,12,ISIS bombers pick off three Iraqis at an outdoor market.
26735,29/6/2015,Iraq,Tarmiyah,4,0,4,A Sunni drive-by leaves four dead.
26736,29/6/2015,Afghanistan,Karukh,11,8,19,Taliban gunmen ambush and massacre eleven local soldiers riding in pickup trucks.
26737,29/6/2015,Iraq,Ramadi,4,8,12,Four people are pulverized when IS militants send rockets into a university.
26738,29/6/2015,Yemen,Sanaa,28,35,63,Eight women are among twenty-eight mourners blown up at a Shiite funeral by Religion of Peace rivals.
26739,29/6/2015,Israel,Shvut Rachel,1,3,4,A targeted attack on Jewish motorists leaves a 25-year-old dead.
26740,29/6/2015,Syria,al-Mayadin,5,0,5,The caliphate crucifies five people for not fasting during Ramadan.
26741,30/6/2015,Iraq,Samarrah,7,3,10,Seven Iraqis lose their lives to an ISIS roadside bomb.
26742,30/6/2015,Nigeria,Monguno,48,17,65,Over four dozen men and boys are rounded up and mowed down by armed Sharia proponents.
26743,30/6/2015,Afghanistan,Helmand,2,51,53,A Fedayeen suicide bombing leaves two others dead.
26744,30/6/2015,Iraq,Madain,2,6,8,Two civilians are cut to ribbons by a Mujahid bomb blast.
26745,30/6/2015,Iraq,Baghdad,3,15,18,Three innocents bleed out after terrorists bomb two neighborhoods.
26746,30/6/2015,Iraq,Mahmudiyah,3,10,13,"Jihadis set off a bomb in a small town, killing three residents."
26747,30/6/2015,Afghanistan,Kabul,5,26,31,A Fedayeen suicide bomber kills five civilians near a busy shopping district.
26748,30/6/2015,Syria,Dair Ezzor,4,0,4,Two women are beheaded for 'sorcery' along with their husbands.
26749,30/6/2015,India,Bhumma,1,0,1,Four Muslims murder a young Hindu.
26750,30/6/2015,Afghanistan,Ghanikhil,1,0,1,The Taliban assassinate a local official on his way home.
26751,30/6/2015,Pakistan,Lashkar Gah,0,40,40,Women and children are among the casualties of a suicide bomber.
26752,30/6/2015,Uganda,Kampala,1,0,1,An imam is gunned down by Religion of Peace rivals.
26753,1/7/2015,Nigeria,Maiduguri,0,2,2,Suicide bombers target a leprosy hospital for the second week in a row.
26754,1/7/2015,Saudi Arabia,Najran,1,0,1,Radicals Shiites murder a border guard.
26755,1/7/2015,Nigeria,Kukawa,97,0,97,"Ninety-seven residents of a fishing village are massacred by Boko Haram in their place of worship and homes, including women and twenty-two children."
26756,1/7/2015,Pakistan,Quetta,3,0,3,"Sunnis fire into a Shia-owned welding shop, killing three workers."
26757,1/7/2015,Iraq,Badush,22,0,22,Twenty-two tribesmen are executed in front of their families by Islamic State members.
26758,1/7/2015,Yemen,Aden,31,100,131,Women and children are among thirty horribly killed when Shiite radicals send rockets into a port city.
26759,1/7/2015,Philippines,Datu Saudi,1,1,2,A local cop is shot to death by Bangsamoro Islamists.
26760,1/7/2015,Egypt,Sinai,68,54,122,Three suicide bombings and attacks on five checkpoints by religious extremists leaves dozens of soldiers and civilians dead.
26761,1/7/2015,Afghanistan,Wardak,7,0,7,Nighttime raids by the Taliban claim the lives of seven local policemen.
26762,1/7/2015,Kenya,Mandera,9,6,15,Nine people are killed in an attack by an al-Shabaab linked group.
26763,1/7/2015,India,Wangam,1,0,1,A village headman is shot to death by Muslim terrorists.
26764,1/7/2015,Iraq,Baghdad,7,22,29,Seven residents in two neighborhoods are laid out by bomb blasts.
26765,1/7/2015,Iraq,Baghdad,3,11,14,"Jihadis set off a bomb in a commercial district, killing three patrons."
26766,2/7/2015,Syria,Aleppo,4,70,74,Four civilians are killed when Islamist groups attack their town.
26767,2/7/2015,Mali,Goundam,6,5,11,"al-Qaeda attack a UN convoy, killing six peacekeepers."
26768,2/7/2015,Yemen,Aden,5,89,94,A child is among five civilians killed by Shiite rockets.
26769,2/7/2015,Syria,al-Askari,4,0,4,Two men and a woman with her 9-year-old child are executed by an Islamic State firing squad.
26770,2/7/2015,Iraq,Fatha,7,10,17,A Holy Warrior with a suicide vest takes out seven Iraqis.
26771,3/7/2015,Iraq,Baghdad,5,0,5,"Jihadis kill three people with a bomb, then finish off two survivors with shots to the head."
26772,3/7/2015,Iraq,Madain,5,13,18,"Two bombs near a row of shops, leave five dead."
26773,3/7/2015,Syria,Damascus,1,0,1,A cleric is blown up by Religion of Peace rivals with a bomb hidden under his own pulpit.
26774,3/7/2015,Afghanistan,Wardak,23,18,41,"A second wave of Taliban attacks leaves two dozen police and village guards dead, some of whom are beheaded."
26775,3/7/2015,Nigeria,Mussa,31,0,31,Pro-Sharia militants shoot six hapless villagers to death and then twenty-five others trying to flee.
26776,3/7/2015,Nigeria,Miringa,11,0,11,Boko Haram pull eleven people out of their homes and slit their throats.
26777,3/7/2015,Libya,Derna,6,10,16,A suicide bomber takes the lives of six other people.
26778,3/7/2015,Syria,Ariha,25,0,25,A bombing at a mosque kills twenty-five ISIS rivals.
26779,3/7/2015,Nigeria,Malari,12,7,19,A  teen female suicide bomber blows up fifteen people at a mosque.
26780,3/7/2015,Saudi Arabia,Taif,3,7,10,Three police are murdered in their own station by assailants inspired by ISIS.
26781,3/7/2015,India,Baramulla,1,1,2,Islamic militants cross the border from Pakistan and shoot a guard to death.
26782,3/7/2015,Iraq,Mosul,1,0,1,A rival imam is put to death by the caliph.
26783,3/7/2015,Nigeria,Zabamari,55,100,155,"Six female suicide bombers rush into a village crowded with panicked residents and detonate in their midst, killing at least fifty-five."
26784,4/7/2015,Yemen,Aden,12,12,24,"A dozen refugees, including five children, are disassembled by a sectarian rocket attack on a kindergarten."
26785,4/7/2015,Chad,Merom,13,0,13,Islamists attack a village and slit the throats of thirteen victims.
26786,4/7/2015,Iraq,Balad Ruz,3,2,5,The Islamic State is thought responsible for a car bomb that leaves three dead.
26787,4/7/2015,Iraq,Doura,8,27,35,Sunnis plant a bomb at a parking garage in a Shiite area which lays out eight innocents.
26788,4/7/2015,Iraq,Baghdad,9,24,33,"Jihadis set off bombs near a row of restaurants, killing nine bystanders."
26789,4/7/2015,Syria,Palmyra,25,0,25,A video by the Islamic State show teens executing two dozen captives in an ancient Roman amphitheater.
26790,4/7/2015,Pakistan,Quetta,8,0,8,"The targeted killing of eight police officers is blamed on the Taliban, who chanted Islamic slogans at the scene."
26791,4/7/2015,Afghanistan,Herat,0,3,3,Fundamentalists throw acid in the face of three young girls on their way to school.
26792,4/7/2015,Egypt,Rafah,1,4,5,A 5-year-old child is pulled into pieces by an Islamist roadside bomb.
26793,4/7/2015,Egypt,Sheikh Zuweid,4,1,5,Four women and a child are killed when a suspected Ansar Bayt al-Maqdis rocket hits their house.
26794,5/7/2015,Nigeria,Potiskum,6,43,49,"A women, a priest and two children are among six killed when a suicide bomber detonates during a church service."
26795,5/7/2015,Afghanistan,Zabul,1,4,5,"Fundamentalists open fire on a group of civilians, killing one."
26796,5/7/2015,Pakistan,Raghzai,3,6,9,Three security personnel on patrol are reduced to pulp by an Islamist roadside bomb.
26797,5/7/2015,Chad,Tiskra,13,0,13,A group of camel herders are waylaid and slaughtered by Boko Haram.
26798,5/7/2015,Syria,Ras al-Ayn,50,0,50,"ISIS sends a 14-year-old suicide bomber into an Kurdish checkpoint, reportedly killing over fifty people."
26799,5/7/2015,Iraq,Baghdad,4,9,13,Mujahid murder four people at a bus stop with a well placed bomb.
26800,5/7/2015,Iraq,Jisr Diyala,4,11,15,Four people at a restaurant are taken out in mid-bite by Religion of Peace bombers.
26801,5/7/2015,Iraq,Obeidi,4,14,18,A bomb blast at a Shiite cafe snuffs out four lives.
26802,5/7/2015,Afghanistan,Kandahar,3,13,16,A woman is among three locals taken out by a Shahid suicide bomber outside a Shiite mosque.
26803,5/7/2015,Syria,Hassakeh,20,0,20,Twenty people are reported dead after suicide bombers detonate at a power plant.
26804,5/7/2015,Iraq,Baiji,9,0,9,At least nine others are killed by two suicide bombers.
26805,5/7/2015,Syria,Damascus,2,18,20,A woman is among two civilians losing their lives to mortars fired by Sunni terrorists.
26806,5/7/2015,Nigeria,Borno,9,0,9,Islamists return to the scene of an earlier massacre and shoot nine survivors in addition to burning thirty-churches and three-hundred homes.
26807,5/7/2015,Iraq,al-Sheeha,21,0,21,Two suicide car bombers send twenty-one souls to Allah.
26808,6/7/2015,Syria,Aleppo,25,40,65,An al-Qaeda suicide car bombing leaves at lease twenty-five others dead.
26809,6/7/2015,Iraq,Mosul,1,0,1,A female journalist is dragged from her home and executed by the caliphate.
26810,6/7/2015,Iraq,Haditha,7,0,7,Seven Iraqis are exterminated by an ISIS suicide bomber on an explosives-laden bulldozer.
26811,6/7/2015,Nigeria,Jos,44,67,111,Islamic extremists set off one bomb at a restaurant and another at a rival mosque which leave over forty dead.
26812,6/7/2015,Pakistan,Quetta,3,2,5,"Sunnis fire on a group of Hazara minorities, killing two."
26813,6/7/2015,Syria,Raqaa,2,0,2,Caliphate members tie two young media activists to trees and then shoot them.
26814,6/7/2015,Iraq,Mosul,4,0,4,Four children are killed when ISIS blow up a church.
26815,6/7/2015,Iraq,Hashd Shaabi,15,18,33,Fifteen Iraqis security personnel are reduced to ashes by four Islamic State suicide bombers.
26816,6/7/2015,Iraq,Shirqat,1,0,1,An elderly teacher is executed by an ISIS child of about 10.
26817,7/7/2015,Afghanistan,Faryab,3,0,3,Three local cops are abducted and beheaded by religious fundamentalists.
26818,7/7/2015,Iraq,Tuz,4,10,14,Children comprise the bulk of casualties when Jihadis set off a bomb outside a school.
26819,7/7/2015,Iraq,Baiji,10,30,40,A triple suicide blast takes out ten Iraqis.
26820,7/7/2015,Iraq,Shirqat,1,0,1,A 'witch' is strapped to a generator and electrocuted by the Islamic State.
26821,7/7/2015,Yemen,Sanaa,1,5,6,One worshipper is dead after a Sunni suicide bomber attacks a Shia mosque.
26822,7/7/2015,Nigeria,Sabon Gari,4,3,7,"A female suicide bomber detonates at a traffic checkpoint, killing four bystanders."
26823,7/7/2015,Afghanistan,Kabul,1,0,1,A suicide bomber manages to kill one other person.
26824,7/7/2015,Thailand,Yala,1,3,4,"Militant Muslims open fire with automatic weapons on a passing car, killing one occupant."
26825,7/7/2015,Yemen,Baida,10,0,10,An ISIS car bomb produces ten dead bodies.
26826,7/7/2015,Nigeria,Zaria,26,32,58,"Twenty-six people are torn limb from limb by a Fedayeen suicide bomber, including many woman and a 2-year-old child."
26827,7/7/2015,Philippines,Sulu,0,13,13,Children are among the casualties when Abu Sayyaf toss a grenade into the street.
26828,7/7/2015,Kenya,Soko Mbuzi,14,10,24,"Islamists attack a sleeping village, throwing grenades into homes and setting tents with laborers on fire."
26829,8/7/2015,India,Shopian,1,0,1,Islamic militants ambush and murder a local soldier.
26830,8/7/2015,Iraq,Fallujah,11,38,49,"ISIS sends mortars into a city, killing eleven residents."
26831,8/7/2015,Iraq,Mosul,6,0,6,Six captives are lined up and shot by the Islamic State.
26832,8/7/2015,Libya,Benghazi,1,3,4,One person is killed when militants rocket a hospital.
26833,8/7/2015,Iraq,Fallujah,24,0,24,Video is released showing the bodies of 'dozens' crucified for eating during Ramadan.
26834,9/7/2015,DRC,Virunga,9,0,9,Nine others are killed during an ADF attack.
26835,9/7/2015,Iraq,Fallujah,10,0,10,Five mothers are burned alive with their children for refusing to join the caliphate.
26836,9/7/2015,Egypt,al-Arish,0,20,20,Sharia proponents bomb a bus carrying off-duty policemen.
26837,9/7/2015,Niger,Dagaya,5,0,5,Islamists slit the throats of five construction workers.
26838,9/7/2015,Syria,Midane,4,2,6,At least four civilians are pulverized by a Sunni rocket.
26839,9/7/2015,Iraq,Baghdad,5,9,14,Two Islamic bomb blasts at markets leave five dead.
26840,9/7/2015,Iraq,Zafaraniya,7,18,25,Seven people are wiped out by a Religion of Peace car bomb blast along a row of restaurants.
26841,9/7/2015,Iraq,Madaen,2,11,13,"Jihadis bomb a cafe, killing two patrons."
26842,9/7/2015,Iraq,Haiyakil,7,9,16,A suicide bomber liberates seven souls with a massive truck blast.
26843,9/7/2015,Thailand,Narathiwat,1,0,1,Muslim 'insurgents' gun down an off-duty policeman outside a mosque.
26844,10/7/2015,Iraq,Mosul,11,0,11,Caliphate members execute eleven Iraqis by running over their prone bodies with a bulldozer.
26845,10/7/2015,Nigeria,Gamboru,8,0,8,Three women are among eight civilians casually picked off by Boko Haram gunmen.
26846,10/7/2015,Nigeria,Ngamdu,11,0,11,Eleven villagers are cut down during a raid by Boko Haram.
26847,10/7/2015,Iraq,Baghdad,6,22,28,An Islamic State car bomb sends six Iraqis to their death.
26848,10/7/2015,Thailand,Songkhla,1,13,14,Two bombings by suspected 'insurgents' leave one woman dead outside a bank.
26849,10/7/2015,Iraq,Anbar,10,0,10,At least ten defenders are killed when ISIS attempt to take over a town.
26850,10/7/2015,Somalia,Mogadishu,12,18,30,"A dozen others are reported killed when Islamists attack a hotel, first with a suicide blast and then gunfire."
26851,10/7/2015,Afghanistan,Mamand,3,0,3,Three tribal elders are assassinated by ISIS.
26852,10/7/2015,Nigeria,Sambisi,1,0,1,A man is shot and beheaded on video by militants chanting slogans to Allah.
26853,11/7/2015,Nigeria,Maiduguri,4,3,7,"A suicide bomber on a tricycle pedals to paradise, taking four civilians with him."
26854,11/7/2015,Iraq,Rashidiya,3,5,8,A fruit and vegetable market is the scene of much blood after Mujahid set off a bomb.
26855,11/7/2015,Iraq,Baghdad,4,9,13,A roadside blast takes care of four Iraqis.
26856,11/7/2015,Iraq,Youssifiya,2,0,2,A Jihadi bomb blast brings down two patrons at a market.
26857,11/7/2015,Egypt,Rafah,1,3,4,A civilian is killed by an Islamist mortar shell.
26858,11/7/2015,Nigeria,Monguno,43,0,43,Islamists attack three small towns and shoot or slit the throats over forty people.
26859,11/7/2015,Thailand,Narathiwat,1,0,1,A 35-year-old is shot to death by Muslim 'separatists'.
26860,11/7/2015,Thailand,Narathiwat,3,8,11,Three lose their lives when Muslims set fire to a night-club district.
26861,11/7/2015,Egypt,Cairo,1,4,5,A bystander is killed when Islamic radicals set off a car bomb outside the Italian consulate.
26862,11/7/2015,Afghanistan,Kandahar,3,6,9,Three children are disassembled by Taliban bombers.
26863,11/7/2015,Yemen,Dhalea,1,0,1,A Shiite shell claims the life of a child.
26864,11/7/2015,Chad,N'Djamena,15,80,95,Fifteen people at a market are blown to bits by a suicide bomber in a burqa.
26865,12/7/2015,Iraq,Bunouk,9,15,24,A car bomb in a commercial district leaves nine dead.
26866,12/7/2015,Iraq,Shaab,19,25,44,Nineteen lives are snuffed out when a suicide bomber drives into a crowded market and explodes.
26867,12/7/2015,Libya,Benghazi,5,17,22,"Suspected Islamists fire a rocket into a residential district, killing five elderly men."
26868,12/7/2015,Iraq,Mosul,1,0,1,A group of female Sharia police beat a woman to death for lifting her veil in a store to read a label.
26869,12/7/2015,Afghanistan,Khost,33,11,44,Over two dozen innocents are blown to bits by suicide car bombers.
26870,12/7/2015,Iraq,Baghdad,2,7,9,An ISIS bomb at a commercial district leaves two dead.
26871,12/7/2015,Iraq,Baghdad,4,11,15,"Sunnis time a car bomb to explode just as Shias are breaking their Ramadan fast, killing four."
26872,12/7/2015,Iraq,Khazimiyah,8,23,31,A Fedayeen suicide bomber murders eight people at a square outside a Shiite mosque.
26873,12/7/2015,Niger,Diffa,1,2,3,One guard is left dead when Boko Haram attack a prison.
26874,12/7/2015,Libya,Benghazi,19,80,99,Nineteen people are killed during an ISIS assault.
26875,12/7/2015,Afghanistan,Kunduz,2,6,8,Religious hardliners plant a bomb that claims the lives of two civilians.
26876,12/7/2015,Cameroon,Fotokol,11,17,28,Two suicide bombers murder eleven people breaking their Ramadan fast.
26877,12/7/2015,Iraq,Mosul,10,0,10,Ten Iraqis are lined up and mowed down by ISIS machine-guns.
26878,12/7/2015,Afghanistan,Tatarkhil,10,4,14,Ten civilians are easily exterminated by a Taliban bomb blast.
26879,12/7/2015,Iraq,Sharqat,1,0,1,Caliphate members booby-trap and set fire to a baby for demonstration purposes.
26880,13/7/2015,Somalia,Rage Celle,7,0,7,Seven others are killed during an al-Shabaab attack.
26881,13/7/2015,Nigeria,Mainok,40,0,40,Forty 'hapless' villagers are massacred by Islamic terrorists.
26882,13/7/2015,Nigeria,Maiduguri,4,5,9,"A Shahid suicide bomber hits a checkpoint screening civilians, killing four."
26883,13/7/2015,Afghanistan,Pul-u-Khumri,0,29,29,Women and children are among the casualties when fundamentalists bomb a rival mosque during the iftar dinner.
26884,13/7/2015,Kenya,Lamu,3,8,11,al-Shabaab claims a bombing that leaves three dead.
26885,13/7/2015,Afghanistan,Zabul,1,8,9,Fundamentalists target the employees of a demining company
26886,13/7/2015,Iraq,Shirqat,5,0,5,Five civilians are executed by the Islamic State.
26887,13/7/2015,Afghanistan,Maidan Wardak,2,2,4,A father and son are aerated by Religion of Peace ball bearings.
26888,13/7/2015,Afghanistan,Lababi,1,0,1,A prayer leader is shot to death by Religion of Peace rivals.
26889,14/7/2015,Iraq,Baghdad,2,0,2,The church reports that two members were kidnapped and killed in the previous two weeks.
26890,14/7/2015,Afghanistan,Ghani Khel,1,0,1,A man is beheaded on video by the Islamic State.
26891,14/7/2015,Chad,Tetewa,6,0,6,Islamists reach an island community and massacre six children.
26892,14/7/2015,Iraq,Khalis,5,11,16,ISIS car bombers take out five people outside a doctor's house.
26893,14/7/2015,Syria,Salqin,7,0,7,A double suicide bombing leaves six dead.
26894,14/7/2015,Nigeria,Borno,20,0,20,Twenty travelers returning for victims of an earlier massacre are forced out of their vehicles and executed by Boko Haram.
26895,14/7/2015,Iraq,Mosul,1,0,1,A rival imam is executed by the Islamic State.
26896,15/7/2015,Iraq,Mosul,14,0,14,Fourteen dissidents are executed for not following Sharia rules.
26897,15/7/2015,Iraq,Mosul,17,0,17,Seventeen fishermen are executed by ISIS for not catching their catch.
26898,15/7/2015,Iraq,Baiji,11,10,21,Eleven security personnel are sent to Allah by a Fedayeen suicide bomber.
26899,15/7/2015,Iraq,Ramadi,8,17,25,Three Shahid suicide bombers murder eight Iraqis.
26900,15/7/2015,Niger,Bosso,16,4,20,"Islamic radicals fire on a group of unarmed villagers, killing sixteen."
26901,15/7/2015,Nigeria,Damasak,12,0,12,At least twelve villagers are slaughtered by Boko Haram shortly after security forces are recalled.
26902,15/7/2015,Afghanistan,Miamana,0,19,19,Women comprise most of the casualties when a bomb detonates outside a bank.
26903,15/7/2015,Afghanistan,Ahmad Wali Khan,4,4,8,At least four local cops lose their lives to a Fedayeen suicide bomber.
26904,15/7/2015,Syria,Deir Ezzor,8,0,8,Eight civilians are crucified by the caliph for breaking Ramadan fasting rules.
26905,15/7/2015,Afghanistan,Nawbahar,5,0,5,Five innocents are shot to death by Taliban while setting up a shop.
26906,15/7/2015,Afghanistan,Shah Joy,2,0,2,A civil rights activist is among two people gunned down by religious extremists.
26907,15/7/2015,Nigeria,Baga,8,0,8,Eight civilians are summarily shot in the back of the head by Sharia activists along a highway.
26908,16/7/2015,Iraq,Mosul,1,0,1,A journalist is executed by the Islamic State.
26909,16/7/2015,Libya,Laith,9,30,39,At least nine civilians are killed during a clash with the Islamic State.
26910,16/7/2015,Thailand,Narathiwat,2,0,2,"Muslim 'separatists' ambush and kill two security personnel, then set fire to the bodies."
26911,16/7/2015,Iran,Isfahan,1,0,1,A 14-year-old boy is reportedly hung from a tree after a cleric accuses him of being gay.
26912,16/7/2015,Nigeria,Gombe,49,71,120,Children are among the dozens of dead and maimed when a suicide bomber targets a market.
26913,16/7/2015,Syria,Deir ez-Zor,4,0,4,Four prisoners are brought to an ancient site and shot in the back of the head by the Islamic State.
26914,16/7/2015,USA,Chattanooga,5,2,7,A 'devout Muslim' stages a suicide attack on a recruiting center at a strip mall and a naval center which leaves five dead.
26915,16/7/2015,Afghanistan,Mihtarlam,8,0,8,Two children are among eight people massacred during a Taliban ambush on their van.
26916,16/7/2015,Saudi Arabia,Riyadh,0,2,2,A suicide bomber attacks a rival mosque.
26917,16/7/2015,Syria,Raqqa,0,94,94,Five children are among nearly one-hundred citizens tortured and held in cages for violating Ramadan fasting rules.
26918,16/7/2015,Iraq,Moseliya,1,0,1,A TV cameraman and father of two is taken from his home and executed by the Islamic State.
26919,16/7/2015,Iraq,Riqqa,5,9,14,"IS militants bomb a home, killing five occupants."
26920,17/7/2015,Algeria,Tifran,11,0,11,Eleven security personnel are ambushed and murdered by al-Qaeda.
26921,17/7/2015,Pakistan,Quetta,1,0,1,"A suicide bomber detonates at a women's university, killing a guard."
26922,17/7/2015,Afghanistan,Sholgar,3,14,17,"Strict Islamic law activists set off a bomb outside a rival mosque that kills three worshippers, including two children."
26923,17/7/2015,Afghanistan,Kangori,1,11,12,"Fundamentalists bomb a rival mosque, killing one worshipper."
26924,17/7/2015,Afghanistan,Gozara,6,3,9,Religious hardliners murder six local cops with an IED.
26925,17/7/2015,Afghanistan,Bukhari,1,0,1,An imam is pulled from his home and murdered after preaching against the Taliban.
26926,17/7/2015,Iraq,Kahn Bani Saad,120,170,290,Children are among over one-hundred innocents cut down by Mujahid bombers while celebrating Ramadan.
26927,17/7/2015,Syria,Homs,1,0,1,The caliphate has a 10-year-old boy behead a captive.
26928,17/7/2015,Nigeria,Damaturu,15,41,56,A 10-year-old girl and elderly woman are strapped with suicide vests and sent onto a rival prayer ground.
26929,17/7/2015,Afghanistan,Alisher,1,4,5,"Taliban bombers target a family visiting the grave of a previous victim, killing a child."
26930,17/7/2015,Afghanistan,Zazi Maidan,2,0,2,A suicide bomber takes out two people at a rival mosque.
26931,18/7/2015,Mali,Niangassadiou,6,0,6,Six residents at a peaceful village are machine-gunned by Religion of Peace extremists.
26932,18/7/2015,Egypt,Sheikh Zueid,7,7,14,"FundamAnsa Bayt al-Maqdis fundamentalists attack a group of local soldiers, killing seven."
26933,18/7/2015,Pakistan,Salim Khan,1,0,1,The Taliban shoot a man returning home from a house of worship.
26934,19/7/2015,Cameroon,Kamouna,23,0,23,"Twenty-three residents of a fishing village are massacred during a raid by Sharia advocates, including nine students burned to death."
26935,19/7/2015,Yemen,Aden,99,220,319,A dozen children are among one-hundred civilians wiped out by a Shiite rocket barrage on a port city.
26936,19/7/2015,Iraq,Mahmoudiya,7,0,7,A family of seven is exterminated in their own home by Islamic terrorists.
26937,19/7/2015,Iraq,Baghdad,3,11,14,Three people are killed by Mujahid bombers.
26938,19/7/2015,Iraq,Baghdad,4,7,11,A bomb blast on a commercial street leaves four dead.
26939,19/7/2015,Thailand,Narathiwat,1,0,1,A defense volunteer is machine-gunned by Muslim terrorists while on his way home.
26940,19/7/2015,Iraq,Habbaniyah,2,3,5,Two Iraqis are taken out by a suicide bomber.
26941,20/7/2015,Yemen,Taiz,8,0,8,Eight residents are crushed to death when Shiite radicals send rockets into their neighborhood.
26942,20/7/2015,Yemen,Sanaa,7,7,14,The Islamic State claims a car bombing in a neighborhood that leaves seven dead.
26943,20/7/2015,Iraq,Baqubah,11,24,35,Four children are among eleven people bleeding to death following a mortar barrage on a sports stadium.
26944,20/7/2015,Nigeria,Damaturu,6,12,18,A half-dozen people are turned to pulp by two suicide bombers.
26945,20/7/2015,Syria,Kobane,2,0,2,At least two others are killed by a Fedayeen suicide bomber.
26946,20/7/2015,Turkey,Surac,32,97,129,"A Shahid suicide bomber wipes out over thirty innocents, mostly university students on a humanitarian mission."
26947,20/7/2015,Iraq,Tal Afar,40,0,40,Forty ISIS members are executed for trying to leave.
26948,20/7/2015,Philippines,Sulu,1,0,1,Abu Sayyaf kill a child kidnapped for use as a human shield.
26949,20/7/2015,Iraq,Hudaid,10,16,26,Ten civilians are flattened by ISIS mortars.
26950,21/7/2015,Nigeria,Buratai,2,8,10,Strict Sharia advocates burn down homes and kill two residents.
26951,21/7/2015,Yemen,Sanaa,4,8,12,Children are among the casualties when the Islamic State sets off a car bomb near a Shia mosque.
26952,21/7/2015,Syria,Idlib,7,100,107,At least seven residents are killed when al-Qaeda militants shell Shiite villages.
26953,21/7/2015,Afghanistan,Paghman,1,0,1,The Taliban gun down a member of a peace committee on his way home.
26954,21/7/2015,Iraq,Mandali,8,16,24,Islamic State bombers murder eight patrons at an outdoor market.
26955,21/7/2015,Iraq,Tarmiya,4,20,24,Four Iraqis are laid out by a suicide car bomber.
26956,21/7/2015,Iraq,Baghdad,2,9,11,"A Sunni with a suicide belt detonates in a Shiite area, taking two civilians with him."
26957,21/7/2015,Iraq,Baghdad,19,43,62,A Fedayeen suicide bombing claims the lives of nineteen innocents at a busy clothing store.
26958,21/7/2015,Mali,Gossi,2,0,2,Two civilians are killed during an attack on a convoy by suspected Islamists.
26959,21/7/2015,Iraq,Fallujah,9,12,21,Women and children are among the victims of a suspected ISIS mortar attack.
26960,21/7/2015,Iraq,Mosul,4,0,4,Four tailors are executed for refusing to sew clothes for the caliphate.
26961,22/7/2015,Syria,Deir-ez-Zur,1,0,1,A 17-year-old boy is crucified on a cross by the caliphate.
26962,22/7/2015,Iraq,Baghdad,8,22,30,"Sunnis bomb a Shiite neighborhood, killing eight."
26963,22/7/2015,Cameroon,Maroua,13,32,45,Two girls disguised as beggars blow themselves up in a crowded market.  Thirteen innocents are killed in the suicide blasts.
26964,22/7/2015,Afghanistan,Alamar,19,32,51,"A Shahid suicide bomber self-detonates at a market, slaughtering nineteen bystanders."
26965,22/7/2015,Afghanistan,Khas Urozgan,1,0,1,A tribal elder is abducted and executed by the Taliban.
26966,22/7/2015,Nigeria,Gombe,42,105,147,Over forty people are blown to bits by Boko Haram bomb blasts at two different bus stations.
26967,22/7/2015,Iraq,Fallujah,22,24,46,A double suicide attack produces two dozen dead Iraqis.
26968,22/7/2015,Nigeria,Pompomari,9,13,22,A boy is among nine villagers shot to death by Boko Haram.
26969,23/7/2015,Libya,Nufaliya,1,0,1,A 25-year-old Christian is kidnapped and executed by Muslim radicals.
26970,23/7/2015,Egypt,Rafah,4,0,4,Four security personnel are disintegrated in their vehicle by Religion of Peace bombers.
26971,23/7/2015,Iraq,Mosul,1,0,1,The caliphate beheads a rival imam.
26972,23/7/2015,DRC,Mayi-Moya,3,0,3,ADF Islamists burn down ten homes and murder three women.
26973,23/7/2015,Syria,Deir ez-Zor,6,0,6,"Islamic State gunmen fire on civilians trying to access relief aid, killing six."
26974,23/7/2015,Iraq,Mosul,9,0,9,Nine civilians are publicly beheaded by caliphate children.
26975,24/7/2015,Pakistan,Bhowana,1,0,1,A woman who married against the will of her conservative family is kidnapped and hanged by her brothers.
26976,24/7/2015,Nigeria,Adamawa,25,0,25,"Sharia proponents ride into three villages and spray residents with machine-gun fire, killing over two dozen."
26977,24/7/2015,Syria,Homs,2,0,2,Two gay men are thrown from a roof and then stoned.
26978,24/7/2015,Turkey,Kilis,1,2,3,ISIS snipers pick off a border guard.
26979,24/7/2015,Iraq,Fallujah,41,0,41,Forty-one Iraqis are brutally executed by the Islamic State.
26980,24/7/2015,Iraq,Therthar Lake,21,24,45,Twenty-one lives are wasted by Fedayeen suicide car bombers.
26981,24/7/2015,Iraq,Iski,10,22,32,Ten residents are killed when ISIS send missiles into a small town.
26982,24/7/2015,Nigeria,Maikadiri,21,0,21,"Strict Islamists open fire on hapless villagers, slaughtering at least twenty-one."
26983,24/7/2015,Nigeria,Yafa,4,0,4,Four villagers are murdered by Boko Haram.
26984,24/7/2015,Nigeria,Dabar Wiya,9,0,9,Nine water melon growers are viciously murdered by Boko Haram.
26985,25/7/2015,Afghanistan,Badakhshan,2,13,15,Religious extremists attack a checkpoint and kill two policemen.
26986,25/7/2015,Iraq,Tuz Khurmatu,12,45,57,A dozen people at a swimming pool are blown up by two suicide bombers.
26987,25/7/2015,Egypt,Sheikh Zuweid,1,4,5,Religious radicals gun down a local cop.
26988,25/7/2015,Somalia,Mogadishu,3,0,3,Three people are picked off by al-Shabaab gunmen.
26989,25/7/2015,Thailand,Pattani,2,6,8,A Buddhist monk is among two killed by a Muslim bomb.
26990,25/7/2015,Lebanon,Ain al-Hilweh,2,1,3,A refugee official is among two gunned down by terrorists.
26991,25/7/2015,Cameroon,Maroua,19,62,81,A female suicide bomber massacres twenty people at a bar.
26992,25/7/2015,India,Anantnag,1,6,7,A civilian dies from splinter injuries from a grenade tossed by a Muslim militant.
26993,25/7/2015,Syria,Aleppo,5,0,5,Five children are disassembled by a Sunni rocket.
26994,26/7/2015,Pakistan,Karachi,1,0,1,A Shiite mosque official is assassinated by sectarian rivals.
26995,26/7/2015,Iraq,Hawija,2,0,2,Religionists behead two people on charges of sorcery.
26996,26/7/2015,Iraq,Baiji,8,3,11,An ISIS bomb produces eight dead Iraqis.
26997,26/7/2015,Cameroon,Tchebe-Tchebe,3,0,3,Boko Haram behead three villagers and set fire to their church.
26998,26/7/2015,Chad,Blarigi,3,30,33,Islamists slit three throats and kidnap thirty women and children.
26999,26/7/2015,Somalia,Mogadishu,15,20,35,A suicide car bomber plows into a hotel and massacres fifteen innocents.
27000,26/7/2015,Iraq,Mosul,1,0,1,A gay man is thrown from the top of a building on orders from a Sharia court.
27001,26/7/2015,Yemen,Sanaa,3,5,8,Terrorists put a bomb under a passenger bus that kills three riders.
27002,26/7/2015,Nigeria,Damaturu,19,47,66,"A 10-year-old suicide bomber detonates at a packed market, scattering body parts and claiming nineteen souls."
27003,26/7/2015,Pakistan,Islamabad,1,0,1,A Shiite who worked for the US embassy is shot to death in his home.
27004,27/7/2015,India,Gurdaspur,7,8,15,"Militants yelling 'Allah Akbar' spray a bus with automatic weapons fire, then assault a municipal building, killing seven."
27005,27/7/2015,Syria,Damascus,1,17,18,Jaish al-Islam kill a civilian by firing a rocket into a hotel.
27006,27/7/2015,Pakistan,Sangni,3,0,3,A woman and her two children are shot to death by a family member in a suspected 'honor' attack.
27007,27/7/2015,Syria,Raaaq,1,0,1,A mother of two is executed for complaining about the Islamic State.
27008,27/7/2015,Iraq,Baghdad,5,9,14,Two bombs targeting Shiite markets kill five patrons.
27009,27/7/2015,Iraq,Fallujah,2,0,2,Two women are shot down in their tracks for protesting the Islamic State.
27010,27/7/2015,Iraq,Sharqat,7,0,7,Seven civilians are pulled out of their homes and executed in the city square by caliphate members.
27011,27/7/2015,Iraq,Abu Saida,4,10,14,"Terrorists detonate a bomb at a soccer game by remote control, killing four participants."
27012,27/7/2015,Nigeria,Kwatar Mali,4,0,4,Boko Haram slit the throats of four fishermen in the third village attacked that day.
27013,27/7/2015,Nigeria,Fishdam,2,0,2,Boko Haram slit the throats of two fishermen in an attack on a second fishing community that day.
27014,27/7/2015,Nigeria,Bundaram,4,0,4,Boko Haram slit the throats of four fishermen.
27015,28/7/2015,Iraq,Mosul,1,0,1,A Kurd is tortured and shot in the back of the head by members of the caliphate.
27016,28/7/2015,Yemen,Aridah,1,2,3,An elderly woman is killed and two children injured by a Shiite rocket.
27017,28/7/2015,Iraq,Golala,7,0,7,An ISIS bomb blast lays out seven Kurds.
27018,28/7/2015,Nigeria,Dille,29,0,29,Two dozen innocent people are slaughtered by strict Islamists in raids on three Christian villages.
27019,28/7/2015,Bahrain,Sitra,2,6,8,Shiite radicals kill two local cops with a bomb.
27020,28/7/2015,Syria,Deir ez-Zor,7,0,7,"Caliphate members kill seven residents via beheading, crucifixion and shooting."
27021,28/7/2015,Libya,Benghazi,3,11,14,Three other people are obliterated by a Holy Warrior with a suicide vest.
27022,28/7/2015,Syria,Raqqa,1,0,1,"A man is beheaded and then strung up, reportedly for leaving Islam."
27023,28/7/2015,Iraq,Hawija,6,0,6,Six brothers from two families are pulled from the homes and executed in cold blood by the Islamic State.
27024,28/7/2015,Iraq,Baiji,9,23,32,Three Shahid suicide bombers take out nine Iraqis.
27025,29/7/2015,Yemen,Nuqum,3,7,10,The Islamic State sets off a bomb at an Ismaili mosque which kills three worshippers.
27026,29/7/2015,Afghanistan,Kundoz,2,11,13,A woman is among two civilians dismantled by a Taliban bomb blast.
27027,29/7/2015,Saudi Arabia,al-Jash,1,2,3,"Religious radicals fire on a group of police, killing one."
27028,29/7/2015,Egypt,Cairo,1,0,1,Islamist snipers pick off a security guard outside an embassy.
27029,29/7/2015,Yemen,Dar Saad,6,0,6,al-Qaeda make six Shiites kneel and kiss their hands before machine-gunning them.
27030,29/7/2015,Nigeria,Kukuwa-Gari,10,0,10,Two women are among ten innocents viciously cut down by Boko Haram.
27031,29/7/2015,Iraq,Deraa Dijla,9,15,24,A Shahid suicide truck bomber takes the lives of nine others.
27032,29/7/2015,Iraq,Ramadi,17,25,42,Seventeen Iraqis are blown to bits by suicide bombers.
27033,30/7/2015,Pakistan,Youhanabad,1,1,2,"A Christian is shot to death for marrying a Muslim, while his wife is tortured."
27034,30/7/2015,Syria,Homs,1,0,1,An elderly man is forced to his knees and beheaded for 'magic'.
27035,30/7/2015,Afghanistan,Tapa Boom,3,1,4,Three children are disassembled by a Taliban landmine while collecting firewood.
27036,30/7/2015,Syria,Sarrin,10,0,10,At least ten others are killed when an ISIS suicide bomber detonates and others open fire on the survivors.
27037,30/7/2015,Pakistan,Dayoba,2,0,2,"Islamic militants pour heavy machine-gun fire into a police checkpoint, killing two officers."
27038,30/7/2015,Iraq,Rashidiya,30,0,30,A mass grave containing thirty ISIS execution victims is discovered.
27039,30/7/2015,Iraq,Baghdad,6,22,28,Islamic State bombers take out six people with two blasts.
27040,30/7/2015,Iraq,Mazraa,5,9,14,Five Iraqis are laid out by an ISIS suicide bomber.
27041,30/7/2015,Iraq,al-Baghdadi,9,16,25,Sixteen souls are liberated by a Fedayeen suicide bomber.
27042,31/7/2015,Nigeria,Maiduguri,6,11,17,"A suicide bomber detonates in a packed market, sending at least six others to Allah."
27043,31/7/2015,Syria,Azaz,11,9,20,An ISIS suicide bomber kills eleven.
27044,31/7/2015,Iraq,Mosul,4,0,4,Four moderate clerics are discovered and executed by caliphate members.
27045,31/7/2015,Syria,Raqqa,6,0,6,Video is released showing the execution of six men for leaving Islam.
27046,31/7/2015,Libya,Banghazi,7,20,27,Seven local soldiers are killed when ISIS militants attack a traffic checkpoint.
27047,31/7/2015,Syria,Damascus,1,5,6,"Sunni extremists lob mortars into a residential area, killing one."
27048,31/7/2015,Saudi Arabia,Asir,3,7,10,"Shiite terrorists fire over twenty rockets into a Saudi border post, killing three members."
27049,31/7/2015,Yemen,Sir Valley,6,30,36,al-Qaeda suicide car bombers take out six local soldiers.
27050,31/7/2015,Iraq,Mosul,2,0,2,A surgeon and his wife are executed by the Islamic State.
27051,1/8/2015,Syria,Aleppo,10,0,10,Two 'adulterers' are among ten executed by an al-Qaeda Sharia court.
27052,1/8/2015,Mali,Nampala,2,4,6,Two local soldiers are murdered in a suspected al-Qaeda ambush.
27053,1/8/2015,Afghanistan,Shor Shorak,2,3,5,Two people in a civilian vehicle are aerated by a Taliban IED.
27054,1/8/2015,Iraq,Mosul,15,0,15,Fifteen police are rounded up and executed by an Islamic State firing squad.
27055,2/8/2015,Afghanistan,Samangan,3,0,3,Three men headed to a mosque for prayers are gunned down by Religion of Peace rivals.
27056,2/8/2015,Iraq,Rashidiyah,3,11,14,"Islamists set off a bomb at an outdoor market, killing three patrons."
27057,2/8/2015,Nigeria,Malari,13,27,40,Religion of Peace activists slay at least thirteen villagers while they burn down their homes.
27058,2/8/2015,Syria,Raqqa,3,1,4,"A woman and her three children are kidnapped by an ISIS member, who rapes the woman and poisons her kids."
27059,2/8/2015,Iraq,Mosul,4,0,4,Four journalism students are executed by the Islamic State for reporting on social media.
27060,2/8/2015,Thailand,Yala,1,0,1,A Buddhist monk dies from injuries suffered by Muslim shrapnel.
27061,2/8/2015,Nigeria,Madagali,5,0,5,Five people are shot to death by Boko Haram.
27062,3/8/2015,Syria,Raqqa,1,0,1,A child carries out an execution at the behest of the caliphate.
27063,3/8/2015,Iraq,Kirkuk,1,0,1,An oil company executive is assassinated by suspected Jihadis.
27064,3/8/2015,Syria,Hama,3,0,3,Three accused homosexuals are forced to their knees and then shot in the head by caliphate members.
27065,3/8/2015,Mali,Timbuktu,11,1,12,"An al-Qaeda attack on a security camp, leave eleven personnel dead."
27066,3/8/2015,Pakistan,Saddar,1,0,1,A peace committee member is gunned down by Muslim terrorists.
27067,3/8/2015,Afghanistan,Khwar,4,0,4,The Taliban take out three women in a rickshaw along with their driver.
27068,3/8/2015,Iraq,Hawija,8,0,8,Eight people trying to flee an ISIS occupation are captured and executed.
27069,3/8/2015,Iraq,Mosul,19,0,19,Nineteen sex slaves are reportedly executed by the Islamic State for refusing duties.
27070,3/8/2015,Iraq,Mosul,6,0,6,Six cab drivers are executed for trying to help families escape the Islamic State.
27071,4/8/2015,Syria,Raqqa,1,0,1,A Syrian is executed by the caliph for 'crimes against Allah'.
27072,4/8/2015,Thailand,Narathiwat,1,1,2,Muslim 'separatists' gun down a civilian in a tea shop.
27073,4/8/2015,Cameroon,Tchakarmari,7,20,27,Militants fighting for an Islamic state slaughter seven villagers.
27074,4/8/2015,Iraq,Mosul,1,0,1,Caliphate members throw a homosexual to his death from a silo to a baying mob.
27075,4/8/2015,Egypt,Sheikh Zuweid,5,9,14,"Fundamentalists blow a family of five to bits, including three children, with a rocket attack on their home."
27076,4/8/2015,Afghanistan,Bagram,1,2,3,A conservative man shoots his sister for attending a wedding party without permission.
27077,4/8/2015,India,Udhampur,2,8,10,Militant Muslims attack a police convoy and kill two members.
27078,4/8/2015,Iraq,Baiji,3,2,5,A bomb left in a home by ISIS claims three lives.
27079,4/8/2015,Somalia,Janale,1,0,1,A man is murdered in his own home by al-Shabaab.
27080,5/8/2015,Somalia,Mogadishu,1,0,1,A government official is assassinated by Sharia proponents.
27081,5/8/2015,Syria,Palmyra,2,0,2,Video is released showing two men being beheaded with knives by the Islamic State.
27082,5/8/2015,Iraq,Mosul,15,0,15,Fifteen Iraqis are lined up and mowed down by ISIS gunmen.
27083,5/8/2015,Iraq,Habbaniyah,5,9,14,An ISIS attack leaves five other dead.
27084,5/8/2015,Nigeria,Borno,1,0,1,A kidnapped policeman is beheaded to shouts of 'Allah Akbar'.
27085,5/8/2015,Iraq,Makhmour,1,2,3,ISIS scores a direct hit on a 20-year-old woman standing outside her home.
27086,5/8/2015,Iraq,Diyala,13,9,22,A Fedayeen suicide bomber takes out thirteen Iraqis.
27087,5/8/2015,Iraq,Baghdad,4,13,17,ISIS car bombers kill four Shiites.
27088,5/8/2015,Iraq,Baghdad,6,12,18,"Sunni bombers target a Shia neighborhood, killing ten."
27089,6/8/2015,India,Santgarh,2,0,2,Lashkar-e-Toiba gun down two local cops.
27090,6/8/2015,Pakistan,Nawabshah,1,1,2,"The Tehreek-e-Taliban attack a remote police post, killing an officer."
27091,6/8/2015,Thailand,Narathiwat,1,3,4,A Muslim bomb claims one life.
27092,6/8/2015,Saudi Arabia,Abha,15,25,40,Fifteen worshippers at a mosque are sent straight to Allah by a Shahid suicide bomber.
27093,6/8/2015,Afghanistan,Pul-i-Alam,6,24,30,Doctors are among the casualties of a suicide truck bomb.
27094,6/8/2015,India,Neelum Valley,1,1,2,Suspected Islamists kill a 13-year-old boy with a bomb resembling a toy.
27095,6/8/2015,Libya,Misrata,1,0,1,"A pro-Sharia group abducts a secular judge, tortures him for a month and then executes him."
27096,7/8/2015,Bangladesh,Dhaka,1,0,1,Religion of Peace proponents hack a secular blogger to death for being an 'enemy of Allah.'
27097,7/8/2015,Afghanistan,Kabul,9,10,19,A suicide attack on a military base leaves nine dead.
27098,7/8/2015,Iraq,Mosul,1,0,1,A school administrator is executed by the Islamic State.
27099,7/8/2015,Nigeria,Tadagara,9,0,9,At least nine people are killed when Islamists set fire to their homes.
27100,7/8/2015,Afghanistan,Kabul,26,28,54,A Fedayeen suicide bomber blasts twenty-six innocents to bits.
27101,7/8/2015,Afghanistan,Kabul,20,240,260,"A suicide bomber detonates in the city center, killing at least twenty civilians, including a teacher and six children."
27102,7/8/2015,Mali,Sevare,13,8,21,A Fedayeen suicide assault on a hotel used by UN staff leaves thirteen others dead.
27103,7/8/2015,Syria,Hama,1,14,15,Sunni terrorists kill a woman with a bomb hidden on a motorcycle.
27104,8/8/2015,Egypt,Cairo,1,3,4,"Militant Islamists open fire on a police vehicle, killing an officer."
27105,8/8/2015,India,Tangdar,1,2,3,A group of militants cross over from Pakistan and murder a border guard.
27106,8/8/2015,Afghanistan,Jalalabad,2,3,5,Two locals are taken out by a Taliban bomb.
27107,8/8/2015,Afghanistan,Sarda,1,0,1,A woman is hanged for adultery by a Sharia court after being raped in front of her family.
27108,8/8/2015,Afghanistan,Kunduz,29,19,48,"A suicide bomber plows into a crowd of people, massacring over two dozen."
27109,9/8/2015,Iraq,Ghazlani,50,0,50,University professors are among fifty people rounded up and executed by the Islamic State.
27110,9/8/2015,Afghanistan,Tir Giran,1,0,1,Fundamentalists take a woman from her home and throw her into a river.
27111,9/8/2015,Iraq,Mosul,300,0,300,Fifty women are among three hundred civil servants executed en masse by the Islamic State for 'promoting ideas that distort Islam'.
27112,9/8/2015,Nigeria,Nwajurko,4,3,7,Four people are killed when Boko Haram ambush a civilian vehicle.
27113,9/8/2015,Syria,Umm Housh,37,20,57,At least thirty-seven others are eliminated by a suicide bomber.
27114,9/8/2015,Egypt,al-Arish,2,3,5,Two local cops are laid out by a fundamentalist bomb blast.
27115,9/8/2015,Afghanistan,Adam Khan,6,0,6,A Taliban in uniform shoots six local cops in the back.
27116,9/8/2015,Philippines,Sulu,2,0,2,Two guards at a market are gunned down by Abu Sayyaf.
27117,9/8/2015,Iraq,Mosul,6,0,6,A clan leader and is family are put to death by the caliphate.
27118,10/8/2015,Thailand,Si Banphot,1,2,3,"Muslim gunmen fire on a family, killing one member and injuring two others."
27119,10/8/2015,Syria,Aleppo,6,14,20,Three children are among six civilians bleeding to death following a Sunni rocket attack on a Shia area.
27120,10/8/2015,Afghanistan,Kabul,5,16,21,Five people outside an airport are taken apart by a Fedayeen suicide bomber.
27121,10/8/2015,Libya,Derna,9,25,34,An ISIS car bomb claims the lives of nine innocents.
27122,10/8/2015,Afghanistan,Nangarhar,10,0,10,Ten prisoners are forced by their fundamentalist captors to kneel in a row and then blown up with an IED.
27123,10/8/2015,Mali,Diabozo,3,4,7,Three people are killed when their vehicle hits a Jihadi roadside bomb.
27124,10/8/2015,Iraq,Hassan Shami,13,3,16,Terrorists lay out thirteen Kurds with two missiles fired into their town.
27125,10/8/2015,Iraq,Aski Mosul,18,5,23,Nine women and a child are among eighteen civilians aerated by caliphate rocket shrapnel.
27126,10/8/2015,Syria,Kuweris,18,0,18,Three suicide bomber take out eighteen Syrians.
27127,10/8/2015,Iraq,Baqubah,7,25,32,A suicide blast on the outskirts of a town kills seven bystanders.
27128,10/8/2015,Iraq,Huwaidar,51,80,131,Fifty people at a market are blown to bits by suicide bomb blast targeting Shia 'rejectionists'.
27129,11/8/2015,Afghanistan,Mahipar,1,1,2,A truck driver is shot to death by religious radicals.
27130,11/8/2015,Nigeria,Sabon Gari,47,52,99,"A female suicide bomber detonates at a packed market, slaughtering fifty innocents."
27131,11/8/2015,Syria,Marea,25,0,25,Four ISIS suicide bombers slaughter twenty-five 'more moderate' rivals.
27132,11/8/2015,Thailand,Sai Buri,1,0,1,A 43-year-old man is gunned down by Muslim 'separatists'.
27133,11/8/2015,Iraq,Mosul,2,0,2,Two tribal elders are kidnapped and executed by ISIS.
27134,11/8/2015,Iraq,Hawija,3,0,3,Three 'youth' are executed by the Islamic State.
27135,11/8/2015,Cameroon,Achigachia,1,0,1,Religious radicals murder a border guard.
27136,12/8/2015,Cameroon,Blame,10,0,10,"Islamists torch a village, leaving ten residents dead."
27137,12/8/2015,Mali,Bamako,2,0,2,Two people are killed after Muslim extremists open fire in a bus station.
27138,12/8/2015,Pakistan,Korangi,5,0,5,Five people at a restaurant are machine-gunned at close range by Muslim terrorists.
27139,12/8/2015,Iraq,Ramadi,14,10,24,ISIS roadside bombs produce fourteen dead Iraqis.
27140,12/8/2015,Egypt,Sinai,1,0,1,A Croatian surveyor is beheaded by Islamic extremists.
27141,12/8/2015,Syria,Ghouta,5,55,60,A mortar barrage by Sunni terrorists leaves five dead.
27142,12/8/2015,Syria,Homs,1,24,25,A mortar attack kills one person in his car.
27143,12/8/2015,Syria,Daraa,8,54,62,Eight civilians die from Sunni shrapnel.
27144,12/8/2015,Afghanistan,Musa Qala,14,2,16,An insidious attack by Taliban in police uniforms leaves fourteen local cops dead.
27145,12/8/2015,Nigeria,Bale Mamman,8,4,12,Eight villagers are shot to death by Boko Haram.
27146,12/8/2015,Pakistan,Tirah,3,2,5,Three members of a security patrol are murdered by Taliban bombers.
27147,12/8/2015,Afghanistan,Nawur,4,0,4,Four Hazara religious minorities are kidnapped and shot to death by Sunni extremists.
27148,12/8/2015,Philippines,Maimbung,1,0,1,An Abu Sayyaf kidnap victim is found bound in handcuffs and beheaded.
27149,13/8/2015,Nigeria,Kukuwa-Gari,160,0,160,"Boko Haram gunmen invade a village and drive fleeing residents into a river, where one-hundred and sixty are shot to death or drowned."
27150,13/8/2015,Afghanistan,Logar,0,20,20,A Taliban suicide bomber detonates along a city street.
27151,13/8/2015,Iraq,Khalis,4,18,22,A Jihadi car bomb claims four lives.
27152,13/8/2015,Iraq,Mosul,36,0,36,Thirteen women are among three dozen innocents executed in cold blood by the Islamic State.
27153,13/8/2015,Iraq,Baghdad,4,13,17,Four people are blown to bits by Mujahid bombers.
27154,13/8/2015,Libya,Sirte,18,0,18,"ISIS murders a rival preacher, triggering a clash that leaves seventeen others dead."
27155,13/8/2015,Syria,Latakia,2,14,16,Two people are killed when Sunnis send rockets into a Shia area.
27156,13/8/2015,Iraq,Sadr City,76,212,288,"The Islamic State detonates a massive suicide truck bomb in a Shiite market, slaughtering eighty 'charlatans'."
27157,13/8/2015,Thailand,Muang,1,0,1,Muslim 'insurgents' shoot a man in the head in front of his wife.
27158,14/8/2015,Iraq,Baiji,7,5,12,Seven Iraqis are exterminated by a Fedayeen suicide bomber.
27159,14/8/2015,Iraq,Kirkuk,4,9,13,"Terrorists set off a bomb on a bus carrying families, killing four members."
27160,14/8/2015,Libya,Benghazi,6,0,6,At least six others are killed during an Islamic State attack.
27161,14/8/2015,Mali,Barkerou,1,0,1,A moderate cleric is assassinated by radical co-religionists.
27162,14/8/2015,Syria,Homs,2,0,2,Two accused homosexuals are thrown from a rooftop and then stoned.
27163,14/8/2015,Libya,Sirte,22,0,22,Twenty-two injured people at a hospital are murdered in their beds by Islamic fanatics.
27164,14/8/2015,Iraq,Mosul,4,0,4,Four politicians are forced to their knees and shot in the head by caliphate members.
27165,14/8/2015,Pakistan,Quetta,1,0,1,A Shiite is gunned down in a targeted attack by Sunni.
27166,15/8/2015,Pakistan,Sheikhan,1,0,1,A man is murdered by religious hardliners.
27167,15/8/2015,Nigeria,Ramirgo,3,7,10,A Shahid suicide bomber takes out three innocents at a market.
27168,15/8/2015,Iraq,Ghazlani,15,0,15,Fifteen women are executed for refusing to marry ISIS militants.
27169,15/8/2015,Iraq,Shingal,70,0,70,"An ISIS mass grave contains the remains of seventy execution victims, including women and children."
27170,15/8/2015,Libya,Sirte,12,0,12,A dozen people are beheaded by the Islamic State.
27171,15/8/2015,Iraq,Madaen,3,19,22,Three people lose their lives to a Religion of Peace bomb blast at a popular market.
27172,15/8/2015,Iraq,Baghdad,5,37,42,Two suspected ISIS bombs kill five and injure nearly forty.
27173,15/8/2015,Iraq,Taji,2,7,9,"Extremists set off a bomb at a car repair shop, killing two."
27174,15/8/2015,Iraq,Habibiya,15,65,80,Fifteen people at a used car market in a Shiite area are sectionalized by a Mujahideen car bomb.
27175,16/8/2015,Nigeria,Kofar Gwari,2,12,14,"Fulani terrorists attack a band of people preparing for church, killing two."
27176,16/8/2015,Pakistan,Shadi Khan,18,25,43,Eighteen people are crushed to death when two suicide bombers bring down the roof of a meeting hall.
27177,16/8/2015,Afghanistan,Sar Gora,5,0,5,Five policemen are drugged and then butchered by a Sunni fundamentalist with a knife.
27178,16/8/2015,Afghanistan,Khamaab,4,6,10,Four police officers are ambushed and killed by religious extremists.
27179,16/8/2015,Afghanistan,Badakhshan,1,1,2,"Fundamentalists brutally beat a couple in their home, killing the wife in front of the husband."
27180,16/8/2015,Thailand,Mayo,1,0,1,Suspected terrorists take out a villager with four shotgun blasts.
27181,16/8/2015,Syria,Raqqa,4,0,4,Four Syrians are forced to their knees and shot in the head by caliphate members.
27182,16/8/2015,Yemen,Taiz,6,0,6,Six civilians are pulled limb from limb when Shiite radicals send rockets into their city.
27183,16/8/2015,Libya,Sirte,4,0,4,Four Libyans are executed and hung for display by the Islamic State.
27184,16/8/2015,Iraq,Fallujah,17,15,32,Three caliphate suicide bombers kill seventeen Iraqis.
27185,16/8/2015,Saudi Arabia,Jazan,2,0,2,Shiite radicals murder two border guards.
27186,17/8/2015,Thailand,Bangkok,22,125,147,Twenty-two people outside a Hindu shrine in a Buddhist majority country are exterminated by Muslim bombers.
27187,17/8/2015,Nigeria,Awonori,7,0,7,Islamists attack a fishing village and massacre seven residents.
27188,17/8/2015,Iraq,Rawa,2,0,2,Two men are crucified by the Islamic State.
27189,17/8/2015,Iraq,Ramadi,25,33,58,Over two dozen people lose their lives to three ISIS suicide truck bombers.
27190,17/8/2015,Pakistan,Orangi,1,0,1,A prominent Sunni is gunned down in a sectarian attack.
27191,17/8/2015,Tunisia,Mount Mghila,2,0,2,Two security personnel are killed by a landmine planted by Islamists.
27192,17/8/2015,Iran,Mashad,1,0,1,A former interpreter is captured and executed while trying to flee the Taliban.
27193,17/8/2015,India,Bamani Chowki,1,0,1,A 17-year-old girl is beheaded by her conservative brothers for having an affair.
27194,18/8/2015,Syria,Palmyra,1,0,1,Islamic purists behead an 82-year-old archaeologist and hang his body from a post.
27195,18/8/2015,India,Tujjar Sharief,2,0,2,"Islamic militants gun down two people, including a 70-year-old man in a wheelchair."
27196,18/8/2015,India,Sopore,1,0,1,"Extremists stage a drive-by on a rival mosque, leaving one guard dead"
27197,18/8/2015,Iraq,Ghazlani,5,0,5,Five women are stoned to death for not wearing the veil.
27198,18/8/2015,Iraq,Anbar,29,43,72,A series of ISIS bombings and shootings leave thirty dead.
27199,19/8/2015,Pakistan,Tunsa,1,0,1,An Ahmadi religious minority is murdered by Sunni haters.
27200,19/8/2015,Tunisia,Sousse,1,0,1,A traffic cop is shot to death by the Okba Ibn Nafaa Brigade.
27201,19/8/2015,Syria,Qamishli,13,40,53,"A suicide blast rips through the middle of a town, claiming thirteen bystanders."
27202,19/8/2015,Pakistan,Mingora,1,0,1,A teenager is gunned down by the Tehreek-e-Taliban.
27203,19/8/2015,Iraq,Tuz,5,0,5,"A family of five is neatly disassembled by Mujahideen bombers, including three children."
27204,19/8/2015,Iraq,Albu Eitha,15,22,37,Fifteen Iraqis are blown to bits by a Shahid suicide bomber.
27205,20/8/2015,Russia,Pyatigorsk,1,0,1,A moderate imam is assassinated by more radical co-religionists.
27206,20/8/2015,Iraq,Kirkuk,6,0,6,Six men are crucified by the Islamic State.
27207,20/8/2015,Yemen,Aden,4,10,14,Sectarian Jihadis set off a bomb that kills four.
27208,20/8/2015,Pakistan,Hajiabad,1,3,4,Islamists set off a roadside bomb that kills one person.
27209,20/8/2015,Egypt,Shubra,0,29,29,Islamists set off a car bomb in front of an office building.
27210,20/8/2015,Iraq,Qayara,1,0,1,An imam is assassinated by Religion of Peace rivals.
27211,20/8/2015,Iraq,Hawija,12,0,12,A dozen young men are executed by the Islamic State.
27212,20/8/2015,Iraq,Mosul,2,0,2,Two university professors are executed by the Islamic State.
27213,21/8/2015,Syria,Marea,2,0,2,A baby is among two people who die from a mustard gas attack by ISIS.
27214,21/8/2015,France,Paris,0,3,3,A Muslim trained by ISIS opens fire with a Kalashnikov on a train before being subdued by unarmed American passengers.
27215,21/8/2015,Nigeria,Barkin Ladi,2,0,2,Two Christians are brutally stabbed to death by Fulani.
27216,21/8/2015,Afghanistan,Sar-e-Rawza,3,1,4,Three young children are taken out by a suspected Taliban rocket at their school.
27217,21/8/2015,Afghanistan,Khas Urozgan,8,6,14,Eight lives are shredded by Taliban bombers.
27218,21/8/2015,Iraq,Anbar,50,0,50,Up to fifty Iraqis are reported killed by ISIS in two attacks.
27219,21/8/2015,Iraq,Mosul,1,0,1,A man is stoned to death by a Sharia court.
27220,21/8/2015,Nigeria,Dikwa,2,0,2,Two Nigerians are sectionalized by a Boko Haram bomb.
27221,22/8/2015,Afghanistan,Helmand,1,0,1,The Taliban kidnap and execute the 9-year-old nephew of a former translator.
27222,22/8/2015,Syria,Koerse,9,0,9,An ISIS suicide car bomb takes out nine Syrians.
27223,22/8/2015,Pakistan,Utmankhel,3,0,3,A 5-year-old child is among three innocents murdered by Khelafat-e-Islamic bombers.
27224,22/8/2015,Afghanistan,Kabul,12,66,78,Women and children are among the casualties of a suicide bombing.
27225,22/8/2015,Somalia,Mogadishu,5,7,12,Five civilians are sent to Allah by a Shahid suicide car bomber.
27226,22/8/2015,Somalia,Kismayo,16,21,37,A Fedayeen suicide bombing at a university building leaves sixteen others dead.
27227,22/8/2015,Pakistan,Arang,3,2,5,Three tribal elders are killed by an Islamist bomb.
27228,22/8/2015,Iraq,Mosul,4,0,4,Three teachers and an engineer are executed by the Islamic State.
27229,23/8/2015,Syria,Damascus,9,50,59,"Terrorists rain mortars down on two churches, killing nine people."
27230,23/8/2015,Egypt,Marsa Matruh,1,0,1,A Coptic soldier is shot four times by fellow soldiers after a religious argument.
27231,23/8/2015,Syria,Damascus,10,53,63,Ten are killed when a Sunni radical group sends mortar shells into a prison.
27232,23/8/2015,Syria,Hasakah,13,50,63,Thirteen people are blown to bits by a Fedayeen suicide bomber.
27233,23/8/2015,Pakistan,Bajour,2,3,5,At least two people are killed in separate terror attacks.
27234,23/8/2015,Pakistan,Tirah,5,0,5,A Jihadi rocket and shooting attack leaves five others dead.
27235,23/8/2015,Pakistan,Dasht,4,0,4,The Taliban is suspected of abducting and brutally executing four laborers.
27236,23/8/2015,Iraq,Baghdad,5,0,5,Five Shiites are disintegrated by a Sunni bomb blast.
27237,23/8/2015,Iraq,Jaramshah,23,0,23,Two dozen people are wiped out by a series of Islamic State suicide bombings.
27238,24/8/2015,Iraq,Baghdad,7,24,31,Three bomb attacks produce seven dead civilians.
27239,24/8/2015,Iraq,Mosul,9,0,9,Nine accused gays are rounded up by the Islamic State and thrown from a roof top.
27240,24/8/2015,Iraq,Ramadi,8,6,14,Eight Iraqis are taken out be a Shahid suicide car bomber.
27241,24/8/2015,Yemen,Taiz,14,3,17,Seven women and four children are among fourteen civilians obliterated by a Shiite rocket attack.
27242,24/8/2015,Tunisia,Bouchebka,1,3,4,Religious radicals gun down a customs official at the border.
27243,24/8/2015,Iraq,Mosul,1,0,1,A man is stoned to death for adultery.
27244,24/8/2015,Thailand,Muang,1,0,1,A fruit vendor is brought down with a bullet to the neck by Muslim 'insurgents'.
27245,24/8/2015,Syria,Kweiris,51,0,51,Fifty-one personnel at an airbase are massacred by ISIS.
27246,24/8/2015,Egypt,Fayoum,1,0,1,A man dies from injuries suffered during a shooting by religious radicals.
27247,24/8/2015,Egypt,Beheira,3,23,26,Three security personnel are killed by a fundamentalist bomb blast.
27248,24/8/2015,Libya,Sirte,4,0,4,ISIS captures and executes four people.
27249,24/8/2015,Afghanistan,Shebarghan,1,2,3,"Terrorists set off a bomb at a market, but only manage to kill one."
27250,25/8/2015,CAR,Kidgigra,20,5,25,"In a series of 'reprisal' attacks targeting Christians, militant Muslims hack and shoot some twenty people to death."
27251,25/8/2015,Afghanistan,Paktia,1,3,4,A pregnant woman loses her baby after a vicious beating by the Taliban.
27252,25/8/2015,Afghanistan,Oruzgan,19,0,19,Nineteen individuals are murdered by the Taliban.
27253,25/8/2015,Nigeria,Marfunudi,24,50,74,"Two dozen innocent people are massacred by Boko Haram, many with their throats cut."
27254,25/8/2015,Saudi Arabia,Jizan,3,3,6,Shiite radicals cross the border and kill three Saudi guards.
27255,25/8/2015,Pakistan,Gwadar,2,2,4,"Muslims toss a hand grenade into a Hindu-owned shop, killing two people."
27256,25/8/2015,Pakistan,Ladha,3,0,3,Three security personnel are ambushed and machine-gunned by pro-Sharia militants.
27257,25/8/2015,Nigeria,Damaturu,5,41,46,Two young female suicide bombers slaughter five people at a bus station.
27258,25/8/2015,Iraq,Fallujah,3,0,3,Three civilians are dragged to the city square and executed by ISIS.
27259,25/8/2015,Pakistan,Dera Ismail Khan,1,1,2,A cleric is gunned down by Religion of Peace rivals.
27260,25/8/2015,India,Khanday Pora,1,0,1,A worker for a secular political party is shot to death by Islamists.
27261,25/8/2015,Iraq,Mosul,10,0,10,Ten people are executed in front of their families by the Islamic State.
27262,26/8/2015,Iran,Orumieh,1,0,1,A political activist is hanged for 'waging war on God'.
27263,26/8/2015,Egypt,al-Arish,2,0,2,Two local cops are riddled with bullets by ISIS gunmen on motorcycles.
27264,26/8/2015,Somalia,Garbaharey,11,0,11,Eleven people are ambushed and murdered by al-Shabaab.
27265,26/8/2015,Iraq,Tal Afar,7,0,7,Seven Kurds are killed by ISIS mortars.
27266,27/8/2015,Iraq,Anbar,50,30,80,A massive double-suicide blast leaves over fifty Iraqis dead.
27267,27/8/2015,Pakistan,Pir Mahal,4,0,4,An al-Qaeda suicide bomber kills three children and their mother.
27268,27/8/2015,Iraq,Baghdad,3,13,16,Muslim terrorists take out three innocents with bombs in two neighborhoods.
27269,27/8/2015,Iraq,Kirkuk,3,6,9,Three people are blown apart by a Mujahideen bomb blast.
27270,27/8/2015,Iraq,Qayara,11,0,11,Eleven Iraqis are executed by the caliphate.
27271,27/8/2015,Iraq,Ramadi,5,10,15,Two suicide bombers eliminate five Iraqis.
27272,27/8/2015,Niger,Abadam,3,0,3,Three locals are killed during a raid by Sharia proponents.
27273,27/8/2015,Nigeria,Kafa,4,0,4,Islamists slit the throats of four fishermen.
27274,28/8/2015,Syria,Aleppo,12,0,12,"Twelve Christians are tortured and murdered by the Islamic State for refusing to embrace Islam, including a 12-year-old boy who had his fingers chopped off, three women who were raped and three others who were crucified."
27275,28/8/2015,Nigeria,Baanu,68,56,124,At least sixty civilians are massacred by Boko Haram during an indiscriminate attack on a village.
27276,28/8/2015,Pakistan,Karachi,1,0,1,Sunnis gun down a Shia official.
27277,28/8/2015,Iraq,Kirkuk,3,8,11,Terrorists kill three people with a roadside bomb.
27278,28/8/2015,Iraq,Baghdad,6,10,16,A half-dozen Iraqis are pulled into pieces by a Mujahid car bomb.
27279,28/8/2015,Afghanistan,Kabul,2,1,3,Two Afghans are taken out by a Taliban bomb blast.
27280,28/8/2015,Pakistan,Charmarkand,1,0,1,A tribal elder is murdered by the Tehreek-e-Taliban.
27281,29/8/2015,Iraq,Shirqat,12,0,12,A dozen people are executed by the Islamic State.
27282,29/8/2015,Iraq,Baghdad,5,19,24,Two Mujahid roadside blasts take out five Iraqis.
27283,29/8/2015,Syria,Homs,4,19,23,"IS terrorists detonate a car bomb in front of a pharmacy, killing four."
27284,29/8/2015,Iraq,Trebil,8,6,14,Eight people are taken apart by Islamist bomb blasts at a border crossing.
27285,29/8/2015,Iraq,Fallujah,6,9,15,A Fedayeen suicide bomber destroys six other lives.
27286,29/8/2015,Afghanistan,Chora,3,0,3,Three people lose their lives to a Taliban bomb blast.
27287,29/8/2015,Afghanistan,Oruzgan,3,0,3,Two tribal elders and their driver are exterminated by religious radicals.
27288,29/8/2015,Afghanistan,Ghazni,6,0,6,Six cops are machine-gunned at a checkpoint by Taliban.
27289,29/8/2015,Bahrain,Karana,1,6,7,A security official is taken down by Shiite bombers.
27290,29/8/2015,Nigeria,Karnuwa,4,0,4,Four villagers are shot to death by Boko Haram.
27291,30/8/2015,Yemen,Mansura,1,0,1,al-Qaeda on motorbikes assassinate a security official.
27292,30/8/2015,Libya,Rakiyat,5,2,7,An Islamist attack on a village checkpoint leaves five dead.
27293,30/8/2015,Pakistan,Mardan,2,0,2,Two local cops are gunned down by Tehreek-e-Taliban snipers.
27294,30/8/2015,Iraq,Haditha,4,2,6,Four people are laid out by a Shahid suicide bomber.
27295,30/8/2015,Nigeria,Hambagda,7,5,12,Sharia proponents shoot seven innocents to death.
27296,31/8/2015,Nigeria,Fatawe,36,0,36,"Several dozen villagers are rounded up and bound, then have their throats slit in front of their families by Boko Haram."
27297,31/8/2015,Pakistan,Khar,1,4,5,A civilian is killed by a roadside blast.
27298,31/8/2015,Iraq,Salahuddin,3,0,3,The caliphate hacks the heads off three people for the crime of helping families escape.
27299,31/8/2015,Iraq,Anbar,4,0,4,Four Shiites are suspended with chains and then burned alive by Sunni extremists.
27300,1/9/2015,Iraq,Haditha,12,8,20,Three ISIS suicide bombers take out a dozen Iraqis.
27301,1/9/2015,Mali,Timbuktu,2,1,3,Two local security personnel are murdered by Jihadists.
27302,1/9/2015,Somalia,Janaale,50,50,100,At least fifty AU peacekeepers are killed during an al-Shabaab attack on their base.
27303,1/9/2015,Pakistan,Jamrud,6,56,62,A Fedayeen suicide bomber kills at least six others.
27304,1/9/2015,Nigeria,Ba'na Iman,8,0,8,Eight villagers are murdered by Sharia proponents.
27305,1/9/2015,Nigeria,Kolori,18,0,18,"Boko Haram ride into a town on horseback, shoot eighteen residents to death and steal their food."
27306,2/9/2015,Pakistan,Latakia,10,25,35,Sunni extremists set off a car bomb in a town square that claims ten lives.
27307,2/9/2015,Pakistan,Urmar Payan,3,6,9,Three cops are liquidated by Islamic terrorists.
27308,2/9/2015,Yemen,Sanaa,32,75,107,Over two dozen worshippers at a Shiite mosque are sent straight to Allah by two suicide bombers.
27309,2/9/2015,Nigeria,Mainari,5,6,11,Muslim 'insurgents' murder five villagers.
27310,2/9/2015,Iraq,Mosul,4,0,4,Four civilians are executed at a market by the Islamic State.
27311,2/9/2015,Iraq,Tel Saqif,8,2,10,Islamic State members kill eight Iraqis with a mortar barrage.
27312,2/9/2015,India,Ladoora,1,2,3,"A Lashkar-e-Islam member opens fire on a security patrol, killing one member."
27313,2/9/2015,Iraq,Khalis,4,18,22,Four people lose their lives to an Islamist car bomb.
27314,2/9/2015,Iraq,Haditha,3,6,9,Three people are killed when ISIS militants send mortars toward a dam.
27315,2/9/2015,Iraq,Hashd Shaabi,11,16,27,Eleven Iraqis are disassembled by two suicide bombers.
27316,3/9/2015,Afghanistan,Helmand,8,0,8,The Taliban drug eight police and then shoot them to death.
27317,3/9/2015,Cameroon,Kerawa,30,143,173,Two female suicide bombers slaughter thirty patrons at a market.
27318,3/9/2015,Iraq,Tarmiya,3,8,11,A bomb blast at a Sunni vegetable market leaves three dead.
27319,3/9/2015,Iraq,Baghdad,4,7,11,"Sunnis bomb two Shiite areas, killing four civilians."
27320,3/9/2015,Iraq,Baghdad,3,10,13,Jihadi bombers take out three patrons at a market.
27321,4/9/2015,Bangladesh,Chittagong,2,0,2,Two Islamists cut the throats of two staff at a Sufi shrine.
27322,4/9/2015,Iraq,Madain,3,6,9,"Jihadis set off a bomb in a commercial district, killing three bystanders."
27323,4/9/2015,Saudi Arabia,Abqaiq,1,2,3,"A terrorist opens fire on police with a machine-gun, killing one."
27324,4/9/2015,Tajikistan,Dushanbe,2,1,3,Two guards at an airport are picked off during an Islamist drive-by.
27325,4/9/2015,Tajikistan,Vahdat,8,2,10,Islamic militants launch pre-dawn attacks on local police that leave eight dead.
27326,4/9/2015,Syria,Sweida,31,24,55,Thirty-one people are taken out by two al-Nusra car bombs.
27327,5/9/2015,Pakistan,Khyber Pakhtunkhwa,1,3,4,The Taliban murder a local politician with a roadside bomb.
27328,5/9/2015,Afghanistan,Balkh,13,0,13,Thirteen Hazara religious minorities are machine-gunned on a minibus by Sunni radicals.
27329,5/9/2015,Iraq,Arab Jabour,4,0,4,"A family of four, including two children, is exterminated in their home by Holy Warriors."
27330,6/9/2015,Pakistan,Kotigram,1,0,1,A local official is sprayed with bullets by a Muslim terrorist group.
27331,6/9/2015,Pakistan,Hangu,2,0,2,A secular-leaning politician is gunned down along with a family member.
27332,6/9/2015,Iraq,Madain,2,2,4,Women and children are among the casualties of a Mujahid bomb attack.
27333,6/9/2015,DRC,Beni,7,0,7,Seven civilians are murdered by ADF Islamists.
27334,6/9/2015,Afghanistan,Nimroz,7,3,10,Seven locals are taken out by the Taliban.
27335,7/9/2015,Yemen,Taiz,1,0,1,A 40-year-old Christian convert is ambushed and shot 15 or 20 times for leaving Islam.
27336,7/9/2015,Libya,Benghazi,7,0,7,Seven people lose their lives to an Islamist attack.
27337,7/9/2015,Egypt,Taweel al-Amir,2,5,7,Islamic 'insurgents' kill two local security personnel with a roadside bomb.
27338,7/9/2015,Pakistan,Qambarkhel,5,0,5,Lashkar-e-Islam gunmen ambush and kill five tribals.
27339,7/9/2015,Afghanistan,Khurasan,1,0,1,A man is brutally beheaded the Uzbekistan Islamic Movement.
27340,8/9/2015,Pakistan,Khyber,6,0,6,Six members of a peace committee are abducted and slain by Lashkar-e-Islam.
27341,8/9/2015,Iraq,Mosul,1,0,1,A female journalist is publicly executed by caliphate enforcers.
27342,8/9/2015,Iraq,Qarma,8,0,8,ISIS members sneak up and machine-gun eight people manning a checkpoint.
27343,9/9/2015,Uganda,Bukedea,0,1,1,A young Catholic woman is raped and left to die by three Muslims because her parents had left Islam.
27344,9/9/2015,Dagestan,Novy Kurush,1,0,1,A moderate imam is shot to death by radical co-religionists.
27345,9/9/2015,Iraq,Anbar,13,13,26,Over a dozen Iraqis are laid out by two suicide bombers.
27346,9/9/2015,Afghanistan,Kalakhan,2,1,3,Two Afghan are taken out by a Taliban bomb blast.
27347,9/9/2015,Iraq,Derik,35,0,35,Three dozen Kurds are reportedly killed by a an Islamic State suicide bomber.
27348,9/9/2015,Syria,Abu al-Duhur,71,40,111,al-Qaeda members line up and execute fifty-six captives at an air base after killing fifteen others in the assault.
27349,9/9/2015,Pakistan,Shah Faisal,1,0,1,A 28-year-old man is shot to death by sectarian rival.
27350,9/9/2015,Pakistan,Karachi,2,0,2,Shiite radicals are suspected of gunning down a shop owner and his assistant.
27351,9/9/2015,Iraq,Mosul,10,0,10,Ten women are executed for refusing to have sex with Islamic extremists.
27352,9/9/2015,Iraq,Hit,2,0,2,The caliph executes two people by tying them to explosives.
27353,10/9/2015,Afghanistan,Ghazni,5,0,5,Five police officers on patrol are destroyed by a Taliban bomb blast.
27354,10/9/2015,Pakistan,Dera Ismail Khan,1,1,2,Terrorists take out a local official with a drive-by.
27355,10/9/2015,Iraq,Abu Ghraib,2,7,9,Two people are flattened by a Religion of Peace bomb blast.
27356,10/9/2015,Iraq,Albu Souda,9,14,23,A Shahid suicide bomber snuffs out the lives of nine others.
27357,10/9/2015,CAR,Bangui,2,20,22,Muslim terrorists are suspected of three grenade attacks on gathered crowds that leave two dead.
27358,11/9/2015,Afghanistan,Nangarhar,1,0,1,A rival imam is executed by the Islamic State.
27359,11/9/2015,DRC,Mamove,9,0,9,An ADF attack leaves at least nine others dead.
27360,11/9/2015,Egypt,Rafah,2,0,2,Fundamentalists take out a woman and child with a car bomb.
27361,11/9/2015,Pakistan,Pandyali,2,0,2,Two members of a peace committee are sectionalized by Taliban bombers.
27362,11/9/2015,Iraq,Daquq,13,47,60,Thirteen Kurds are blown to bits by ISIS bombs.
27363,11/9/2015,Nigeria,Yola,7,20,27,Children are among the victims of a horrible Boko Haram bombing at a refugee camp that claims seven.
27364,11/9/2015,Nigeria,Madgali,4,3,7,"A female suicide bomber detonates at a market, taking four patrons with her."
27365,11/9/2015,Syria,Damascus,1,12,13,A civilian loses his life to an ISIS mortar round.
27366,11/9/2015,Egypt,Sinai,4,0,4,Four local soldiers are blown to bits by Islamic extremists.
27367,11/9/2015,Yemen,Marib,20,40,60,At least twenty civilians bleed out following a rocket attack by Shiite radicals on a marketplace.
27368,12/9/2015,Syria,Damascus,11,30,41,"Jaish al-Islam send rockets into a suburb, killing eleven residents."
27369,12/9/2015,Iraq,Mosul,1,0,1,The director of a radio station is executed by the Islamic State.
27370,12/9/2015,Iraq,Baiji,3,8,11,An ISIS attack leaves three others dead.
27371,13/9/2015,Somalia,Raaso,2,0,2,Two brothers are beheaded by al-Shabaab.
27372,13/9/2015,Cameroon,Kolofata,9,24,33,"Three suicide bombers set themselves off at a packed market, killing at least nine."
27373,13/9/2015,Pakistan,Khyber Pakhtunkhwa,7,0,7,Seven people are shot to death by suspected terrorists.
27374,13/9/2015,Pakistan,Khaisoor,2,0,2,Two men are picked off by Taliban snipers while fetching water.
27375,13/9/2015,Iraq,Ghazlani,32,0,32,Thirty-two captives are euthanized by Islamic State executioners.
27376,13/9/2015,Egypt,Western Desert,1,0,1,An Egyptian is beheaded and crucified by ISIS.
27377,13/9/2015,Iraq,Mosul,5,0,5,Five rival prayer leaders are shot in the back of the head by the caliphate.
27378,14/9/2015,Israel,Jerusalem,1,2,3,A 64-year-old man dies of injuries suffered during an Arab rock attack.
27379,14/9/2015,Syria,Khashman,16,40,56,Two children are among sixteen slaughtered by an ISIS suicide car bombing.
27380,14/9/2015,Afghanistan,Ghazni,4,7,11,Four guards lose their lives when the Taliban stage a Fedayeen suicide attack on a prison.
27381,14/9/2015,Egypt,Khareeza,12,4,16,Ansar Bait Al-Maqdis is strongly suspected of a shooting at a wedding in which a dozen guests were massacred.
27382,14/9/2015,Syria,Mahata,10,40,50,Ten people are laid out by a Shahid suicide car bomber.
27383,14/9/2015,Mali,Mopti,2,0,2,Armed Islamists take out two local cops.
27384,14/9/2015,Iraq,Saqlawiya,3,5,8,A Shahid suicide bomber takes out three Iraqis.
27385,14/9/2015,Pakistan,Multan,11,59,70,A suicide blast produces eleven charred bodies.
27386,14/9/2015,England,White Chapel,1,0,1,A faith healer is stabbed to death in a targeted attack by a religious Muslim.
27387,14/9/2015,Nigeria,Barkin Ladi,20,17,37,Twenty Christians are massacred by Muslim militants.
27388,15/9/2015,Libya,Benghazi,1,0,1,A 39-year-old baker is forced to his knees and shot by fundamentalists.
27389,15/9/2015,Nigeria,Sarkin Kudu,9,9,18,Nine Christians are murdered in their village by Muslim invaders.
27390,15/9/2015,Afghanistan,Char Dewar,6,0,6,Six civilians are machine-gunned in their car at point-blank range by fundamentalists.
27391,15/9/2015,Syria,Aleppo,38,150,188,At least fourteen children are among forty innocents turned to paste by Sunni rockets.
27392,15/9/2015,Syria,al-Jazira,3,0,3,"Two homosexuals are flung from a rooftop by caliphate members, who also shoot another man in the back of the head."
27393,15/9/2015,Syria,Hasakah,7,21,28,An Islamic State suicide bomber detonates in front of a water authority building and takes out seven souls.
27394,15/9/2015,Iraq,Mosul,3,0,3,Three university professors are executed with shots to the back of the head by the Islamic State.
27395,16/9/2015,Iraq,Mosul,5,0,5,Five Kurdish civilians are captured and executed by the Islamic State.
27396,16/9/2015,Iraq,Khalidiya,6,14,20,Two children are among a half-dozen city residents blown to bits by ISIS mortar rounds.
27397,16/9/2015,Thailand,Pattani,1,0,1,A 22-year-old man is pulled into three pieces by a Muslim bomb.
27398,16/9/2015,Afghanistan,Kabul,4,41,45,A Shahid suicide car bomber murders four innocents and injures dozens more.
27399,16/9/2015,Nigeria,Kadunung,18,150,168,"Muslims attack a Christian community, killing eighteen innocents, including a man and his six children."
27400,16/9/2015,Cameroon,Ngoulma,2,0,2,Two guards are killed when Islamists fire into a village.
27401,16/9/2015,Cameroon,Aissa Harde,9,0,9,Boko Haram members burn 40 homes and kill nine villagers.
27402,17/9/2015,Thailand,Narathiwat,3,10,13,Muslim 'rebels' kill three people with a series of planted bombs.
27403,17/9/2015,Germany,Berlin,0,1,1,An Islamic extremist stabs a policewoman in the neck.
27404,17/9/2015,Somalia,Kismayo,3,7,10,An al-Shabaab bomb hidden in a tree claims three lives.
27405,17/9/2015,Iraq,Baghdad,9,31,40,Nine people at a public square are incinerated by a Fedayeen suicide bomber.
27406,17/9/2015,Iraq,Bab al-Sharji,12,45,57,A suicide bomber on foot takes out thirteen Iraqis.
27407,17/9/2015,Afghanistan,Faizabad,1,0,1,Suspected Islamists toss a grenade into the house of a freelance journalist.
27408,18/9/2015,China,Aksu,50,0,50,Five guards are among some fifty people at a coal mine stabbed to death by Muslim 'separatists'.
27409,18/9/2015,Dagestan,Khtun,5,0,5,Five local hunters are brutally slain by Muslim militants.
27410,18/9/2015,Syria,Fua,12,0,12,A suicide car bomber kills at least a dozen others in a small village.
27411,18/9/2015,Sudan,Umray,4,3,7,Arab militia invade a village and murder four Africans.
27412,18/9/2015,Afghanistan,Arghandab,8,0,8,All eight policemen manning a checkpoint are mowed down by religious extremists.
27413,18/9/2015,Pakistan,Nazimabad,1,0,1,A Shiite shop owner is gunned down by Sunni radicals.
27414,18/9/2015,Iraq,Abu Saida,6,5,11,"Terrorists open fire on a group of young people outside a house, killing six."
27415,18/9/2015,Iraq,al-Fura,1,0,1,A gay man is thrown off a roof by caliphate members.
27416,18/9/2015,Afghanistan,Kabul,4,7,11,Women and children are among several civilians 'liberated' by Taliban shrapnel.
27417,18/9/2015,Pakistan,Korangi,2,4,6,Two people are killed when Religion of Peace gunmen attack a rival shrine.
27418,18/9/2015,Pakistan,Sopore,1,1,2,Terrorists kill a man and injure his 3-year-old-son.
27419,18/9/2015,Libya,Tripoli,3,0,3,Three guards at an airport are gunned down by ISIS.
27420,18/9/2015,Philippines,Zamboanga,1,16,17,Abu Sayyaf bombers kill a woman with a bomb planted under a bus seat.
27421,18/9/2015,Pakistan,Peshawar,29,30,59,Sharia proponents machine-gun twenty-nine people at an air base mosque.
27422,18/9/2015,Libya,Tripoli,2,0,2,An ISIS attack on a prison leaves two others dead.
27423,18/9/2015,Somalia,Yaqbariweyne,12,5,17,"Islamists overrun a security base, killing a dozen defenders."
27424,19/9/2015,Thailand,Pattani,1,0,1,A moderate imam is shot to death by Religion of Peace rivals.
27425,19/9/2015,Mali,Bih,4,0,4,Macina Islamist gunmen on motorcycles take out four innocents in a drive-by.
27426,19/9/2015,Egypt,al-Arish,1,0,1,A police officer is shot to death on the street by Muslim extremists.
27427,19/9/2015,Afghanistan,Zarmat,5,24,29,A shooting attack and separate suicide bombings leave five dead and two dozen injured.
27428,20/9/2015,Syria,Qaryatin,1,0,1,A Christian is executed by the Islamic State for refusing to pay jizya.
27429,20/9/2015,Nigeria,Maiduguri,85,90,175,"Boko Haram bombers strike a rival mosque and several other buildings, killing at least eighty - including children."
27430,20/9/2015,Syria,Aleppo,14,25,39,Seven children are among fourteen killed when Sunnis pour rockets into an Armenian neighborhood.
27431,20/9/2015,Cameroon,Mora,3,29,32,Three others are killed when two female suicide bombers blow themselves up.
27432,20/9/2015,Pakistan,Kandiwal,2,0,2,Two sisters are shot dead by their conservative uncle for marrying against the family's wishes.
27433,20/9/2015,Nigeria,Monguno,45,60,105,"A Fedayeen suicide bomb blast rips through an outdoor market, claiming forty-five innocents."
27434,20/9/2015,Pakistan,Swat,1,0,1,Religious extremists shoot a man to death on his way home.
27435,20/9/2015,Iraq,Mosul,2,0,2,Two younger people are executed by the caliphate for taking pictures on their phones.
27436,20/9/2015,Nigeria,Ngorongoro,6,0,6,Six villagers have their throats slit by Boko Haram.
27437,21/9/2015,Syria,Hreitan,3,0,3,Two men and a boy are executed on charges of being homosexual by the Islamic State.
27438,21/9/2015,Syria,Rastan,7,0,7,Seven men are shot by the Islamic State 'for being gay.'
27439,21/9/2015,Philippines,Sandah,1,0,1,A cleric is killed during an Abu Sayyaf attack.
27440,21/9/2015,Somalia,Mogadishu,5,12,17,A suicide car bomber takes out five souls.
27441,21/9/2015,Iraq,Baghdad,11,40,51,A horrific blast at a vegetable market lays out eleven patrons.
27442,21/9/2015,Syria,Sere Kaniye,8,25,33,Two ISIS car bombings take eight lives.
27443,21/9/2015,Cameroon,Gouzoudou,0,2,2,Two female suicide bombers blow themselves up on market day.
27444,21/9/2015,Iraq,Mosul,1,0,1,A TV news cameraman is kidnapped and executed by the Islamic State.
27445,21/9/2015,Iraq,Tarmiya,3,0,3,Three family members are shot to death by religious radicals.
27446,21/9/2015,Iraq,Baghdad,2,7,9,Mujahid bombers kill two Iraqis.
27447,22/9/2015,Iraq,Qayara,5,0,5,Five police officers are kidnapped and executed by the Islamic State.
27448,22/9/2015,Afghanistan,Dalwat Abad,5,3,8,Five local cops are laid out by Sunni bombers.
27449,22/9/2015,Afghanistan,Qush Tepa,10,0,10,Ten soldiers are murdered by a Taliban insider.
27450,23/9/2015,Syria,Hasaka,3,0,3,Three Christian Assyrians taken captive by the caliphate are executed with shots to the head.
27451,23/9/2015,Uganda,Kalampete,1,0,1,A Christian evangelist is beaten to death by Islamists following a debate.
27452,23/9/2015,Syria,Homs,1,12,13,A woman is murdered by Jihadi car bombers.
27453,23/9/2015,Syria,Damascus,1,3,4,"Sunnis shell a neighborhood, killing one civilian."
27454,23/9/2015,Niger,Allawa,35,25,60,Nearly three dozen people are hacked to death by Muslim terrorists.
27455,23/9/2015,Afghanistan,Nokundi,6,0,6,Six people are taken hostage and executed by the Taliban.
27456,23/9/2015,Pakistan,Karachi,12,0,12,A TTP operative confesses to serial killing a dozen MQM political activists over the years.
27457,23/9/2015,Syria,al-Raee,2,0,2,Two Turks are beheaded by Islamists.
27458,23/9/2015,Syria,Khacham,1,0,1,The Islamic State executes a young woman for using an Internet app to talk with men.
27459,24/9/2015,Yemen,Sanaa,29,60,89,At least twenty-nine Shia worshippers are reduced to pulp by a dedicated Sunni suicide bomber.
27460,24/9/2015,Pakistan,Hari Chand,2,0,2,Two brothers are shot in their home by Sharia activists.
27461,25/9/2015,Mali,Yogodogi,1,3,4,A local herder is murdered and three other people beaten by Islamic terrorists.
27462,25/9/2015,Nigeria,Lokoja,1,7,8,"A Boko Haram storm a government building, killing a guard."
27463,25/9/2015,Saudi Arabia,Marib,2,0,2,Shiite radicals are suspected of disabling a vehicle with a bomb and then shooting the occupants.
27464,25/9/2015,Saudi Arabia,al-Shamli,3,0,3,The Islamic State is suspected of gunning down three people in two attacks.
27465,25/9/2015,Niger,N'Gourtoua,15,4,19,Islamists slash the throats of fifteen villagers.
27466,26/9/2015,CAR,Bangui,21,100,121,"A mob of Muslims pour automatic weapons fire into a Christian neighborhood, killing at least twenty-one."
27467,26/9/2015,Iraq,Mosul,2,0,2,Two lawyers are executed by the Islamic State.
27468,26/9/2015,Somalia,Kismayo,4,3,7,Four people at a restaurant are bitten off by Mujahid bombers.
27469,26/9/2015,Egypt,Sinai,2,16,18,Two local cops are taken out by fundamentalist bombers.
27470,26/9/2015,Nigeria,Madagali,40,50,90,'Scores' are killed during a sustained Boko Haram assault on three villages.
27471,27/9/2015,Nigeria,Mailari,20,24,44,Islamists attack a village and shoot twenty residents to death.
27472,27/9/2015,Afghanistan,Achin,3,8,11,Three local cops are riddled with bullets by Islamic State members.
27473,27/9/2015,Afghanistan,Chahar Burjak,2,4,6,A mother and son are disassembled by Taliban bombers.
27474,27/9/2015,Pakistan,Khairkot,9,51,60,"A Shahid suicide bomber detonates at a playground volleyball game, killing nine innocents."
27475,28/9/2015,Afghanistan,Kunduz,30,200,230,A Taliban assault on a poorly-protected city leaves thirty others dead.
27476,28/9/2015,Iraq,Fallujah,12,0,12,Shahid suicide bombers reportedly claim a dozen lives.
27477,28/9/2015,Iraq,Garma,7,10,17,A Fedayeen suicide bomber takes seven Iraqis with him.
27478,28/9/2015,Iraq,Khalidiya,6,0,6,Religious militia murder six policemen.
27479,28/9/2015,Iraq,Baghdad,4,11,15,At least four are left dead after an ISIS car bomb goes off in a parking garage.
27480,28/9/2015,Pakistan,Punjab,2,0,2,Two young women are shot to death for having 'bad character'.
27481,28/9/2015,Bangladesh,Dhaka,1,0,1,The Islamic State claims the shooting of an Italian charity worker.
27482,29/9/2015,Iraq,Tarmiyah,7,16,23,Seven people are exterminated by a Shahid suicide bomber.
27483,29/9/2015,Thailand,Bannang Sata,1,0,1,A 26-year-old man is shot in the face by Muslim terrorists outside his house.
27484,29/9/2015,Syria,Raqqa,3,0,3,Three captives are forced to kneel and then shot in the head by caliphate members.
27485,29/9/2015,Egypt,Giza,1,2,3,A police recruit is gunned down by religious radicals on motorbikes.
27486,29/9/2015,Syria,Homs,30,0,30,At least thirty others are left dead after an al-Qaeda assault.
27487,29/9/2015,Pakistan,Piran,1,1,2,Islamist gunmen take out a secular schoolteacher.
27488,29/9/2015,Pakistan,Omar Kalay,3,4,7,Three police are shot to death by militant Muslims.
27489,29/9/2015,Iraq,Awenat,7,1,8,Seven members of one family are neatly disassembled by a Jihadi bomb blast.
27490,29/9/2015,Denmark,Copenhagen,0,1,1,A Palestinian ISIS sympathizer stabs a policeman at a refugee center.
27491,30/9/2015,Thailand,Tak Bai,2,0,2,Two guards are gunned down by militant Muslims outside a festival.
27492,30/9/2015,Egypt,Obour,1,0,1,The Islamic State shoot a man to death outside his home.
27493,30/9/2015,Pakistan,Liaquatabad,1,0,1,A 55-year-old rickshaw driver is shot dead for being a member of the wrong Islamic sect.
27494,30/9/2015,Iraq,Jeraishi,13,15,28,Thirteen people are dismantled by three suicide bombers.
27495,30/9/2015,Iraq,Kirkuk,10,0,10,Ten Kurdish captives are beheaded by the Islamic State.
27496,30/9/2015,Nigeria,Adamawa,4,0,4,Boko Haram sneak up on two villages and murder four residents.
27497,1/10/2015,Pakistan,Kanju,1,0,1,A member of a peace committee is assassinated by Islamists.
27498,1/10/2015,Yemen,Aden,1,0,1,ISIS releases video of a man beaten by a mob and then shot in the head.
27499,1/10/2015,Israel,Beit Furik,2,0,2,Fatah gunmen shoot a Jewish couple to death inside their car in front of their four young children.
27500,1/10/2015,Nigeria,Kirchinga,7,0,7,"Religion of Peace proponents slit the throats of seven villagers in an early morning attack, including three women."
27501,1/10/2015,Philippines,Basilan,4,23,27,A suspected Abu Sayyaf blast produces four bodies.
27502,1/10/2015,Iraq,Baghdad,1,6,7,Mujahid plant a bomb outside a soccer stadium that claims a passerby.
27503,2/10/2015,Yemen,Taiz,1,0,1,Extremists enter a home and shoot a young convert to Christianity to death.
27504,2/10/2015,Libya,Es Sider,1,2,3,A guard is left dead after Islamic extremists attack an oil port.
27505,2/10/2015,Niger,Barwa,2,4,6,Two border guards are shot to death by religious radicals.
27506,2/10/2015,Nigeria,Maiduguri,14,29,43,Boko Haram strap suicide vests on five girls and send them to a rival mosque.  At least fourteen are killed during the carnage.
27507,2/10/2015,Nigeria,Abuja,18,41,59,"Two suicide bombings, one at a bus stop blow eighteen innocents to bits."
27508,2/10/2015,Australia,Sydney,1,0,1,A youth shoots an IT worker to death outside a police station after expressing anger of a 'war on Islam.'
27509,2/10/2015,India,Bareilly,1,0,1,A man described as 'fanatical' about his Muslim faith kills his 4-year-old daughter in a fit of rage for not covering her head.
27510,3/10/2015,Syria,Yilda,5,0,5,The al-Islam army storms a courthouse and shoot five people to death.
27511,3/10/2015,Thailand,Yala,1,0,1,A father and grocer is gunned down in his shop by militant Muslims.
27512,3/10/2015,Thailand,Yala,2,0,2,"Muslim 'insurgents' fire into a pickup truck, killing two occupants."
27513,3/10/2015,Iraq,Baghdad,24,61,85,"Three suicide bombers attack a city square in a Shiite neighborhood, massacring two dozen people out enjoying the day."
27514,3/10/2015,Israel,Jerusalem,2,2,4,"Two men walking with their families are stabbed to death by an Islamic Jihad member, who also shoots a baby in the leg."
27515,3/10/2015,Bangladesh,Kownia,1,0,1,A Japanese sponsor is gunned down by Muslim radicals while visiting a humanitarian project.
27516,4/10/2015,Pakistan,Nala Tochi,1,1,2,"Islamists set off a bomb as a father and son pass, killing the older man instantly."
27517,4/10/2015,Niger,Diffa,6,4,10,Two suicide bombings leave six others dead.
27518,4/10/2015,Iraq,Tharthar,70,0,70,Seventy Iraqis are kidnapped from their homes and executed by the Islamic State.
27519,4/10/2015,Afghanistan,Maimana,7,0,7,Seven members of a single family are wiped out by Taliban terrorists.
27520,4/10/2015,Egypt,al-Arish,2,0,2,Two Egyptian police officers are shot point-blank by ISIS.
27521,5/10/2015,Bangladesh,Pabna,0,1,1,Islamists stab a pastor at his home after feigning an interest in converting.
27522,5/10/2015,Afghanistan,Kabul,0,11,11,Three suicide bombers detonate outside a house and other targets.
27523,5/10/2015,Afghanistan,Nangarhar,1,0,1,ISIS capture and behead local man.
27524,5/10/2015,Iraq,Baghdad,14,25,39,Over a dozen innocents lose their lives in their own neighborhood to a Religion of Peace car bomb blast.
27525,5/10/2015,Iraq,Basra,10,25,35,"Militant Sunnis set off a bomb in a Shiite shopping area, killing at least ten."
27526,5/10/2015,Iraq,al-Khales,35,58,93,At least thirty Shiites are torn to shreds by a Sunni car bomb in a commercial district.
27527,5/10/2015,Iraq,Mosul,2,0,2,Two accused homosexuals are thrown from a roof.
27528,5/10/2015,Philippines,Banguingi,4,2,6,A father and three children are murdered in their home by suspected Abu Sayyaf.
27529,5/10/2015,Pakistan,Gulistan-i-Jauhar,1,0,1,A 36-year-old mechanic is shot to death on his way home by radical Sunnis.
27530,5/10/2015,Yemen,Aden,15,0,15,ISIS claims credit for a suicide bombing at a hotel that leaves fifteen dead.
27531,5/10/2015,India,Hadwara,4,0,4,"Islamic militants open fire on a group of Indian soldiers, killing four."
27532,5/10/2015,Iraq,Kbeibah,4,0,4,Three women and a man are machine-gunned in their tracks while trying to escape the caliphate.
27533,6/10/2015,Yemen,Sanaa,7,0,7,An Islamic State suicide bomber slaughters seven at a rival mosque.
27534,6/10/2015,Chad,Kaiga Ngouboua,11,13,24,Eleven defenders are killed during a cross-border attack by Boko Haram.
27535,6/10/2015,Thailand,Kam Cham,1,1,2,"Militant Muslims fire on a Buddhist man in a pickup truck, killing him and badly injuring his wife."
27536,6/10/2015,Thailand,Yala,1,0,1,Muslim 'insurgents' shoot a rubber tapper to death on his way to work.
27537,6/10/2015,Syria,Aleppo,2,1,3,Two women are beheaded and another tortured by the Islamic State.
27538,6/10/2015,Iraq,Baghdad,2,4,6,Two people are taken out by Mujahid bombers.
27539,6/10/2015,Iraq,Mosul,6,0,6,Six contractors at government projects are lined up and shot by the Islamic State.
27540,7/10/2015,Syria,Aleppo,1,0,1,A man is stoned to death in front of children for adultery.
27541,7/10/2015,Somalia,Mogadishu,2,0,2,Fundamentalists shoot a doctor and his companion to death.
27542,7/10/2015,India,Bandipora,1,0,1,Lashkar-e-Taiba gunmen assassinate a police officer on the job.
27543,7/10/2015,Germany,Dessau,1,0,1,A young refugee is honor killed on the order of her family after being gang-raped in Syria.
27544,7/10/2015,Nigeria,Damaturu,1,5,6,At least one other person outside a mosque is liquidated by a suicide bomber.
27545,7/10/2015,Nigeria,Damaturu,9,5,14,An entire family is blown up by a Religion of Peace suicide bomber.
27546,7/10/2015,Nigeria,Damaturu,7,5,12,A suicide bomber takes out seven people outside a shop.
27547,7/10/2015,Afghanistan,Bati Kot,1,0,1,Religious extremists murder a rival cleric outside his seminary.
27548,7/10/2015,Nigeria,Gubio,12,0,12,A dozen people are reported dead following a Boko Haram suicide blast at a rival mosque.
27549,7/10/2015,Iraq,Ridhwaniya,5,16,21,Five people are killed by Mujahid bombers.
27550,7/10/2015,Iraq,Baghdad,2,8,10,At least two Iraqis are picked off by Islamist bombers.
27551,8/10/2015,Israel,Tel Aviv,0,8,8,Eight Israelis are stabbed in multiple attacks by 'Allah Akbar' shouting Muslims.
27552,8/10/2015,Syria,Aleppo,5,0,5,"Five people are executed by the Islamic State, including two by beheading."
27553,8/10/2015,Thailand,Nong Chik,2,0,2,A Buddhist couple selling pork are murdered by Muslim 'insurgents'.
27554,8/10/2015,Pakistan,Peshawar,1,2,3,Radical Sunnis murder a Shiite father in front of his two young daughters.
27555,8/10/2015,Iraq,Mosul,4,0,4,Four accused homosexuals are thrown from a rooftop by Religion of Peace activists.
27556,8/10/2015,Iraq,Baghdad,2,6,8,Two people are blown up by Mujahid bombers.
27557,9/10/2015,Burkina Faso,Samorogouan,3,0,3,Three Burkinese are killed in a cross-border attack by Jihadists.
27558,9/10/2015,Iraq,Diyala,35,45,80,ISIS mortar attacks on three villages leave three dozen dead.
27559,9/10/2015,Afghanistan,Kabul,1,3,4,A civilian is killed when extremists bomb a rival religious center.
27560,9/10/2015,Mali,Dounapen,3,0,3,Jihadists machine-gun three civilians.
27561,9/10/2015,Afghanistan,Baraki Barak,3,4,7,Three civilians are killed during a Taliban ambush.
27562,9/10/2015,Pakistan,Okara,1,2,3,A politician is murdered by suspected Tehreek-e-Taliban.
27563,10/10/2015,Nigeria,Chibok,4,20,24,Four people are killed when Islamist gunmen fire into homes.
27564,10/10/2015,Yemen,Mayfaa,4,0,4,Four men are executed for witchcraft - in accordance with 'Allah's law'.
27565,10/10/2015,Chad,Baga Sola,41,48,89,Two suicide bombings by female devotees leave forty dead at a busy market and refugee camp.
27566,10/10/2015,Iraq,Baghdad,2,9,11,"Islamic purists bomb a marketplace, snuffing out the lives of two patrons."
27567,10/10/2015,Iraq,Baghdad,3,7,10,Jihadis plant a bomb in a bus that kills three passengers.
27568,10/10/2015,Turkey,Ankara,97,246,343,Two suicide bombers massacre one-hundred demonstrators at a peace rally.
27569,10/10/2015,Iraq,Fallujah,3,12,15,"ISIS hits a house with a rocket, killing three civilians."
27570,11/10/2015,Kyrgyzstan,Bishkek,3,0,3,Jaish al-Mahdi members stab three guards to death at a prison where they were being kept.
27571,11/10/2015,Israel,Gan Shmuel,0,9,9,A Palestinian rams his car into a group of Israelis and then begins stabbing.
27572,11/10/2015,Cameroon,Mora,11,29,40,Eleven people are pulled into pieces by a Fedayeen suicide bomber.
27573,11/10/2015,Iraq,Mahmudiya,3,20,23,Mujahid bombers eliminate three Iraqis.
27574,11/10/2015,Iraq,Baghdad,4,12,16,Two bombs in separate neighborhoods leave four dead.
27575,12/10/2015,Iraq,Hawija,10,0,10,Jihadis behead ten less radical Jihadis.
27576,12/10/2015,Afghanistan,Kandahar,1,0,1,A UN doctor is shot to death on her way home.
27577,12/10/2015,DRC,Mukoko,8,0,8,ADF Islamists hack eight people to death with machetes.
27578,12/10/2015,Iraq,Mudheij,9,8,17,A Shahid suicide car bomber takes out nine Iraqis.
27579,12/10/2015,Tunisia,Kasserine,3,4,7,al-Qaeda militants execute a shepherd and two policemen trying to his rescue.
27580,12/10/2015,Iraq,Mosul,1,0,1,A former political candidate is executed by the Islamic State.
27581,13/10/2015,Iraq,Tel Abyad,1,1,2,The Islamic State kill a rival cleric and injure his 10-year-old son.
27582,13/10/2015,Israel,Jerusalem,3,15,18,"Two Palestinians board a bus and begin hacking and shooting Jews, killing three."
27583,13/10/2015,Israel,Jerusalem,2,8,10,"A Palestinian rams into a group of pedestrians then hacks several with a meat cleaver, killing a 60-year-old rabbi and a 76-year-old American peace activist."
27584,13/10/2015,Nigeria,Maiduguri,4,11,15,Four other people are wiped out by three Fedayeen suicide bombers in an otherwise peaceful neighborhood.
27585,13/10/2015,Indonesia,Singkil,1,4,5,One person is killed when a Muslim bomb burns down a church.
27586,13/10/2015,Mali,Gossi,6,0,6,"Islamists fire on civilians, bringing down at least six."
27587,13/10/2015,Iraq,Mosul,25,0,25,Twenty-five Iraqis are pulled from their homes and shot by the Islamic State.
27588,14/10/2015,Iraq,Sadr City,2,9,11,Two people at a cafe are blown away in mid-bite by a Mujahid bomb blast.
27589,14/10/2015,Syria,Aleppo,1,0,1,A man is beheaded for trying to help others escape the caliphate.
27590,14/10/2015,Afghanistan,Qalami Kariz,29,0,29,"Twenty-two local cops lose their lives to a vicious Taliban attack, including eight taken hostage and murdered."
27591,14/10/2015,Pakistan,Dera Ghazi Khan,7,13,20,Seven people at an office building are sent to Allah by a Shahid suicide bomber.
27592,14/10/2015,India,Krishna Ghati,1,3,4,Muslim militants murder a border guard.
27593,14/10/2015,Egypt,al-Arish,2,6,8,Islamic bombers kill a civilian and cop with a roadside bomb.
27594,15/10/2015,Nigeria,Maiduguri,42,9,51,Two suicide bombers massacre forty-two worshippers at a rival mosque.
27595,15/10/2015,Iraq,Mosul,5,0,5,Three artists are among five executed by fundamentalists.
27596,15/10/2015,Iraq,Yusufiya,1,4,5,A woman is reduced to parts by a Religion of Peace blast.
27597,16/10/2015,Nigeria,Molai,7,17,24,Seven people at a rival mosque are sent straight to Allah by suicide bombers.
27598,16/10/2015,Iran,Dezful,2,2,4,Two worshippers at a Shiite event are picked off by a Sunni drive-by.
27599,16/10/2015,Iraq,Tarmiyah,4,12,16,"Jihadi bombers send shrapnel through an outdoor market, claiming the lives of four patrons."
27600,16/10/2015,Iraq,Youssifiyah,3,9,12,Three people are dismantled by a Mujahid bomb blast in a commercial area.
27601,16/10/2015,Yemen,Hodaida,12,0,12,An al-Qaeda suicide bombing and machine-gun attack leave a dozen dead.
27602,16/10/2015,Nigeria,Umari,22,14,36,Four female suicide bombers take two dozen villagers with them.
27603,16/10/2015,Saudi Arabia,Saihat,5,4,9,"A terrorist opens fire on a Shiite meeting hall, killing five."
27604,16/10/2015,Syria,al-Basira,1,0,1,A Sufi imam is put to death by the Islamic State.
27605,17/10/2015,Libya,Ajdabiya,1,1,2,The relative of an 'apostate' is killed by a car bomb.
27606,17/10/2015,Egypt,al-Arish,2,0,2,Two local cops are killed by fundamentalist bombers.
27607,17/10/2015,Iraq,Mosul,2,0,2,Two lawyers are dragged from their homes and executed by a Sharia court.
27608,18/10/2015,Iraq,Mosul,3,0,3,Three women are dragged out of a house and killed for 'waging war against Allah'.
27609,18/10/2015,Iraq,Ramadi,1,0,1,Fundamentalists behead a man for 'insulting Allah'.
27610,18/10/2015,Afghanistan,Ghormach,20,25,45,A sustained Taliban assault leaves at least twenty others dead.
27611,18/10/2015,Israel,Be-er Sheva,1,10,11,One other person is killed when an Arab begins stabbing and shooting people at a bus station.
27612,19/10/2015,Iraq,Baghdad,3,6,9,Three shoppers at a market are reduced to pulp by an Islamic bomb blast.
27613,19/10/2015,Iraq,Ghazaliya,2,8,10,Terrorists kill two people with a bomb.
27614,19/10/2015,Thailand,Pattani,2,5,7,Two security staff bleed out following a Muslim roadside bombing outside a village.
27615,19/10/2015,Libya,Cyrenaica,1,0,1,An African Christian is beheaded by an Arab Muslim on video.
27616,19/10/2015,Syria,Derna,2,0,2,"ISIS execute one man by shooting him after making him dig his own grave, and another by dragging him behind a car."
27617,19/10/2015,Syria,Aleppo,2,1,3,An Armenian mother and son are taken out by a Sunni rocket.
27618,19/10/2015,Nigeria,Dar,11,34,45,Two female suicide bombers massacre eleven villagers.
27619,19/10/2015,Thailand,Pattani,2,5,7,An 'insurgent' bomb claims the lives of two people riding in a pickup.
27620,19/10/2015,Uganda,Kalampete,1,0,1,Muslims drag a mother of eight from her home and shoot her because her husband converted to Christianity.
27621,19/10/2015,Nigeria,Mile 40 Village,5,1,6,Boko Haram machine-gun five civilians in a car.
27622,20/10/2015,Iraq,Hawija,18,0,18,Eighteen civilians are pulled from their homes and summarily executed by the Islamic State.
27623,20/10/2015,Iraq,Taji,3,7,10,ISIS bombers murder three bystanders outside a row of shops.
27624,20/10/2015,Thailand,Narathiwat,1,0,1,The body parts of a 54-year-old man are scattered by a Muslim truck bomb.
27625,20/10/2015,Israel,Hebron,1,0,1,A 54-year-old Israeli is pelted with rocks and then run over twice by a Palestinian driver.
27626,21/10/2015,Egypt,Sheikh Zuweid,3,0,3,Three children are disassembled by an Islamist mortar round.
27627,21/10/2015,Niger,Diffa,2,3,5,A double-suicide bombing takes out two other people.
27628,21/10/2015,Yemen,Taiz,22,30,52,Twenty-two civilians are sectionalized by Shiite rockets.
27629,21/10/2015,Cameroon,Daoulo,8,9,17,Eight villagers are massacred by Boko Haram.
27630,21/10/2015,Afghanistan,Spin Boldak,2,3,5,Four Taliban suicide bombers manage to kill two other people.
27631,21/10/2015,Nigeria,Jingalta,20,0,20,"Religion of Peace activists open fire on four civilians vehicles, killing all twenty passengers."
27632,21/10/2015,Iraq,Hawija,4,0,4,Four people are abducted and executed by the Islamic State.
27633,22/10/2015,Iraq,Hawija,4,0,4,Four hostages are beheaded by the Islamic State.
27634,22/10/2015,Pakistan,Bolan,12,21,33,Six children are among a dozen Hazara religious minorities slaughtered in a targeted suicide bombing.
27635,22/10/2015,Afghanistan,Jaghato,2,0,2,"The Taliban murder two people, including a secular government official."
27636,22/10/2015,Iraq,Baghdad,6,17,23,A half dozen Iraqis lose their lives to three Mujahid bomb attacks.
27637,22/10/2015,Iraq,Tuz Khormato,3,36,39,Sunni bombers take out three Shiite pilgrims on foot.
27638,22/10/2015,Afghanistan,Ghormach,13,0,13,Thirteen local cops are executed by the Taliban.
27639,23/10/2015,Nigeria,Yola,33,56,89,Thirty-three worshippers at a rival mosque are exterminated by a Shahid suicide bomber.
27640,23/10/2015,Pakistan,Swabi,2,0,2,The Tehreek-e-Taliban murder two guards at a marketplace.
27641,23/10/2015,Libya,Benghazi,12,39,51,Suspected Islamists kill a dozen demonstrators with a rocket barrage.
27642,23/10/2015,Pakistan,Jacobabad,22,40,62,Five children are among twenty-two worshippers at a Shiite mosque sent straight to Allah by a Sunni suicide bomber.
27643,23/10/2015,Nigeria,Maiduguri,19,60,79,A suicide blast by men chanting praises to Allah leaves a bloody mess and nineteen bodies.
27644,23/10/2015,Iraq,Khalediya,1,6,7,A 6-year-old child is reduced to pulp by an ISIS mortar round.
27645,23/10/2015,Iraq,Mosul,2,0,2,A university professor is among two people executed by the Islamic State.
27646,24/10/2015,Egypt,Giza,0,4,4,Fundamentalists place a bomb near the pyramids.
27647,24/10/2015,Egypt,al-Arish,3,8,11,Fundamentalists kill three cops with a roadside bomb.
27648,24/10/2015,Nigeria,Maiduguri,3,6,9,"A female suicide bomber detonates in a quiet neighborhood, taking three residents with her."
27649,24/10/2015,Bangladesh,Dhaka,2,87,89,The Islamic State sets off a bomb at a Shiite religious festival that kill a 12-year-old and one other.
27650,24/10/2015,France,Marseille,0,2,2,A man yelling 'Allah Akbar' attacks a rabbi in a synagogue and stabs another Jew trying to help.
27651,24/10/2015,Iraq,Baqubah,1,0,1,An imam is kidnapped and murdered by Religion of Peace rivals.
27652,24/10/2015,Iraq,Jeraishi,5,12,17,A Shahid suicide bomber snuffs out the lives of five innocents.
27653,24/10/2015,Thailand,Narathiwat,1,0,1,Muslim 'insurgents' shoot a 65-year-old woman to death in her home.
27654,25/10/2015,Iraq,Tarmiya,2,9,11,A Shahid suicide bomber claims the lives of two others.
27655,25/10/2015,Iraq,Albu Eitha,15,27,42,Fifteen Iraqis are blown to bits by a Fedayeen suicide bomber.
27656,25/10/2015,Iraq,Aziz,10,7,17,A suicide car bomber exterminates ten bystanders.
27657,25/10/2015,Egypt,al-Arish,1,0,1,A political candidate is gunned down by suspected Brotherhood supporters.
27658,25/10/2015,Syria,Homs,1,0,1,The Islamic State execute a hostage by driving a tank over him.
27659,25/10/2015,Syria,Aleppo,3,3,6,Three women are pulled into pieces by a Shuhada Bader rocket.
27660,25/10/2015,Syria,Asharah,2,0,2,A man and boy are thrown off a high building on charges of being homosexual.
27661,26/10/2015,Turkey,Diyarbakir,2,5,7,"ISIS members open fire on police, killing two."
27662,26/10/2015,Israel,Kiryat Arba,0,1,1,An Israeli teen is stabbed in the neck by a Palestinian terrorist.
27663,26/10/2015,Iraq,Husseiniyah,2,0,2,A married couple is gunned down in a sectarian attack.
27664,26/10/2015,Iraq,Madaen,2,9,11,"Jihadis set off a bomb at a popular market, killing two patrons."
27665,26/10/2015,Syria,Palmyra,3,0,3,Three people are strapped to ancient columns and blown up by the caliphate.
27666,26/10/2015,Yemen,Aden,2,5,7,Two souls are sent to Allah by a suicide bomber.
27667,26/10/2015,Saudi Arabia,Najran,2,25,27,An elderly man is among two worshippers murdered by a suicide bomber at a mosque.
27668,26/10/2015,Afghanistan,Jalalabad,2,6,8,The Taliban murder two local human rights workers with a remote-controlled bomb.
27669,26/10/2015,Iraq,Baghdad,7,23,30,Seven Shiite pilgrims are slaughtered in their tent by a Sunni suicide bomber.
27670,26/10/2015,CAR,Bangui,3,0,3,"Three ordinary Christians are targeted, abducted and murdered by Muslim radicals."
27671,27/10/2015,Syria,Deir-ez-Zor,2,0,2,Two gay men are thrown from a roof by caliphate members.
27672,27/10/2015,Pakistan,Angoor Adda,7,3,10,"Terrorists open fire point-blank on a border check post, killing seven guards."
27673,27/10/2015,Iraq,Shirqat,10,0,10,Ten people are executed for 'failing to perform their duty to Allah.'
27674,27/10/2015,Iraq,Thar Thar,2,10,12,Two people lose their lives to a Shahid suicide bomber.
27675,28/10/2015,Libya,Banghazi,3,0,3,Three locals are beheaded by ISIS.
27676,28/10/2015,Iraq,Qayara,3,0,3,Three tribal elders are burned alive by Islamic State diplomats.
27677,28/10/2015,India,Bhutoo,3,0,3,Three security personnel are murdered by Muslim terrorists.
27678,28/10/2015,Afghanistan,Darqand,4,0,4,Four defenders are killed when the Taliban attack a town.
27679,28/10/2015,Niger,Ala,14,3,17,Fourteen villagers are murdered by Boko Haram.
27680,28/10/2015,Bangladesh,Feni,1,0,1,A woman loses her baby following a Muslim attack on a Hindu celebration.
27681,28/10/2015,Iraq,al-Hadba,17,0,17,Seventeen Iraqis die under torture at a caliphate prison.
27682,28/10/2015,Afghanistan,Sayid Karam,4,0,4,Four local cops are slaughtered by the Taliban.
27683,28/10/2015,Iraq,Abbasiya,10,0,10,At least ten Iraqis are killed by two ISIS suicide car bombers.
27684,28/10/2015,Iraq,Ghabat,30,0,30,Seven women are among thirty Iraqis beheaded by the Islamic State
27685,29/10/2015,Iraq,Baghdad,26,40,66,"Militant Shiites send rockets into a Sunni refugee camp, killing over two dozen."
27686,29/10/2015,Libya,Ajdabiya,1,0,1,The Islamic State takes out a rival cleric with a car bomb.
27687,29/10/2015,Iraq,Talsaqif,12,10,22,A dozen Iraqis are blown apart by an ISIS rocket attack on a power plant.
27688,30/10/2015,Iraq,al-Furat,4,0,4,Four men are forced to kneel and then shot in the head by caliphate members.
27689,30/10/2015,Turkey,Sanliurfa,2,0,2,Two anti-ISIS journalists are beheaded in Turkey for being 'apostates'.
27690,31/10/2015,Yemen,Aden,2,0,2,Two men are shot to death in separate al-Qaeda drive-bys.
27691,31/10/2015,Egypt,al-Arish,1,6,7,A 60-year-old man is blown apart by a fundamentalist bomb blast.
27692,31/10/2015,Afghanistan,Achin,6,4,10,"Islamists fire rockets into a rival mosque, killing six worshippers."
27693,31/10/2015,Bangladesh,Shahbagh,1,0,1,A publisher who sponsored a book critical of Islam is stabbed and beheaded at his office.
27694,31/10/2015,Bangladesh,Lalmatia,0,3,3,Three secular writers are slashed with knives by Islamists.
27695,31/10/2015,Egypt,Sinai,224,0,224,Suspected Wilayat Sinai terrorists bomb a Russian airplane carrying two-hundred and twenty-four civilians.
27696,31/10/2015,Pakistan,Karachi,1,0,1,A secular political activist is assassinated by suspected Islamists.
27697,31/10/2015,Iraq,Mosul,12,0,12,A dozen teenagers forced into a terror training camp are executed for attempting to flee.
27698,31/10/2015,Nigeria,Itu,2,0,2,Two people are killed when terrorists attack a fish market.
27699,1/11/2015,Pakistan,Rana Deray,1,0,1,"Suspected Islamists fire on a car carrying a female judge, killing the driver."
27700,1/11/2015,Iraq,Mosul,3,0,3,Three Kurds are executed for refusing to join the caliphate.
27701,1/11/2015,Somalia,Mogadishu,12,10,22,"a dozen people at a hotel are massacred by suicide bombers, followed by gunfire."
27702,1/11/2015,Chad,Bougouma,3,14,17,A suicide bombing and subsequent attack leave three dead.
27703,1/11/2015,Syria,Maheen,50,0,50,Two suicide car bombings followed by a sustained assault leave at least fifty other dead.
27704,2/11/2015,India,Bharuch,2,0,2,Two Hindu leaders are assassinated by Muslim terrorists.
27705,2/11/2015,Somalia,Walaweyn,15,15,30,Fifteen Somalis are killed in a road ambush by al-Shabaab.
27706,2/11/2015,Israel,Rishon Lezion,0,3,3,An 80-year-old woman is among three stabbed by a Palestinian terrorist outside a store.
27707,2/11/2015,Afghanistan,Ghor,1,0,1,A 19-year-old woman is stoned to death for premarital sex.
27708,2/11/2015,Syria,Homs,3,0,3,Three men are executed by Quran-quoting Muslims.
27709,2/11/2015,Iraq,Mahmoudiya,2,6,8,"Terrorists set off a bomb at a popular market, killing two innocents."
27710,2/11/2015,Iraq,Badush,3,0,3,Three female doctors are put against a wall and shot in the head by the Islamic State.
27711,3/11/2015,Iraq,Dibis,4,15,19,Four people are murdered by a Shahid suicide bomber.
27712,3/11/2015,Syria,Harasta,1,0,1,Shrapnel from a Sunni rocket kills a woman on her way to work.
27713,3/11/2015,Pakistan,Salarzai,1,2,3,Sharia activists set off a bomb that kills a tribal elder and injures his two sons.
27714,3/11/2015,Afghanistan,Tank,1,0,1,A journalist and father of five is shot to death by Sunni fundamentalists.
27715,4/11/2015,USA,"Merced, CA",0,4,4,A student vowing to behead and 'praise Allah' stabs four others on campus.
27716,4/11/2015,Afghanistan,Shah Joy,1,0,1,The Taliban murder a civil activist on his way to work.
27717,4/11/2015,Syria,Hassakeh,2,0,2,Two people are murdered by a Fedayeen suicide bomber.
27718,4/11/2015,Iraq,Baghdad,3,14,17,Two bombs claim the lives of three bystanders.
27719,4/11/2015,Egypt,al-Arish,5,10,15,"A suicide bomber plows into a police club, killing at least five others."
27720,4/11/2015,Bangladesh,Ashulia,1,1,2,Islamists hack a police officer to death during a traffic stop.
27721,4/11/2015,Syria,Mayadeen,3,0,3,Three brothers are publicly and slowly tortured to death by the Islamic State.
27722,4/11/2015,Iraq,Tal Afar,2,0,2,Two men are forced to kneel and then shot in the back of the head by Islamic warriors.
27723,5/11/2015,Iraq,Baghdad,2,6,8,A bomb placed on a bus kills two passengers.
27724,5/11/2015,Lebanon,Arsal,5,15,20,Five Muslim scholars are taken out by a suicide blast from a Religion of Peace rival.
27725,6/11/2015,Iraq,Yusufiya,1,2,3,Jihadi bombers take out a woman and injure her two children.
27726,6/11/2015,Libya,Ajdabiya,1,0,1,A Salafi cleric is shot to death by Religion of Peace rivals.
27727,6/11/2015,Iraq,Maidan,2,5,7,Two people at a meat market are butchered by ISIS bombers.
27728,6/11/2015,Iraq,Baghdad,3,9,12,"Bombers target a residential area, killing three unfortunates."
27729,6/11/2015,Pakistan,Quetta,1,1,2,A Shiite is gunned down by Sunni radicals.
27730,6/11/2015,Afghanistan,Shamir,1,0,1,Religion of Peace activists kill a rival cleric with a car bomb.
27731,7/11/2015,Iraq,Baghdad,3,15,18,Two Jihad bombings leave three dead.
27732,7/11/2015,Iraq,Tarmiya,6,0,6,A suicide bomber claims six other lives.
27733,7/11/2015,Iraq,Albu Haiyat,5,12,17,"Roadside bombs take care of five Iraqis, with a dozen surviving."
27734,7/11/2015,Pakistan,Quetta,2,0,2,Two Hazara religious minorities are sprayed with bullets by Ahle Sunnat wal Jamaat members.
27735,8/11/2015,Afghanistan,Rasani,7,0,7,Two women and a child are among seven civilians kidnapped and beheaded by ISIS.
27736,8/11/2015,Chad,Ngouboua,3,12,15,Two female suicide bombers murder three refugees at a fishing village.
27737,8/11/2015,Syria,Aleppo,4,3,7,A child is among four civilians cut down by a Sunni rocket.
27738,8/11/2015,Iraq,Baghdad,2,8,10,A bomb at a popular market produces a bloody mess and two dead bodies.
27739,8/11/2015,Iraq,Sadr City,7,20,27,A double suicide bombing at a Shiite market lays out seven patrons.
27740,8/11/2015,Yemen,Sanaa,16,6,22,Shiite militants are thought responsible for a brutal bombing that killed sixteen government troops at their barracks.
27741,9/11/2015,CAR,Ndassima,10,8,18,Muslim militia cut the throats of ten Christian villagers.
27742,9/11/2015,Pakistan,Karachi,1,3,4,One person is cut down by sectarian Jihadis.
27743,9/11/2015,Jordan,Amman,5,4,9,Two Americans and a South African are gunned down along with two locals by an Islamic extremist in uniform.
27744,9/11/2015,Israel,Hilhul Junction,1,6,7,Six Israelis are stabbed or run over by Palestinians.  A victim also dies of wounds suffered in an earlier attack.
27745,9/11/2015,Cameroon,Fotokol,3,20,23,At least three others are killed when female suicide bombers attack a rival mosque.
27746,9/11/2015,Iraq,Mosul,3,0,3,Three young people are executed by the Islamic State.
27747,10/11/2015,Yemen,Sanaa,1,0,1,An American contractor dies in custody after being kidnapped by Shiite militia.
27748,10/11/2015,India,Madikeri,1,20,21,A farmer's skull is crushed from a rock thrown by angry Muslims during a an anti-Hindu riot.
27749,10/11/2015,Iraq,Dora,2,0,2,Two merchants are shot to death by Islamists.
27750,10/11/2015,Pakistan,Guddu,2,0,2,Islamic terrorists sneak up on a police post and machine-gun two officers.
27751,10/11/2015,Iraq,Shaab,2,7,9,"A Sunni bomb rips through a parking lot, killing two."
27752,10/11/2015,Syria,Latakia,23,65,88,"Sunnis send rockets into an area near a university, sending sixty-five to the hospital and twenty-three to the morgue."
27753,10/11/2015,Iraq,Hussainiyah,4,7,11,"Terrorists set off a bomb in a residential neighborhood, killing four."
27754,10/11/2015,Iraq,Baghdad,3,8,11,A blast at an outdoor market leaves three dead.
27755,10/11/2015,Afghanistan,Khak-i-Afghan,2,0,2,At least two others are killed by a Shahid suicide bomber.
27756,11/11/2015,Egypt,Harhor,8,1,9,A child is among eight family members slaughtered in their home by fundamentalist militants.
27757,11/11/2015,Niger,Bossa,5,0,5,At least five civilians are killed when Boko Haram attack a village.
27758,11/11/2015,Iraq,Baiji,13,0,13,Thirteen members of two families are crushed to death in their own homes by ISIS explosives.
27759,11/11/2015,Iraq,Ekreshat,22,0,22,Twenty-two civil servants are marched out to a field and executed by the Islamic State.
27760,11/11/2015,Iraq,Tarmiya,2,4,6,Two people are killed when Jihadis bomb a market.
27761,12/11/2015,Jordan,Irbid,2,0,2,"In the name of honor, a man beheads his sister and stabs her 15-year-old son."
27762,12/11/2015,Lebanon,Beirut,43,240,283,Two Sunni suicide bombers massacre over forty people in a Shiite residential neighborhood.
27763,12/11/2015,Italy,Milan,0,1,1,A Haredi Jew is stabbed nine times by a masked Muslim.
27764,12/11/2015,Syria,al-Heisha,4,0,4,"A boy, his grandfather and two farmers reduced to pulp by an ISIS missile."
27765,12/11/2015,CAR,Bandambou,6,0,6,Six hunters are shot to death by suspected Seleka militants.
27766,12/11/2015,Thailand,Pattani,4,4,8,Four Thais are exterminated by Jihadi bombers.
27767,13/11/2015,Israel,Otniel,2,5,7,A Jewish father and son are murdered by Palestinians as they are on their way to a wedding event.
27768,13/11/2015,Iraq,Sadr City,5,15,20,"Sunnis set off a bomb near a Shiite shrine, killing five passersby."
27769,13/11/2015,Iraq,Baghdad,21,46,67,"A suicide bomber strikes a Shia funeral, laying out twenty-one mourners."
27770,13/11/2015,Yemen,Shibam,3,14,17,At least three people are left dead after terrorists bomb a rival mosque.
27771,13/11/2015,France,Paris,89,322,411,"Islamic terrorists open fire and throw bombs during a concert at a music hall, slaughtering nearly ninety innocents while shouting 'Allah Akbar' (Bataclan)."
27772,13/11/2015,France,Paris,5,8,13,"Islamic terrorists shoot up a bar and pizzeria, killing five patrons (La Bonne Biere, Casa Nostra)."
27773,13/11/2015,France,Paris,15,10,25,Islamic terrorists massacre fifteen innocents at two restaurants (Le Carillon and Le Petit Cambodge).
27774,13/11/2015,France,Paris,1,0,1,Islamic terrorists eliminate a passerby with two suicide blasts outside a soccer stadium (Stade de France) and a nearby McDonalds's.
27775,13/11/2015,France,Paris,0,3,3,Islamic terrorists stage a suicide bombing outside a cafe Comptoir Voltaire).
27776,13/11/2015,France,Paris,19,9,28,Islamic terrorists pile up nineteen bodies at a restaurant (Belle Equipe).
27777,13/11/2015,Tunisia,Sawar Soultaniya,1,0,1,Islamists behead a 16-year-old shepherd and send the head back to his family.
27778,14/11/2015,Iraq,Mandali,1,1,2,A Shahid suicide car bomber kills a bystander.
27779,14/11/2015,Yemen,Mahwit,1,0,1,One other person is killed when a suicide bomber explodes prematurely outside a mosque.
27780,14/11/2015,Iraq,Sinjar,78,0,78,"A mass grave is unearthed, containing seventy-eight elderly female victims of ISIS execution."
27781,14/11/2015,Iraq,Mosul,1,0,1,The head of a university physics department is executed by ISIS.
27782,14/11/2015,Pakistan,Karachi,2,0,2,Two police officers are shot to death by the Tehreek-e-Taliban.
27783,14/11/2015,Somalia,Kismayo,15,25,40,At least fifteen are left dead after a surprise attack by al-Shabaab.
27784,14/11/2015,Iraq,Tal Afar,20,0,20,Twenty Kurds are executed by the Islamic State.
27785,15/11/2015,Syria,Jamleh,7,0,7,An al-Qaeda suicide bomber takes out seven members of a rival group.
27786,15/11/2015,Iraq,Sinjar,70,0,70,Two more mass graves are unearthed with the bodies of seventy Yazidi minority victims of ISIS execution.
27787,15/11/2015,Afghanistan,Lashkar Gah,1,12,13,A Shahid suicide bomber detonates along a city street.
27788,15/11/2015,Turkey,Gaziantep,0,5,5,An ISIS suicide bomber injures five policemen.
27789,15/11/2015,Pakistan,Gulshan-e-Iqbal,2,0,2,Two Shia guards outside a minority religion complex are picked off in a targeted shooting by Sunnis.
27790,15/11/2015,Iraq,Baghdad,7,15,22,Seven people are killed by a series of Mujahideen bombings.
27791,15/11/2015,Iraq,Ameriyat al-Fallujah,3,5,8,Three Iraqis are dismantled by an ISIS rocket.
27792,15/11/2015,Iraq,Tuz Khormato,1,0,1,Shiite militia murder a 14-year-old Kurd.
27793,16/11/2015,Yemen,Mocha,44,0,44,Forty-four Yemenis near a port are killed during a brutal ambush by Shiite rebels.
27794,16/11/2015,Iraq,Baghdad,2,8,10,"Radicals set off a bomb outside a car parts shop, killing two passersby."
27795,16/11/2015,Iraq,Nineveh,45,0,45,Media figures are among forty-five civilians pulled from their homes and executed by the Islamic State.
27796,17/11/2015,Iraq,Taji,2,8,10,Mujahideen kill two people with a planted bomb.
27797,17/11/2015,Nigeria,Yola,34,80,114,"Islamists bomb a fruit and vegetable market, obliterating thirty-four patrons."
27798,17/11/2015,Philippines,Jolo,1,0,1,A businessman is beheaded by Abu Sayyaf.
27799,17/11/2015,Iraq,Tuz Khurmatu,1,0,1,A Kurdish doctor on his way to work is ambushed and killed by Shiite radicals.
27800,18/11/2015,Bosnia,Sarajevo,2,1,3,"An 'ultra-conservative' Salafi fires an automatic weapon into a gambling shop, killing two guards."
27801,18/11/2015,Afghanistan,Ghazni,2,0,2,The Taliban take out two brothers with a planted explosive.
27802,18/11/2015,Bangladesh,Dinajpur,0,1,1,An Italian priest is stabbed by Islamists.
27803,18/11/2015,France,Marseille,0,1,1,A Jewish teacher is stabbed by 'radicalized' Muslims.
27804,18/11/2015,Saudi Arabia,al-Qatif,2,0,2,Two local cops are shot to death by Shiite extremists.
27805,18/11/2015,Nigeria,Kano,15,123,138,"Fifteen patrons at a mobile phone market are sent to the afterlife by two child suicide bombers, including an 11-year-old girl."
27806,18/11/2015,Syria,Raqqa,2,0,2,A Norwegian and a Chinese hostage are executed by the Islamic State after being captured.
27807,18/11/2015,Iraq,Mahmoudiya,2,6,8,"Jihadis set off a bomb at a popular market, killing two patrons."
27808,19/11/2015,Afghanistan,Arghandab,1,6,7,Islamic radicals stage a suicide attack on a police station.
27809,19/11/2015,Israel,Gush Etzion,3,4,7,An American teenager is among three people cut down by an Arab drive-by shooter.
27810,19/11/2015,Israel,Tel Aviv,2,3,5,Two worshippers at a synagogue are stabbed to death by a Muslim terrorist.
27811,20/11/2015,Pakistan,Lahore,1,0,1,A woman is shot to death for 'not having good character.'
27812,20/11/2015,Iraq,Yousifiya,2,9,11,Two worshippers are killed when radicals place a bomb outside a rival mosque.
27813,20/11/2015,Mali,Bamako,27,6,33,Gunmen yelling 'Allah Akbar' storm a hotel and kill or capture dozens of people who are unable to recite Quran verses.
27814,20/11/2015,Pakistan,Ittehad,4,0,4,Hardline gunmen pick off four guards outside a rival mosque during Friday prayers.
27815,20/11/2015,Iraq,Baghdad,10,28,38,Ten worshippers at a Shiite mosque are sent straight to Allah by a Sunni suicide bomber.
27816,20/11/2015,Yemen,Shibam,19,24,43,An al-Qaeda suicide attack leaves at leaves nineteen others dead.
27817,20/11/2015,Pakistan,Charssada,2,0,2,Two traffic cops are shot in the head by Islamic extremists.
27818,20/11/2015,Iraq,Makhmour,7,0,7,Seven Kurds are killed during an attack by the Islamic State.
27819,21/11/2015,Iraq,Sinjar,9,0,9,Nine people are killed when an ISIS bomb detonates at a house.
27820,21/11/2015,Cameroon,Leymarie,5,15,20,Five civilians are laid out by three female suicide bombers outside their residence.
27821,21/11/2015,Pakistan,Karachi,4,5,9,Terrorists shoot four people to death.
27822,22/11/2015,Pakistan,Warghara,5,0,5,Five policemen are blown to bits by the Tehreek-e-Taliban.
27823,22/11/2015,Nigeria,Maiduguri,8,7,15,A female suicide bomber exterminates eight people at a displaced persons camp.
27824,22/11/2015,Israel,Etzion,1,0,1,A young Israeli woman is brutally stabbed to death by Palestinians.
27825,22/11/2015,Afghanistan,Kohat,1,0,1,A TV journalist is murdered by suspected Taliban.
27826,22/11/2015,Iraq,Baghdad,2,8,10,Two patrons at a restaurant are cut down in mid-bite by Mujahideen bombers.
27827,23/11/2015,Iraq,Fallujah,2,0,2,Two homosexuals are blindfolded and flung from a roof by a Sharia court.
27828,23/11/2015,Israel,Beit Horon,1,1,2,An 18-year-old Israel is stabbed to death by Arabs.
27829,23/11/2015,Iraq,Zab,10,0,10,Ten civilians are executed and hung from poles by caliphate members.
27830,23/11/2015,Egypt,Tamiyyah,1,0,1,A 26-year-old mother of two is murdered by her conservative uncle after leaving Islam for Christianity.
27831,23/11/2015,Iraq,Madain,2,8,10,Religion of Peace shrapnel liberates two souls from their bodies.
27832,23/11/2015,Iraq,Baghdad,2,6,8,A bomb near shops leaves a bloody mess and two dead.
27833,24/11/2015,Pakistan,Angoor Adda,7,3,10,Seven Pakistanis are killed when Taliban militants fire shells from across the border.
27834,24/11/2015,Syria,Raqqa,1,0,1,An Austrian teen bride is beaten to death for trying to leave the caliphate.
27835,24/11/2015,Tunisia,Tunis,15,16,31,Fifteen on a bus are reduced to pulp by a Religion of Peace bomb blast.
27836,24/11/2015,Syria,Turkman Mountains,1,0,1,A Russian hostage is executed by the Islamic State.
27837,24/11/2015,Egypt,al-Araish,7,17,24,"Two bombings at a hotel, one a suicide attack, leave six others dead."
27838,24/11/2015,Libya,Mislattah,5,16,21,Islamist bombers kill five people at a checkpoint.
27839,24/11/2015,Mali,Goundam,1,0,1,A civilian is killed by a bomb planted by Islamic extremists.
27840,24/11/2015,Afghanistan,Ghor,1,0,1,A 19-year-old girl is publicly lashed to death by a cleric for disobeying her family.
27841,25/11/2015,India,Tanghdar,1,1,2,Jaish-e-Mohammad gunmen storm a camp and kill a civilian.
27842,25/11/2015,Niger,Wogom,18,11,29,"Boko Haram members wade into a village, hacking and shooting eighteen residents to death."
27843,25/11/2015,Pakistan,Sheikh Baba,1,2,3,Sunni fundamentalists murder a government official.
27844,25/11/2015,Iraq,Mosul,11,0,11,A woman is among eleven civilian employees executed by the Islamic State.
27845,25/11/2015,Iraq,Hardan,9,4,13,An ISIS bomb blows nine Kurds into pieces.
27846,26/11/2015,Azerbaijan,Baku,2,0,2,Two policeman are killed when members of the Movement for Muslim Unity open fire.
27847,26/11/2015,Pakistan,Narmikhel,2,3,5,An Islamist roadside bomb claims two lives.
27848,26/11/2015,Pakistan,Akram Khan Durrani,2,5,7,Islamists bombers pick off two local cops.
27849,26/11/2015,Bangladesh,Horipur,1,3,4,"Five terrorists enter a Shiite mosque and open fire on worshippers, killing a 70-year-old man."
27850,27/11/2015,Nigeria,Gajiganna,3,0,3,Three villagers are murdered by Boko Haram Islamists.
27851,27/11/2015,Iraq,Mosul,1,0,1,A woman is forced to her knees and shot in the head by the Islamic State.
27852,27/11/2015,Nigeria,Dakasoye,22,45,67,"A Sunni suicide bomber targets a Shiite procession and slaughters twenty-two pilgrims, including women and children."
27853,27/11/2015,Iraq,Jubba,17,0,17,Seventeen Iraqis are exterminated by a suicide truck bomber.
27854,28/11/2015,Niger,Fougou Boukar,4,2,6,"Sharia proponents pour machine-gun fire into a village, killing four occupants."
27855,28/11/2015,Iraq,Madain,2,5,7,Muslim terrorists kill two people with a well-placed bomb at a fishing village.
27856,28/11/2015,Cameroon,Goudouzou,5,0,5,Islamists burn down homes and kill five people.
27857,28/11/2015,Iraq,Sinjar,123,0,123,A mass grave is discovered containing one-hundred and twenty-three religious minorities executed by ISIS .
27858,28/11/2015,Egypt,Saqqara,4,0,4,Four police at a security checkpoint are machine-gunned point-blank by fundamentalists on motorbikes.
27859,28/11/2015,Afghanistan,Kabul,1,4,5,A suicide bomber takes out a passing driver.
27860,28/11/2015,Pakistan,Tursa,1,1,2,"Islamic militants fire a rocket at a truck, killing the driver."
27861,28/11/2015,Pakistan,Ambar,2,0,2,Two peace volunteers are pulled into disparate parts by fundamentalist bombers.
27862,28/11/2015,Iraq,Tuz Khormato,7,17,24,"A Shahid suicide bomber detonates at the entrance to a market, sending seven bystanders to their doom."
27863,28/11/2015,Cameroon,Dabanga,5,12,17,"Two female suicide bombers detonate in a small two, sending five innocents to their deaths."
27864,28/11/2015,Syria,Damascus,1,30,31,"Sunnis send a rocket into a Christian neighborhood, killing one resident."
27865,28/11/2015,Mali,Kidal,3,20,23,"Jihadis fire a rocket at a UN facility, killing three people."
27866,29/11/2015,Nigeria,Bam,4,0,4,"Boko Haram roll into a village, kill four adults and kidnap several teenager girls to rape."
27867,29/11/2015,Iraq,Baghdad,3,8,11,"Two bombs, one set off in a shopping district, leave three dead."
27868,29/11/2015,Iraq,Sinjar,100,0,100,One-hundred more victims of ISIS execution are discovered in a mass grave.
27869,29/11/2015,DRC,Eringeti,7,0,7,Seven civilians at a hospital are hacked to death by Islamic extremists.
27870,30/11/2015,Niger,Diffa,8,0,8,At least eight people are reported dead following a Boko Haram attack.
27871,30/11/2015,Pakistan,Zaida,1,1,2,A physician specializing in immunization is shot to death by religious extremists.
27872,30/11/2015,Iraq,Baghdad,9,21,30,Nine Shiite pilgrims are sent straight to Allah by a Sunni suicide bomber.
27873,30/11/2015,Syria,Palmyra,18,0,18,Eighteen captives are executed by the Islamic State.
27874,30/11/2015,Cameroon,Gangse,2,0,2,Islamic extremists kill two local soldiers with a planted bomb.
27875,1/12/2015,Jordan,Irbid,2,0,2,"Suspected Sunni militants open fire on a police car, killing two occupants."
27876,1/12/2015,Dagestan,Khasavyurt,1,0,1,An imam is assassinated by Religion of Peace rivals.
27877,1/12/2015,Iraq,Abu Ghraib,2,9,11,"Islamic militia set of a bomb at a popular market, killing two patrons."
27878,1/12/2015,Iraq,Baghdad,2,11,13,Two people are killed in separate Mujahideen bomb blasts.
27879,1/12/2015,Iraq,Zammar,5,7,12,Five Kurds are eliminated by a Fedayeen suicide bomber.
27880,1/12/2015,Iraq,Shura,6,0,6,Six tribal elders are executed by the ISIS.
27881,1/12/2015,Iraq,Kirkuk,1,1,2,A man is shot to death by terrorists in his car while sitting next to his wife.
27882,2/12/2015,Uganda,Komodo,1,0,1,A father-of-five is hacked to death by a group of Islamists after leaving Islam for Christianity.
27883,2/12/2015,Cameroon,Waza,6,0,6,Two female suicide bombers slaughter six people.
27884,2/12/2015,Syria,Raqqa,2,0,2,Two gay men are thrown from a rooftop by a Sharia court.
27885,2/12/2015,Syria,Raqqa,1,0,1,A Russian hostage is beheaded by the Islamic State.
27886,2/12/2015,USA,"San Bernardino, CA",14,17,31,"A 'very religious' Muslim shoots up a Christmas party with his wife, leaving fourteen dead."
27887,2/12/2015,Iraq,Shingal,7,1,8,Seven Kurds are leveled by an ISIS bomb blast.
27888,2/12/2015,Libya,Sidi Faraj,1,0,1,A man is killed by an ISIS bomb at a farming community.
27889,2/12/2015,Yemen,Seiyun,2,0,2,Two tribesmen are kidnapped and executed by ISIS.
27890,2/12/2015,Syria,Ghouta,2,26,28,Two Assyrian women are disassembled by a Sunni mortar blast.
27891,3/12/2015,Yemen,Jaar,15,0,15,al-Qaeda elements sweep into a town and wipe out fifteen locals.
27892,3/12/2015,Iraq,Mosul,3,0,3,A man and his wife are among three Kurds executed in cold blood by the Islamic State.
27893,3/12/2015,Somalia,Mogadishu,1,1,2,A female journalist is blown apart by an al-Shabaab car bomb.
27894,3/12/2015,CAR,Ngakobo,8,1,9,Eight civilians at a displaced persons camp are murdered by Muslim 'rebels'.
27895,4/12/2015,Nigeria,Sabon Gari,3,0,3,A Fedayeen suicide bomber murders three others.
27896,4/12/2015,Nigeria,Kimba,1,0,1,An elderly man is killed by a Shahid suicide bomber.
27897,4/12/2015,Yemen,Sanaa,9,0,9,Nine Shiites are beheaded by the Islamic State.
27898,4/12/2015,Yemen,Sanaa,4,0,4,An Islamic State execution video shows bombs hung from the necks of four Shiite prisoners.
27899,4/12/2015,Yemen,Sanaa,6,0,6,An Islamic State execution video show six Shiites strapped to a boat and then blown up.
27900,4/12/2015,Yemen,Sanaa,6,0,6,An Islamic State execution video shows six Shiites blown up with a rocket launcher.
27901,4/12/2015,Iraq,Ramadi,25,23,48,Five suicide car bombers take out over two dozen Iraqis.
27902,5/12/2015,England,London,0,3,3,A Muslim with a machete slashes commuters at a subway station.
27903,5/12/2015,Iraq,Nineveh,1,0,1,An accused witch is beheaded by caliphate members in front of a baying mob.
27904,5/12/2015,Bangladesh,Dinjapur,0,10,10,Suspected Islamists hurl three bombs at a Hindu temple.
27905,5/12/2015,Chad,Koulfoua,27,80,107,Three female suicide bombers massacre twenty-seven patrons at a local market.
27906,5/12/2015,Iraq,Mosul,29,0,29,Seventeen teenagers are among twenty-nine Iraqis laid out by ISIS executioners.
27907,5/12/2015,Iraq,Baghdad,2,8,10,An ISIS bomb blast at a cafe leaves two dead.
27908,6/12/2015,Yemen,Aden,7,3,10,A suicide car bomber turns seven 'apostates' into rubble.
27909,6/12/2015,Iraq,Ramadi,8,15,23,A Shahid suicide car bomber massacres eight Iraqis.
27910,7/12/2015,Israel,Hebron,1,0,1,A Palestinian stabs an Israeli outside a Jewish holy site who dies three weeks later.
27911,7/12/2015,Iraq,Madain,2,6,8,Jihadis take out two Iraqis with a bomb planted near a hospital.
27912,7/12/2015,Afghanistan,Nangarhar,2,22,24,Two civilians are blown up by the Taliban.
27913,7/12/2015,Libya,Tripoli,2,0,2,Sharia advocates behead two men for 'sorcery' at a public event.
27914,8/12/2015,Syria,Deir ez-Zor,1,0,1,A journalist is tied between two vehicles and then pulled apart by caliphate members.
27915,8/12/2015,Afghanistan,Kandahar,50,35,85,Thirty-eight civilians are slaughtered with a dozen others when Taliban fundamentalists in suicide vests pour machine-gun fire into a crowded market.
27916,8/12/2015,Egypt,Sinai,4,4,8,Fundamentalists murder four security personnel with a roadside bomb.
27917,8/12/2015,Philippines,Tulunan,3,0,3,Three villagers are shot dead by Moro Islamists.
27918,8/12/2015,Iraq,Mosul,1,0,1,A rival imam is assassinated in front of his mosque by ISIS.
27919,8/12/2015,Iraq,Baaj,3,0,3,Three doctors are executed by the Islamic State.
27920,8/12/2015,Iraq,Albu Farraj,7,12,19,An ISIS suicide bomber kills seven Iraqis.
27921,9/12/2015,Syria,Raqqa,5,0,5,Five Russian nationals are murdered by the Islamic State.
27922,9/12/2015,Iraq,Baghdad,11,20,31,"A holy warrior with a suicide vest detonates at a Shiite mosque, sending eleven worshippers straight to Allah."
27923,10/12/2015,Iraq,Mosul,1,0,1,A female teacher is dragged before a caliphate firing squad and executed.
27924,10/12/2015,Syria,Tal Tamr,60,80,140,Three suicide car bombers take out scores bystanders at a hospital and market square.
27925,10/12/2015,Somalia,Mogadishu,1,0,1,A man bleeds out after Islamists set off a bomb under his car.
27926,10/12/2015,Egypt,Cairo,1,0,1,Muslim terrorists shoot a traffic cop to death.
27927,10/12/2015,Nigeria,Kamuya,14,6,20,"Religion of Peace activists bicycle into a village and massacre fourteen civilians, some by decapitation."
27928,11/12/2015,Iraq,Ramadi,27,0,27,Over two dozen Iraqis are reported dead following two Religion of Peace suicide blasts.
27929,11/12/2015,Cameroon,Kolofata,11,22,33,"Islamists strap a 13-year-old girl with explosives and send her into a house, killing at least eleven inside."
27930,11/12/2015,Afghanistan,Kabul,7,7,14,Two Spanish guards are among seven killed when a Taliban suicide bomber detonates at their embassy.
27931,11/12/2015,Iraq,Mosul,4,0,4,A judge is among four people executed by the Islamic State.
27932,11/12/2015,Afghanistan,Jalalabad,4,0,4,Three children are among four innocents are murdered by a female suicide bomber.
27933,12/12/2015,Nigeria,Mangari,4,0,4,Four villagers are chopped up with machetes by Islamic extremists.
27934,12/12/2015,Nigeria,Bura-Shika,6,5,11,A half-dozen people are stabbed to death by Boko Haram.
27935,12/12/2015,Nigeria,Warwara,20,10,30,Twenty villagers are hacked to death by Islamists.
27936,12/12/2015,Syria,Damascus,2,6,8,Sunnis kill two civilians with a mortar attack on their neighborhood.
27937,12/12/2015,Pakistan,Karachi,1,0,1,The Tehreek-e-Taliban gun down a 52-year-old man.
27938,12/12/2015,Iraq,Baghdad,2,6,8,Two patrons at a market are turned to paste by Mujahideen bombers.
27939,12/12/2015,Iraq,al-Nukhayb,8,10,18,Eight Iraqis are blown to bits by a Fedayeen suicide bomber.
27940,12/12/2015,Pakistan,Quetta,2,5,7,Two people are killed by Taliban fundamentalists.
27941,12/12/2015,Egypt,Rafah,4,0,4,Four people are shot to death by suspected Islamists.
27942,12/12/2015,Syria,Raqqa,1,0,1,Caliphate members string up an 'apostate' and execute him on video.
27943,12/12/2015,Afghanistan,Baghlan,1,0,1,Islamic extremists assassinate a local governor.
27944,12/12/2015,Syria,Homs,16,54,70,Sixteen 'infidels' are pulled limb from limb by two ISIS suicide blasts at a hospital.
27945,13/12/2015,Nigeria,Jos,16,0,16,Muslim militia storm a village and slaughter sixteen residents.
27946,13/12/2015,Thailand,Yala,1,1,2,Militants murder an off-duty cop by planting a bomb at his mother's grave.
27947,13/12/2015,Syria,Damascus,1,3,4,A child is exterminated by a Sunni mortar round.
27948,13/12/2015,Pakistan,Parachinar,25,62,87,Two dozen people at a busy clothing market are ripped to shreds by a Lashkar-e-Jhangvi bomb blast.
27949,13/12/2015,Iraq,Aski Mosul,6,5,11,Six Kurds are laid out by ISIS car bombers.
27950,14/12/2015,Somalia,Mogadishu,1,0,1,An aid worker and father of two is senselessly shot to death by suspected al-Shabaab.
27951,14/12/2015,Syria,Damascus,2,4,6,A young girl is among the casualties of Sunni rocket attack.
27952,14/12/2015,DRC,Oicha,4,3,7,"Islamists attack a small village, killing four people before withdrawing."
27953,14/12/2015,Iraq,Kirkuk,2,2,4,Terrorists gun down two oil company workers.
27954,14/12/2015,Israel,Jerusalem,0,11,11,A baby and elderly woman are among the casualties when a Palestinian deliberately drives into a bus stop.
27955,14/12/2015,Libya,Sirte,1,0,1,A woman is beheaded by caliphate members for 'witchcraft'.
27956,14/12/2015,Iraq,Mosul,1,0,1,The Islamic State executes a teacher for refusing to teach the caliph's curriculum.
27957,14/12/2015,Iraq,Mosul,3,0,3,Three mosque imams are beheaded by Religion of Peace rivals.
27958,14/12/2015,Iraq,Shandokhah,15,0,15,Fifteen people are dragged before an ISIS firing squad.
27959,14/12/2015,Iraq,Baghdad,2,7,9,Terrorists set off a bomb near a restaurant that leaves two dead.
27960,15/12/2015,Libya,Sirte,1,0,1,"A Sharia court executed two, including a teenager who 'blasphemed'."
27961,15/12/2015,Yemen,Mas,15,20,35,Fifteen Yemenis are reported killed by Shiite radicals.
27962,15/12/2015,Yemen,Taez,7,15,22,Seven civilians are killed by Shiite militia armed with heavy weaponry.
27963,15/12/2015,Iraq,Ramadi,2,6,8,A wave of suicide car bombers manages to kill only two locals.
27964,15/12/2015,Iraq,Baghdad,2,5,7,"Jihadis set off a bomb amid a cluster of shops, killing two patrons."
27965,16/12/2015,Iraq,Sinjar,5,0,5,Five men are executed by the caliph for trading cigarettes.
27966,16/12/2015,Iraq,Kaske,6,7,13,Six Kurds are blown to bits by a Shahid suicide bomber.
27967,16/12/2015,Nigeria,Mafa,1,0,1,One other person is killed when Islamists send four child suicide bombers into a village.
27968,16/12/2015,Iraq,Bashiqa,7,4,11,An ISIS rocket claims seven lives.
27969,16/12/2015,Kenya,Mkunumbi,2,2,4,An al-Shabaab firing on a lorry leaves two dead.
27970,16/12/2015,Iraq,Abu Ghraib,6,1,7,An ISIS bomb levels six Iraqis.
27971,16/12/2015,Mali,Karena,1,0,1,A local man is marched off and executed to shouts of 'Allah Akbar'.
27972,17/12/2015,Mali,Tougue Mourrari,1,0,1,Islamists murder a local council member in cold blood.
27973,17/12/2015,Syria,Idlib,1,0,1,A journalist is shot to death by terrorists.
27974,17/12/2015,Syria,Jamla,3,0,3,Three men are doused with gas and set on fire by the Islamic State.
27975,17/12/2015,Iraq,Sinjar,10,12,22,"Caliphate members send a rocket into a small town, killing ten people."
27976,17/12/2015,Iraq,Baghdad,3,16,19,Two ISIS bomb blasts leave three dead.
27977,18/12/2015,Libya,Ajdabiya,14,25,39,Children are among the dead when al-Qaeda attack civilians.
27978,18/12/2015,Afghanistan,Kukoldash,3,0,3,Three civilians are murdered by the Taliban in front of a shop.
27979,18/12/2015,Mali,Timbuktu,3,0,3,Three broadcasters are brutally murdered outside a Christian radio station.
27980,18/12/2015,Pakistan,Karachi,1,0,1,A secular political activist is kidnapped and murdered by suspected extremists.
27981,19/12/2015,Syria,Shaddadi,4,0,4,The Islamic State stone four people to death for sexual immorality.
27982,19/12/2015,Syria,Manbij,1,0,1,A man is beheaded for apostasy after declining to attend prayers.
27983,19/12/2015,Afghanistan,Andkhoy,1,0,1,"Fundamentalists fire on an official returning from a housing project for the disabled, killing his companion."
27984,19/12/2015,Nigeria,Guba Shango,6,0,6,Suspected Boko Haram stalk and murder six workers from a construction site.
27985,19/12/2015,Saudi Arabia,Najran,3,0,3,"Shiite radicals fire a rocket at a museum, killing three civilians."
27986,19/12/2015,Somalia,Mogadishu,4,9,13,"An al-Qaeda linked group sets off a car bomb along a crowded road and then opens fire, killing four civilians."
27987,20/12/2015,Nigeria,Beneshiek,9,24,33,Nine people lose their lives when three child suicide bombers target a youth group.
27988,20/12/2015,Iraq,Hamdania,9,0,9,Three women and an elderly man are among nine members of a family exterminated in the home by Islamic State proponents.
27989,20/12/2015,Iraq,Arola,28,4,32,"A Shahid suicide bomber detonates in a small village, killing twenty-eight people around him."
27990,20/12/2015,Afghanistan,Kabul,1,0,1,A Mullah shoot an American woman to death outside her apartment.
27991,21/12/2015,Afghanistan,Bagram,6,3,9,A Fedayeen suicide bomber takes out six Americans at their base.
27992,21/12/2015,Syria,Aleppo,3,2,5,Three teenaged sisters are disassembled by a Sunni rocket.
27993,21/12/2015,Syria,Suqaylabiyah,2,33,35,At least one child is among the causalities when Sunnis bomb a Christian neighborhood.
27994,21/12/2015,Syria,Barzah,1,9,10,A civilian is taken out by a Jaish al-Islam mortar blast.
27995,21/12/2015,Kenya,Mandera,2,3,5,Two passengers are killed when Islamists board a bus and try to separate Christians for execution.
27996,21/12/2015,Pakistan,Atam,1,3,4,A civilian is laid out by an Islamic bomb blast.
27997,21/12/2015,Pakistan,Baizai,2,0,2,Two people lose their lives when militants bomb a taxi.
27998,21/12/2015,Iraq,Mosul,1,0,1,A local imam is executed by Religion of Peace rivals.
27999,22/12/2015,Iraq,Albu Diab,14,17,31,Over a dozen Iraqis are wasted by a Shahid suicide bomber.
28000,22/12/2015,Syria,Homs,3,0,3,Three men are publicly executed to chants from the Quran.
28001,22/12/2015,Syria,Damascus,3,20,23,Students are among the casualties of ISIS mortar attacks.
28002,22/12/2015,Syria,Deir al-Zor,9,20,29,Nine girls are crushed to death in their own school by targeted ISIS shelling.
28003,22/12/2015,Iraq,Mosul,17,0,17,Caliphate members execute seventeen citizens for Internet use.
28004,23/12/2015,Mali,Isseye,1,0,1,A local resident is abducted and beheaded by Sharia proponents.
28005,23/12/2015,Uganda,Nansololo,1,0,1,A pastor is beheaded by militant Muslims.
28006,23/12/2015,Iraq,Baghdad,5,18,23,Five souls are snuffed out by Jihadi bombers.
28007,23/12/2015,Iraq,Ramadi,4,0,4,A family of four is executed for trying to flee the Islamic State.
28008,23/12/2015,Syria,Deir al-Zor,11,20,31,A triple-suicide attack claims eleven lives.
28009,23/12/2015,Iraq,Khalis,4,8,12,A Sunni bomb outside an outdoor market leaves four dead.
28010,23/12/2015,Iraq,Khalis,3,10,13,"Jihadis set off a car bomb at a bus station in a Shiite town, killing three people."
28011,23/12/2015,Yemen,Dar Saad,1,0,1,A local official is assassinated by suspected al-Qaeda.
28012,23/12/2015,Pakistan,Mohmand,3,2,5,Two children ages 8 and 10 are disassembled by Taliban bombers.
28013,23/12/2015,Niger,Abadam,5,0,5,"Two attacks, one a triple suicide bombing, leaves five others dead."
28014,23/12/2015,Israel,Jerusalem,2,1,3,Two Israelis are left dead after Palestinians stab pedestrians at random.
28015,23/12/2015,Afghanistan,Nimroz,2,0,2,Two civilians are blown off a motorcycle by a Taliban roadside bomb.
28016,23/12/2015,Cameroon,Nguetchewe,2,0,2,A small girl is among two others murdered by a suicide bomber.
28017,24/12/2015,Mali,Talahandak,6,0,6,A half-dozen people are killed in a small town by an al-Qaeda linked group.
28018,24/12/2015,Somalia,Bariirey,2,0,2,Sharia activists execute two men in front of 200 people.
28019,24/12/2015,Philippines,Barangay Paitan,2,2,4,A farmer and his son are shot to death by Muslim extremists who also kidnap a woman and boy.
28020,24/12/2015,Egypt,Sinai,1,2,3,Muslim fundamentalists kill a local cop with a bomb.
28021,24/12/2015,Philippines,Mindanao,5,0,5,Bangsamoro Islamists capture and shoot five Christian farmers 'one-by-one' the day before Christmas.
28022,24/12/2015,Iraq,Baghdad,5,6,11,Five Iraqis are pulled limb from limb by a Jihadi bomb blast.
28023,24/12/2015,Iraq,Mahmoudiya,2,8,10,"Terrorists set off bombs in a residential neighborhood, killing two passersby."
28024,25/12/2015,Afghanistan,Logar,1,0,1,A community elder is assassinated by religious fundamentalists.
28025,25/12/2015,India,Shantipur,1,0,1,A Hindu trader is murdered by a Muslim gang.
28026,25/12/2015,Bangladesh,Bagmara,0,10,10,"A suicide bomber targets a rival mosque, blowing himself up amid Ahmadi worshippers."
28027,25/12/2015,Syria,al-Zahra,5,3,8,Five civilians are killed when Sunni terrorists shell a neighborhood.
28028,25/12/2015,Philippines,Sultan Kudarat,2,0,2,Two more people are murdered by Bangsamoro extremists.
28029,25/12/2015,Nigeria,Kimba,14,25,39,Islamists massacre fourteen villagers and abduct children while chanting 'Allah Akbar'.
28030,25/12/2015,Afghanistan,Logar,3,0,3,The Islamic State releases a beheading video showing the execution of three Afghans.
28031,25/12/2015,Kenya,Budhei,1,0,1,A father and husband is gunned down by al-Shabaab.
28032,25/12/2015,Mali,Azawad,4,0,4,Four security personnel are ambushed and killed while on their way to an earlier Islamist massacre.
28033,26/12/2015,Iraq,Ghazlani,19,0,19,Nineteen civilians are shot dead in cold blood by ISIS for 'waging war on Allah'.
28034,26/12/2015,Iraq,Mosul,8,0,8,Eight Sunni tribal leaders are executed by the Islamic State.
28035,26/12/2015,Philippines,Marawi,2,0,2,Two guards for a news crew are cut down in a hail of bullets from suspected ISIS sympathizers.
28036,26/12/2015,Mali,Kidal,11,0,11,Eleven people are murdered by Ansar Dine.
28037,27/12/2015,Afghanistan,Lashkar Gah,4,0,4,Four lives are claimed by a Taliban bomb blast.
28038,27/12/2015,Syria,Damascus,9,16,25,"Sunni terrorists target a refugee camp with mortars, killing nine innocents."
28039,27/12/2015,Kenya,El Wak,2,3,5,al-Shabaab ambush and kill two local security personnel.
28040,27/12/2015,Nigeria,Maiduguri,13,0,13,Ten children are among thirteen blown up by a Shahid suicide bomber.
28041,27/12/2015,Turkey,Gaziantep,1,0,1,A journalist is assassinated by ISIS operatives.
28042,28/12/2015,Iraq,Houdi,20,0,20,Twenty civilians are pulled from their homes and executed by the caliphate to 'send a message'.
28043,28/12/2015,Iraq,Shirqat,1,0,1,The Islamic State attaches explosives to and detonates a 4-year-old child by means of execution.
28044,28/12/2015,Georgia,Tbilisi,1,0,1,A 22-year-old Shiite is stabbed to death by a Salafi over 'religious hatred'.
28045,28/12/2015,Syria,Zahra,32,90,122,Thirty-two people are slaughtered when a car bombing is followed up by a suicide bomber detonating amid the survivors and rescuers.
28046,28/12/2015,Afghanistan,Kandahar,1,1,2,An elderly polio volunteer is shot to death by fundamentalists in a attack that leaves her granddaughter injured.
28047,28/12/2015,Philippines,Talipao,2,1,3,An Abu Sayyaf attack leaves two dead.
28048,28/12/2015,Afghanistan,Kabul,1,33,34,A Fedayeen suicide bomber kills one other person near a school - also injuring eighteen children.
28049,28/12/2015,Nigeria,Maiduguri,34,86,120,A series of suicide bombings leave over thirty dead.
28050,28/12/2015,Nigeria,Madagali,28,41,69,"Two suicide bombers strike a crowded fish market, obliterating over two dozen patrons."
28051,28/12/2015,Nigeria,Maiduguri,20,10,30,At least twenty are killed when suicide bombers target a rival mosque.
28052,28/12/2015,Iraq,Mosul,3,0,3,Three women are executed by Islamists using a cruel instrument known as a 'biter'.
28053,28/12/2015,Iraq,Dumez,9,5,14,Nine people lose their lives to a Fedayeen suicide bomber.
28054,29/12/2015,Pakistan,Mardan,26,50,76,Over two dozen souls are snuffed out by a violent Shahid suicide bombing.  Children were among the dead.
28055,29/12/2015,Thailand,Narathiwat,1,0,1,Muslim 'rebels' shoot an office worker three times in the head.
28056,29/12/2015,Iraq,Mosul,3,0,3,A youth is among three people decapitated by the Islamic State.
28057,29/12/2015,Iraq,Mosul,20,0,20,Twenty 'media activists' are executed by the caliphate.
28058,29/12/2015,Syria,Qamishlo,17,30,47,Two suicide blasts outside eateries in a Christian neighborhood leave seventeen dead.
28059,29/12/2015,Iraq,Mosul,2,0,2,Two teachers are executed for refusing to teach the Islamic State agenda.
28060,29/12/2015,Syria,al-Foua,1,0,1,At least one resident is killed when Sunnis shell a Shiite village.
28061,29/12/2015,Iraq,Ramadi,40,0,40,Forty members of several families are kidnapped and executed by ISIS after being lured out by Iraqi army uniforms.
28062,30/12/2015,Iraq,Aski,120,0,120,The remains of over one-hundred victims of ISIS execution are discovered in a mass grave.
28063,30/12/2015,Dagestan,Derbent,1,10,11,"ISIS claims an attack in which machine-gun fire was poured into a group of tourists, hitting eleven."
28064,31/12/2015,Egypt,Rafah,5,1,6,A 5-year-old girl is among a family of five crushed in their home by an Islamist shell.
28065,1/1/2016,Libya,Tripoli,300,0,300,Three-hundred West African migrants are reportedly rounded up by ISIS and executed.
28066,1/1/2016,Somalia,Mogadishu,1,4,5,"Islamists fire on a group of aid workers, killing one."
28067,1/1/2016,Israel,Tel Aviv,2,6,8,"An Arab terrorist carrying a Quran fires into bars and restaurants, killing two innocents."
28068,1/1/2016,Afghanistan,Kabul,2,15,17,"A suicide bomber strikes a French restaurant, killing two patrons, including a 12-year-old boy."
28069,1/1/2016,Israel,Tel Aviv,1,0,1,A taxi driver is shot to death by a Palestinian terrorist.
28070,1/1/2016,Syria,Deir ez-Sor,1,0,1,A 15-year-old boy is thrown to his death from a roof by Sharia enthusiasts for 'being gay'.
28071,1/1/2016,Iraq,Ramadi,12,0,12,The bodies of twelve civilian victims of ISIS executions are discovered.
28072,1/1/2016,Iraq,Ramadi,3,17,20,Ten ISIS suicide bombers manage to kill only three other people.
28073,1/1/2016,France,Valence,0,2,2,Two other people are injured when a Muslim deliberately rams French guards outside a mosque.
28074,2/1/2016,India,Pathankot,7,0,7,Jaish-e-Mohammad stage a suicide attack on an Indian air base that leaves seven others dead.
28075,2/1/2016,Somalia,Mogadishu,3,0,3,"Sharia proponents throw grenades into a police station, killing three occupants."
28076,2/1/2016,Syria,Raqqa,1,0,1,A female activist is executed by the caliphate.
28077,3/1/2016,Saudi Arabia,Awamiya,1,1,2,"Shiite radicals open fire on the home of a Sunni, killing him and wounding an 8-year-old child."
28078,3/1/2016,Iraq,Mosul,3,0,3,Three university students are executed in cold blood by ISIS.
28079,3/1/2016,Pakistan,Naushero Feroz,1,0,1,A conservative family has a younger brother shoot a daughter to death for marrying without their permission.
28080,3/1/2016,Iraq,Tikrit,19,22,41,ISIS suicide bombers kill nineteen Iraqis.
28081,3/1/2016,Syria,Raqqa,5,0,5,Five British 'kuffar' are executed by the Islamic State.
28082,3/1/2016,Somalia,Mogadishu,1,3,4,A suicide bomber kills one other person at a restaurant.
28083,3/1/2016,Syria,Raqqa,15,0,15,Fifteen 'moderates' are beheaded by caliphate members.
28084,4/1/2016,Iraq,Ramadi,40,0,40,A mass grave containing forty ISIS execution victims is discovered.
28085,4/1/2016,Yemen,Hadramawt,1,0,1,Fundamentalists put an alleged prostitute in the ground and stone her to death.
28086,4/1/2016,Syria,Raqqa,1,0,1,A man is beheaded by a Sharia court on charges of 'apostasy'.
28087,4/1/2016,Nigeria,Gwoza,26,10,36,"Over two dozen villagers are massacred by Islamists disguised as soldiers, who opened fire after luring the victims from their homes."
28088,4/1/2016,Iraq,Haditha,11,30,41,At least eleven Iraqis are laid out by a Fedayeen suicide bomber.
28089,4/1/2016,Yemen,Aden,1,0,1,A Sufi imam is assassinated by Sunni extremists while leaving his mosque.
28090,4/1/2016,Afghanistan,Kabul,1,20,21,One other person is killed by a Shahid suicide bomber at a hotel entrance.
28091,4/1/2016,Afghanistan,Dasht-e-Asfandi,5,0,5,Five Afghans are pulled from a bus and murdered by the Taliban.
28092,4/1/2016,Nigeria,Udeni Ruwa,8,0,8,At least eight others are killed when Muslim terrorists attack two villages.
28093,4/1/2016,Libya,al-Sidra,2,16,18,Two others are killed by suicide car bombers at a oil port.
28094,4/1/2016,Iraq,Iskandariya,1,0,1,A Sunni cleric is shot to death in a targeted attack by Shia rivals.
28095,4/1/2016,Iraq,Hillah,1,0,1,Shiite radicals attack a Sunni mosque and kill a guard.
28096,5/1/2016,Pakistan,Bahawalnagar,1,0,1,"A 7-year-old Christian boy is kidnapped, raped and killed by 'influential' Muslims."
28097,5/1/2016,Libya,al-Sidra,7,25,32,Seven more oil port guards are killed during an attack by ISIS militants.
28098,5/1/2016,Nigeria,Borno,7,12,19,"A suicide bomber detonates at a market, slaughtering seven bystanders."
28099,5/1/2016,Nigeria,Izgeki,2,0,2,Two people are riddled with bullets by Boko Haram on bicycles.
28100,5/1/2016,Afghanistan,Samangan,1,0,1,A peace activist is gunned down by suspected Taliban.
28101,5/1/2016,Egypt,Sinai,4,0,4,ISIS-linked terrorists fire a rocket that claims four lives.
28102,5/1/2016,Syria,Manbij,1,0,1,A 21-year-old woman is tortured to death by a female fundamentalist for a dress code violation.
28103,6/1/2016,Syria,Raqqa,1,0,1,A35-year-old woman is put up against a wall and shot to death by ISIS.
28104,6/1/2016,Syria,Damascus,8,4,12,Eight civilians bleed out following a Jaish al-Islam mortar hit on their neighborhood.
28105,6/1/2016,Iraq,Dawra,2,7,9,Two civilians are liquidated along a city street by Muslim bombers.
28106,7/1/2016,Nigeria,Maiduguri,1,0,1,A displaced person is beheaded by suspected Boko Haram
28107,7/1/2016,Somalia,Mogadishu,1,1,2,An al-Shabaab mortar leaves one civilian dead and another seriously wounded.
28108,7/1/2016,Libya,Zliten,65,200,265,A massive suicide truck bomb at a police training facility kills dozens of young recruits during their graduation ceremony.
28109,7/1/2016,USA,"Philadelphia, PA",0,1,1,A man shoots a police officer three times 'in the name of Islam'.
28110,7/1/2016,Egypt,Hurghada,0,3,3,Three tourists are among the casualties of a suicide attack on a hotel.
28111,7/1/2016,Pakistan,Shaktoi,4,0,4,Four displaced refugees are murdered by Taliban gunmen.
28112,7/1/2016,Iraq,Mosul,6,0,6,Six Iraqis are shot to death by caliphate members for using the Internet on their phones.
28113,7/1/2016,Libya,Ras,7,11,18,A Shahid suicide bomber at an oil facility takes seven others with him.
28114,7/1/2016,Bangladesh,Jhenaidah,1,0,1,A convert to Christianity is 'eliminated' by devout Muslims for leaving Islam.
28115,8/1/2016,Afghanistan,Nangarhar,7,0,7,A local soldier is among seven people beheaded by ISIS.
28116,8/1/2016,Syria,Raqqa,1,0,1,A woman is publicly executed her own son on charges of leaving the Islamic faith.
28117,8/1/2016,Iraq,Mosul,3,0,3,Three university students are executed by the Islamic State.
28118,8/1/2016,Iraq,Zummar,16,3,19,Well-placed ISIS shells kill sixteen Iraqis in a residential neighborhood.
28119,8/1/2016,Lebanon,Arsal,1,0,1,"Masked terrorists fire on a married couple, killing the man and injuring his wife."
28120,8/1/2016,Pakistan,Gulshan-e-noor,1,0,1,A 45-year-old man is murdered for no reason than his status as a Shiite.
28121,8/1/2016,Iraq,Haditha,18,7,25,Eighteen Iraqis are blown to bits by a caliphate suicide bomber.
28122,9/1/2016,Iraq,Jbala,3,2,5,"Sectarian militia storm a home and shoot three people to death, including a woman."
28123,9/1/2016,Iraq,Ghazlani,80,0,80,Eighty Iraqi civilians are executed by an Islamic State firing squad.
28124,9/1/2016,Egypt,Giza,2,0,2,Two local cops are gunned down by ISIS.
28125,9/1/2016,Syria,Deir ez-Zor,2,0,2,Two fathers are executed for not allowing their teen daughters to be married off to caliphate members.
28126,9/1/2016,Pakistan,Rahim Yar Khan,2,0,2,Two women are 'honor-killed' by their families for alleged sexual behavior.
28127,10/1/2016,Nigeria,Madagali,7,0,7,Seven villagers are beheaded by Sharia proponents.
28128,10/1/2016,Syria,Faisaliyah,5,0,5,The Islamic State lines up and crushes five civilians under a bulldozer for the crime of 'apostasy'
28129,11/1/2016,Afghanistan,Mirzakhil,3,2,5,"The Taliban set off a bomb near a school, killing two bystanders."
28130,11/1/2016,Iraq,Baghdad,7,15,22,An ISIS bomb blast leaves seven suburbanites dead.
28131,11/1/2016,France,Marseille,0,1,1,A Jewish teacher is attacked with a machete 'in the name of Allah.'
28132,11/1/2016,Iraq,Baghdad,18,50,68,"Religious radicals stage a suicide assault on a shopping mall, killing at least eighteen innocents with bombs and bullets."
28133,11/1/2016,Afghanistan,Khost,3,8,11,"Fundamentalists fire a rocket into a secondary school, killing three pupils."
28134,11/1/2016,Syria,Aleppo,3,2,5,Three children are disassembled by a Sunni rocket.
28135,11/1/2016,Iraq,Muqdadiya,23,51,74,Two dozen Iraqis are torn limb from limb by a couple of well-placed bombs at a crowded coffee shop.
28136,11/1/2016,Iraq,Nineveh,85,0,85,Eighty-five Iraqis are arrested and executed by caliphate firing squads.
28137,11/1/2016,Pakistan,Rabwa,1,0,1,A religious minority is brutally slain by suspected Islamists.
28138,11/1/2016,Pakistan,Derai,2,0,2,Two local cops are shot to death by religious radicals.
28139,12/1/2016,Israel,Nazareth,1,0,1,A man honor kills his teen sister over clothing and 'lifestyle' by beating her to death with a hammer.
28140,12/1/2016,Iraq,Muqdadiya,10,0,10,Ten people are shot to death by sectarian militia.
28141,12/1/2016,Iraq,Diyala,2,0,2,Two journalists are shot to death by terrorists.
28142,12/1/2016,Turkey,Istanbul,12,14,26,"A Syrian 'refugee' with a suicide vest self-detonates in a bustling tourist area, slaughtering a dozen bystanders, including eight Germans."
28143,12/1/2016,Iraq,Baqubah,4,1,5,A Fedayeen suicide bomber takes out four Iraqis.
28144,13/1/2016,Pakistan,Jalalabad,7,7,14,Seven other people are blown to bits by a Fedayeen suicide bombing.
28145,13/1/2016,Pakistan,Quetta,15,24,39,A Shahid suicide bomber slaughters fifteen people at a polio clinic.
28146,13/1/2016,Cameroon,Kolofata,10,11,21,"Two female suicide bombers detonate at a rival mosque, taking out ten worshippers."
28147,13/1/2016,Pakistan,Lahore,1,1,2,A 17-year-old girl is killed after telling a group of Muslim men that she would not have sex with them because she is a devout Christian.
28148,13/1/2016,Iraq,Abu Ghraib,6,0,6,Five women and 1 man are slaughtered in their own home by suspected moral fundamentalists.
28149,13/1/2016,Thailand,Yala,2,1,3,Muslim 'insurgents' ambush and kill a local cop as well as a maid.
28150,13/1/2016,Iraq,Baghdad,2,6,8,Two people at a market are sectionalized by a Religion of Peace bomb blast.
28151,13/1/2016,Afghanistan,Badghis,1,0,1,A man is executed by the Taliban on charges of adultery.
28152,14/1/2016,Indonesia,Jakarta,4,20,24,"Four suicide bombers attack a shopping and restaurant district, managing to kill four civilians."
28153,14/1/2016,Yemen,Aden,4,0,4,Four policemen are killed by Jihadists in two separate attacks.
28154,15/1/2016,Iraq,Mosul,3,0,3,Three women are burned alive by the Islamic State.
28155,15/1/2016,Syria,Hasakah,2,6,8,A suicide bomber takes out two bystanders in a residential neighborhood.
28156,15/1/2016,Burkina Faso,Ouagadougou,29,56,85,Dozens of tourists from eighteen countries are massacred by Islamic extremists shouting praises to Allah at a luxury hotel.
28157,15/1/2016,Mali,Timbuktu,2,3,5,Two guards are killed when terrorists ambush an aid convoy.
28158,15/1/2016,Somalia,El-Adde,180,20,200,Somalia claims over one-hundred-eighty peacekeepers were taken out by a massive suicide assault on their base.
28159,15/1/2016,Iraq,Muqdadiya,1,0,1,A Sunni cleric is assassinated by Shia militia.
28160,15/1/2016,Libya,Bin Jawad,3,0,3,At least three residents are beheaded after Muslim extremists take over a town.
28161,15/1/2016,Mali,Dioura,1,0,1,"A guard is killed when gunmen attack a market, shouting praises to Allah."
28162,16/1/2016,Iraq,Mosul,3,0,3,Three women are burned alive on charges of betraying Islam.
28163,16/1/2016,Syria,al-Fu'ah,1,5,6,A civilian is dismantled by a terrorist rocket.
28164,16/1/2016,Syria,Aleppo,4,55,59,Four residents bleed out following a Sunni rocket attack.
28165,16/1/2016,Somalia,Burhakabo,2,0,2,A young ice factory worker is among two people executed by al-Shabaab.
28166,16/1/2016,Syria,Baghaliyeh,300,400,700,Three hundred people are reported massacred during an ISIS assault on a small town featuring a suicide blast and 'door-to-door' beheadings.
28167,16/1/2016,Iraq,Hajj Ali,19,0,19,Nineteen civilians are executed for trying to flee the Islamic State.
28168,16/1/2016,Iraq,al-Furat,1,0,1,An accused homosexual is flung from a roof by Religion of Peace proponents.
28169,17/1/2016,Israel,Otniel,1,0,1,A mother of six children is stabbed to death in her home by an Arab terrorist.
28170,17/1/2016,Afghanistan,Uruzgan,9,0,9,Nine local police are shot dead by Taliban insiders.
28171,17/1/2016,Yemen,Aden,11,15,26,"A Fedayeen suicide bomber rams a bus into the home of a policeman, killing eleven."
28172,17/1/2016,Afghanistan,Jalalabad,13,14,27,"A Shahid suicide bomber detonates at a house, killing thirteen occupants."
28173,18/1/2016,Cameroon,Nguetchewe,4,2,6,"A suicide bomber hits a rival mosque, taking out four worshippers."
28174,18/1/2016,Turkey,Kilis,1,1,2,An employee is killed when ISIS hits a school with a rocket.
28175,18/1/2016,Yemen,Aden,1,0,1,A judge is assassinated near his home by Islamists on a motorbike.
28176,18/1/2016,Thailand,Thepa,1,7,8,A woman is killed when suspected terrorists toss a hand grenade into a restaurant.
28177,18/1/2016,Thailand,Raman,2,0,2,A married couple are shot to death by Muslim terrorists.
28178,19/1/2016,Syria,Raqqa,1,0,1,A woman is stoned to death for adultery.
28179,19/1/2016,Pakistan,Jamrud,12,39,51,"Twelve people at a market, including a child, are blown to bits by a Fedayeen suicide bomber."
28180,19/1/2016,Thailand,Songkhla,1,8,9,Muslim 'insurgents' set off a bomb at a restaurant that kills a 28-year-old woman.
28181,19/1/2016,Iraq,Mopti,3,0,3,Jihadists gun down three local cops.
28182,19/1/2016,Iraq,Baqubah,14,0,14,Fourteen young people are tortured and executed by the Islamic State.
28183,20/1/2016,Pakistan,Charsadda,31,19,50,Gunmen storm a university and shout praises to Allah while massacring over thirty civilians.
28184,20/1/2016,Afghanistan,Kabul,7,24,31,Seven TV station employees burn to death after a Shahid suicide bomber slams into their minibus.
28185,20/1/2016,Iraq,Baghdad,2,5,7,"Jihadis bomb a market, killing two patrons."
28186,21/1/2016,Somalia,Mogadishu,20,20,40,Gunmen shout praises to Allah as they slaughter patrons at a beach-side restaurant during an attack that began with a suicide bombing.
28187,21/1/2016,Egypt,Giza,10,13,23,ISIS claims a bombing at a tourist area that leaves ten others dead.
28188,21/1/2016,Egypt,El-Arish,5,3,8,Islamists roll up on a police checkpoint and shoot five officers point-blank.
28189,21/1/2016,Iraq,Hamamiyat,3,7,10,Mujahideen set off a bomb in a village that leaves three dead.
28190,21/1/2016,Iraq,Baghdad,4,15,19,Three bombings and a shooting produce four dead civilians.
28191,21/1/2016,Iraq,Baghdad,2,5,7,"Jihadis bomb a commercial district, killing two bystanders."
28192,21/1/2016,Iraq,Baghdad,2,6,8,Two people lose their lives when terrorists set off a bomb at a popular restaurant.
28193,21/1/2016,Libya,sirte,3,0,3,Three men are executed for apostasy.
28194,23/1/2016,Syria,Wafidin,3,7,10,Women and children are among the casualties of a Jaish al-Islam rocket attack.
28195,23/1/2016,Afghanistan,Jalalabad,2,2,4,Two others are killed when two suicide bombers detonate near the Indian consulate.
28196,23/1/2016,Pakistan,Peshawar,2,0,2,Militants gun down two policemen.
28197,23/1/2016,Pakistan,Bhal Syeda,1,0,1,A Shiite is beheaded by radical Sunnis
28198,23/1/2016,Iraq,Hit,1,0,1,A civilian is murdered for trying to help families escape the Islamic State.
28199,23/1/2016,Iraq,Kilo,43,0,43,Fort-three local police officer are reportedly killed by a Shahid suicide bomber.
28200,23/1/2016,Iraq,Tal Msheihda,5,11,16,Five Iraqis are taken out by a Fedayeen suicide bomber.
28201,23/1/2016,Iraq,Fallujah,10,0,10,Ten young boys are summarily executed for attempting to escape the caliphate.
28202,24/1/2016,Nigeria,Girei,62,0,62,"Muslim terrorists raid six villages and slaughter over sixty innocents, most of which are women and children."
28203,24/1/2016,Syria,Qamishli,3,10,13,Three Christians are killed in a targeted bomb attack on their restaurant.
28204,24/1/2016,Nigeria,Babangida,1,0,1,An elderly man is killed by Boko Haram as they are burning down his home.
28205,24/1/2016,Egypt,Kafr Keshk,3,4,7,"Islamists fire on a group of villagers, killing three."
28206,24/1/2016,Yemen,Mansura,5,0,5,A woman is among five people shot to death by suspected al-Qaeda.
28207,25/1/2016,Syria,Deir al-Zour,5,6,11,ISIS members kill five citizens with a rocket.
28208,25/1/2016,Cameroon,Bodo,32,86,118,Dozens of shoppers are torn to shreds when three suicide bombers detonate at entrances to a market.
28209,25/1/2016,Afghanistan,Spin Boldak,3,3,6,Five suicide bombers manage to take out three border guards.
28210,25/1/2016,Israel,Beit Horon,1,1,2,Two women are stabbed in a grocery by Palestinian terrorists.
28211,25/1/2016,Syria,Aleppo,23,24,47,Two dozen people are blown up by a suicide bomber in a fuel truck.
28212,25/1/2016,Syria,Raqqa,1,0,1,A man is beheaded for refusing to pray at the local mosque.
28213,25/1/2016,Iraq,Ramadi,40,0,40,About forty victims of ISIS executions are found in a mass grave.
28214,26/1/2016,Afghanistan,Chinarto,10,0,10,A Taliban infiltrator drugs and murders ten local cops.
28215,26/1/2016,Syria,Homs,25,100,125,Twenty-five people are laid out by an ISIS suicide bombing in a commercial district.
28216,26/1/2016,Iraq,Ramadi,55,0,55,Over fifty Iraqis are reportedly killed in two suicide bombings.
28217,26/1/2016,Syria,Manbij,1,0,1,A local media activist is beheaded by the Islamic State.
28218,26/1/2016,Pakistan,Safi,1,0,1,The body of a peace committee member is found a few days after his abduction by fundamentalists.
28219,26/1/2016,Kenya,Lamu,5,2,7,al-Shabaab ambush and murder five local cops.
28220,26/1/2016,Iraq,Hamamiyat,2,8,10,Mujahideen set off a bomb that claims two lives.
28221,27/1/2016,Sweden,Tanum,1,0,1,A 60-year-old man is stabbed to death by one of his employees after being accused of 'Islamophobia'…
28222,27/1/2016,Uganda,Numuseru,1,0,1,A Christian convert is murdered after being threatened by an imam.
28223,27/1/2016,Afghanistan,Gerishk,4,0,4,Four members of a crew working to clear landmines are shot dead by the Taliban.
28224,27/1/2016,Egypt,al-Arish,4,12,16,Ansar Beit al-Maqdis members set off an IED that takes the live of four policemen.
28225,27/1/2016,Iraq,al-Baghdadi,4,10,14,A series of suicide attacks on a guesthouse leave four others dead.
28226,27/1/2016,Nigeria,Chibok,16,32,48,Suicide bombers send shrapnel through sixteen innocents at a vegetable market in a Christian town.
28227,28/1/2016,Yemen,Aden,11,10,21,"A Fedayeen suicide car bombing kills eleven, including two children."
28228,28/1/2016,Mali,Gao,4,3,7,Four security personnel are killed in two separate attacks.
28229,28/1/2016,Cameroon,Kerawa,4,12,16,Two suicide bombers murder four people at a school.
28230,28/1/2016,Pakistan,Quetta,4,0,4,The Taliban gun down four traffic cops.
28231,28/1/2016,Egypt,Rafah,6,12,18,Four children and two security personnel are killed in a bombing and clash with Islamic militants.
28232,28/1/2016,Iraq,Baghdad,2,9,11,"Jihadis bomb a popular market, killing two patrons."
28233,29/1/2016,Egypt,al-Arish,2,7,9,An bomb planted by extremists near a school leaves two dead.
28234,29/1/2016,Saudi Arabia,Mahasen,5,36,41,"Religion of Peace rivals attack a Shiite mosque with a suicide bombing and gunfire, killing five worshippers."
28235,29/1/2016,Afghanistan,Nangarhar,1,0,1,A journalist is shot to death by ISIS.
28236,29/1/2016,Pakistan,Regi,1,0,1,A polio worker is murdered by fundamentalists.
28237,29/1/2016,Nigeria,Adamawa,10,28,38,"A young suicide bomber detonates at a busy market near a church, taking out ten innocents."
28238,29/1/2016,Syria,Deir Ezzor,3,3,6,Three children are disassembled by an ISIS rocket.
28239,29/1/2016,Yemen,Aden,7,7,14,Seven people are shredded by a Shahid suicide bomber.
28240,30/1/2016,Iraq,Shirqat,3,0,3,Three children are reportedly executed for insulting ISIS.
28241,30/1/2016,Iraq,Hadher,17,0,17,"Seventeen members of two families, including woman and young children, are beheaded by caliphate members."
28242,30/1/2016,Syria,Jarablus,1,0,1,A 14-year-old boy is beheaded on charges of apostasy after missing prayers.
28243,30/1/2016,Iraq,Saladin,1,0,1,A Shiite is beheaded on video by Sunni radicals.
28244,30/1/2016,Afghanistan,Sarkano,3,2,5,The Taliban uses a roadside bomb to kill three Afghans.
28245,30/1/2016,Yemen,Lahj,3,1,4,An ISIS gunmen takes down three targets.
28246,30/1/2016,Nigeria,Dalori,86,62,148,Children are among eighty-six souls horribly burned to death by Boko Haram.
28247,30/1/2016,Afghanistan,Sarkanu,4,3,7,A bomb planted by Islamists takes the lives of four people.
28248,30/1/2016,Kenya,Pandanguo,3,1,4,Islamists murder three men in a fishing village.
28249,31/1/2016,Yemen,Aden,1,0,1,A cleric who opposed extremism is tortured to death.
28250,31/1/2016,Saudi Arabia,Qatif,2,0,2,Two guards are killed by terrorists.
28251,31/1/2016,Chad,Miterine,4,24,28,Four children playing soccer are killed after being deliberately targeted by two suicide bombers.
28252,31/1/2016,Chad,Guie,1,32,33,A suicide bomber on a motorcycle kills one other person.
28253,31/1/2016,Saudi Arabia,Najran,1,9,10,An 11-year-old boy is killed when suspected Shiite militia hit his house with a rocket.
28254,31/1/2016,Egypt,Rafah,2,4,6,Two more security personnel are killed by a homemade bomb planted by Sharia proponents.
28255,31/1/2016,Syria,Sayeda Zeinab,71,110,181,Five children are among seventy Shiite worshippers exterminated outside their mosque by two Fedayeen suicide bombers.
28256,31/1/2016,Kenya,Kaisari,4,1,5,"Militant Muslims raid a Christian village and kill four innocents, one of whom is beheaded and the other burned inside his home."
28257,31/1/2016,Iraq,Mosul,4,0,4,Four Kurdish civilians are forced to their knees and executed by the Islamic State.
28258,31/1/2016,Iraq,Khazir,8,6,14,An ISIS attack produces eight dead Kurds.
28259,31/1/2016,Egypt,Sheikh Zuwaid,2,0,2,Two more people are killed by Islamist bombers.
28260,1/2/2016,Iraq,Hit,7,5,12,Children are among those eliminated by two Mujahideen bomb blasts.
28261,1/2/2016,Syria,Manbij,3,0,3,Three brothers are beheaded by the Islamic State.
28262,1/2/2016,Somalia,Mogadishu,1,6,7,A child is sectionalized by an al-Shabaab mortar round.
28263,1/2/2016,Iraq,Anbar,1,0,1,"An elderly man is beheaded for ""disobeying"" the caliphate."
28264,1/2/2016,Afghanistan,Kabul,20,29,49,Twenty people are reported dead in the aftermath of a Fedayeen suicide bombing.
28265,2/2/2016,Somalia,Mogadishu,0,2,2,"A suicide bomber detonates on a plane, but manages to kill only himself."
28266,2/2/2016,Iraq,Baghdad,6,27,33,A half-dozen Iraqis lose their lives to a series of Mujahideen bomb blasts.
28267,2/2/2016,Thailand,Narathiwat,1,1,2,An off-duty cop is shot to death in front of his wife by Muslim 'insurgents.'
28268,2/2/2016,Iraq,Al-Bu Dhiaab,18,0,18,Eighteen Iraqis are reportedly slain by three ISIS suicide bombers.
28269,2/2/2016,Nigeria,Goniambari,6,1,7,Islamists slaughter six villagers.
28270,2/2/2016,Iraq,Madain,2,9,11,"Terrorists set off a bomb near a café, killing two bystanders."
28271,3/2/2016,Libya,Sirte,1,0,1,Islamic State members capture and crucify a young man.
28272,3/2/2016,Iraq,Ramadi,13,0,13,ISIS shelling produces thirteen dead Iraqis.
28273,3/2/2016,Iraq,Hawija,2,0,2,Two people are shot to death for trying to escape the caliphate.
28274,3/2/2016,Syria,Daraa,17,101,118,Seventeen civilians are smashed to bits by a Sunni rocket barrage.
28275,3/2/2016,Israel,Jerusalem,1,2,3,A 19-year-old woman bleeds out following a Palestinian shooting and stabbing spree.
28276,3/2/2016,Afghanistan,Tirin Kot,1,0,1,A 10-year-old boy is cut down in a targeted attack by Taliban gunmen.
28277,3/2/2016,Iraq,Mosul,12,0,12,A dozen university students are executed by the Islamic State.
28278,3/2/2016,Libya,Benghazi,3,13,16,An ISIS assault on a small town leaves three defenders dead.
28279,4/2/2016,Yemen,Hadramaut,6,0,6,An ISIS video shows members opening fire on a busy market and beheading four 'apostates.'
28280,4/2/2016,Syria,Raqqa,1,0,1,A child invokes the name of Allah before beheading a 'kafir'.
28281,4/2/2016,Mali,Timbuktu,1,3,4,A suicide bombing at a UN camp kills a guard.
28282,4/2/2016,Iraq,Baghdad,9,33,42,Nine people are left dead after a string of bombings by Muslim terrorists.
28283,5/2/2016,Syria,Aleppo,35,24,59,Thirty-five Syrians are reportedly killed in two ISIS suicide car bombings.
28284,5/2/2016,Somalia,Mogadishu,3,0,3,A woman is among three people incinerated by a car bombing outside a pharmacy.
28285,5/2/2016,Afghanistan,Zanu,1,0,1,A woman is executed after being accused of adultery.
28286,6/2/2016,Nigeria,Zamfara,23,10,33,"Boko Haram stages a two-hour assault on a village, firing indiscriminately and killing dozens of people."
28287,6/2/2016,Nigeria,Konduga,4,0,4,"Boko Haram rampage through two villages, burning homes and killing four innocents."
28288,6/2/2016,Iraq,Fallujah,14,0,14,A suicide bomber murders fourteen Iraqis.
28289,6/2/2016,Iraq,Baghdadi,9,16,25,A Fedayeen suicide attack leaves nine others dead.
28290,6/2/2016,Pakistan,Quetta,10,35,45,A child and woman are obliterated along with eight others by a suicide bomber.
28291,7/2/2016,Israel,Rahat,0,1,1,An elderly Jewish woman is stabbed in the neck by a young Palestinian man.
28292,7/2/2016,Afghanistan,Logar,1,8,9,Taliban bombers pick off a man on his way to work.
28293,7/2/2016,Mali,Boni,1,0,1,A civilian is murdered by Islamists.
28294,7/2/2016,Afghanistan,Kunar,3,0,3,Three polio workers are found murdered by suspected fundamentalists.
28295,7/2/2016,Iraq,Baghdad,3,0,3,"A sectarian militia murders three civilians, including an 8-year-old boy."
28296,7/2/2016,Iraq,Baghdad,7,22,29,Mujahid bombers eliminate seven Iraqis with four bombs.
28297,8/2/2016,Iraq,Hammam al-Alil,14,0,14,Fourteen people are summarily executed by ISIS at a college.
28298,8/2/2016,Iraq,Mosul,4,0,4,Four youth are flung from a roof by caliphate enforcers.
28299,8/2/2016,Bangladesh,Gobindaganj,1,0,1,Police find the beheaded body of a Hindu trader.
28300,8/2/2016,Pakistan,Peshawar,1,1,2,A Shiite elder is shot to death in front of his son by sectarian Jihadis.
28301,8/2/2016,Pakistan,Havid,2,0,2,A terrorist bomb blast outside a shop leaves the owner and a rickshaw driver dead.
28302,8/2/2016,Iraq,Mosul,300,0,300,"At least three-hundred people are reported executed by the Islamic State, including activists."
28303,8/2/2016,Iraq,Albu Diab,15,0,15,Victim victims of ISIS execution are discovered in a mass grave.
28304,8/2/2016,Afghanistan,Dehdadi,3,14,17,"A suicide bomber attacks a bus, killing at least three others."
28305,8/2/2016,Afghanistan,Yahyakhil,6,9,15,Six people are massacred by a suicide bomber outside a bakery shop.
28306,8/2/2016,Syria,Hasakah,9,4,13,Nine corpses are counted after an ISIS Shahid suicide bombing.
28307,9/2/2016,Syria,Damascus,8,20,28,A Fedayeen suicide car bomber sends eight civilians straight to Allah.
28308,9/2/2016,Egypt,Sinai,1,3,4,"Fundementalists fire on a group of police, killing one."
28309,9/2/2016,Iraq,Mosul,1,0,1,A journalist is executed by a  caliphate firing squad for taking pictures.
28310,9/2/2016,Iraq,Mosul,1,0,1,A female bank employee is put against a wall and shot to death by caliphate members.
28311,10/2/2016,Somalia,Jameo Mubarac,1,0,1,A cleric is beheaded by Religion of Peace rivals.
28312,10/2/2016,Nigeria,Dikwa,60,78,138,"Sixty refugees at a displaced persons camp, including women and children, are massacred by two female suicide bombers."
28313,10/2/2016,Cameroon,Nguetchewe,6,30,36,"Two female suicide bombers detonate during a funeral wake, killing six mourners, including two children."
28314,10/2/2016,Afghanistan,Abdul Rauf,5,7,12,Two religious radicals gun down five local cops at dinner.
28315,10/2/2016,Iraq,Taji,3,9,12,Three Iraqis are disintegrated by a shrapnel blast.
28316,10/2/2016,Iraq,Wafa,2,5,7,At least two others are killed during a Shahid sucide attack.
28317,11/2/2016,Yemen,Aden,3,0,3,Jihadists kill three security personnel.
28318,11/2/2016,Mali,Mopti,3,0,3,Islamic militants shoot three people to death.
28319,11/2/2016,Iraq,Mosul,4,0,4,Four women are stoned to death for adultery - after having been raped.
28320,11/2/2016,USA,"Columbus, OH",0,4,4,Four people at a Christian-owned restaurant with an Israeli flag are slashed by a Muslim wielding a machete yelling 'Allah Akbar'…
28321,12/2/2016,Pakistan,Takht-e-Nusrati,1,2,3,A dispute between clerics at a mosque is settled with gunfire that leaves one of them dead.
28322,12/2/2016,Thailand,Yala,1,1,2,Muslim bombers pick off a guard for a group of teachers.
28323,12/2/2016,Yemen,Aden,5,0,5,al-Qaeda gunmen sneak up on a police post and murder five officers.
28324,12/2/2016,Nigeria,Kachifa,8,0,8,Boko Haram murder eight villagers and kidnap a number of women and children.
28325,12/2/2016,Iraq,Makhmour,1,11,12,A 3-year-old girl is killed while trying to escape the caliphate with her family.
28326,12/2/2016,Mali,Kidal,5,30,35,"Ansar Dine members lob shells into a UN camp, killing five guards."
28327,13/2/2016,Syria,Sfeira,2,5,7,Two children are disassembled by an ISIS rocket.
28328,13/2/2016,Pakistan,Islamabad,1,2,3,A traffic cop is picked off by Islamic State gunmen.
28329,13/2/2016,Afghanistan,Helmand,5,7,12,Five Afghans are left dead following a double-suicide attack.
28330,13/2/2016,Iraq,Mahmoudiya,2,7,9,"Mujahideen set off a bomb at a market, killing two patrons."
28331,13/2/2016,Iraq,Tarmiya,5,5,10,"A vicious double-bombing kills five people overall, including first responders."
28332,13/2/2016,Egypt,Sinai,2,1,3,An ISIS bomb kills two sappers.
28333,13/2/2016,Thailand,Narathiwat,1,0,1,A truck driver is executed in cold blood by Muslim 'insurgents'.
28334,13/2/2016,Nigeria,Yakshari,22,0,22,Islamists sneak into a village and slit the throats of twenty-two innocents.
28335,14/2/2016,India,Chowkibal,2,2,4,Two members are killed when Lashkar-e-Toiba militants open fire on a security patrol.
28336,14/2/2016,Syria,Mrat,100,0,100,A mass grave containing the victims of about 100 ISIS victims (including children) is discovered.
28337,14/2/2016,Nigeria,Abbi,2,19,21,Fulani terrorists attack a Christian community and hack a brother and sister to death.
28338,14/2/2016,Iraq,Faisaliah,8,0,8,The Islamic State drowns eight prisoners by herding them into a metal cage and then dipping it into a lake.
28339,14/2/2016,Iraq,Mosul,2,0,2,Two young men are shot to death for 'apostasy' after missing prayers.
28340,15/2/2016,Saudi Arabia,Abu Arish,1,0,1,A retired man is shot to death on his farm by the Islamic State.
28341,15/2/2016,Dagestan,Makhachkala,3,2,5,Fedayeen suicide bombers take out three other people.
28342,15/2/2016,Afghanistan,Pul-e-Momin,2,7,9,"Armed fundamentalists attack a security post, killing two members."
28343,15/2/2016,Somalia,Mogadishu,1,1,2,A government official is assassinated by Jihadi car bombers.
28344,15/2/2016,Nigeria,Kuda,6,20,26,"Boko Haram invade a village and fire at fleeing residents, killing six."
28345,15/2/2016,Afghanistan,Jalalabad,1,0,1,Radicals are suspected of gunning down a rival religious scholar.
28346,15/2/2016,Iraq,Hawija,5,0,5,Five civilians are executed for trying to escape the caliphate.
28347,15/2/2016,Iraq,Tarmiya,3,8,11,Three patrons at a popular market are sectionalized by a Jihadi bomb blast.
28348,15/2/2016,Iraq,Nineveh,1,0,1,A man is beheaded for 'insulting Allah'.
28349,16/2/2016,Philippines,Datu Salibo,4,2,6,A father and son are among four people bleeding to death in the aftermath of an Islamist roadside blast.
28350,16/2/2016,Iraq,Ramadi,40,0,40,Children are among forty victims of ISIS execution found in a mass grave.
28351,16/2/2016,Iraq,Mosul,1,0,1,A 15-year-old is beheaded for listening to Western pop music.
28352,17/2/2016,Yemen,Aden,13,60,73,Thirteen recruits at a military camp are wiped out by a Fedayeen suicide bombing.
28353,17/2/2016,Thailand,Narathiwat,1,1,2,"Bombers target a group of teachers, killing a guard."
28354,17/2/2016,Iraq,Nineveh,3,0,3,Three civilians are executed for refusing to join the Islamic State.
28355,17/2/2016,Egypt,Giza,1,2,3,Islamists gun down a traffic cop.
28356,18/2/2016,Syria,Aleppo,1,0,1,A priest is reportedly beheaded for offering prayers at the altar of his church.
28357,18/2/2016,England,Rochdale,1,0,1,A popular imam is beaten to death by Muslims with terror ties.
28358,18/2/2016,Syria,Kobane,13,24,37,Over a dozen people lose their lives during an ISIS bomb attack on several villages.
28359,18/2/2016,Syria,Palmyra,2,0,2,Two young men are detained and executed by the Islamic State.
28360,18/2/2016,Afghanistan,Waskhwa,6,0,6,Four children are among a family of six eliminated by Taliban bombers.
28361,18/2/2016,Pakistan,Mohmand,9,0,9,Religious radicals murder nine local security personnel in two attacks.
28362,18/2/2016,Iraq,Mosul,3,0,3,Three women who formerly served as election workers are forced to their knees and shot in the back of the head by caliphate members.
28363,18/2/2016,Syria,Aleppo,4,5,9,Four civilians lose their lives to Sunni mortar shells on their neighborhood.
28364,18/2/2016,Israel,Shaare Benjamin,1,1,2,A 21-year-old father is stabbed to death in a supermarket by Palestinians.
28365,18/2/2016,Iraq,Hawija,17,0,17,Seventeen young people are beheaded after being accused of drawing anti-ISIS banners.
28366,19/2/2016,Afghanistan,Landi Kotal,1,0,1,A religious scholar is assassinated by rivals.
28367,19/2/2016,Iraq,Hardan,9,9,18,ISIS bombs targeting a bus kill nine Kurds.
28368,19/2/2016,Mali,Menaka,1,1,2,"Jihadists fire into a group of village guards, killing one."
28369,19/2/2016,Cameroon,Meme,24,112,136,Four Shahid suicide bombers massacre twenty-four others at a market and a nearby school.
28370,19/2/2016,Egypt,Sinai,1,0,1,ISIS beheads a hostage taken in a tourist province.
28371,19/2/2016,Pakistan,Faisalabad,3,0,3,"Three policemen are shot to death for ""protecting the unIslamic system of democracy."""
28372,20/2/2016,Yemen,Aden,2,0,2,Two people are gunned down by al-Qaeda operatives on a motorcycle.
28373,20/2/2016,Yemen,Ahwar,3,0,3,An al-Qaeda attack on a small town leaves three defenders dead.
28374,21/2/2016,Egypt,al-Arish,2,10,12,Two civilians are taken out by an Islamist IED.
28375,21/2/2016,Iraq,Kirkuk,4,2,6,"ISIS members target fleeing families, killing four members."
28376,21/2/2016,Pakistan,Navi Mandi,3,1,4,Four displaced persons are disassembled by Taliban bombers.
28377,21/2/2016,Iraq,Kirkuk,2,0,2,Two more people are publicly beheaded by the Islamic State.
28378,21/2/2016,Bangladesh,Deviganj,1,2,3,A Hindu priest is hacked to death and beheaded by Muslim extremists outside his temple.
28379,21/2/2016,India,Pulwama,3,10,13,"Islamic militants open fire on a bus, killing three passengers."
28380,21/2/2016,Philippines,Butig,3,6,9,"Moro Islamists fire on a group of soldiers guarding a town, killing three."
28381,21/2/2016,Syria,Damascus,83,178,261,Children are among the eighty-three destroyed by a horrific suicide bombing outside a Shiite shrine and school.
28382,21/2/2016,Syria,Zahra,59,200,259,A double-bombing by ISIS along a commerical strip leaves nearly sixty dead and two-hundred burned and battered.
28383,21/2/2016,Thailand,Pattani,2,0,2,'Insurgents' shoot a Buddhist couple to death.
28384,22/2/2016,Afghanistan,Baghlan,1,2,3,A Taliban rocket takes out an Afghan citizen.
28385,22/2/2016,Afghanistan,Parwan,13,19,32,"A suicide bomber detonates near a clinic, taking thirteen other souls with him."
28386,22/2/2016,Afghanistan,Jabba,2,2,4,Religious fundamentalists murder two local cops.
28387,22/2/2016,Iraq,Ramadi,6,10,16,An ISIS assault leaves six town defenders dead.
28388,22/2/2016,India,Pompore,3,0,3,Three more people are killed by Lashkar-e-Toiba.
28389,22/2/2016,Iraq,Ramadi,8,0,8,Eight people are killed in their own homes by ISIS booby-traps.
28390,22/2/2016,Philippines,Tugaya,1,0,1,Muslim terrorists murder a local soldier guarding a village
28391,23/2/2016,Syria,Raqqa,1,0,1,Radicals execute a man for 'apostasy'.
28392,23/2/2016,Iraq,Yusufiya,1,9,10,"Terrorists bomb a vegetable market, killing one person."
28393,23/2/2016,Syria,Deir Ezzor,2,14,16,Two civilians are pulled apart by a Sunni mortar blast.
28394,23/2/2016,Iraq,Hawija,4,0,4,Four young people are executed by ISIS after members call for 'repentance'.
28395,23/2/2016,Syria,Hamidiya,2,0,2,Two teenage girls are stoned for adultery.
28396,23/2/2016,Iraq,Fallujah,12,0,12,"A dozen Iraqis are caught trying to flee the caliphate, marched to the city center and executed."
28397,24/2/2016,Nigeria,Agatu,300,0,300,"Radical Islamic mercenaries sweep through a series of Christian villages and slaughter over three hundred, including pregnant women and children."
28398,24/2/2016,Iraq,Mosul,1,0,1,An imam is beheaded by Religion of Peace rivals.
28399,24/2/2016,Syria,Aleppo,10,5,15,Seven children are among ten civilians disassembled by two Sunni mortar rounds.
28400,24/2/2016,Syria,Dayr al-Zawr,2,14,16,Sunni rockets take out two civilians.
28401,24/2/2016,Afghanistan,Kabul,7,0,7,The Taliban kill seven Afghans over a 24-hour period.
28402,24/2/2016,Mali,Timbuktu,3,2,5,"Islamists attack a checkpoint, killing three defenders."
28403,24/2/2016,Libya,Sabratha,12,0,12,A dozen local security agents are captured and beheaded by ISIS.
28404,25/2/2016,Iraq,Baghdad,15,50,65,"Two Sunni suicide bombers detonate at a Shiite mosque, slaughtering at least fifteen worshippers."
28405,25/2/2016,Somalia,Mogadishu,4,8,12,Four civilians lose their lives to an al-Shabaab attack.
28406,26/2/2016,Germany,Hanover,0,1,1,A 'radicalized' teen girl stabs a female police officer.
28407,26/2/2016,Egypt,Giza,1,1,2,"Fundamentalists open fire on two traffic cops, killing one."
28408,26/2/2016,Syria,al-Zahra,1,0,1,A child is killed by Jabhat al-Nusra.
28409,26/2/2016,Somalia,Mogadishu,14,30,44,"Holy Warriors attack a 'Youth League' hotel with bombs and gunfire, laying out fourteen innocents."
28410,27/2/2016,Syria,Deir Ezzor,3,12,15,Three children are disassembled by Sunni mortars.
28411,27/2/2016,Syria,Teeba,4,4,8,Four villagers lose their lives to an Islamic State suicide bomber.
28412,27/2/2016,Afghanistan,Kabul,15,31,46,"A suicide bomber targets a bus, killing fifteen passengers and bystanders."
28413,27/2/2016,Syria,Salamiya,2,3,5,An ISIS suicide bomber takes at least two others with him.
28414,27/2/2016,Afghanistan,Nangarhar,1,5,6,Taliban bombers take out a civilian.
28415,27/2/2016,Afghanistan,Asadabad,12,40,52,"A dozen people lose their lives to a suicide blast along a city street, including three brothers."
28416,27/2/2016,Syria,Ajila,2,4,6,A suicide car bomber takes out two village guards.
28417,27/2/2016,Iraq,Baghdad,5,25,30,A series of Mujahideen blasts leave five dead.
28418,27/2/2016,Iraq,Abu Ghraib,2,9,11,"Jihadis bomb an outdoor market, killing two patrons."
28419,27/2/2016,Egypt,Rafah,2,2,4,Two local security personnel are cut down by an Islamist bomb.
28420,27/2/2016,Afghanistan,Bolan,2,0,2,The Taliban wipe out two local police with a roadside bomb.
28421,27/2/2016,Pakistan,Qayum,1,2,3,"A Muslim shouts a religious slur and fires into a Christian home, killing a 17-year-old boy."
28422,28/2/2016,Saudi Arabia,Qassim,1,0,1,"A local cop is murdered by family members, who then pledge allegiance to ISIS."
28423,28/2/2016,Afghanistan,Lashkar Gah,3,11,14,Three souls are snuffed out by an explosive device planted by Sharia proponents.
28424,28/2/2016,Afghanistan,Qads,1,0,1,A tribal elder is tortured to death by religious extremists.
28425,28/2/2016,Somalia,Baidoa,30,60,90,At least thirty civilians and first responders are slaughtered by a twin suicide attack near a restaurant.
28426,28/2/2016,Egypt,al-Arish,1,0,1,A man is shot to death in front of his home by the Islamic State.
28427,28/2/2016,Iraq,Baghdad,78,112,190,Seventy-eight people at a packed market in a Shiite area are exterminated by two Sunni suicide bombers.
28428,28/2/2016,Iraq,Abu Ghraib,24,22,46,Two dozen Iraqis are shot or blown apart during a Fedayeen suicide attack by ISIS.
28429,29/2/2016,Syria,Deir ez-Zor,3,0,3,Three men are crucified by a Sharia court for crimes against Allah.
28430,29/2/2016,Nigeria,Badarawa,15,22,37,"Suspected Boko Haram surround a group of villagers gathered to watch a video and pour machine gun fire into them, killing at least fifteen."
28431,29/2/2016,DRC,Ntombi,13,0,13,Four women are among thirteen villagers found hacked to pieces by ADF Islamists.
28432,29/2/2016,Yemen,Aden,4,5,9,A Shahid suicide bomber snuffs out four other souls.
28433,29/2/2016,Iraq,Hawija,3,0,3,Three youth are beheaded for putting up anti-ISIS posters.
28434,29/2/2016,Iraq,Muqdadiya,40,58,98,"A Fedayeen suicide bomber detonates at a funeral, sending at least forty mourners straight into their own afterlife."
28435,29/2/2016,Iraq,Mosul,2,0,2,Two religious clerics are murdered by their more radical brethren
28436,29/2/2016,Iraq,Mosul,24,0,24,Two dozen Iraqis are rounded up and executed by the Islamic State.
28437,29/2/2016,Afghanistan,Uruzgan,4,3,7,Four locals are shot to death by the Taliban
28438,29/2/2016,Afghanistan,Farah,3,3,6,Three children are disassembled by a Taliban IED.
28439,29/2/2016,Russia,Moscow,1,0,1,"A woman beheads a child, saying that it was revenge for 'spilled Muslim blood' in Syria."
28440,1/3/2016,Pakistan,Sheikhupura,1,0,1,An Ahmadi religious minority is stabbed to death for his faith.
28441,1/3/2016,Philippines,Datu Salibo,1,2,3,Bangsamoro Islamists kill one other person during an ambush.
28442,1/3/2016,Philippines,Zamboanga,2,0,2,An assassination attempt on an anti-ISIS preacher outside a university hall leaves two dead.
28443,1/3/2016,Iraq,Haditha,8,8,16,Eight Iraqis are blown up by four Fedayeen suicide bombers.
28444,1/3/2016,Egypt,al-Arish,2,0,2,Fundamentalists behead a man and shoot his son to death.
28445,1/3/2016,Somalia,Alamada,5,8,13,An al-Shabaab bomb produces five dead bodies.
28446,1/3/2016,Afghanistan,Pul-e-Khumri,3,2,5,"Religious extremists hit a house with a rocket, killing three family members."
28447,1/3/2016,Pakistan,Peshawar,2,4,6,Two employees at the US consulate bleed to death following an Islamist bombing.
28448,1/3/2016,Pakistan,Noorshah,2,0,2,Two women are murdered over 'doubts about their character and lifestyles'.
28449,2/3/2016,Afghanistan,Jalalabad,2,19,21,"Four suicide bombers target the Indian consulate, killing two civilians."
28450,2/3/2016,Egypt,Khariza,1,3,4,An Islamist bomb claims one life.
28451,2/3/2016,Syria,Quneitra,18,30,48,Two suicide bombers massacre eighteen bystanders.
28452,2/3/2016,Iraq,Nineveh,5,0,5,"A 12-year-old girl is forced by the caliphate to execute five women, including a doctor."
28453,2/3/2016,Iraq,Hawija,6,0,6,Six people are beheaded and crucified by the Islamic State.
28454,3/3/2016,Thailand,Yala,1,0,1,"Militant Muslims shoot a rubber tapper to death, then set his body on fire."
28455,3/3/2016,Libya,Surman,2,0,2,Two Italian hostages are killed while being used as human shields by ISIS.
28456,3/3/2016,Syria,Kafriya,1,3,4,Sunni militants machine-gun a civilian in his home.
28457,3/3/2016,Iraq,Abu Ghraib,2,10,12,Two civilians are killed when terrorists sent mortar shells into a market.
28458,4/3/2016,Yemen,Aden,16,0,16,"Militant Muslims storm a Catholic retirement home and murder sixteen, including four nuns and the elderly residents."
28459,5/3/2016,Iraq,Mosul,132,0,132,One-hundred and thirty-two people are executed by Sharia courts.
28460,5/3/2016,Yemen,Aden,2,0,2,"Sectarian terrorists fire on a vehicle, killing two occupants."
28461,5/3/2016,Syria,Jarablus,1,0,1,A teen is beheaded for apostasy after missing Friday prayers.
28462,6/3/2016,Iraq,al-Jahash,12,0,12,A dozen people are executed by a Sharia court.
28463,6/3/2016,Egypt,Sheikh Zuweid,3,0,3,Fundamentalists ambush an ambulance and machine-gun a medic and two injured patients.
28464,6/3/2016,Syria,Aleppo,14,40,54,"Jaish-al-Sunna terrorists send mortars and rockets into a busy market, massacring over a dozen shoppers."
28465,6/3/2016,Iraq,Hillah,61,95,156,At least sixty people are incinerated when a suicide bomber in a fuel tanker detonates outside a town.
28466,7/3/2016,Iraq,Kirkuk,5,0,5,Five young people are torn to shreds by an ISIS bomb blast.
28467,7/3/2016,Pakistan,Shabqadar,17,30,47,"A Jamatul Ahrar suicide bomber murders seventeen people at a courthouse, including two children."
28468,7/3/2016,Somalia,Beledweyne,0,6,6,A bomb hidden in a laptop detonates at an airport.
28469,7/3/2016,Tunisia,Ben Guerdane,19,17,36,A 12-year-old girl is among nineteen others who lose their lives during an Islamist assault on a small town.
28470,7/3/2016,Chechnya,Grozny,1,0,1,Video surfaces showing religious radicals executing a man with a shot to the head.
28471,7/3/2016,Syria,Hasakah,1,3,4,A woman loses her life to an ISIS explosive device.
28472,7/3/2016,Egypt,al-Arish,2,0,2,Two local cops are pulled into pieces by Muslim bombers.
28473,7/3/2016,Afghanistan,Shindand,3,3,6,Three civilians are blown to bits by a Taliban bomb blast.
28474,7/3/2016,Iraq,Abu Ghraib,3,7,10,Three people at a market are sectionalized by a Jihadi bomb blast.
28475,7/3/2016,Pakistan,Orangi Town,2,0,2,A young couple is shot to death by conservative relatives for marrying of their own free will.
28476,8/3/2016,Turkey,Kilis,2,1,3,A 4-year-old and his mother die when Sunni extremists hit their car with a rocket.
28477,8/3/2016,Thailand,Si Sakhon,1,0,1,A man on a motorcycle is ambushed and killed by Muslim terrorists.
28478,8/3/2016,Iraq,Baghdad,3,7,10,Three people are left dead following a Mujahideen bombing.
28479,8/3/2016,Iraq,Fallujah,50,0,50,Fifty civilians are executed by the Islamic State.
28480,8/3/2016,Thailand,Tak Bai,1,0,1,A Muslim 'insurgent' walks up to a man in a crowd and fires a bullet into the back of his head.
28481,8/3/2016,Syria,Aleppo,1,0,1,Devout Muslims implement the 'Rule of Allah' by shooting an 'apostate' in the head.
28482,8/3/2016,Afghanistan,Maiwand,2,0,2,Two men clearing landmines are executed by suspected fundamentalists.
28483,8/3/2016,Israel,Jaffa,1,15,16,Palestinians stab an American tourist to death.
28484,8/3/2016,Iraq,al-Hadar,4,0,4,Four sex slaves are executed for trying to escape captivity in the caliphate.
28485,8/3/2016,Uruguay,Paysandu,1,0,1,A Jewish man is stabbed to death by a Muslim convert 'following Allah's order'…
28486,9/3/2016,Iraq,Husseiniya,1,6,7,Terrorists place a bomb under a bus that kills a passenger.
28487,9/3/2016,Somalia,Mogadishu,4,2,6,Four people bleed out following a suicide car bombing outside a café.
28488,9/3/2016,Afghanistan,Gereshk,4,30,34,A Taliban suicide assault on a government building leaves four guards dead.
28489,9/3/2016,Nigeria,Benue,8,0,8,"Fulani mercenaries invade four villages in the middle of the night, shooting at least eight residents to death."
28490,9/3/2016,Thailand,Narathiwat,2,3,5,Muslim terrorists murder two members of a guard patrol for teachers.
28491,9/3/2016,Iraq,Taza,1,1500,1501,A 3-year-old girl dies from an ISIS chemical attack that left hundreds injured.
28492,10/3/2016,Syria,Deir Ezzor,2,0,2,A poet and his son are murdered by the Islamic State.
28493,10/3/2016,Iraq,Mosul,3,0,3,Three Kurds are beheaded by caliphate members.
28494,10/3/2016,Libya,Misrata,3,0,3,Three police are killed when ISIS members attack a checkpoint.
28495,10/3/2016,Syria,Wilayat al-Khayr,2,0,2,The Islamic State executes two terrified men by blowing them up.
28496,10/3/2016,Syria,Wilayat al-Khayr,1,0,1,"A man is forced by ISIS to climb a radio tower, from which he is shot off."
28497,10/3/2016,Nigeria,Tarka,3,0,3,Fulani mercenaries kill three villagers and burn their homes.
28498,11/3/2016,Iraq,Sinjar,5,3,8,Five Kurds are laid out by a Shahid suicide bomber.
28499,11/3/2016,Iraq,Sheikhan,11,2,13,Two ISIS rockets claim the lives of eleven Iraqis.
28500,11/3/2016,Pakistan,Kohistan,2,0,2,A couple is shot to death for 'illicit relations'.
28501,11/3/2016,Ingushetia,Nazran,0,4,4,'Problems in the religious sphere' result in a car bomb blast outside a mosque.
28502,12/3/2016,Afghanistan,Khanashin,1,3,4,A child is disassembled by Taliban bombers.
28503,12/3/2016,Iraq,Munsiyah,7,0,7,Three women are among seven people murdered in their home by sectarian militia.
28504,12/3/2016,Iraq,Mahmoudiyah,2,7,9,Mujahid bombers kill two patrons at a market.
28505,13/3/2016,Ivory Coast,Bassam,18,17,35,al-Qaeda gunmen assault a hotel and murder anyone refusing to praise Allah with them.  The eighteen killed include a 5-year-old Christian who was cut down while praying.
28506,13/3/2016,Afghanistan,Yengi Qala,2,0,2,A young couple is murdered over suspected sexual activity.
28507,13/3/2016,Iraq,Sinjar,7,11,18,"ISIS pour shells into a Yazidi village, killing seven residents."
28508,13/3/2016,Iraq,Tal Kasab,8,22,30,Suicide bomb attacks leave eight dead.
28509,14/3/2016,Iraq,Mosul,6,0,6,Six young people are rounded up and executed by the caliphate.
28510,14/3/2016,Iraq,Ramadi,25,20,45,ISIS suicide bombers massacre over two dozen in attacks on two villages.
28511,14/3/2016,Bangladesh,Jhenaidah,1,0,1,Radical Muslims assassinate a 'polytheist apostate' (i.e. Shia cleric).
28512,14/3/2016,Syria,Busayrah,1,0,1,A young man is shot in the head for 'mocking religion'.
28513,14/3/2016,Canada,"Toronto, ON",0,2,2,"A man stabs two soldiers at a recruiting center, saying that he was just following Allah's instructions."
28514,14/3/2016,Iraq,Zankurah,22,16,38,Twenty-two Iraqis are killed during an assault by the Islamic State.
28515,14/3/2016,Egypt,al-Arish,2,0,2,Two Egyptians are picked off by fundamentalist snipers.
28516,14/3/2016,Nigeria,Huyum,1,1,2,Islamic gunmen kill a woman and shoot a child in the leg.
28517,14/3/2016,Nigeria,Chul,3,7,10,Three civilians are taken out by a Boko Haram bomb blast.
28518,14/3/2016,Afghanistan,Kandahar,1,0,1,A woman is shot to death by the Taliban.
28519,15/3/2016,Syria,Safafa,68,0,68,Sixty-eight people imprisoned by the Islamic State are executed to 'reduce expenses'.
28520,15/3/2016,Thailand,Pattani,1,0,1,Suspected terrorists shoot a young woman twice in the head at a market.
28521,15/3/2016,Afghanistan,Laghman,1,1,2,Sharia state proponents ambush and kill an off-duty police officer.
28522,15/3/2016,Philippines,Patikul,2,0,2,Abu Sayyaf members ambush and kill two local soldiers.
28523,15/3/2016,Afghanistan,Hajiabad,4,0,4,Women and children are among four civilians exterminated by Taliban bombers.
28524,15/3/2016,Iraq,Qwar,9,17,26,An ISIS chlorine gas attack kills nine Kurds.
28525,16/3/2016,Nigeria,Maiduguri,18,35,53,Two female suicide bombers slaughter two dozen worshippers at a rival mosque.
28526,16/3/2016,Pakistan,Peshawar,15,30,45,Fifteen people are torn to shreds when Lashkar-e-Islam bomb a bus carrying commuters.
28527,17/3/2016,Egypt,Rafah,5,10,15,Five are killed when religious extremists attack a local military base.
28528,17/3/2016,Philippines,Sarangani,1,0,1,A 43-year-old man is beheaded by a pro-caliphate group.
28529,17/3/2016,Iraq,Fallujah,6,0,6,"Six men are executed in barbaric fashion by the Islamic State, including one whose head is blown off with explosives."
28530,17/3/2016,Thailand,Pattani,1,0,1,A 53-year-old guard at a school is shot to death by Muslim militants.
28531,17/3/2016,Iraq,Hamidat,1,0,1,Radicals put a rival imam against a wall and shoot him to death.
28532,17/3/2016,Niger,Diffa,1,2,3,Four suicide bombers manage to kill one other person.
28533,17/3/2016,Niger,Dolbel,3,3,6,Three guards at a market are shot to death point blank by Jihadis.
28534,17/3/2016,Pakistan,Smagal,4,0,4,A woman and her child are among four souls obliterated by a suicide bomber.
28535,18/3/2016,Nigeria,Bori,5,3,8,A young girl is among five villagers murdered by Boko Haram.
28536,18/3/2016,Pakistan,Sherabad,2,0,2,A young couple is shot to death by a conservative family member on suspicion of adultery.
28537,18/3/2016,Syria,Aleppo,2,3,5,"Two children, a boy and a girl, are reduced to pulp by a series of Sunni rockets on their neighborhood."
28538,18/3/2016,Iraq,Mosul,1,0,1,A gentleman's head is removed by the Islamic State.
28539,18/3/2016,Afghanistan,Seori Tapi,2,1,3,"A Taliban landmine takes out two people, including a child."
28540,18/3/2016,Syria,Aleppo,1,6,7,A Sunni rocket sends a woman to the morgue.
28541,19/3/2016,Iraq,Kirkuk,2,0,2,Two more children die from the effects of an ISIS mustard gas attack.
28542,19/3/2016,Egypt,al-Arish,15,0,15,ISIS claims to have detonated a suicide car bomb that leaves fifteen others dead.
28543,19/3/2016,Somalia,Afmadhow,2,5,7,An al-Shabaab attack leaves two others dead.
28544,19/3/2016,Iraq,Mosul,70,0,70,A mass grave is discovered containing the remains of seventy female Yazidi victims of ISIS torture and execution.
28545,19/3/2016,Turkey,Istanbul,4,39,43,"An ISIS suicide bomber murders four people along a city street, including two American tourists."
28546,20/3/2016,Iraq,Haqlaniyah,24,12,36,A wave of Shahid suicide bombers kill two dozen Iraqis.
28547,21/3/2016,Egypt,Cairo,4,0,4,Four Bible translators for Wycliffe are brutally slain in their office at an undisclosed location in the Middle East.
28548,21/3/2016,Yemen,Taiz,1,3,4,"Shiite snipers fire on a group of journalists, bringing down one."
28549,21/3/2016,Iraq,Anbar,30,0,30,A British suicide bomber is said to be responsible for a blast that kills thirty Iraqis.
28550,21/3/2016,Iraq,Makhmour,2,0,2,Two others are taken out by a series of suicide bombers.
28551,21/3/2016,Iraq,al-Baghdadi,6,9,15,An ISIS attack that began with five suicide bombings manages to kill six Iraqis.
28552,21/3/2016,Somalia,Laantu Buur,6,0,6,Six local soldiers are ambushed and killed by an Islamist group.
28553,22/3/2016,Iraq,Tarmiya,3,7,10,A Mujahid bomb blast claims three lives.
28554,22/3/2016,Belgium,Brussels,21,130,151,A Religion of Peace suicide blast on a subway train incinerates twenty-one commuters.
28555,22/3/2016,Belgium,Brussels,14,92,106,Fourteen people are murdered when two suicide bombers detonate nail-packed explosives at crowded airline counters.
28556,22/3/2016,Bangladesh,Kurigram,1,0,1,A Christian convert is stabbed to death by Religion of Peace proponents.
28557,23/3/2016,Iraq,Zkhaikha,6,13,19,A suicide car bomber lays out a half-dozen Iraqis.
28558,23/3/2016,Iraq,Baghdad,2,6,8,Two people outside a shop are sent to the hereafter by Jihadi bombers.
28559,23/3/2016,Syria,Foua,2,3,5,Ahrar al-Sham snipers pick off two civilians.
28560,24/3/2016,Afghanistan,Arghandab,7,0,7,Three Taliban in police uniform sprays seven sleeping officers with machine-gun fire.
28561,24/3/2016,Scotland,Glasgow,1,0,1,An Ahmadi minority is stabbed to death by a radical Muslim over his religious beliefs.
28562,24/3/2016,Pakistan,Dera Ismail Khan,2,0,2,Muslim extremists gun down two police officers.
28563,24/3/2016,Pakistan,Hayatabad,1,0,1,A university professor is shot to death by fundamentalists.
28564,25/3/2016,Syria,Jarablus,2,0,2,"Two teenagers are chained, blindfolded and shot to death by a Sharia court."
28565,25/3/2016,Yemen,Aden,25,15,40,Three al-Qaeda suicide bombings leave twenty-five dead.
28566,25/3/2016,Libya,Zaria,2,0,2,A suspected ISIS bomb blast takes out a woman and her infant son.
28567,25/3/2016,Iraq,Iskandariyah,41,105,146,Forty-one innocents are blown to bits by a Fedayeen suicide bomber at a soccer game.
28568,26/3/2016,Pakistan,Lwargi,1,0,1,A polio worker is gunned down inside his clinic by Lashkar-e-Islam.
28569,26/3/2016,Iraq,Ein al-Asad,3,4,7,"A group of suicide bombers attack an air base, killing three local defenders."
28570,26/3/2016,Syria,Aleppo,5,20,25,Five civilians lose their lives when Sunni extremists pour rockets into a neighborhood.
28571,26/3/2016,Nigeria,Tumpun,4,0,4,"Boko Haram gunmen open fire on a group of villagers, killing four."
28572,27/3/2016,Iraq,Baghdad,2,9,11,"Jihadists bomb a vegetable market, killing two patrons."
28573,27/3/2016,Pakistan,Lahore,78,362,440,"A massive suicide blast targeting Christian families celebrating Easter leaves over seventy dead, half of whom were children."
28574,27/3/2016,Thailand,Yarang,2,0,2,Two guards at a flea market are sprayed point-blank with machine-gun fire.
28575,28/3/2016,Iraq,Mosul,15,0,15,Fifteen civilians are rounded up and executed by caliphate members.
28576,28/3/2016,Iraq,Mosul,3,0,3,Three Kurdish captives are beheaded by the Islamic State.
28577,28/3/2016,Afghanistan,Kabul,1,0,1,"Islamists fire rockets at the parliament building, killing a guard."
28578,29/3/2016,Thailand,Ra-Ngae,3,9,12,"Islamist 'rebels' ambush a police convoy, killing three members."
28579,29/3/2016,Afghanistan,Kabul,2,3,5,A bomb planted by Sunni fundamentalists takes out a woman and teenager.
28580,29/3/2016,Iraq,Baghdad,7,23,30,"A Shahid suicide bomber detonates amid a group of civilians, laying out seven."
28581,29/3/2016,Syria,Manbij,1,0,1,A young woman is beheaded by the Islamic State.
28582,29/3/2016,Dagestan,Makhachkala,1,2,3,ISIS claims responsibility for a car bomb attack that leaves one dead.
28583,29/3/2016,Iraq,Salahudin,11,0,11,Eleven members of a single family are murdered in their own home by Mujahideen.
28584,29/3/2016,Syria,Deir Ezzor,1,0,1,A boy is shot to death for helping his sister-in-law escape the caliphate.
28585,30/3/2016,Somalia,Mogadishu,6,6,12,Six people are killed in a drive-by shooting by al-Qaeda linked militants.
28586,30/3/2016,Afghanistan,Zabul,2,1,3,Suspected Taliban bombers exterminate two young children.
28587,30/3/2016,Dagestan,Sirtych,1,0,1,A suicide bomber kills one other person.
28588,30/3/2016,Thailand,Prado,1,0,1,A 40-year-old Buddhist man is gunned down by Muslim terrorists.
28589,31/3/2016,Syria,Manbij,2,0,2,Fundamentalists stone a man and woman to death over suspected adultery.
28590,31/3/2016,Iraq,Tarmiyah,3,7,10,"Mujahideen set off a bomb near a popular market, successfully killing three passersby."
28591,31/3/2016,Iraq,Makhmour,4,1,5,Four people are blown to bits by two suicide bombers.
28592,31/3/2016,Somalia,Galkayo,9,10,19,Ten people are torn limb from limb by a Shahid suicide bomber.
28593,31/3/2016,Iraq,Mosul,15,0,15,Fifteen civilians are electrocuted by the Islamic State.
28594,31/3/2016,Iraq,Fallujah,35,0,35,Thirty-five civilians are executed by firing squad for attempting to flee the caliphate.
28595,31/3/2016,Niger,Diffa,6,3,9,A half-dozen security personnel are ambushed and killed by a radical Islamist group.
28596,31/3/2016,Pakistan,Battagram,2,0,2,Two employees at an Islamic seminary are shot to death on suspicion of sexual activity.
28597,31/3/2016,Thailand,Bangpu,1,12,13,A series of bomb attacks leaves a civilian dead and a dozen others wounded.
28598,31/3/2016,Iraq,Makhmour,11,0,11,Eleven Iraqis are take out by two suicide car bombers.
28599,31/3/2016,Nigeria,Abbi,2,19,21,Two siblings are hacked to death by Fulani mercenaries.
28600,1/4/2016,Thailand,Raman,2,1,3,"Runda Kumpulan Kecil Islamists spray a tea shop with bullets, killing two villagers."
28601,1/4/2016,Syria,Palmyra,40,0,40,A mass grave is discovered containing women and children among other victims of the Islamic State.
28602,2/4/2016,Libya,Maradah,2,0,2,Two guards at an oil field are murdered by ISIS.
28603,2/4/2016,Syria,Raqqa,1,0,1,Caliphate members murder a man in front of his family and hang from a traffic light.
28604,2/4/2016,Syria,Aleppo,1,5,6,A child is disassembled by a Sunni mortar shell.
28605,2/4/2016,Iraq,Tarmiya,1,0,1,Islamic militants storm a house and kill a woman.
28606,3/4/2016,Yemen,Marib,3,17,20,Three civilians are left dead after a Shiite militant attack on a hospital.
28607,3/4/2016,India,Sahaspur,1,1,2,Suspected Mujahid gun down a man in front of his wife and children.
28608,4/4/2016,Afghanistan,Khewa,2,6,8,Two civilians are laid out by a Taliban bomb blast.
28609,4/4/2016,Afghanistan,Dawlat Abad,6,0,6,Sunni fundamentalists ambush and murder six local cops.
28610,4/4/2016,Syria,Raqqa,8,0,8,Eight young people are crucified by the Islamic State.
28611,4/4/2016,Iraq,Mishahda,4,10,14,"A Shahid suicide car bomber hits a government building, killing four employees."
28612,4/4/2016,Iraq,Sadr al-Qanat,6,13,19,A half-dozen people lose their lives to a suicide car bomber.
28613,4/4/2016,Iraq,Basra,5,10,15,Five Iraqis are blown to bits by a Fedayeen suicide bomber at a commercial area.
28614,4/4/2016,Iraq,Nasiriyah,14,27,41,"A suicide bomber detonates at a restaurant frequented by Shiites, killing at least fourteen."
28615,4/4/2016,Libya,Jufra,1,1,2,One person is murdered by ISIS.
28616,4/4/2016,Nigeria,Izghe,5,0,5,At least five others are killed when Boko Haram launch an attack on a small town.
28617,4/4/2016,Syria,Aleppo,8,20,28,Eight residents are killed when al-Nusra lob rocket shells into a neighborhood.
28618,5/4/2016,Saudi Arabia,Dawadmi,1,0,1,ISIS snipers pick off a local military officer.
28619,5/4/2016,Afghanistan,Parwan,6,22,28,Children are among six killed when a suicide bomber detonates near a school.
28620,5/4/2016,Pakistan,Khyber Pakhtunkhwa,4,0,4,"Four people, including two refugees, are gunned down by Islamic militants."
28621,5/4/2016,Iraq,Baghdad,1,2,3,A suicide bomber manages to kill one other person.
28622,5/4/2016,Iraq,Mahmoudiya,2,7,9,A marketplace blast leaves two patrons in pieces.
28623,6/4/2016,Pakistan,Wandala,1,1,2,A Muslim gang slits the throat of a disabled Christian for trying to defend members of his community.
28624,6/4/2016,Afghanistan,Andar,1,9,10,A civilian bleeds out after the Taliban spray a vehicle with bullets.
28625,6/4/2016,Thailand,Narathiwat,2,0,2,Two villagers are machine-gunned in their pick-up truck by Muslim terrorists.
28626,6/4/2016,Iraq,Fallujah,15,0,15,The caliphate burns fifteen civilians alive for trying to flee.
28627,6/4/2016,Niger,Diffa,3,3,6,Three civilians are reduced to disparate parts by two Fedayeen suicide bombers.
28628,6/4/2016,Bangladesh,Dhaka,1,0,1,A secular student activist is hacked to death at a university by three devotees chanting praises to Allah.
28629,6/4/2016,Syria,Aleppo,18,70,88,A pregnant woman and three children are among over a dozen left dead after terrorists fire rockets into a Kurdish neighborhood.
28630,7/4/2016,Nigeria,Gurum,20,0,20,At least twenty innocents are slaughtered when Boko Haram members burn their village.
28631,7/4/2016,Thailand,Pattani,1,0,1,Islamic terrorists shoot a 31-year-old man to death.
28632,7/4/2016,Egypt,al-Arish,3,1,4,Terrorists murder three young police recruits with a roadside bomb.
28633,7/4/2016,Syria,Raqqa,2,0,2,"A video shows a gay man thrown to his death and stoned, while another is beheaded."
28634,7/4/2016,Syria,Aleppo,23,100,123,"ISIS sends shells containing chemical agents into a residential neighborhood, choking two dozen residents to death."
28635,7/4/2016,Egypt,Sheikh Zuweid,4,14,18,A woman is among four people laid out by Islamic bombers.
28636,7/4/2016,Iraq,Abu Ghraib,2,8,10,Two people are killed when Mujahideen set off a bomb blast near a market.
28637,8/4/2016,Somalia,Hamar Weyne,3,10,13,"Islamists send mortars into a seaside district, killing three residents."
28638,8/4/2016,Pakistan,Karachi,3,0,3,"Three Shiites are gunned down by Sunnis after Friday prayers, including a father and son."
28639,9/4/2016,Syria,Qaryatain,21,0,21,Three women are among twenty-one Christians murdered in cold blood for refusing to submit to Islam.
28640,9/4/2016,Syria,Darb Hassan,6,3,9,A half-dozen children are disassembled by an ISIS landmine.
28641,9/4/2016,Syria,Damascus,4,0,4,Four cement workers are murdered on account of their being members of the Druze religious minority.
28642,9/4/2016,Somalia,Mogadishu,6,5,11,"A Fedayeen suicide car bomber rams a busy restaurant, taking out six bystanders."
28643,9/4/2016,Philippines,Basilan,18,53,71,"Abu Sayyaf ambush and kill eighteen local security personnel, some of which are beheaded."
28644,9/4/2016,Iraq,Madain,4,18,22,Mujahid bombers murder four young people at a soccer match.
28645,9/4/2016,Iraq,Albu Bali,4,10,14,A suicide car bomber takes out four Iraqis.
28646,9/4/2016,Iraq,Baghdad,2,8,10,"Jihadis bomb a popular market, killing two patrons."
28647,9/4/2016,Yemen,Ahwar,19,0,19,"Nineteen local soldiers are ambushed, captured and beheaded by al-Qaeda."
28648,9/4/2016,Philippines,Bula,1,0,1,Ansar al Khilafah members behead a 43-year-old non-Muslim.
28649,10/4/2016,Syria,Azaz,20,0,20,Twenty civilians are reported killed when ISIS members assault several small towns.
28650,10/4/2016,Iraq,Zab,6,4,10,ISIS landmines take out a half dozen civilians.
28651,10/4/2016,Nigeria,Abraka,1,0,1,A 52-year-old university staffer is shot twice in the head by militant Muslims.
28652,10/4/2016,Iraq,Hit,6,12,18,"An Islamic State suicide bomber targets fleeing families, killing six members."
28653,11/4/2016,Thailand,Songkla,2,8,10,A 4-year-old boy is among two killed when Muslim terrorists bomb a train station.
28654,11/4/2016,Somalia,Mogadishu,5,7,12,Children are among those killed by an al-Shabaab bomb blast outside a restaurant.
28655,11/4/2016,Afghanistan,Kabul,14,38,52,A suicide bomber on a motorcycle slaughters fourteen people.
28656,11/4/2016,Afghanistan,Wesh,7,0,7,A Taliban in police uniform murders seven border guards.
28657,11/4/2016,Pakistan,Karachi,1,0,1,A secular-leaning party activist is assassinate in a tea room by suspected fundamentalists.
28658,11/4/2016,Nigeria,Gashak,44,0,44,Fulani terrorists invade two villages and massacre over forty residents.
28659,11/4/2016,Turkey,Kilis,1,11,12,A 74-year-old man dies from injuries suffered from ISIS rocket shrapnel.
28660,12/4/2016,Afghanistan,Mingora,1,0,1,The Taliban shoot an official to death after he stops to buy fruit.
28661,12/4/2016,Thailand,Mae Lan,3,0,3,A Buddhist monk is among three Thais murdered by Muslim terrorists.
28662,12/4/2016,Yemen,Aden,5,7,12,A Shahid suicide bomber sends five other souls to Allah.
28663,12/4/2016,Philippines,Butig,2,4,6,Two sawmill workers are beheaded by Muslim extremists.
28664,12/4/2016,Libya,Bani Waleed,7,2,9,Seven others die after an attack by ISIS gunmen.
28665,12/4/2016,Pakistan,Sabzi Mandi,1,2,3,Taliban militants kill a government employee in a targeted attack.
28666,12/4/2016,Iraq,Mosul,3,0,3,Three women at a market are forced to their knees and shot in the head by the Islamic State.
28667,12/4/2016,Iraq,Mosul,1,0,1,Caliphate members execute a university student in front of his home.
28668,12/4/2016,Turkey,Gaziantep,1,0,1,A journalist dies after being shot in the head by Islamists.
28669,12/4/2016,Iraq,Madain,3,5,8,Three people are torn limb from limb by a Jihadi bomb blast.
28670,12/4/2016,Mali,Tessalit,3,1,4,Three French peacekeepers are reduced to pulp by an Islamist landmine.
28671,13/4/2016,Turkey,Kilis,2,8,10,Two lives are cut short by an ISIS rocket attack on a small town.
28672,13/4/2016,Libya,Misrata,1,4,5,A security guard is killed during an ISIS drive-by.
28673,14/4/2016,Iraq,Mahmoudiya,2,7,9,Two people at a market are sectionalized by a Mujahideen bomb blast.
28674,14/4/2016,Afghanistan,Takhar,8,0,8,Taliban ambush and murder eight local security personnel.
28675,15/4/2016,Libya,Benghazi,2,3,5,An ISIS car bomb near a cemetery leaves two dead.
28676,15/4/2016,Libya,Benghazi,6,25,31,Six Libyans are taken out by a suicide bomber at a cement factory.
28677,15/4/2016,Syria,Raqqa,1,0,1,A man is beheaded for alleged 'sorcery'.
28678,16/4/2016,Germany,Essen,0,3,3,ISIS-inspired teens bomb a Sikh wedding.
28679,16/4/2016,Iraq,Tarmiya,2,4,6,Two Iraqis are murdered by Mujahideen bombers.
28680,16/4/2016,Bahrain,Karbabad,1,2,3,Shiite radicals are suspected of burning a police officer alive.
28681,16/4/2016,Iraq,Kirkuk,1,0,1,An imam at a mosque is assassinated by Religion of Peace rivals.
28682,17/4/2016,Syria,Raqqa,1,0,1,A man is beheaded and crucified by the Islamic State.
28683,17/4/2016,Somalia,Mogadishu,1,1,2,Suspected al-Shabaab gun down a cleaning woman outside the UN headquarters.
28684,17/4/2016,Yemen,Aden,4,2,6,A Fedayeen suicide bomber kills four people at a checkpoint.
28685,17/4/2016,Pakistan,Zakha Khel,1,0,1,A guard is killed when a suicide bomber tries to enter a bazaar.
28686,17/4/2016,Iraq,Mosul,2,0,2,A photojournalist and his brother are pulled from their home and executed by the Islamic State.
28687,18/4/2016,Egypt,al-Arish,2,11,13,Religious radicals murder two civilians with a roadside bomb.
28688,18/4/2016,Somalia,Mogadishu,4,0,4,An Islamist shooting and suicide blast leaves four civilians dead.
28689,18/4/2016,Israel,Jerusalem,0,21,21,An Hamas suicide bomber detonates on a passenger bus.
28690,18/4/2016,Turkey,Kilis,4,6,10,Three children are among four people cut to ribbons by ISIS shrapnel.
28691,18/4/2016,Syria,Hama,2,3,5,Two civilians bleed to death after their neighborhood is hit with a Sunni rocket attack.
28692,18/4/2016,Syria,Kefraya,3,5,8,An ISIS rocket ends the lives of three children.
28693,18/4/2016,Iraq,Abu Karma,1,5,6,A boy on a farm is disassembled by a terrorist mortar shell.
28694,19/4/2016,Egypt,Sheikh Zuweid,3,8,11,Fundamentalists exterminate three local cops with an RPG.
28695,19/4/2016,Pakistan,Mardan,1,23,24,A Shahid suicide bomber takes out one person at a tax office.
28696,19/4/2016,Afghanistan,Kabul,64,347,411,Over sixty are killed when religious extremists stage a massive attack on a government building that begins with a suicide bombing.
28697,19/4/2016,Iraq,Makhmour,13,18,31,Thirteen Kurds are killed following an ISIS chemical attack.
28698,19/4/2016,Pakistan,Dhok Lona,4,0,4,A conservative Muslims shoots his own daughter and three other family members to death in an honor killing.
28699,19/4/2016,Iraq,Baghdad,2,5,7,"Jihadis set off a bomb outside a row of shops, killing two passersby."
28700,19/4/2016,Thailand,Songkhla,1,11,12,A child is among the casualties of an Islamic 'separatist' bomb blast outside a grocery store.
28701,19/4/2016,Uganda,Kanginima,0,1,1,A 22-year-old Christian woman is beaten and gang-raped in a targeted attack by followers of a local imam.
28702,20/4/2016,Iraq,Hawija,2,1,3,An 11-year-old girl is among two Yazidi girls killed while trying to escape caliphate sex slavery.
28703,20/4/2016,Iraq,Nineveh,14,0,14,Seven employees at a police station and seven more at a market are executed by caliphate members.
28704,20/4/2016,Iraq,Ramadi,40,0,40,Women and children are among forty victims of Islamic State execution found in a mass grave.
28705,20/4/2016,Egypt,Sinai,6,12,18,"Beit Ansar al-Maqdis members fire a missile at a police convoy, killing six officers."
28706,20/4/2016,Thailand,Songkhla,1,11,12,"A 62-year-old is killed, and an 11-year-old boy is among the injured, when Muslim militants set off a bomb at a grocery."
28707,20/4/2016,Syria,Aleppo,1,2,3,Sunni snipers pick off a Shiite woman.
28708,20/4/2016,Syria,Yarmouk,20,0,20,Twenty Palestinians at a refugee camp are reportedly beheaded by ISIS.
28709,20/4/2016,Pakistan,Orangi,7,0,7,Islamic militants brutally murder seven guards for an polio vaccination team.
28710,20/4/2016,Iraq,Mosul,5,0,5,Sharia proponents throw five accused homosexuals to their deaths from the roof of a building.
28711,20/4/2016,Nigeria,Zango,11,6,17,"Boko Haram gunmen fire into a village, then at fleeing residents, taking out eleven."
28712,20/4/2016,Iraq,Baghdad,2,8,10,"Jihadis bomb a popular market, killing two patrons."
28713,21/4/2016,Iraq,Baghdad,6,20,26,A half-dozen Iraqis are shot or blown up in a series of attacks by Muslim terrorists.
28714,21/4/2016,Iraq,Madain,2,8,10,Two people at a café lose their lives to Mujahid bombers.
28715,21/4/2016,Nigeria,Banki,7,9,16,Two women and their babies are among seven people exterminated by two suicide bombers at a refugee camp.
28716,21/4/2016,Afghanistan,Kunar,2,4,6,Two local cops are murdered by Taliban bombers.
28717,21/4/2016,Iraq,Ramadi,6,0,6,"ISIS members booby-trap the homes of civilians, killing six."
28718,21/4/2016,Somalia,Baay,6,0,6,al-Shabaab bombers take out six AU peacekeepers.
28719,22/4/2016,Turkey,Kilis,4,0,4,"An ISIS rocket claims the lives of four people, including a 14-year-old boy."
28720,22/4/2016,Pakistan,Pir Baba,1,0,1,A Sikh activist is assassinated by Islamists.
28721,22/4/2016,Iraq,Baghdad,9,25,34,At least nine worshippers at a Shiite mosque are blown to bits by a Sunni suicide bomber.
28722,22/4/2016,Iraq,Abu Ghraib,2,9,11,Islamist bombers murder two people.
28723,22/4/2016,Syria,Raqqa,1,0,1,A magician is beheaded by the Islamic State.
28724,22/4/2016,Iraq,Dukok,3,0,3,Three Yazidi sex slaves are killed trying to flee captivity.
28725,22/4/2016,Syria,Raqqa,1,0,1,Video shows fundamentalists beheading a man with a necklace bomb.
28726,22/4/2016,Iraq,Mosul,161,0,161,One-hundred and sixty-one more Yazidi women and girls than previously reported are executed for refusing sex slavery.
28727,23/4/2016,Iraq,Baghdad,4,8,12,A Shahid suicide bomber snuffs out four souls in a suburb.
28728,23/4/2016,Syria,Damascus,1,1,2,A woman bleeds out following a Sunni mortar attack on a refugee camp.
28729,23/4/2016,Libya,Brega,1,7,8,A guard at an oil plant is gunned down by ISIS.
28730,23/4/2016,Iraq,Baghdad,10,28,38,A suicide car bomber successfully kills ten Iraqis.
28731,23/4/2016,Bangladesh,Rajshahi,1,0,1,An 'atheist' professor is hacked to death by Islamists.
28732,23/4/2016,Syria,Idlib,4,3,7,A Fedayeen suicide bomber murders four rivals.
28733,23/4/2016,Iraq,Garma,4,15,19,Four locals are blown to bits by a Fedayeen suicide car bomber.
28734,23/4/2016,Iraq,Mosul,2,0,2,Two women are dragged to a market and executed by ISIS.
28735,23/4/2016,Bangladesh,Tungipara,1,0,1,A 75-year-old Hindu is stabbed to death over his religion by a young Muslim.
28736,24/4/2016,Thailand,Yala,1,0,1,Muslim 'insurgents' gun down a guard at a bank.
28737,24/4/2016,Nigeria,Alau,30,0,30,Thirty herdsmen and their families are massacred by Boko Haram.
28738,24/4/2016,Yemen,Mukalla,7,14,21,Seven security personnel are blown up by al-Qaeda bombers.
28739,24/4/2016,Afghanistan,Helmand,2,2,4,Two lives are extinguished by a Shahid suicide bomber.
28740,24/4/2016,Syria,Aleppo,11,0,11,"al-Qaeda linked militant send mortars into a residential neighborhood, killing eleven."
28741,24/4/2016,Turkey,Kilis,2,26,28,Two civilians are torn to shreds by an ISIS rocket.
28742,24/4/2016,Iraq,Baghdad,2,2,4,Suicide bombers kill two guards outside a rival mosque.
28743,24/4/2016,Iraq,Roufa,6,8,14,Six Iraqis are laid out by a Fedayeen suicide bomber.
28744,25/4/2016,Bangladesh,Dhaka,2,0,2,A gay rights magazine editor is stabbed to death along with a companion by five men shouting praises to Allah.
28745,25/4/2016,Syria,Sayyida Zeinab,6,42,48,"A car bomb strikes a Shiite mosque, killing six bystanders."
28746,25/4/2016,Iraq,Salahiya,3,0,3,Three women are executed for refusing to blow themselves up at a refugee camp.
28747,25/4/2016,Nigeria,Enugu,48,60,108,"Forty-eight people are reported dead after Muslim terrorists attack their village, hacking, shooting, and burning their homes and church."
28748,25/4/2016,Bangladesh,Kashimpur,1,0,1,A man is shot in front of a pharmacy at close range by Islamic militants.
28749,25/4/2016,Iraq,Mosul,4,0,4,Four young people are arrested at a university and then burned alive by caliphate members.
28750,25/4/2016,Iraq,Tahrir,7,0,7,"A family of seven, including two women and a 6-year-old, are pulled from their home and shot in the head by Islamic State loyalists."
28751,25/4/2016,Thailand,Narathiwat,1,11,12,A 33-year-old dies from wounds following a Muslim bomb blast.
28752,25/4/2016,Iraq,Baghdad,11,39,50,Eleven people standing outside a cinema in a Shiite district are eliminated by Sunni extremists.
28753,25/4/2016,Thailand,Yala,2,0,2,Two rubber traders are gunned down by Muslim terrorists.
28754,25/4/2016,Syria,Aleppo,2,6,8,Two civilians are reduced to rubble by a Sunni rocket attack on a café district.
28755,25/4/2016,Iraq,Baghdad,7,32,39,An ISIS suicide bomber massacres seven people in a shopping district.
28756,26/4/2016,Iraq,Faysaliya,7,0,7,Seven civilians are reportedly drowned in metal cages by a Sharia court.
28757,26/4/2016,Philippines,Jolo,1,0,1,The severed head of a Canadian retiree is found seven months after his capture by Abu Sayyaf.
28758,26/4/2016,Syria,al-Zahra,19,120,139,"Sunni hardliners pour rocket fire into a small town, killing at least sixteen civilians - including children."
28759,26/4/2016,Somalia,Baidoa,8,13,21,"Islamists fire an RPG into a government convoy, killing eight occupants."
28760,27/4/2016,Pakistan,Pir Mahal,1,0,1,A Christian boy is lynched for flirting with a Muslim girl.
28761,27/4/2016,Syria,Aziziye,4,25,29,Four innocents lose their lives to Sunni shrapnel.
28762,27/4/2016,Egypt,al-Arish,3,8,11,Three local cops are brought down by an al-Qaeda affiliate.
28763,27/4/2016,Pakistan,Shopian,1,0,1,Islamic militants gun down a shopkeeper.
28764,27/4/2016,Iraq,Mahmoudiya,2,7,9,Two patrons are laid out by a Mujahideen bomb blast at a popular market.
28765,27/4/2016,Iraq,Mosul,28,0,28,Twenty-eight civilians are executed for trying to flee the caliphate.
28766,27/4/2016,Afghanistan,Mehtarlam,3,0,3,A police officer turns fundamentalist and shoot three others in the back.
28767,28/4/2016,Iraq,Mosul,1,0,1,A Christian girl is burned alive in her home when her family is unable to pay jizya.
28768,28/4/2016,Iraq,Tuz Khurmatu,1,0,1,A Shiite militia sniper picks off a teenager from a distance.
28769,28/4/2016,Thailand,Yala,1,5,6,A Muslim bomb targeting military engineers on a humanitarian mission leaves one dead.
28770,28/4/2016,Afghanistan,Laghman,5,3,8,The Taliban kill five local cops in two separate terror attacks.
28771,28/4/2016,Pakistan,Fareed,1,0,1,A teenage girl is beaten and then stabbed to death after disregarding her conservative brother's instructions not to talk to boys.
28772,28/4/2016,Afghanistan,Herat,1,1,2,Suspected Taliban shoot a man to death and wound his 7-year-old son.
28773,28/4/2016,Syria,Aleppo,6,43,49,"Terrorists shell an Armenian district, killing six residents."
28774,28/4/2016,Syria,Manbij,2,0,2,Two young men are beheaded by ISIS.
28775,28/4/2016,Pakistan,Donga Gali,1,0,1,Fifteen members of a jirga council 'honor kill' a 16-year-old girl by burning her alive in a van for helping a couple elope.
28776,29/4/2016,Dagestan,Shamil,1,0,1,A retired man is murdered by suspected Islamists.
28777,29/4/2016,Syria,Aleppo,15,30,45,At least fifteen worshippers are killed when Sunnis shell a rival mosque during Friday prayers.
28778,29/4/2016,Iraq,Makhoul,3,2,5,Three local cops are taken out by an ISIS suicide bomber.
28779,29/4/2016,Iraq,Baiji,11,12,23,Four suicide car bombers kill eleven Iraqis.
28780,30/4/2016,Nigeria,Dadawa,2,0,2,A man and his daughter are burnt alive in their church by Boko Haram.
28781,30/4/2016,Syria,Aleppo,25,0,25,Over two dozen civilians are exterminated by an al-Nusra mortar attack on their neighborhood.
28782,30/4/2016,Bangladesh,Gopalpur,1,0,1,A Hindu tailor is hacked to death for 'slurring the Prophet'.
28783,30/4/2016,Pakistan,Oghi,1,0,1,A woman is honor killed by her family over a sexual affair.
28784,30/4/2016,Iraq,Dora,23,48,71,A Sunni suicide bomber sends two dozen Shiite pilgrims straight to Allah.
28785,1/5/2016,Somalia,Runirgood,22,10,32,Twenty-two defenders of a small town are killed during an al-Shabaab attack that began with a suicide bomber.
28786,1/5/2016,Yemen,Aden,5,0,5,Five people are taken down by a Fedayeen suicide car bomber.
28787,1/5/2016,Syria,Raqqa,4,0,4,Four teenagers are beheaded by the Islamic State.
28788,1/5/2016,Iraq,Samawa,38,86,124,Several children are among over three dozen dead when two suicide car bomb blasts go off in different areas.
28789,1/5/2016,Turkey,Gaziantep,2,23,25,"An ISIS suicide car bombers detonates at a police station, killing two officers."
28790,1/5/2016,Nigeria,Fadan Karshi,2,0,2,A man and his nephew are shot in the head in their own home by Fulani terrorists.
28791,2/5/2016,Iraq,Baghdad,3,0,3,Three more Shiite pilgrims are taken out by Sunni bombers.
28792,2/5/2016,Iraq,Mosul,4,0,4,Four young Yazidi women are dragged to the public square and shot in the head for trying to escape sex slavery.
28793,2/5/2016,Syria,Aleppo,3,17,20,"Sunni Radicals fire a rocket at a hospital, killing three women."
28794,2/5/2016,Iraq,Baghdad,18,45,63,Eighteen Shiite pilgrims are reduced to pulp by a Sunni car bomb.
28795,2/5/2016,Pakistan,Thakal Bala,0,18,18,Terrorists toss a hand grenade into a rival mosque.
28796,2/5/2016,Thailand,Tak Bai,1,0,1,Muslim bombers kill the member of a local security patrol.
28797,3/5/2016,Bangladesh,Chuadanga,0,2,2,Islamists toss a bomb into the home of a Christian family.
28798,3/5/2016,Syria,Aleppo,9,45,54,"al-Nusra fire 60 mortars into a Christian residential area, killing nine innocents."
28799,3/5/2016,Cameroon,Mora,1,0,1,A 14-year-old girl is killed when a suicide bomber goes off next to her.
28800,3/5/2016,Iraq,Tal Afar,5,0,5,Five women are executed by the Islamic State.
28801,3/5/2016,DRC,Beni,34,0,34,"ADF Islamists hack and slash thirty-four Christian villagers to death in their own homes, including eight women and four children."
28802,3/5/2016,Iraq,Yusufiya,2,8,10,Two people lose their lives when Mujahid bombers target a vegetable market.
28803,4/5/2016,Iraq,Hawija,4,2,6,ISIS bombers pick off four civilians trying to flee the caliphate.
28804,4/5/2016,Syria,Aleppo,3,1,4,al-Nusra militants take out three family members with a rocket attack on their home.
28805,4/5/2016,Nigeria,Zamfara,10,0,10,Muslim terrorists slaughter ten villagers in their homes.
28806,4/5/2016,Syria,Khween,15,0,15,Four children are among fifteen civilians murdered by Jabhat al-Nusra.
28807,4/5/2016,Iraq,Mosqul,5,0,5,Five girls are pulled from their homes and executed after their families could not pay a special tax to the caliph.
28808,5/5/2016,Iraq,Haswa,5,14,19,Five mourners are killed by a bomb planted at a graveyard.
28809,5/5/2016,Turkey,Kilis,1,8,9,A 5-year-old girl bleeds to death following an ISIS rocket attack on her neighborhood.
28810,5/5/2016,Afghanistan,Qadis,5,5,10,Fundamentalists take out five civilians with a remote-controlled bomb.
28811,5/5/2016,Syria,Homs,12,49,61,"A dozen people are modularized by a pair of Fedayeen suicide bombers, including four children and three women."
28812,5/5/2016,Libya,Zamzam,5,6,11,Five people at are laid out by a Shahid suicide bomber.
28813,5/5/2016,Syria,Raqqa,1,0,1,A 7-year-old boy is executed in the public square by a Sharia court for 'insulting divinity'.
28814,6/5/2016,Afghanistan,Zabul,4,1,5,Four small children from the same family are vaporized by Taliban bombers.
28815,6/5/2016,DRC,Biane,4,0,4,Four people are hacked to death by ADF Islamists.
28816,6/5/2016,Syria,Deir Ezzor,5,0,5,Five civilians are executed by the caliphate for apostasy.
28817,6/5/2016,Yemen,Marib,7,15,22,Seven patrons are left dead after suspected fundamentalists bomb a market selling qat.
28818,6/5/2016,Bangladesh,Satkhira,1,0,1,The caretaker for a Hindu temple is stabbed to death by a Muslim gang.
28819,6/5/2016,India,Kupwara,1,0,1,Islamic terrorists murder a border guard.
28820,6/5/2016,Pakistan,Di Khan,2,0,2,Two Shiite lawyers are gunned down in a targeted attack.
28821,6/5/2016,Pakistan,Miryali,2,0,2,Two Shiite school teachers are shot dead in a targeted attack.
28822,6/5/2016,Iraq,Abu Ghraib,3,13,16,Mujahideen bombers dismantle three innocentshttp://news.xinhuanet.com/english/2016-05/08/c_135343118.htm.
28823,6/5/2016,DRC,Ituri,13,0,13,Thirteen innocents are hacked to death by the Muslim Defense International.
28824,7/5/2016,Afghanistan,Khanqa,1,0,1,"An accused adulteress is forced to kneel, then shot in the head by Sharia enthusiasts."
28825,7/5/2016,Afghanistan,Jani Khel,2,0,2,Two local cops are kidnapped and murdered by religious extremists.
28826,7/5/2016,Iraq,Nasir,21,0,21,Six women and four children are among twenty-one civilians blown to bits by ISIS bombers.
28827,7/5/2016,Pakistan,Karachi,2,1,3,"Two prominent Shiites, including a liberal rights activist, are shot to death by sectarian Jihadis."
28828,7/5/2016,Nigeria,Coromo,12,18,30,Two women and three children are among a dozen villagers butchered by Fulani mercenaries.
28829,7/5/2016,Pakistan,Saddar,1,1,2,A conservative family shoots two sisters for helping another elope.
28830,7/5/2016,Bangladesh,Rajshahi,1,0,1,A Sufi leader is hacked to death by Islamists.
28831,7/5/2016,Pakistan,Karachi,1,2,3,A Sufi religious minority is hacked to death by mainstream Islamists.
28832,7/5/2016,Libya,Benghazi,5,11,16,Five protesters are killed when suspected Islamists send shells into their demonstration.
28833,7/5/2016,Afghanistan,Kandahar,2,0,2,Two NATO peacekeepers are shot in the back by Taliban in uniform.
28834,7/5/2016,Iraq,Madain,2,11,13,"Jihadis set off a bomb at a football stadium, killing two spectators."
28835,7/5/2016,Iraq,Abu Ghraib,3,5,8,A suicide bomber blows up himself and three others.
28836,7/5/2016,Syria,Manbij,1,0,1,Devout Muslims toss a gay man from a roof top.
28837,8/5/2016,Pakistan,Gujaranwala,1,0,1,"A 14-year-old Christian is hanged, allegedly for his faith."
28838,8/5/2016,Uganda,Mbaale,1,0,1,A young woman is strangled by her husband for leaving Islam for Christianity.
28839,8/5/2016,Egypt,Helwan,8,0,8,Eight local cops are machine-gunned point-blank while sitting in a bus.
28840,8/5/2016,Syria,Aleppo,4,10,14,Two women and two children are killed when Sunni extremists shell their neighborhood.
28841,8/5/2016,Iraq,Baghdad,6,11,17,"A suicide bomber detonates at a funeral, taking six mourners with him."
28842,8/5/2016,Saudi Arabia,Taif,1,0,1,"Terrorists open fire on a police station, killing an officer."
28843,8/5/2016,Iraq,Mosul,8,0,8,Eight civilians are publicly executed by a Sharia court.
28844,8/5/2016,Iraq,Jeraishi,5,8,13,A Shahid suicide bomber extinguishes five other lives.
28845,8/5/2016,Thailand,Thanto,1,0,1,A rubber tapper is gunned down by Muslim militants while on his way home.
28846,9/5/2016,Pakistan,Lodhran,1,0,1,A journalist is murdered by a Muslim family for helping one of their own marry by choice - contrary to Sharia.
28847,9/5/2016,Somalia,Mogadishu,4,9,13,Fedayeen suicide bombers murder four outside a police station.
28848,9/5/2016,Pakistan,Shrengal,4,0,4,"Suspected Islamist open fire on a car, killing four, including a woman."
28849,9/5/2016,Philippines,Tubigan,1,1,2,Islamic terrorists target and kill a 'Christian' soldier.
28850,9/5/2016,Iraq,Mosul,11,0,11,"Eleven ""enemies of Allah"" are executed by a Sharia court and thrown into a ditch."
28851,9/5/2016,Iraq,Baqubah,16,54,70,"An Islamic State suicide car bomb liberates sixteen souls outside a bakery, including children."
28852,9/5/2016,Chechnya,Grozny,1,4,5,A local cop is killed by a suicide bomber.
28853,10/5/2016,Iraq,Riyadh,5,0,5,Three children are among a family of five burned alive for trying to escape the caliphate.
28854,10/5/2016,Germany,Grafing,1,3,4,A man shouting praises to Allah stabs four commuters at a train station.
28855,10/5/2016,Afghanistan,Nazyan,11,22,33,Four children are among eleven blown to bits when a suicide bomber detonates outside a home.
28856,10/5/2016,Pakistan,Quetta,2,5,7,Taliban bombers murder two guards outside a university.
28857,10/5/2016,Iraq,Qayyarah,45,0,45,Forty-five people are buried alive by the caliphate.
28858,10/5/2016,Afghanistan,Lashkar Gah,15,0,15,Armed fundamentalists overrun two checkpoints and massacre fifteen policemen.
28859,10/5/2016,Nigeria,Biu,3,0,3,"Boko Haram set fire to two villages, killing three residents."
28860,10/5/2016,Iraq,Baqubah,3,0,3,Three truck drivers are stopped and summarily executed by caliphate advocates.
28861,10/5/2016,Iraq,Mahmoudiya,2,9,11,Two civilians are sectionalized by a Jihadi bomb blast at a market.
28862,10/5/2016,Israel,Jerusalem,0,2,2,Two elderly women are stabbed by a Palestinian terrorist.
28863,11/5/2016,Nigeria,Maiduguri,4,0,4,"Two bombings, one a suicide attack on a mosque, kill four people."
28864,11/5/2016,Iraq,Jamea,13,31,44,Over a dozen Iraqis are eliminated by a Shahid suicide bomber.
28865,11/5/2016,Iraq,Kadhimiya,17,43,60,"A Fedayeen suicide bomber detonates near a Shiite shrine, killing seventeen innocents."
28866,11/5/2016,Iraq,Sadr City,68,165,233,A suicide bomber targets a Shiite commercial district and slaughters over sixty near a beauty salon.
28867,11/5/2016,Yemen,Hadramawt,4,0,4,An al-Qaeda suicide bomber takes out four other people.
28868,11/5/2016,Pakistan,Faisalbad,3,0,3,Three young women from the same family are shot dead by a conservative relative on suspicion of 'illicit relations'.
28869,12/5/2016,Kenya,Shamu,1,2,3,A man is machine-gunned in his own living room by al-Shabaab.
28870,12/5/2016,Iraq,Jarayshi,17,0,17,Seventeen Iraqis are blown to bits by suicide truck bombers.
28871,12/5/2016,Mali,Gao,2,0,2,Two local soldiers are killed by a Jihadist landmine and ambush.
28872,12/5/2016,Nigeria,Maiduguri,8,19,27,A Fedayeen suicide bombing claims eight innocents.
28873,12/5/2016,Yemen,Mukalla,13,15,28,An ISIS suicide attack leaves thirteen dead.
28874,12/5/2016,Iraq,Nineveh,5,0,5,ISIS forces five civilians to shoot kneeling apostates in the head.
28875,12/5/2016,Iraq,Abu Ghraib,3,10,13,Three others are killed by two ISIS suicide bombers.
28876,13/5/2016,Nigeria,Tarfi,60,11,71,Muslim terrorists raid a village and massacre sixty residents.
28877,13/5/2016,Syria,Aleppo,7,0,7,Two children are among seven civilians pulled into pieces by Sunni shrapnel.
28878,13/5/2016,Syria,al-Zara,19,0,19,"Nineteen religious minorities, including six women are butchered in their homes by al-Nusra."
28879,13/5/2016,Iraq,Mosul,11,0,11,Eleven civilians are executed by an ISIS firing squad for using cell phones.
28880,13/5/2016,Iraq,Balad,16,20,36,Sixteen people at a café are machine-gunned by three Islamists for being soccer fans.
28881,13/5/2016,Iraq,Balad,4,0,4,Four guards at a vegetable market are turned to paste by a Fedayeen suicide bomber.
28882,14/5/2016,Somalia,Aden Yabal,4,0,4,Four tribal elders are executed by Islamic hardliners.
28883,14/5/2016,Thailand,Sai Buri,1,0,1,Muslim terrorists are thought responsible for slaying a 55-year-old man on his way home.
28884,14/5/2016,Pakistan,Gomal,1,0,1,A member of a peace committee is gunned down by religious extremists.
28885,14/5/2016,Syria,Raqqa,1,0,1,A man is crucified in line with 'Quranic punishment'.
28886,14/5/2016,Syria,Deir Ezzor,20,0,20,"ISIS members assault a hospital, killing twenty inside."
28887,14/5/2016,Dagestan,Derbent,2,15,17,"Islamic State operatives open fire on police, killing two."
28888,14/5/2016,Afghanistan,Nad Ali,3,9,12,Three people are laid out by a Shahid suicide car bomber.
28889,14/5/2016,Bangladesh,Bandarban,1,0,1,An elderly Buddhist monk is hacked to death by Religion of Peace activists.
28890,14/5/2016,Nigeria,Ajaji,1,2,3,"Muslim 'nomads' attack three women, beheading one and leaving the others with deep machete wounds."
28891,14/5/2016,Syria,Qamishli,6,15,21,Terrorists kill six civilians with a car bomb.
28892,14/5/2016,Iraq,Amiriyat Fallujah,6,18,24,A wave of suicide bombers manage to take down only a half-dozen others.
28893,15/5/2016,Egypt,al-Arish,1,1,2,Fundamentalists assassinate a young police recruit.
28894,15/5/2016,Yemen,Hadramawt,6,1,7,Six police officers are disassembled by an ISIS bomber.
28895,15/5/2016,Yemen,Mukalla,41,60,101,Forty-one police recruits are obliterated by a Shahid suicide bomber.
28896,15/5/2016,Iraq,Baghdad,8,28,36,Suicide bombers murder eight Iraqis.
28897,15/5/2016,Iraq,Taji,14,21,35,A suicide bomb attack on a cooking gas factory leaves fourteen others dead.
28898,15/5/2016,Syria,Aleppo,2,0,2,Two locals are brutally murdered by teenage French ISIS.
28899,15/5/2016,Iraq,Latifiya,7,18,25,"ISIS bombers target a shopping area, killing seven bystanders."
28900,15/5/2016,Syria,Deir Ezzor,10,0,10,At least ten others are killed when ISIS militants attack and desecrate a non-Muslim cemetery.
28901,16/5/2016,Iraq,Tahrir,21,0,21,A 'moral accountability' squad stones a woman and twenty 'youth' over illicit relations.
28902,16/5/2016,Syria,Manbij,1,0,1,A young man is crucified by the Islamic State.
28903,16/5/2016,Iraq,Bezaas Kanaan,1,0,1,A farmer is shot to death at his orchard by Sunni extremists.
28904,16/5/2016,Dagestan,Suleiman-Stal,1,0,1,An accountant is gunned down by suspected Islamists.
28905,16/5/2016,Libya,Buairat el-Hassun,32,50,82,Thirty-two locals are taken down by ISIS suicide bombers.
28906,16/5/2016,Afghanistan,Helmand,3,0,3,Three less radical Muslims are shot in the head by ISIS.
28907,16/5/2016,Afghanistan,Abkhor,4,0,4,Four guards at a road construction site are blown to bits by Taliban fundamentalists.
28908,16/5/2016,Chechnya,Grozny,0,6,6,An ISIS suicide bomber detonates after disguising himself as a goat herder.
28909,16/5/2016,Somalia,Mogadishu,2,3,5,Two others are blown to bits by a suicide car bomber.
28910,16/5/2016,Afghanistan,Khoshamand,7,4,11,Seven local cops are machine-gunned in their cars by the Taliban.
28911,16/5/2016,India,Batapora,1,0,1,Religious radicals kidnap and execute a carpenter.
28912,16/5/2016,Iraq,Baghdad,4,17,21,Two Mujahideen bomb blasts leave four dead.
28913,16/5/2016,Iraq,Khalidiya,5,15,20,"The Islamic State sends a rocket into a small town, taking out five residents."
28914,17/5/2016,Iraq,Habibia,9,0,9,At least nine patrons are killed when a suicide bomber wades into a packed restaurant and detonates.
28915,17/5/2016,Iraq,al-Shaab,41,75,116,A female suicide bomber murders over forty people who gathered to help victims of an earlier blast.
28916,17/5/2016,Iraq,Rashid,8,22,30,Eight Iraqis are reduced to pulp by an ISIS car bombing.
28917,17/5/2016,Iraq,Sadr City,30,57,87,Thirty people at a market are exterminated by a Fedayeen suicide bomber.
28918,17/5/2016,Libya,Abugrein,4,5,9,ISIS shrapnel claims four lives.
28919,17/5/2016,Iraq,Daquq,1,0,1,An ISIS bomb takes out an Australian charity worker trying to protect children.
28920,17/5/2016,Syria,Ghouta,4,12,16,Four civilian bystanders are killed during a clash between rival Islamist groups.
28921,17/5/2016,Syria,Aleppo,1,6,7,A woman bleeds to death following a Sunni rocket blast.
28922,18/5/2016,Mali,Kidal,5,3,8,Five UN peacekeepers are murdered by religious extremists.
28923,18/5/2016,Iraq,Latifiya,9,9,18,The Islamic State kills nine with a booby-trapped home.
28924,18/5/2016,Syria,Genderes,1,1,2,A civilian is killed when ISIS members send rockets into a neighborhood.
28925,18/5/2016,Pakistan,Peshawar,1,15,16,Islamic militants kill a local cop with a bomb.
28926,18/5/2016,Libya,Sirte,24,0,24,A rights group reports that two dozen people are pulled from their homes by ISIS and 'unlawfully' executed.
28927,18/5/2016,Iraq,Mosul,25,0,25,The caliphate tortures and executes twenty-five people with nitric acid.
28928,19/5/2016,Iraq,Taji,3,10,13,"Mujahideen bomb an industrial district, killing three passersby."
28929,19/5/2016,Afghanistan,Baghlan Jadid,11,0,11,Five children and two women are among a family of eleven exterminated by Taliban bombers.
28930,19/5/2016,Afghanistan,Qalat,8,0,8,A Taliban in uniform shoots eight unarmed soldiers.
28931,19/5/2016,Syria,Tabqa,3,0,3,Three citizens of the Islamic State are executed for apostasy.
28932,19/5/2016,Germany,Baden-Württemberg,1,0,1,A 70-year-old woman is murdered in her home by a young Muslim who leaves a 'religious' note at the scene.
28933,20/5/2016,England,London,0,4,4,A Turkish man yelling about Lee Rigby stabs four women in a parking lot on the third anniversary.
28934,20/5/2016,Tanzania,Mwanza,3,1,4,Islamic extremists hack three people at a rival mosque to death with machetes.
28935,20/5/2016,Iran,Urmia,5,0,5,Five Kurdish rights activists are publicly hanged for 'conspiring against Islam'.
28936,20/5/2016,Iraq,Mosul,3,0,3,Three civilians are captured and beheaded by the Islamic State.
28937,20/5/2016,Afghanistan,Kabul,1,1,2,A UN security guard is gunned down by suspected Taliban.
28938,20/5/2016,Yemen,Wilayet,3,0,3,Fundamentalists gruesomely execute three men - one by crushing his head with a rock.
28939,20/5/2016,Niger,Yebi,8,7,15,"Boko Haram set a village on fire and shoot into it, killing at least eight."
28940,20/5/2016,Bangladesh,Kushtia,1,1,2,A 55-year-old homoeopathic doctor is hacked to death by Religion of Peace activists.
28941,20/5/2016,Syria,Idlib,1,0,1,A woman is vaporized by an ISIS tank shell.
28942,20/5/2016,Syria,Sheikh Maqsoud,1,5,6,A young girl is killed when terrorists bomb her neighborhood.
28943,20/5/2016,Iraq,Husseiniya,2,6,8,A Jihadi bomb blast near a row of shops leaves two dead.
28944,21/5/2016,Afghanistan,Charchino,6,0,6,A Taliban insider shoots six local cops in the back.
28945,21/5/2016,Egypt,Sheikh Zuweid,3,0,3,Three local cops are laid out by a fundamentalist bomb blast.
28946,21/5/2016,Iraq,Dujail,7,28,35,A Shahid suicide bomber massacres seven patrons at a popular market.
28947,21/5/2016,Iraq,Tarmiya,2,7,9,Two people are blown to bits by a Mujahideen bomb blast at a market.
28948,22/5/2016,Iraq,Suleiman Beg,2,11,13,Two Shiites are taken out by an ISIS suicide bomber.
28949,22/5/2016,Afghanistan,Herat,1,7,8,A Taliban rocket claims the life of a civilian.
28950,22/5/2016,Syria,Qamishli,6,15,21,Six Assyrians are laid out by Allah-praising suicide bombers targeting a Christian restaurant.
28951,22/5/2016,Syria,Tal Tamr,5,0,5,Two suicide bombers take out five Kurds.
28952,22/5/2016,Sudan,Arzini,8,5,13,Children are among the victims when Arabs fire into a group of Africans at a mosque.
28953,22/5/2016,Iraq,Rataba,8,0,8,Eight people are burned alive in ovens by the caliphate.
28954,22/5/2016,Iraq,Mosul,19,0,19,Nineteen young women and men are executed by the Islamic State on charges of apostasy.
28955,23/5/2016,Syria,Jableh,180,300,480,Children are among one-hundred and eighty innocents incinerated or blown apart by ISIS suicide blasts.
28956,23/5/2016,Pakistan,Bara Bandai,2,0,2,A peace committee member and his guard are assassinated by Islamist gunmen.
28957,23/5/2016,India,Tengpora,1,0,1,A police officer is shot to death by Muslim terrorists.
28958,23/5/2016,Yemen,Aden,45,60,105,At least forty young people lining up for work are blown to bits by two Fedayeen suicide bombers.
28959,23/5/2016,India,Zadibal,2,2,4,Islamic militants gun down two cops at close range.
28960,23/5/2016,Yemen,Jazan,1,3,4,A Shiite landmine kills a Saudi border guard.
28961,23/5/2016,Syria,Mayadin,1,0,1,A teenager is publicly stoned to death on charges of being gay.
28962,23/5/2016,Afghanistan,Shah Wali Kot,5,4,9,Five civilians are killed and four others badly wounded by a Taliban bomb blast.
28963,24/5/2016,Yemen,Sanaa,2,2,4,Sunni extremists are suspected of a university bombing that leaves two dead.
28964,24/5/2016,Iraq,Mosul,12,0,12,Twelve civilians are hauled from their homes and executed by the Islamic State.
28965,24/5/2016,Iraq,Zafaraniya,2,6,8,"Jihadis bomb a popular restaurant, killing two people."
28966,25/5/2016,Pakistan,Karachi,1,1,2,Religious extremists gun down an Ahmadi religious minority and injure his friend.
28967,25/5/2016,Afghanistan,Kabul,11,10,21,Eleven lives are snuffed out by a suicide bomber on foot targeting a bus carrying court employees.
28968,25/5/2016,Turkey,"Hah, Tur Abdin",5,0,5,At least five people are killed when a suicide bomber targets a checkpoint outside two historic churches.
28969,25/5/2016,Syria,Aleppo,7,5,12,Three women and two children are among seven innocents torn to shreds by Sunni rockets.
28970,25/5/2016,Bangladesh,Gobindaganj,1,0,1,A physically disabled Hindu trader's throat is cut by radicalized Muslims.
28971,25/5/2016,India,Kupwara,1,0,1,A porter is shot to death by Islamic terrorists.
28972,25/5/2016,Iraq,Suleiman Bag,2,6,8,At least two others are killed by a Shahid suicide bomber.
28973,25/5/2016,Pakistan,Patang Chowk,2,1,3,"Islamists fire on a police vehicle, killing two occupants."
28974,25/5/2016,India,Pulwama,1,1,2,Muslim terrorists shoot a cop to death and injure a woman.
28975,25/5/2016,Pakistan,Peshawar,1,0,1,A transgender is shot by 'conservative elements.'
28976,26/5/2016,Syria,Aleppo,1,0,1,Sunni snipers pick off a civilian in a Shiite area.
28977,26/5/2016,Iraq,Mishada,4,16,20,"Jihadis strike a commercial area with two bomb blasts, laying out four bystanders."
28978,26/5/2016,Iraq,Baghdad,3,10,13,Three shoppers in a retail district are sent to Allah by Mujahid bombers.
28979,26/5/2016,Iraq,Tarmiya,5,3,8,Five people are killed when ISIS booby-traps a house.
28980,26/5/2016,Pakistan,Karachi,2,0,2,Two Shiites are gunned down by sectarian Jihadis.
28981,27/5/2016,Mali,Bamako,5,4,9,Five UN peacekeepers are killed from a Jihadi landmine and small arms attack.
28982,27/5/2016,France,Saint Julien du Puy,0,1,1,An off-duty soldier is stabbed by ISIS supporters while jogging.
28983,27/5/2016,Syria,Aleppo,1,9,10,"Holy Warriors fire ten rockets into a neighborhood, managing to take down an elderly woman."
28984,28/5/2016,Syria,Ain al-Dananeer,1,3,4,A woman is obliterated by an al-Nusra rocket.
28985,28/5/2016,Syria,Shaddadi,4,18,22,Three Shahid suicide bombers take out four Kurds.
28986,28/5/2016,Philippines,Sulu,2,3,5,Abu Sayyaf gunmen kill two people during an attempt to kidnap a female physician.
28987,28/5/2016,Syria,Raqqa,4,0,4,Four young men are beheaded by the Islamic State.
28988,28/5/2016,Iraq,Fallujah,2,20,22,ISIS shrapnel dismantles two women.
28989,28/5/2016,Iraq,Baghdad,12,8,20,Islamists machine-gun a dozen fan watching soccer on television.
28990,29/5/2016,Afghanistan,Nadi Ali,4,10,14,Four local security personnel lose their lives to a Taliban assault.
28991,29/5/2016,Niger,Pandogari,4,0,4,A Muslim mob burns churches and kill four people based on a 'blasphemous' post on Facebook.
28992,29/5/2016,Iraq,Kahriz,2,21,23,A chlorine gas attack by ISIS on a small village produces two dead children.
28993,29/5/2016,Egypt,Sinai,2,3,5,Fundamentalists kill two local cops with a roadside bomb.
28994,29/5/2016,Nigeria,Biu,5,0,5,A woman and her baby are among five people slain by Boko Haram bombers.
28995,29/5/2016,Mali,Savare,5,1,6,Jihadis ambush and murder five UN peacekeepers.
28996,29/5/2016,Iraq,Karmardi,11,0,11,A Shahid with a suicide belt sends eleven souls to Allah.
28997,29/5/2016,Iraq,Mualimeen,7,35,42,Seven people are slaughtered at a casino by a Fedayeen suicide bomber.
28998,29/5/2016,Iraq,Wilayat al-Jazihra,3,0,3,The caliphate imposes the 'rule of Allah' on three captives by executing them.
28999,30/5/2016,Syria,Aleppo,5,21,26,Five civilians are pulled into pieces by Sunni rockets.
29000,30/5/2016,Syria,Palmyra,150,0,150,A mass grave is discovered containing the remains of one-hundred and fifty victims of ISIS torture and execution.
29001,30/5/2016,Kenya,Bongwe,3,0,3,Three village elders are shot to death in their homes by al-Shabaab.
29002,30/5/2016,Afghanistan,Helmand,47,40,87,A massive two-day assault by the Taliban leaves nearly fifty police and citizens dead.
29003,30/5/2016,Tunisia,Samama Mountain,2,0,2,Two women collecting herbs are vaporized by an Islamist landmine.
29004,30/5/2016,Pakistan,Mardan,0,12,12,Children are among the casualties of a suicide bomber.
29005,30/5/2016,Iraq,Sadr City,3,10,13,Sunnis take down three Shiites with a motorcycle bomb at a market.
29006,30/5/2016,Iraq,Tarmiya,10,24,34,"A Shahid suicide bomber strikes a popular market, killing ten patrons."
29007,30/5/2016,Iraq,Shaab,11,14,25,Eleven Iraqis are sent to Allah by a Fedayeen suicide car bomber.
29008,30/5/2016,Tanzania,Tanga,8,0,8,Eight people are hacked to death in their beds by suspected Islamists.
29009,31/5/2016,Mali,Gao,4,3,7,al-Qaeda members murder four UN mission staff.
29010,31/5/2016,Iraq,Suleiman Bek,4,13,17,A Holy warrior with a suicide vest obliterates four souls along a city street.
29011,31/5/2016,Somalia,Galgala Hills,2,0,2,Two Somalis lose their lives to an al-Shabaab bomb blast.
29012,31/5/2016,Egypt,Qabr Omeir,6,6,12,Six young police recruits are murdered by an Islamic State linked group.
29013,31/5/2016,Thailand,Narathiwat,2,0,2,Five Muslim 'separatists' ambush and kill two local security personnel.
29014,31/5/2016,Afghanistan,Kunduz,17,30,47,The Taliban stop four civilian buses and summarily execute seventeen passengers.
29015,31/5/2016,Nigeria,Ninte,3,0,3,"Muslim terrorists burn churches and a pastors home, and hack three villagers to death as they slept."
29016,1/6/2016,Iraq,Nineveh,13,0,13,Thirteen people are executed for refusing to join the Islamic State.
29017,1/6/2016,Iraq,Abu Ghraib,2,4,6,Two Iraqis are eliminated by Mujahid bombers.
29018,1/6/2016,Iraq,Madain,2,9,11,"Jihadis set off a bomb near a sports arena, taking out two bystanders."
29019,1/6/2016,Sudan,Singi,1,0,1,A Janjaweed-linked militia guns down a rival imam.
29020,1/6/2016,Iraq,Mosul,6,0,6,Six men are executed by the caliphate for selling cigarettes.
29021,1/6/2016,Somalia,Mogadishu,16,55,71,"Islamists stage a suicide assault on a hotel, killing at least sixteen guests."
29022,1/6/2016,Afghanistan,Balkh,1,3,4,A local police chief is assassinated by Taliban bombers.
29023,1/6/2016,Afghanistan,Ghazni,6,13,19,Fundamentalists storm a court building in a suicide attack that leaves five civilians and one police officer dead.
29024,1/6/2016,Iraq,Tal Afar,3,0,3,Three young men are forced to their knees and then shot in the back of the head by the Islamic State.
29025,1/6/2016,Libya,Sirte,10,40,50,Ten Libyans are taken out by two ISIS suicide bombers.
29026,2/6/2016,Afghanistan,Sheikh Ali,3,0,3,A woman is among three aid workers murdered by religious extremists.
29027,2/6/2016,Afghanistan,Kunduz,2,0,2,"Two civilians, taken hostage after being pulled from a bus, are executed by the Taliban."
29028,2/6/2016,Nigeria,Kano,1,0,1,Muslim youth behead a Christian woman for insulting Muhammad after an argument over religion.
29029,2/6/2016,Syria,Latakia,5,0,5,Five people are reported killed when a suicide bomber strikes a rival mosque.
29030,2/6/2016,Pakistan,Faqirabad,1,0,1,A retired man is shot to death by religious radicals.
29031,3/6/2016,Dagestan,Ashaga-Stal,1,0,1,Islamists break into a policeman's home and murder him in front of his wife and children.
29032,3/6/2016,Nigeria,Waga,2,3,5,Boko Haram kill two villagers and abduct three women.
29033,3/6/2016,Iraq,Mosul,19,0,19,Nineteen Yazidi girls are put in cages and burned alive for refusing sex with caliphate members.
29034,3/6/2016,Yemen,Taiz,17,30,47,Ten women and a girl are among seventeen shredded by Shiite shrapnel at a market.
29035,3/6/2016,Iraq,Fallujah,2,3,5,"A suicide bomber targets a family fleeing the caliphate, killing two members."
29036,3/6/2016,Iraq,Abu Dsher,3,7,10,Three Iraqis are reduced to pulp by Mujahid shrapnel.
29037,3/6/2016,India,Bejbehara,3,5,8,Islamic terrorists ambush and kill three members of a local security convoy.
29038,3/6/2016,Iraq,Khalis,2,2,4,A probable premature detonation in a taxi cab leaves two dead.
29039,3/6/2016,Niger,Bosso,32,67,99,Thirty-two defenders are slain during a massive Boko Haram assault on a small town.
29040,4/6/2016,Niger,Bosso,1,0,1,A convert to Christianity is singled out and executed by Muslim radicals.
29041,4/6/2016,Syria,Hamadaniyey,5,47,52,A well-placed Sunni shell takes out five residents in their own neighborhood.
29042,4/6/2016,Syria,Aleppo,7,33,40,Seven civilians are killed when Sunni terrorists fire rockets into their section of a city.
29043,4/6/2016,India,Anantnag,2,0,2,Two cops are gunned down by Muslim terrorists.
29044,4/6/2016,Iraq,Baghdad,7,25,32,Terrorists kill seven Iraqis in two separate attacks on a restaurant and market.
29045,4/6/2016,Iraq,Tarmiyah,8,15,23,A Shahid suicide bomber eliminates eight people waiting at a checkpoint.
29046,4/6/2016,Iraq,Fallujah,34,15,49,Thirty-four Iraqis are killed by two Islamic State suicide bombers.
29047,4/6/2016,Iraq,Fallujah,400,0,400,A mass grave is discovered containing at least four hundred victims of ISIS executions.
29048,5/6/2016,Philippines,Sumisip,2,0,2,Two off-duty soldiers are machine-gunned point-blank by two Abu Sayaaf gunmen.
29049,5/6/2016,Somalia,Mogadishu,1,0,1,A female journalist is assassinated by al-Shabaab outside a college campus.
29050,5/6/2016,Pakistan,Sachal Goth,3,0,3,Two Hindus are among three slain at a liquor shop by members of a banned terror group.
29051,5/6/2016,Bangladesh,Natore,1,0,1,A Christian man is hacked to death at his shop by Islamists.
29052,5/6/2016,Syria,Aleppo,2,27,29,Two people are killed when Islamists target a church with rockets.
29053,5/6/2016,Bangladesh,Chittagong,1,0,1,A woman is murdered in her home by religious radicals.
29054,5/6/2016,Iraq,al-Mahouz,3,0,3,Three civilians are beheaded by the Islamic State.
29055,5/6/2016,Afghanistan,Puli Alim,7,23,30,Islamic hardliners with suicide vests storm a courthouse and murder seven workers.
29056,5/6/2016,Pakistan,Attock,1,0,1,A 65-year-old Ahmadi religious minority is gunned down.
29057,5/6/2016,Iraq,Abu Ghraib,3,7,10,A Jihadi bomb blast ends the lives of three people at a market.
29058,5/6/2016,Afghanistan,Kabul,3,3,6,Fundamentalists set off a bomb outside a house that leaves three dead.
29059,5/6/2016,Kazakhstan,Aktobe,6,3,9,Islamic radicals murder six people in two separate attacks.
29060,5/6/2016,Afghanistan,Kabul,1,0,1,An NPR journalist and his translator are picked off by Taliban snipers.
29061,6/6/2016,Cameroon,Darak,10,0,10,Ten fishermen are cut down by Boko Haram.
29062,6/6/2016,Yemen,Taiz,8,13,21,"Shiite shells kill eight family members, including three children."
29063,6/6/2016,Iraq,Fallujah,4,0,4,Four civilians are tortured to death by a Shiite militia.
29064,6/6/2016,Yemen,Khormaksar,1,0,1,A civilian is killed when Muslim extremists fire on an airport.
29065,6/6/2016,Afghanistan,Sari Pul,7,0,7,A child is among seven gunned down by Taliban fundamentalists.
29066,6/6/2016,Iraq,Mosul,11,0,11,Eleven people are executed in front of their families for trying to flee the caliphate.
29067,6/6/2016,Thailand,Narathiwat,3,2,5,Two villagers are shot point blank by Muslim terrorists.
29068,6/6/2016,Egypt,Sadwet,1,0,1,A young policeman is shot to death in the name of Allah.
29069,6/6/2016,Nigeria,Adamawa,4,0,4,Four farmers are murdered by Boko Haram.
29070,6/6/2016,Iraq,Baghdad,2,11,13,"Jihadis bomb a local market, killing two patrons."
29071,6/6/2016,Jordan,Amman,5,0,5,At least five employees are killed in their office by Islamic militants.
29072,6/6/2016,Iraq,Mosul,65,0,65,"Sixty-five civilians, including university students, are rounded up and executed by caliphate staff."
29073,7/6/2016,Iraq,Khazar,5,0,5,Five displaced persons are further removed by ISIS bombers.
29074,7/6/2016,Afghanistan,Ghazni,12,50,62,The Taliban stop vehicles along a highway and massacre a dozen occupants.
29075,7/6/2016,Afghanistan,Sokhti,11,12,23,Eleven local security personnel are killed during a Taliban attack.
29076,7/6/2016,Iraq,Karbala,7,20,27,A Sunni suicide bomber produces seven dead Shiites at a commercial area.
29077,7/6/2016,Bangladesh,Jhenaidah,1,0,1,A 69-year-old Hindu priest is hacked to death by Islamic radicals.
29078,7/6/2016,Iraq,Haditha,2,0,2,Two female factory workers are disassembled by a Fedayeen suicide bomber.
29079,8/6/2016,Syria,Manbij,19,0,19,Nineteen civilians are killed by the Islamic State.
29080,8/6/2016,Libya,Buairat el-Hassun,7,18,25,An ISIS car bomb claims seven lives.
29081,8/6/2016,Libya,Abu Grein,25,32,57,Over two dozen defenders are killed during an ISIS assault on a small town.
29082,8/6/2016,Iraq,Hanbas,3,3,6,An ISIS bomb blast lays out three Shiites.
29083,8/6/2016,Israel,Tel Aviv,4,13,17,"Muslims disguised as Orthodox Jews fire into a food and retail market, killing four patrons as they praise Allah."
29084,8/6/2016,Pakistan,Lahore,1,0,1,A 17-year-old girl is burnt alive by her conservative mother for eloping without permission.
29085,9/6/2016,Syria,Meydan,5,50,55,At least five are killed when al-Nusra deliberately shells a civilian area.
29086,9/6/2016,Somalia,Halgan,43,0,43,Dozens of AU peacekeepers are massacred during an al-Shabaab suicide assault.
29087,9/6/2016,Iraq,Taji,12,32,44,A dozen Iraqis are sent to Allah by a Shahid suicide bomber.
29088,9/6/2016,Iraq,Baghdad,19,46,65,"A Sunni suicide bomber targets a commercial district in a Shiite area, killing nineteen."
29089,9/6/2016,Iraq,Kirkuk,1,5,6,A mother is killed by an IS IED while leading her family out of the caliphate.
29090,9/6/2016,Iraq,Mosul,1,0,1,A woman is stoned to death in front of a mosque for adultery.
29091,9/6/2016,Iraq,Wilayat Salahuddin,1,0,1,A man is beheaded for sorcery by the caliphate.
29092,9/6/2016,Syria,Handarat,1,8,9,A Sunni rocket claims the life of a child.
29093,9/6/2016,Pakistan,Changa Manga,0,1,1,A Christian man is badly beaten by a Muslim mob for selling food deemed 'unclean' because of his religion.
29094,10/6/2016,Somalia,Bula Fulay,4,0,4,A pro-Sharia group beheads one man and shoot three others.
29095,10/6/2016,Nigeria,Mairari,4,0,4,Islamists drag four women out of their homes and slit their throats.
29096,10/6/2016,Syria,Ghandoura,37,0,37,"ISIS members massacre at least thirty-seven villagers, including women and children."
29097,10/6/2016,Syria,Aleppo,3,15,18,A young girl is among three civilians aerated by Sunni shrapnel.
29098,10/6/2016,Syria,al-Zahraa,1,6,7,A civilian is killed when terrorists send a rocket into a home.
29099,10/6/2016,Egypt,Rafah,1,0,1,A young police recruit is cut down in the prime of life by Islamic radicals.
29100,10/6/2016,Bangladesh,Dhaka,1,0,1,A 62-year-old Hindu monastery worker is hacked to death by Religion of Peace proponents.
29101,10/6/2016,Iraq,Fallujah,30,0,30,"Islamists spray machine-gun fire into a crowd of women and children trying to flee the caliphate, killing at least thirty."
29102,10/6/2016,Iraq,Baghdad,3,11,14,A Shahid suicide bomber takes out three other souls.
29103,10/6/2016,Pakistan,Lahore,3,1,4,A young couple are honor killed for marrying against their family's wishes along with a friend who helped them.
29104,10/6/2016,Syria,Bukamal,1,0,1,One person is crucified for eating during Ramadan.
29105,11/6/2016,Syria,Manbij,1,3,4,"Islamists invade a home, kill the man and rape his wife and two daughters."
29106,11/6/2016,Libya,Benghazi,7,8,15,Seven civilians lose their lives when Islamists shell their neighborhood.
29107,11/6/2016,Syria,Sayyida Zeinab,20,30,50,A double suicide bombing outside a Shiite mosque leaves at least twenty dead.
29108,11/6/2016,Afghanistan,Rodat,4,70,74,Religious extremists plant a bomb in a rival mosque that eliminates four worshippers.
29109,11/6/2016,Afghanistan,Haska Mena,6,11,17,At least six are left dead after Islamic State members fire into a police station.
29110,11/6/2016,Iraq,Sichr,17,0,17,Seventeen people are allegedly massacred by a Shiite militia.
29111,11/6/2016,Iraq,Yathrib,10,0,10,A grave is discovered containing ten ISIS victims.
29112,11/6/2016,Iraq,Tarmiya,7,0,7,Three children and two women are among seven family members massacred in their home by sectarian activists.
29113,12/6/2016,Libya,Sirte,3,7,10,"A suicide bomber detonates at a hospital, taking three others with him."
29114,12/6/2016,Syria,Raqqa,1,0,1,A caliphate member executes his own brother for apostasy.
29115,12/6/2016,Afghanistan,Ghor,1,0,1,The Taliban cut out the eyes of a day laborer and skin him alive.
29116,12/6/2016,Iraq,Razalani,2,0,2,An ISIS member slaughters his own parents for refusing to hand over his brothers to the caliphate.
29117,12/6/2016,Cameroon,Darak,42,0,42,The bodies of forty-two fishermen are found a few days after they were captured by Boko Haram.
29118,12/6/2016,USA,"Orlando, FL",49,53,102,An Islamic extremist massacres forty-nine people at a gay nightclub.
29119,12/6/2016,Iraq,Fallujah,27,17,44,Two ISIS suicide attacks produce over two dozen dead Iraqis.
29120,12/6/2016,Libya,Sirte,1,0,1,A Fedayeen suicide bomber claims one other life.
29121,12/6/2016,Syria,Sanilurfa,0,1,1,ISIS gunmen shoot a journalist three times.
29122,13/6/2016,Pakistan,Ghor,1,0,1,A Sharia court executes a woman on a charge of trying to escape her home.
29123,13/6/2016,Iraq,Fallujah,49,0,49,Shiite radicals are accused of executing at least forty-nine civilians displaced by the violence.
29124,13/6/2016,France,Magnanville,2,1,3,A terrorist stabs a couple to death while shouting praises to Allah.
29125,13/6/2016,Libya,Sirte,2,3,5,Two people are killed when a suicide bomber detonates outside a government building.
29126,13/6/2016,Iraq,Ramadi,5,11,16,Five Iraqis are taken out by ISIS suicide bombers.
29127,13/6/2016,India,Kud,1,6,7,"Muslim militants open fire from a bus, killing a woman and injuring a child."
29128,13/6/2016,Philippines,Samal Island,1,0,1,A Canadian hostage is beheaded by Abu Sayyaf.
29129,13/6/2016,Pakistan,Ghor,1,0,1,A woman is shot dead by her family for attempting to leaver her husband.
29130,14/6/2016,India,Kupwara,1,5,6,"A group of terrorists attack a police patrol, killing one officer."
29131,14/6/2016,Iraq,Baghdad,2,9,11,A Mujahid bomb blast at a market produces two corpses.
29132,14/6/2016,Nigeria,Kautuva,4,3,7,"Jihadists burn down houses, murder four villagers and kidnap three women."
29133,14/6/2016,Belgium,Etterbeek,0,1,1,A transgender is stabbed by religious radicals.
29134,14/6/2016,CAR,Ngaoundaye,10,0,10,At least ten villagers are slaughtered by Muslim militia.
29135,15/6/2016,Iraq,Fallujah,4,0,4,A journalist is among four Iraqis killed by an ISIS mortar round.
29136,15/6/2016,Bangladesh,Madaripur,0,1,1,A Hindu college professor is stabbed by Muslim radicals.
29137,15/6/2016,Syria,Raqqa,1,0,1,A 4-year-old girl is allegedly beheaded by the caliphate.
29138,15/6/2016,Afghanistan,Kohmard,1,0,1,A local governor is assassinated by Sharia proponents.
29139,15/6/2016,Iraq,Yusufiyah,7,0,7,At least seven Iraqis are sent to Allah by a Fedayeen suicide bomber.
29140,15/6/2016,Iraq,Baghdad,2,8,10,"Jihadi bombers target a fruit and vegetable market, killing two patrons."
29141,16/6/2016,Uganda,Luuka,1,0,1,A Christian woman's baby is poisoned to death by a Muslim family member for being fed during Ramadan.
29142,16/6/2016,Syria,Latakia,1,0,1,"A suicide bomber hits an aid convoy, killing one member."
29143,16/6/2016,India,Kashmir,1,0,1,Islamic terrorists murder a border guard.
29144,16/6/2016,Egypt,al-Arish,2,0,2,Two off-duty cops are gunned down in their own homes by four fundamentalists.
29145,16/6/2016,Libya,Abu Grein,10,7,17,An ISIS suicide bomb blast claims the lives of ten others.
29146,16/6/2016,Iraq,Fallujah,1,1,2,An ISIS sniper picks off a 2-year-old boy in his mother's arms.
29147,16/6/2016,Iraq,Shirqat,19,0,19,Nineteen civilians are pulled from their homes and executed by the Islamic State.
29148,16/6/2016,Iraq,Baghdad,2,4,6,Two people at a popular market are exterminated by Mujahideen bombers.
29149,16/6/2016,Iraq,Sinsil,4,0,4,Four people are stoned to death for adultery.
29150,16/6/2016,Syria,Mayadin,2,0,2,Two people are crucified for not fasting during Ramadan.
29151,16/6/2016,Pakistan,Peshawar,1,3,4,Religion of Peace roadside bombers take out a policeman.
29152,16/6/2016,Iraq,Birahmed,15,0,15,"An ISIS attack on a cluster of towns produces fifteen dead Iraqis, including a father and son."
29153,17/6/2016,Pakistan,Gujranwala,1,0,1,A conservative family slits the throat of a young mother who was seven months pregnant for marrying against their wishes.
29154,17/6/2016,Nigeria,Kuda,24,0,24,Twenty-four women are summarily shot dead at a funeral by Islamic extremists.
29155,17/6/2016,Iraq,Haj Ali,12,6,18,A dozen civilians at a displaced persons camp are pulled limb from limb by Jihadi bombers.
29156,17/6/2016,Pakistan,Burewala,2,0,2,A man returns from Haj and then honor kills his pregnant sister and her husband.
29157,17/6/2016,Niger,Ghafam,7,12,19,Seven 'apostates' are killed by Boko Haram at a displaced persons camp.
29158,17/6/2016,Iraq,Tuz Khurmatu,24,7,31,Two dozen people are reported killed following sustained ISIS assault that involved three suicide truck bombs.
29159,17/6/2016,Syria,Manbij,6,0,6,Two children are among six members of one family exterminated by firing squad for trying to flee the caliphate.
29160,17/6/2016,Pakistan,Sohbatpur,2,0,2,The Taliban is suspected of planted a landmine that claims the lives of two children.
29161,18/6/2016,Syria,Aleppo,7,0,7,Seven members of a Kurdish family are killed in a targeted bombing of their vehicle.
29162,18/6/2016,Syria,Sheikh Maqsoud,7,40,47,At least seven residents are aerated by Sunni shrapnel in their own neighborhood.
29163,18/6/2016,Iraq,Tuz Khurmatu,2,6,8,A street sweeper is among two people taken out by an ISIS suicide blast.
29164,18/6/2016,Iraq,Qayara,3,0,3,Three people are executed for trying to flee the caliphate.
29165,18/6/2016,Nigeria,Wumbi,2,0,2,"Islamists set fire to a village, killing two residents."
29166,19/6/2016,Thailand,Tak Bai,1,0,1,A 35-year-old woman is murdered by two Muslim militants.
29167,19/6/2016,Afghanistan,Tagab Yari,6,0,6,"Fundamentalists open fire on civilians eating during Ramadan, killing six."
29168,19/6/2016,Egypt,Hasna,1,1,2,Fundamentalists take down a local cop with an IED.
29169,19/6/2016,Syria,Latakia,1,0,1,An ISIS suicide bomber kills one other person.
29170,19/6/2016,Syria,Qamishi,3,5,8,At least three people are killed after a suicide bomber detonates at a memorial to massacred Christians.
29171,19/6/2016,Nigeria,Benue,18,0,18,Eighteen dead villagers are discovered following a raid by Fulani terrorists.
29172,19/6/2016,Iraq,Amrli,9,0,9,Nine Sunnis are executed by Shiite radicals.
29173,19/6/2016,Iraq,Mahmoudiya,2,9,11,Two people are left dead following a Mujahideen bomb blast at a popular market.
29174,20/6/2016,Kenya,Dimu,5,0,5,Five border guards are murdered by al-Shabaab extremists.
29175,20/6/2016,Afghanistan,Kabul,1,5,6,A politician is assassinated by Taliban bombers.
29176,20/6/2016,Afghanistan,Kabul,33,5,38,Thirty-three bus passengers are incinerated by a Shahid suicide bomber.
29177,20/6/2016,Afghanistan,Badakhshan,10,40,50,"Religious fanatics plant a motorcycle bomb at a crowded market that claims ten lives, including five children."
29178,20/6/2016,Iraq,Tuz Khurmatu,1,0,1,A Sunni is murdered at his office by Shiite radicals.
29179,20/6/2016,Kenya,Owane,1,3,4,An Islamist landmine kills an ambulance driver.
29180,20/6/2016,Iraq,Dibs,1,4,5,A bomb blast targeting a family fleeing the caliphate manages to kill one member.
29181,20/6/2016,Iraq,Taji,4,12,16,Four Iraqis are laid out by a Fedayeen suicide bomber.
29182,20/6/2016,Pakistan,Karachi,1,0,1,An Ahmadiyya doctor is gunned down in a targeted attack on a religious minority.
29183,20/6/2016,Sudan,Thur,4,0,4,"Suspected Arab militia attack a displaced persons camp and shoot four refugees to death, including a child."
29184,20/6/2016,Nigeria,Uzzar,8,0,8,Eight people are slaughtered by Muslim terrorists.
29185,20/6/2016,Egypt,al-Arish,1,0,1,Islamic fanatics kill a police officer in his own home.
29186,21/6/2016,Egypt,al-Arish,1,0,1,Another policeman is murdered in his own home by four religious extremists.
29187,21/6/2016,Nigeria,Vase,12,0,12,Six members of the same family are among a dozen butchered in cold blood by Fulani mercenaries.
29188,21/6/2016,Philippines,Sulu,3,0,3,Three accused apostates are beheaded by caliphate loyalists.
29189,21/6/2016,Jordan,Ruqban,6,14,20,"A suicide car bomber slams into a border gate, killing at least six others."
29190,21/6/2016,Somalia,Jowhar,1,0,1,An Islamist infiltrates a security detail and assassinates a government official.
29191,21/6/2016,Libya,Garabulli,29,30,59,An ISIS RPG fired at a group of fleeing civilians hits an armory.  Over two dozen are incinerated in the ensuing explosion.
29192,21/6/2016,Iraq,Souib,4,5,9,Four people at a checkpoint are torn to shreds by a Shahid suicide bomber.
29193,21/6/2016,Syria,Manbij,32,0,32,At least thirty people are killed by ISIS suicide bombers and executioners in a three day assault.
29194,21/6/2016,Iraq,Dor,5,35,40,A Sunni suicide bomber takes out five Shiites.
29195,21/6/2016,Iraq,Baghdad,2,3,5,Two Sunnis are cut down by more-radical Sunnis.
29196,22/6/2016,Pakistan,Karachi,1,1,2,A Sufi singer is gunned down in a targeted attack by radicals.
29197,22/6/2016,Afghanistan,Jalalabad,2,2,4,A Taliban bomb takes out a traffic cop and a commuter.
29198,22/6/2016,Egypt,al-Arish,1,1,2,A police officer is shot to death by Religion of Peace proponents.
29199,22/6/2016,Pakistan,Yakatoot,1,0,1,An official is shot to death outside a mosque by suspected extremists.
29200,22/6/2016,Afghanistan,Jund,4,1,5,An Afghan soldier gets religion and turns his gun on four colleagues.
29201,23/6/2016,Uganda,Lakabuku,1,0,1,Faithful Muslims murder a Christian widow for refusing to allow a mosque on her property.
29202,23/6/2016,Iraq,Tuz,2,3,5,Islamic State cadres murder an old man and his brother.
29203,23/6/2016,Syria,al-Bab,20,0,20,Twenty Kurds are executed for refusing to obey the Islamic State.
29204,23/6/2016,Syria,Maalula,1,0,1,Jihadists slit the throat of a Christian man in front of his wife.
29205,23/6/2016,Iraq,Naeima,2,1,3,A man and his son are killed when their house is burnt down by caliphate members.
29206,23/6/2016,Iraq,Baghdad,2,5,7,"Jihadis set off a bomb near a candy factory, killing two passersby."
29207,23/6/2016,Syria,Raqqa,1,0,1,"A man is stabbed, shot and crucified by the Islamic State."
29208,23/6/2016,Saudi Arabia,Riyadh,1,2,3,Two ISIS-supporting brothers stab their mother to death.
29209,24/6/2016,Pakistan,Quetta,3,32,35,The Taliban are suspected of a bomb blast in a shopping district that leaves three dead.
29210,24/6/2016,Saudi Arabia,Qatif,1,0,1,A local cop is gunned down by Shia radicals.
29211,24/6/2016,Cameroon,Gouzoudoum,4,2,6,Boko Haram kill four villagers and torch their homes.
29212,24/6/2016,Libya,Benghazi,4,14,18,Four civilians are killed when terrorists set off a car bomb in front of a hospital.
29213,24/6/2016,Iraq,Hawija,5,0,5,Five civilians are executed by ISIS at a popular market.
29214,24/6/2016,Afghanistan,Kot,8,12,20,At least eight civilians are killed when ISIS loyalists burn down a village.
29215,24/6/2016,Somalia,Yurkuk,5,0,5,Five farmers are killed during an al-Shabaab attack.
29216,25/6/2016,Somalia,Mogadishu,14,25,39,An al-Shabaab suicide bombing at a hotel claims the lives of fourteen employees and guests.
29217,25/6/2016,India,Pampore,8,24,32,"Lashkar-e-Taiba members pour machine-gun fire into a bus, killing eight passengers."
29218,25/6/2016,Syria,Raqqa,5,0,5,ISIS executed five journalists by forcing them to use cameras and computers rigged with explosives.
29219,25/6/2016,Pakistan,Lahore,0,1,1,Four Muslims gang-rape a Christian whose brother had eloped with a Muslim.
29220,25/6/2016,Syria,Deir Ezzor,4,0,4,ISIS hangs four young people while forcing their families to watch.
29221,25/6/2016,Bangladesh,Chittagong,1,0,1,A Hindu practitioner is beheaded by Religion of Peace radicals.
29222,26/6/2016,Egypt,Sheikh Zuweid,2,3,5,Two policemen are disassembled by an ISIS roadside bomb.
29223,26/6/2016,Iraq,Baghdad,2,1,3,Two civilians are blown to bits by Mujahideen bombers.
29224,26/6/2016,Thailand,Narathiwat,1,2,3,A shooting and bombing leave one dead and two injured.
29225,26/6/2016,Kuwait,Kuwait City,1,0,1,A man kills his own brother for not fasting and praying during Ramadan.
29226,27/6/2016,Lebanon,Qaa,6,19,25,Six people are left dead after four suicide bombers detonate at a small village.
29227,27/6/2016,Egypt,Sheikh Zuweid,1,0,1,A young policeman at a checkpoint is picked off by a long-range Islamist sniper.
29228,27/6/2016,Kenya,Dimu,5,4,9,Five border guards are murdered by al-Shabaab extremists.
29229,27/6/2016,Yemen,Mukalla,42,30,72,A woman and child are among over forty taken out by four suicide bombers.
29230,27/6/2016,Iraq,Fallujah,7,0,7,Seven people are found tortured to death by the Islamic State.
29231,27/6/2016,Iraq,Baghdad,2,5,7,Two people are leveled by a Jihadi bomb blast outside a row of shops.
29232,28/6/2016,Afghanistan,Kabul,1,0,1,A secular judge is gunned down by Sharia proponents.
29233,28/6/2016,Iraq,Abu Ghraib,14,32,46,At least a dozen worshippers are laid out by a suicide blast at a mosque.
29234,28/6/2016,Turkey,Istanbul,44,239,283,Three suicide bombers massacre over forty innocents at a busy airport.
29235,28/6/2016,Malaysia,Puchong,0,8,8,A grenade thrown into a Malaysian bar during Ramadan is the work of an Islamist.
29236,28/6/2016,Thailand,Muang,2,1,3,Muslim 'insurgents' gun down a father and son.
29237,28/6/2016,Iraq,Baghdad,4,0,4,"Terrorists fire on a suspected brothel, killing three women and a child."
29238,28/6/2016,Iraq,Sharqat,4,0,4,Four civilians are kidnapped and executed by the Islamic State.
29239,29/6/2016,Syria,Bokomal,5,0,5,Five young people are beheaded on video by the Islamic State.
29240,29/6/2016,Syria,Tal Abyad,10,25,35,A suicide car bomber targeting Kurdish civilians takes out ten.
29241,29/6/2016,Cameroon,Djakana,4,4,8,"A young suicide bomber detonates at a video club, killing four patrons."
29242,29/6/2016,Iraq,Abu Ghraib,3,7,10,Three patrons at a market are sectionalized by Mujahideen bombers.
29243,29/6/2016,Iraq,Sharqat,2,8,10,"ISIS mortar crews target refugees fleeing the violence, killing two."
29244,29/6/2016,Thailand,Narathiwat,1,3,4,A Muslim roadside bomb claims one life.
29245,29/6/2016,Mali,Timbuktu,3,6,9,al-Qaeda linked militants ambush and kill three local soldiers.
29246,30/6/2016,Nigeria,Obi,1,0,1,An evangelical pastor is hacked to death by militant Muslims.
29247,30/6/2016,Israel,Netanya,0,2,2,A mother shopping for her daughter's wedding dress is among two civilians stabbed by Muslim terrorists.
29248,30/6/2016,Bangladesh,Bandarban,1,0,1,A 55-year-old Buddhist leader is hacked to death by Religion of Peace proponents.
29249,30/6/2016,Afghanistan,Paghman,37,80,117,Two suicide bombers massacre thirty-seven souls in a coordinated attack on a group of buses.
29250,30/6/2016,Israel,Kiryat Arba,1,1,2,A 13-year-old girl is stabbed to death in her bedroom by a Palestinian terrorist.
29251,30/6/2016,Egypt,al-Arish,1,0,1,A Coptic priest is shot in the head by Muslim radicals.
29252,30/6/2016,Egypt,Rafah,2,1,3,Two security personnel are ambushed and killed by Islamists.
29253,30/6/2016,Somalia,Lafole,18,20,38,Eighteen passengers on a minibus are cooked alive by an Islamist roadside blast.
29254,30/6/2016,Cameroon,Limani,11,50,61,"A Fedayeen suicide bomber detonates at a rival mosque, taking eleven others with him."
29255,30/6/2016,Egypt,Farafra,6,3,9,"Islamic extremists open fire on two police vehicles, killing six officers."
29256,30/6/2016,Pakistan,Peshawar,3,6,9,Three security personnel are taken out in separate attacks by armed fundamentalists.
29257,30/6/2016,Iraq,Fallujah,4,5,9,"An Islamic State supporter sprays a group of policemen with automatic weapons fire, killing four."
29258,30/6/2016,Iraq,Baghdad,6,19,25,A Shahid suicide bomber takes out six bystanders at a popular market.
29259,30/6/2016,Bahrain,Manama,1,3,4,A bomb planted by suspected Shiites kills a woman and injures her three children.
29260,1/7/2016,Pakistan,Haripur,1,0,1,A man is shot dead by a conservative family for marrying their dauther without permission.
29261,1/7/2016,Iraq,Baghdad,5,30,35,Five people lose their lives to a Fedayeen suicide car bomber.
29262,1/7/2016,Kenya,Wak,6,2,8,Children are among six people on a bus brutally machine-gunned by religious radicals.
29263,1/7/2016,Bangladesh,Jhenaidah,1,0,1,A Hindu temple worker is hacked to death.
29264,1/7/2016,Israel,Hebron,1,3,4,"Palestinians fire on a family's vehicle, killing the father and injuring his wife and two children."
29265,1/7/2016,Somalia,Mogadishu,1,0,1,A moderate cleric is shot to death by more-radical co-religionists.
29266,1/7/2016,Afghanistan,Kandahar,5,0,5,Five local cops are gunned down by the Taliban.
29267,1/7/2016,Afghanistan,Shahwali Kot,7,0,7,Three woman are among a family of seven murdered in their home by Sunni militants.
29268,1/7/2016,Syria,Damascus,1,0,1,A pilot is murdered by Jaish-al-Islam.
29269,1/7/2016,Bangladesh,Dhaka,22,26,48,Seven terrorists take hostages at a restaurant and summarily execute all who cannot quote from the Quran.
29270,1/7/2016,Iraq,Tuz Khormato,2,4,6,A suicide attack at a Shiite mosque leaves two dead.
29271,2/7/2016,Syria,Elkheir,1,0,1,A man is brutally beheaded for 'pledging to infidels'.
29272,2/7/2016,Afghanistan,Jalalabad,2,17,19,A Shahid suicide bomber on a motorbike kills two bystanders.
29273,2/7/2016,Bangladesh,Satkhira,0,1,1,A Hindu priest is stabbed at a bakery by Muslim extremists.
29274,2/7/2016,Afghanistan,Khakrez,4,0,4,Four people are taken out by a Taliban bomb blast.
29275,2/7/2016,Afghanistan,Khorasan,3,0,3,Video shows three 'apostates' executed to religious music by child soldiers.
29276,2/7/2016,Somalia,Baidoa,2,19,21,"Two girls, ages 4 and 5, are disintegrated by an al-Shabaab mortar round."
29277,3/7/2016,Libya,Benghazi,2,0,2,A car bombing leaves two dead.
29278,3/7/2016,Iraq,Karrada,308,246,554,"A Fedayeen suicide bomber detonates in a shopping mall packed with Shiites, slaughtering over three hundred, including many children."
29279,3/7/2016,Iraq,Shaab,5,16,21,Jihadis set off a bomb in a commercial district that claims five lives.
29280,3/7/2016,Libya,Banghazi,2,7,9,"An ISIS car bomb explodes in a busy district, killing two traffic cops."
29281,3/7/2016,Iraq,Kirkuk,7,0,7,Seven civilians are executed by caliphate members.
29282,3/7/2016,Thailand,Yala,2,0,2,Two civilians are neatly taken out by Muslim bombers.
29283,3/7/2016,Syria,Raqqa,1,0,1,A man is beheaded for 'mocking Islam'.
29284,3/7/2016,Thailand,Pattani,1,2,3,One person is killed by a bomb left outside a mosque.
29285,3/7/2016,Iraq,Arabi,2,0,2,A father and son are executed by the Islamic State after three months in captivity.
29286,4/7/2016,Iraq,Tal Kaif,3,0,3,Three Kurds are executed by the Islamic State.
29287,4/7/2016,Iraq,Baghdad,2,9,11,A bomb near a popular market leaves two dead.
29288,4/7/2016,Saudi Arabia,Jeddah,0,2,2,A suicide bomber detonates near the US embassy.
29289,4/7/2016,Iraq,Sharqat,7,0,7,The Islamic State boils seven members alive.
29290,4/7/2016,Saudi Arabia,Medina,4,5,9,Four guards are killed by a suicide bomber outside Islam's second holiest mosque.
29291,5/7/2016,Thailand,Pattani,1,3,4,A bomb planted by Muslim militants in front of a police station leaves one dead.
29292,5/7/2016,DRC,Tenambo,9,0,9,Nine Christian villagers are murdered by ADF Islamists.
29293,5/7/2016,Indonesia,Surakarta,0,1,1,A suicide bomber detonates in front of a police station.
29294,5/7/2016,Thailand,Bannang Sata,1,0,1,"Militant Muslims launch a grenade from an M79 in front of a mosque, killing a passerby."
29295,5/7/2016,Syria,Hassakeh,30,40,70,A suicide bomber massacres thirty innocents outside a Shiite bakery.
29296,5/7/2016,Somalia,Galcad,2,0,2,Two staffers at a telecommunication company are beheaded by al-Shabaab.
29297,5/7/2016,Syria,Um al-Housh,40,0,40,Women and children are among forty civilians captured and 'mercilessly' executed by the Islamic State.
29298,5/7/2016,Syria,Raqqa,4,0,4,Four popular soccer players are forced to kneel and then shot in the head by caliphate members in front of children.
29299,5/7/2016,Iraq,Saidiya,3,12,15,"Jihadis send mortars into a displaced persons camp, killing three."
29300,5/7/2016,Thailand,Songkhla,1,2,3,Muslim 'insurgents' place a bomb that kills one other person.
29301,6/7/2016,Afghanistan,Sancharak,4,1,5,Four family members are wiped out by a Shahid suicide bomber.
29302,6/7/2016,India,Vijaywada,1,0,1,A teen is honor-killed by her conservative Muslim mother for having an affair with a Hindu boy.
29303,6/7/2016,Yemen,Aden,25,8,33,al-Qaeda suicide bombers take out over two dozen local soldiers.
29304,6/7/2016,Iraq,Mosul,6,0,6,Six people are beheaded by a Sharia court.
29305,6/7/2016,Syria,al-Zahraa,2,6,8,Two children are turned to paste by a Sunni rocket.
29306,6/7/2016,Syria,Aleppo,3,3,6,Three civilians are flattened by a Sunni mortar barrage.
29307,7/7/2016,Iraq,Balad,56,70,126,Fifty-six pilgrims are blown up by a Sunni suicide bomb attack on a Shiite shrine.
29308,7/7/2016,Bangladesh,Sholakia,4,12,16,A police officer is hacked to death and a woman is among four total killed by an Islamist attack during Eid prayers
29309,7/7/2016,Libya,Benghazi,12,35,47,A dozen souls are sent to Allah by a Shahid suicide bomber.
29310,8/7/2016,Nigeria,Damboa,9,12,21,"A suicide bomber strikes a rival mosque, killing at least nine."
29311,8/7/2016,Syria,Aleppo,34,200,234,"al-Nusra members send shells into a populated area, killing thirty-four civilians."
29312,8/7/2016,Syria,Tel Abyad,10,11,21,Women and children are among ten taken out by an ISIS suicide bombing at a popular market.
29313,9/7/2016,Nigeria,Rann,7,0,7,"Boko Haram invade a village, stealing food and gunning down seven residents."
29314,9/7/2016,Nigeria,Abuja,1,0,1,A female pastor is hacked to death by Muslim radicals who left her severed head on a Bible.
29315,9/7/2016,Iraq,Kirkuk,2,2,4,ISIS is suspected of a home invasion in which a moderate cleric and his family member are killed.
29316,9/7/2016,Iraq,Riyadh,3,0,3,Three Kurdish brothers are executed by the Islamic State.
29317,9/7/2016,Pakistan,Islamabad,1,1,2,The wife of a Shiite cleric is gunned down in a targeted attack.
29318,9/7/2016,Mali,Koro,2,0,2,Two guards at a checkpoint are machine-gunned point-blank by suspected Jihadis.
29319,9/7/2016,Bangladesh,Kajura,0,1,1,A Catholic nurse is set on fire by suspected Religion of Peace operatives.
29320,9/7/2016,Libya,Sirte,7,3,10,A secret ISIS prison is unearthed with seven bodies and three surviving torture victims.
29321,10/7/2016,Syria,Raqqa,5,0,5,Five civilians are beheaded in front of their families by the Islamic State.
29322,10/7/2016,India,Kashmir,3,96,99,"At least three security personnel are killed by a Muslim mob, angered over the death of a terrorist."
29323,10/7/2016,Iraq,Fallujah,46,0,46,"Forty-six Sunnis are burned alive by Hashd al-Shaabi, a Shiite milita."
29324,10/7/2016,Afghanistan,Kandahar,3,6,9,Three children are ripped apart by Taliban shrapnel.
29325,10/7/2016,Syria,Aleppo,5,61,66,"al-Nusra members sends a barrage of explosives into a residential neighborhood, laying out five civilians."
29326,10/7/2016,Nigeria,Benue,81,0,81,The death toll from two weeks of rolling Fulani attacks on peaceful farming communities rises to over 80.
29327,11/7/2016,Iraq,Nineveh,4,0,4,Four doctors are beheaded by the Islamic State.
29328,11/7/2016,Somalia,Mogadishu,1,6,7,An al-Shabaab bomb blast claims one life.
29329,11/7/2016,Somalia,Lanto Buro,11,6,17,At least eleven others are killed by a Fedayeen suicide car bomber.
29330,11/7/2016,Pakistan,Orangi,1,1,2,A woman is shot dead by her conservative brother-in-law for 'bringing dishonor' to the family.
29331,11/7/2016,Nigeria,Paikoro,11,0,11,Eleven people in two villages are hacked to death by Fulani terrorists.
29332,11/7/2016,India,Keran,1,2,3,A border guard is murdered by Muslim terrorists.
29333,11/7/2016,Iraq,Qayara,9,0,9,Women and the elderly are among nine members of two families dragged from their homes and executed by ISIS.
29334,11/7/2016,Pakistan,Parachinar,1,0,1,A young tribal leader is tortured and murdered by suspected militants.
29335,12/7/2016,Pakistan,Faisalabad,1,0,1,A Christian family man is murdered in a targeted attack by Muslim kidnappers.
29336,12/7/2016,Iraq,Baghdad,12,37,49,A dozen people at a vegetable and fruit market are reduced to pulp by a Shahid suicide bomber.
29337,12/7/2016,Philippines,Tipo-Tipo,1,5,6,One person is taken out by an Abu Sayyaf IED.
29338,12/7/2016,Nigeria,Akombo,5,0,5,A school principal is among five villagers murdered by Fulani terrorists.
29339,12/7/2016,Iraq,Mahmoudiya,3,10,13,Three shoppers are sectionalized by a Religion of Peace bomb blast at an outdoor market.
29340,12/7/2016,Nigeria,Kangarwa,2,7,9,A Boko Haram attack leaves two others dead.
29341,13/7/2016,Syria,Aleppo,1,0,1,A teenager is disassembled in his own home by a Sunni rocket.
29342,13/7/2016,Iraq,Baghdad,4,16,20,Two separate Mujahid blasts leave four dead.
29343,13/7/2016,Iraq,Quayyarah,1,2,3,A well-placed ISIS bomb takes out a journalist.
29344,13/7/2016,Iraq,Rashidiya,7,11,18,Seven Iraqis are laid out by a Fedayeen suicide bomber.
29345,13/7/2016,Iraq,Baqubah,2,0,2,Two people are killed in their own home by a suicide bomber.
29346,14/7/2016,Iraq,Meshahda,1,5,6,One other person is killed by a suicide bomber.
29347,14/7/2016,Iraq,Taji,3,4,7,Three Iraqis are blown to bits by a Fedayeen suicide bomber.
29348,14/7/2016,Pakistan,Bashirabad,1,0,1,A traffic cop is gunned down by religious radicals.
29349,14/7/2016,Philippines,Manilop,3,0,3,Three off-duty soldiers are ambushed and killed by Abu Sayyaf while buying food.
29350,14/7/2016,France,Nice,84,202,286,A Muslim migrant mows down eighty-four Bastille Day revellers (including ten children) with a truck while shouting praises to Allah.
29351,15/7/2016,India,Kulgam,1,7,8,"A terrorist lobs a grenade into a group of policemen, killing one."
29352,15/7/2016,Kenya,al-Wak,4,0,4,Four Kenyans lose the lives to an al-Shabaab ambush.
29353,15/7/2016,Iraq,Quayyarah,22,0,22,Twenty-two people are taken to a swamp and executed by the Islamic State.
29354,15/7/2016,Nigeria,Oke-Ogun,1,0,1,A Fulani man beats a shepherd to death and credits Allah.
29355,16/7/2016,Pakistan,Multan,1,0,1,A model is strangled to death by her brother after offending religious conservatives.
29356,16/7/2016,Iraq,Taji,3,6,9,Mujahideen detonate a bomb outside a market that leaves three dead.
29357,16/7/2016,Iraq,Tal Abta,5,0,5,Five civilians are burned alive in cages by Islamic State members.
29358,16/7/2016,Afghanistan,Kabul,1,2,3,A bomb attached to a vehicle kills one and injures two.
29359,16/7/2016,Kazakhstan,Kyzylorda,1,0,1,Two Islamic radicals kill a woman.
29360,16/7/2016,Syria,Aleppo,5,9,14,Two brothers are two women are among five civilians ripped to shreds by Sunni shrapnel.
29361,18/7/2016,Syria,Aleppo,3,15,18,"Sunnis send rockets into a residential neighborhood, taking out a child and two women."
29362,18/7/2016,Yemen,Mukalla,10,18,28,Ten people are blown to bits by a suicide car bomber.
29363,18/7/2016,Kazakhstan,Almaty,4,0,4,An extremist shouting praises to Allah murders a civilian and three policemen.
29364,18/7/2016,Germany,Wuerzburg,0,5,5,A 'refugee' with an axe hacks at people on a train while screaming 'Allah Akbar'.
